pid,seq,act,start,end,duration
0,0,<START>,0,0,0
0,1,home,0,7,7
0,2,work,7,14,7
0,3,shop,14,15,1
0,4,work,15,20,5
0,5,home,20,24,4
0,6,<ENDS>,24,24,0
1,0,<START>,0,0,0
1,1,home,0,7,7
1,2,work,7,14,7
1,3,shop,14,15,1
1,4,home,15,24,9
1,5,<ENDS>,24,24,0
2,0,<START>,0,0,0
2,1,home,0,7,7
2,2,work,7,14,7
2,3,home,14,18,4
2,4,shop,18,19,1
2,5,home,19,23,4
2,6,work,23,24,1
2,7,<ENDS>,24,24,0
3,0,<START>,0,0,0
3,1,home,0,8,8
3,2,work,8,13,5
3,3,home,13,24,11
3,4,<ENDS>,24,24,0
4,0,<START>,0,0,0
4,1,home,0,7,7
4,2,shop,7,8,1
4,3,work,8,17,9
4,4,home,17,24,7
4,5,<ENDS>,24,24,0
5,0,<START>,0,0,0
5,1,home,0,7,7
5,2,work,7,15,8
5,3,shop,15,16,1
5,4,home,16,22,6
5,5,work,22,23,1
5,6,home,23,24,1
5,7,<ENDS>,24,24,0
6,0,<START>,0,0,0
6,1,home,0,6,6
6,2,work,6,8,2
6,3,home,8,13,5
6,4,work,13,15,2
6,5,home,15,22,7
6,6,work,22,23,1
6,7,home,23,24,1
6,8,<ENDS>,24,24,0
7,0,<START>,0,0,0
7,1,home,0,7,7
7,2,work,7,14,7
7,3,home,14,24,10
7,4,<ENDS>,24,24,0
8,0,<START>,0,0,0
8,1,home,0,7,7
8,2,work,7,8,1
8,3,home,8,13,5
8,4,work,13,14,1
8,5,home,14,21,7
8,6,work,21,22,1
8,7,home,22,24,2
8,8,<ENDS>,24,24,0
9,0,<START>,0,0,0
9,1,home,0,7,7
9,2,work,7,13,6
9,3,shop,13,14,1
9,4,education,14,16,2
9,5,home,16,24,8
9,6,<ENDS>,24,24,0
10,0,<START>,0,0,0
10,1,home,0,7,7
10,2,shop,7,8,1
10,3,home,8,21,13
10,4,work,21,22,1
10,5,home,22,24,2
10,6,<ENDS>,24,24,0
11,0,<START>,0,0,0
11,1,home,0,7,7
11,2,work,7,13,6
11,3,home,13,22,9
11,4,work,22,23,1
11,5,home,23,24,1
11,6,<ENDS>,24,24,0
12,0,<START>,0,0,0
12,1,home,0,7,7
12,2,work,7,9,2
12,3,home,9,14,5
12,4,work,14,16,2
12,5,home,16,23,7
12,6,work,23,24,1
12,7,<ENDS>,24,24,0
13,0,<START>,0,0,0
13,1,home,0,8,8
13,2,work,8,13,5
13,3,shop,13,14,1
13,4,home,14,21,7
13,5,work,21,22,1
13,6,home,22,24,2
13,7,<ENDS>,24,24,0
14,0,<START>,0,0,0
14,1,home,0,6,6
14,2,work,6,13,7
14,3,shop,13,14,1
14,4,work,14,19,5
14,5,home,19,24,5
14,6,<ENDS>,24,24,0
15,0,<START>,0,0,0
15,1,home,0,6,6
15,2,work,6,8,2
15,3,home,8,14,6
15,4,work,14,16,2
15,5,home,16,23,7
15,6,work,23,24,1
15,7,<ENDS>,24,24,0
16,0,<START>,0,0,0
16,1,home,0,6,6
16,2,shop,6,7,1
16,3,home,7,9,2
16,4,education,9,13,4
16,5,work,13,19,6
16,6,home,19,24,5
16,7,<ENDS>,24,24,0
17,0,<START>,0,0,0
17,1,home,0,8,8
17,2,work,8,15,7
17,3,home,15,24,9
17,4,<ENDS>,24,24,0
18,0,<START>,0,0,0
18,1,home,0,6,6
18,2,work,6,13,7
18,3,shop,13,14,1
18,4,home,14,18,4
18,5,work,18,20,2
18,6,home,20,24,4
18,7,<ENDS>,24,24,0
19,0,<START>,0,0,0
19,1,home,0,8,8
19,2,work,8,15,7
19,3,home,15,24,9
19,4,<ENDS>,24,24,0
20,0,<START>,0,0,0
20,1,home,0,7,7
20,2,work,7,13,6
20,3,shop,13,14,1
20,4,home,14,24,10
20,5,<ENDS>,24,24,0
21,0,<START>,0,0,0
21,1,home,0,8,8
21,2,work,8,15,7
21,3,home,15,21,6
21,4,work,21,22,1
21,5,home,22,24,2
21,6,<ENDS>,24,24,0
22,0,<START>,0,0,0
22,1,home,0,8,8
22,2,work,8,14,6
22,3,shop,14,15,1
22,4,work,15,20,5
22,5,home,20,24,4
22,6,<ENDS>,24,24,0
23,0,<START>,0,0,0
23,1,home,0,7,7
23,2,work,7,14,7
23,3,home,14,24,10
23,4,<ENDS>,24,24,0
24,0,<START>,0,0,0
24,1,home,0,8,8
24,2,work,8,14,6
24,3,home,14,19,5
24,4,shop,19,20,1
24,5,home,20,24,4
24,6,<ENDS>,24,24,0
25,0,<START>,0,0,0
25,1,home,0,7,7
25,2,work,7,13,6
25,3,home,13,24,11
25,4,<ENDS>,24,24,0
26,0,<START>,0,0,0
26,1,home,0,6,6
26,2,shop,6,7,1
26,3,home,7,14,7
26,4,education,14,16,2
26,5,home,16,24,8
26,6,<ENDS>,24,24,0
27,0,<START>,0,0,0
27,1,home,0,9,9
27,2,work,9,16,7
27,3,home,16,24,8
27,4,<ENDS>,24,24,0
28,0,<START>,0,0,0
28,1,home,0,8,8
28,2,shop,8,9,1
28,3,education,9,12,3
28,4,shop,12,14,2
28,5,education,14,16,2
28,6,home,16,24,8
28,7,<ENDS>,24,24,0
29,0,<START>,0,0,0
29,1,home,0,7,7
29,2,education,7,12,5
29,3,shop,12,14,2
29,4,education,14,16,2
29,5,shop,16,17,1
29,6,home,17,24,7
29,7,<ENDS>,24,24,0
30,0,<START>,0,0,0
30,1,home,0,7,7
30,2,work,7,13,6
30,3,shop,13,14,1
30,4,home,14,23,9
30,5,work,23,24,1
30,6,<ENDS>,24,24,0
31,0,<START>,0,0,0
31,1,home,0,6,6
31,2,work,6,13,7
31,3,home,13,16,3
31,4,work,16,20,4
31,5,home,20,24,4
31,6,<ENDS>,24,24,0
32,0,<START>,0,0,0
32,1,home,0,6,6
32,2,shop,6,7,1
32,3,work,7,9,2
32,4,home,9,13,4
32,5,work,13,14,1
32,6,home,14,21,7
32,7,work,21,22,1
32,8,home,22,24,2
32,9,<ENDS>,24,24,0
33,0,<START>,0,0,0
33,1,home,0,8,8
33,2,work,8,14,6
33,3,home,14,24,10
33,4,<ENDS>,24,24,0
34,0,<START>,0,0,0
34,1,home,0,6,6
34,2,work,6,13,7
34,3,home,13,24,11
34,4,<ENDS>,24,24,0
35,0,<START>,0,0,0
35,1,home,0,8,8
35,2,work,8,15,7
35,3,home,15,24,9
35,4,<ENDS>,24,24,0
36,0,<START>,0,0,0
36,1,home,0,7,7
36,2,education,7,11,4
36,3,home,11,17,6
36,4,shop,17,19,2
36,5,home,19,24,5
36,6,<ENDS>,24,24,0
37,0,<START>,0,0,0
37,1,home,0,7,7
37,2,shop,7,8,1
37,3,education,8,14,6
37,4,shop,14,15,1
37,5,home,15,24,9
37,6,<ENDS>,24,24,0
38,0,<START>,0,0,0
38,1,home,0,7,7
38,2,work,7,13,6
38,3,home,13,24,11
38,4,<ENDS>,24,24,0
39,0,<START>,0,0,0
39,1,home,0,7,7
39,2,work,7,13,6
39,3,home,13,17,4
39,4,work,17,20,3
39,5,home,20,24,4
39,6,<ENDS>,24,24,0
40,0,<START>,0,0,0
40,1,home,0,6,6
40,2,work,6,13,7
40,3,home,13,17,4
40,4,shop,17,18,1
40,5,home,18,24,6
40,6,<ENDS>,24,24,0
41,0,<START>,0,0,0
41,1,home,0,7,7
41,2,education,7,11,4
41,3,home,11,14,3
41,4,education,14,16,2
41,5,home,16,19,3
41,6,shop,19,20,1
41,7,home,20,24,4
41,8,<ENDS>,24,24,0
42,0,<START>,0,0,0
42,1,home,0,6,6
42,2,shop,6,7,1
42,3,home,7,10,3
42,4,education,10,11,1
42,5,home,11,18,7
42,6,shop,18,19,1
42,7,home,19,24,5
42,8,<ENDS>,24,24,0
43,0,<START>,0,0,0
43,1,home,0,6,6
43,2,shop,6,7,1
43,3,work,7,14,7
43,4,shop,14,15,1
43,5,home,15,22,7
43,6,work,22,23,1
43,7,home,23,24,1
43,8,<ENDS>,24,24,0
44,0,<START>,0,0,0
44,1,home,0,8,8
44,2,work,8,14,6
44,3,shop,14,15,1
44,4,home,15,24,9
44,5,<ENDS>,24,24,0
45,0,<START>,0,0,0
45,1,home,0,7,7
45,2,work,7,14,7
45,3,home,14,18,4
45,4,work,18,20,2
45,5,home,20,24,4
45,6,<ENDS>,24,24,0
46,0,<START>,0,0,0
46,1,home,0,7,7
46,2,shop,7,8,1
46,3,work,8,14,6
46,4,home,14,24,10
46,5,<ENDS>,24,24,0
47,0,<START>,0,0,0
47,1,home,0,7,7
47,2,shop,7,8,1
47,3,home,8,9,1
47,4,work,9,13,4
47,5,home,13,15,2
47,6,work,15,20,5
47,7,home,20,24,4
47,8,<ENDS>,24,24,0
48,0,<START>,0,0,0
48,1,home,0,6,6
48,2,shop,6,7,1
48,3,home,7,9,2
48,4,education,9,11,2
48,5,home,11,17,6
48,6,shop,17,18,1
48,7,home,18,24,6
48,8,<ENDS>,24,24,0
49,0,<START>,0,0,0
49,1,home,0,7,7
49,2,shop,7,8,1
49,3,home,8,13,5
49,4,work,13,19,6
49,5,home,19,24,5
49,6,<ENDS>,24,24,0
50,0,<START>,0,0,0
50,1,home,0,7,7
50,2,work,7,15,8
50,3,home,15,24,9
50,4,<ENDS>,24,24,0
51,0,<START>,0,0,0
51,1,home,0,6,6
51,2,shop,6,7,1
51,3,home,7,12,5
51,4,work,12,19,7
51,5,home,19,24,5
51,6,<ENDS>,24,24,0
52,0,<START>,0,0,0
52,1,home,0,6,6
52,2,work,6,13,7
52,3,home,13,20,7
52,4,shop,20,21,1
52,5,home,21,24,3
52,6,<ENDS>,24,24,0
53,0,<START>,0,0,0
53,1,home,0,7,7
53,2,shop,7,8,1
53,3,education,8,11,3
53,4,home,11,19,8
53,5,shop,19,20,1
53,6,home,20,24,4
53,7,<ENDS>,24,24,0
54,0,<START>,0,0,0
54,1,home,0,7,7
54,2,work,7,14,7
54,3,home,14,24,10
54,4,<ENDS>,24,24,0
55,0,<START>,0,0,0
55,1,home,0,7,7
55,2,work,7,13,6
55,3,shop,13,14,1
55,4,work,14,20,6
55,5,home,20,24,4
55,6,<ENDS>,24,24,0
56,0,<START>,0,0,0
56,1,home,0,7,7
56,2,work,7,14,7
56,3,home,14,24,10
56,4,<ENDS>,24,24,0
57,0,<START>,0,0,0
57,1,home,0,8,8
57,2,education,8,11,3
57,3,home,11,16,5
57,4,work,16,20,4
57,5,home,20,24,4
57,6,<ENDS>,24,24,0
58,0,<START>,0,0,0
58,1,home,0,9,9
58,2,work,9,16,7
58,3,shop,16,17,1
58,4,home,17,24,7
58,5,<ENDS>,24,24,0
59,0,<START>,0,0,0
59,1,home,0,7,7
59,2,work,7,13,6
59,3,shop,13,14,1
59,4,work,14,20,6
59,5,home,20,24,4
59,6,<ENDS>,24,24,0
60,0,<START>,0,0,0
60,1,home,0,6,6
60,2,work,6,12,6
60,3,shop,12,13,1
60,4,work,13,19,6
60,5,home,19,24,5
60,6,<ENDS>,24,24,0
61,0,<START>,0,0,0
61,1,home,0,6,6
61,2,work,6,13,7
61,3,home,13,17,4
61,4,work,17,19,2
61,5,home,19,24,5
61,6,<ENDS>,24,24,0
62,0,<START>,0,0,0
62,1,home,0,7,7
62,2,work,7,14,7
62,3,home,14,18,4
62,4,work,18,20,2
62,5,home,20,24,4
62,6,<ENDS>,24,24,0
63,0,<START>,0,0,0
63,1,home,0,6,6
63,2,work,6,13,7
63,3,home,13,17,4
63,4,work,17,19,2
63,5,home,19,24,5
63,6,<ENDS>,24,24,0
64,0,<START>,0,0,0
64,1,home,0,7,7
64,2,work,7,13,6
64,3,home,13,18,5
64,4,shop,18,19,1
64,5,home,19,24,5
64,6,<ENDS>,24,24,0
65,0,<START>,0,0,0
65,1,home,0,6,6
65,2,work,6,7,1
65,3,home,7,12,5
65,4,work,12,14,2
65,5,home,14,22,8
65,6,work,22,23,1
65,7,home,23,24,1
65,8,<ENDS>,24,24,0
66,0,<START>,0,0,0
66,1,home,0,6,6
66,2,work,6,13,7
66,3,home,13,21,8
66,4,work,21,22,1
66,5,home,22,24,2
66,6,<ENDS>,24,24,0
67,0,<START>,0,0,0
67,1,home,0,6,6
67,2,shop,6,7,1
67,3,home,7,9,2
67,4,education,9,11,2
67,5,home,11,18,7
67,6,shop,18,19,1
67,7,home,19,24,5
67,8,<ENDS>,24,24,0
68,0,<START>,0,0,0
68,1,home,0,7,7
68,2,work,7,14,7
68,3,home,14,24,10
68,4,<ENDS>,24,24,0
69,0,<START>,0,0,0
69,1,home,0,7,7
69,2,work,7,13,6
69,3,shop,13,14,1
69,4,work,14,20,6
69,5,home,20,24,4
69,6,<ENDS>,24,24,0
70,0,<START>,0,0,0
70,1,home,0,6,6
70,2,work,6,13,7
70,3,home,13,17,4
70,4,work,17,20,3
70,5,home,20,24,4
70,6,<ENDS>,24,24,0
71,0,<START>,0,0,0
71,1,home,0,8,8
71,2,shop,8,9,1
71,3,education,9,12,3
71,4,shop,12,14,2
71,5,education,14,16,2
71,6,home,16,24,8
71,7,<ENDS>,24,24,0
72,0,<START>,0,0,0
72,1,home,0,8,8
72,2,work,8,13,5
72,3,home,13,17,4
72,4,shop,17,18,1
72,5,home,18,24,6
72,6,<ENDS>,24,24,0
73,0,<START>,0,0,0
73,1,home,0,7,7
73,2,shop,7,8,1
73,3,education,8,11,3
73,4,home,11,19,8
73,5,shop,19,20,1
73,6,home,20,24,4
73,7,<ENDS>,24,24,0
74,0,<START>,0,0,0
74,1,home,0,8,8
74,2,work,8,14,6
74,3,home,14,22,8
74,4,work,22,23,1
74,5,home,23,24,1
74,6,<ENDS>,24,24,0
75,0,<START>,0,0,0
75,1,home,0,6,6
75,2,work,6,8,2
75,3,home,8,12,4
75,4,work,12,14,2
75,5,home,14,21,7
75,6,work,21,22,1
75,7,home,22,24,2
75,8,<ENDS>,24,24,0
76,0,<START>,0,0,0
76,1,home,0,8,8
76,2,education,8,12,4
76,3,shop,12,14,2
76,4,home,14,19,5
76,5,shop,19,20,1
76,6,home,20,24,4
76,7,<ENDS>,24,24,0
77,0,<START>,0,0,0
77,1,home,0,9,9
77,2,work,9,15,6
77,3,home,15,21,6
77,4,work,21,22,1
77,5,home,22,24,2
77,6,<ENDS>,24,24,0
78,0,<START>,0,0,0
78,1,home,0,8,8
78,2,work,8,15,7
78,3,home,15,24,9
78,4,<ENDS>,24,24,0
79,0,<START>,0,0,0
79,1,home,0,7,7
79,2,education,7,11,4
79,3,home,11,17,6
79,4,shop,17,18,1
79,5,home,18,24,6
79,6,<ENDS>,24,24,0
80,0,<START>,0,0,0
80,1,home,0,7,7
80,2,work,7,14,7
80,3,shop,14,15,1
80,4,home,15,24,9
80,5,<ENDS>,24,24,0
81,0,<START>,0,0,0
81,1,home,0,6,6
81,2,work,6,8,2
81,3,home,8,11,3
81,4,work,11,13,2
81,5,home,13,21,8
81,6,work,21,22,1
81,7,home,22,24,2
81,8,<ENDS>,24,24,0
82,0,<START>,0,0,0
82,1,home,0,6,6
82,2,work,6,13,7
82,3,home,13,17,4
82,4,work,17,20,3
82,5,home,20,24,4
82,6,<ENDS>,24,24,0
83,0,<START>,0,0,0
83,1,home,0,7,7
83,2,shop,7,8,1
83,3,work,8,15,7
83,4,home,15,24,9
83,5,<ENDS>,24,24,0
84,0,<START>,0,0,0
84,1,home,0,7,7
84,2,work,7,13,6
84,3,shop,13,14,1
84,4,work,14,20,6
84,5,home,20,24,4
84,6,<ENDS>,24,24,0
85,0,<START>,0,0,0
85,1,home,0,7,7
85,2,work,7,14,7
85,3,shop,14,15,1
85,4,home,15,24,9
85,5,<ENDS>,24,24,0
86,0,<START>,0,0,0
86,1,home,0,6,6
86,2,work,6,13,7
86,3,shop,13,14,1
86,4,home,14,24,10
86,5,<ENDS>,24,24,0
87,0,<START>,0,0,0
87,1,home,0,7,7
87,2,work,7,13,6
87,3,home,13,17,4
87,4,shop,17,18,1
87,5,home,18,22,4
87,6,work,22,23,1
87,7,home,23,24,1
87,8,<ENDS>,24,24,0
88,0,<START>,0,0,0
88,1,home,0,6,6
88,2,shop,6,7,1
88,3,home,7,13,6
88,4,education,13,16,3
88,5,shop,16,17,1
88,6,home,17,24,7
88,7,<ENDS>,24,24,0
89,0,<START>,0,0,0
89,1,home,0,6,6
89,2,work,6,12,6
89,3,shop,12,13,1
89,4,work,13,19,6
89,5,home,19,24,5
89,6,<ENDS>,24,24,0
90,0,<START>,0,0,0
90,1,home,0,6,6
90,2,shop,6,7,1
90,3,home,7,8,1
90,4,education,8,11,3
90,5,home,11,17,6
90,6,shop,17,18,1
90,7,home,18,24,6
90,8,<ENDS>,24,24,0
91,0,<START>,0,0,0
91,1,home,0,7,7
91,2,work,7,9,2
91,3,home,9,12,3
91,4,work,12,13,1
91,5,home,13,20,7
91,6,shop,20,21,1
91,7,home,21,24,3
91,8,<ENDS>,24,24,0
92,0,<START>,0,0,0
92,1,work,0,9,9
92,2,shop,9,11,2
92,3,home,11,24,13
92,4,<ENDS>,24,24,0
93,0,<START>,0,0,0
93,1,home,0,7,7
93,2,work,7,14,7
93,3,home,14,18,4
93,4,work,18,20,2
93,5,home,20,24,4
93,6,<ENDS>,24,24,0
94,0,<START>,0,0,0
94,1,home,0,8,8
94,2,work,8,15,7
94,3,home,15,23,8
94,4,work,23,24,1
94,5,<ENDS>,24,24,0
95,0,<START>,0,0,0
95,1,home,0,7,7
95,2,work,7,13,6
95,3,home,13,24,11
95,4,<ENDS>,24,24,0
96,0,<START>,0,0,0
96,1,home,0,7,7
96,2,education,7,11,4
96,3,home,11,18,7
96,4,shop,18,19,1
96,5,home,19,24,5
96,6,<ENDS>,24,24,0
97,0,<START>,0,0,0
97,1,home,0,7,7
97,2,education,7,12,5
97,3,home,12,18,6
97,4,shop,18,19,1
97,5,home,19,24,5
97,6,<ENDS>,24,24,0
98,0,<START>,0,0,0
98,1,home,0,7,7
98,2,work,7,9,2
98,3,home,9,13,4
98,4,work,13,15,2
98,5,shop,15,16,1
98,6,work,16,18,2
98,7,home,18,23,5
98,8,work,23,24,1
98,9,<ENDS>,24,24,0
99,0,<START>,0,0,0
99,1,home,0,6,6
99,2,work,6,8,2
99,3,home,8,14,6
99,4,work,14,16,2
99,5,home,16,22,6
99,6,work,22,23,1
99,7,home,23,24,1
99,8,<ENDS>,24,24,0
100,0,<START>,0,0,0
100,1,home,0,7,7
100,2,shop,7,9,2
100,3,education,9,12,3
100,4,home,12,19,7
100,5,shop,19,20,1
100,6,home,20,24,4
100,7,<ENDS>,24,24,0
101,0,<START>,0,0,0
101,1,home,0,8,8
101,2,shop,8,9,1
101,3,home,9,10,1
101,4,work,10,17,7
101,5,home,17,24,7
101,6,<ENDS>,24,24,0
102,0,<START>,0,0,0
102,1,home,0,7,7
102,2,shop,7,8,1
102,3,education,8,12,4
102,4,home,12,19,7
102,5,shop,19,20,1
102,6,home,20,24,4
102,7,<ENDS>,24,24,0
103,0,<START>,0,0,0
103,1,home,0,7,7
103,2,work,7,14,7
103,3,home,14,16,2
103,4,shop,16,17,1
103,5,home,17,24,7
103,6,<ENDS>,24,24,0
104,0,<START>,0,0,0
104,1,home,0,7,7
104,2,shop,7,9,2
104,3,education,9,12,3
104,4,home,12,20,8
104,5,shop,20,21,1
104,6,home,21,24,3
104,7,<ENDS>,24,24,0
105,0,<START>,0,0,0
105,1,home,0,6,6
105,2,work,6,13,7
105,3,shop,13,14,1
105,4,work,14,19,5
105,5,home,19,24,5
105,6,<ENDS>,24,24,0
106,0,<START>,0,0,0
106,1,home,0,7,7
106,2,work,7,14,7
106,3,shop,14,15,1
106,4,home,15,24,9
106,5,<ENDS>,24,24,0
107,0,<START>,0,0,0
107,1,home,0,7,7
107,2,work,7,13,6
107,3,home,13,17,4
107,4,shop,17,18,1
107,5,home,18,24,6
107,6,<ENDS>,24,24,0
108,0,<START>,0,0,0
108,1,home,0,8,8
108,2,education,8,11,3
108,3,home,11,15,4
108,4,work,15,20,5
108,5,home,20,24,4
108,6,<ENDS>,24,24,0
109,0,<START>,0,0,0
109,1,home,0,8,8
109,2,work,8,15,7
109,3,shop,15,16,1
109,4,home,16,24,8
109,5,<ENDS>,24,24,0
110,0,<START>,0,0,0
110,1,home,0,9,9
110,2,work,9,16,7
110,3,home,16,24,8
110,4,<ENDS>,24,24,0
111,0,<START>,0,0,0
111,1,home,0,9,9
111,2,work,9,16,7
111,3,home,16,24,8
111,4,<ENDS>,24,24,0
112,0,<START>,0,0,0
112,1,home,0,7,7
112,2,work,7,13,6
112,3,home,13,17,4
112,4,work,17,20,3
112,5,home,20,24,4
112,6,<ENDS>,24,24,0
113,0,<START>,0,0,0
113,1,home,0,8,8
113,2,work,8,15,7
113,3,home,15,24,9
113,4,<ENDS>,24,24,0
114,0,<START>,0,0,0
114,1,home,0,9,9
114,2,work,9,16,7
114,3,home,16,24,8
114,4,<ENDS>,24,24,0
115,0,<START>,0,0,0
115,1,home,0,6,6
115,2,work,6,8,2
115,3,home,8,13,5
115,4,work,13,15,2
115,5,home,15,22,7
115,6,work,22,23,1
115,7,home,23,24,1
115,8,<ENDS>,24,24,0
116,0,<START>,0,0,0
116,1,home,0,7,7
116,2,work,7,14,7
116,3,shop,14,15,1
116,4,home,15,23,8
116,5,work,23,24,1
116,6,<ENDS>,24,24,0
117,0,<START>,0,0,0
117,1,home,0,7,7
117,2,shop,7,8,1
117,3,work,8,15,7
117,4,home,15,17,2
117,5,shop,17,18,1
117,6,home,18,24,6
117,7,<ENDS>,24,24,0
118,0,<START>,0,0,0
118,1,home,0,6,6
118,2,shop,6,7,1
118,3,work,7,14,7
118,4,shop,14,15,1
118,5,home,15,22,7
118,6,work,22,23,1
118,7,home,23,24,1
118,8,<ENDS>,24,24,0
119,0,<START>,0,0,0
119,1,home,0,6,6
119,2,work,6,13,7
119,3,home,13,24,11
119,4,<ENDS>,24,24,0
120,0,<START>,0,0,0
120,1,home,0,6,6
120,2,work,6,14,8
120,3,shop,14,15,1
120,4,home,15,24,9
120,5,<ENDS>,24,24,0
121,0,<START>,0,0,0
121,1,home,0,6,6
121,2,work,6,8,2
121,3,home,8,15,7
121,4,work,15,17,2
121,5,home,17,22,5
121,6,work,22,23,1
121,7,home,23,24,1
121,8,<ENDS>,24,24,0
122,0,<START>,0,0,0
122,1,home,0,7,7
122,2,work,7,9,2
122,3,home,9,13,4
122,4,work,13,15,2
122,5,home,15,22,7
122,6,work,22,23,1
122,7,home,23,24,1
122,8,<ENDS>,24,24,0
123,0,<START>,0,0,0
123,1,home,0,8,8
123,2,work,8,15,7
123,3,home,15,22,7
123,4,work,22,23,1
123,5,home,23,24,1
123,6,<ENDS>,24,24,0
124,0,<START>,0,0,0
124,1,home,0,9,9
124,2,education,9,12,3
124,3,home,12,24,12
124,4,<ENDS>,24,24,0
125,0,<START>,0,0,0
125,1,home,0,7,7
125,2,education,7,11,4
125,3,home,11,17,6
125,4,shop,17,18,1
125,5,home,18,24,6
125,6,<ENDS>,24,24,0
126,0,<START>,0,0,0
126,1,home,0,8,8
126,2,education,8,12,4
126,3,home,12,24,12
126,4,<ENDS>,24,24,0
127,0,<START>,0,0,0
127,1,home,0,7,7
127,2,work,7,13,6
127,3,shop,13,14,1
127,4,work,14,19,5
127,5,home,19,24,5
127,6,<ENDS>,24,24,0
128,0,<START>,0,0,0
128,1,home,0,7,7
128,2,shop,7,8,1
128,3,home,8,14,6
128,4,work,14,20,6
128,5,home,20,24,4
128,6,<ENDS>,24,24,0
129,0,<START>,0,0,0
129,1,home,0,7,7
129,2,work,7,13,6
129,3,shop,13,14,1
129,4,education,14,17,3
129,5,home,17,24,7
129,6,<ENDS>,24,24,0
130,0,<START>,0,0,0
130,1,home,0,7,7
130,2,work,7,13,6
130,3,shop,13,14,1
130,4,home,14,24,10
130,5,<ENDS>,24,24,0
131,0,<START>,0,0,0
131,1,home,0,8,8
131,2,work,8,15,7
131,3,shop,15,16,1
131,4,work,16,20,4
131,5,home,20,24,4
131,6,<ENDS>,24,24,0
132,0,<START>,0,0,0
132,1,home,0,7,7
132,2,work,7,13,6
132,3,shop,13,14,1
132,4,work,14,20,6
132,5,home,20,24,4
132,6,<ENDS>,24,24,0
133,0,<START>,0,0,0
133,1,home,0,7,7
133,2,work,7,13,6
133,3,shop,13,14,1
133,4,work,14,19,5
133,5,home,19,24,5
133,6,<ENDS>,24,24,0
134,0,<START>,0,0,0
134,1,home,0,7,7
134,2,work,7,9,2
134,3,home,9,15,6
134,4,work,15,16,1
134,5,home,16,21,5
134,6,work,21,22,1
134,7,home,22,24,2
134,8,<ENDS>,24,24,0
135,0,<START>,0,0,0
135,1,home,0,7,7
135,2,work,7,14,7
135,3,home,14,24,10
135,4,<ENDS>,24,24,0
136,0,<START>,0,0,0
136,1,home,0,8,8
136,2,work,8,15,7
136,3,home,15,19,4
136,4,shop,19,20,1
136,5,home,20,24,4
136,6,<ENDS>,24,24,0
137,0,<START>,0,0,0
137,1,home,0,7,7
137,2,work,7,13,6
137,3,home,13,24,11
137,4,<ENDS>,24,24,0
138,0,<START>,0,0,0
138,1,home,0,7,7
138,2,work,7,13,6
138,3,home,13,24,11
138,4,<ENDS>,24,24,0
139,0,<START>,0,0,0
139,1,home,0,7,7
139,2,shop,7,9,2
139,3,education,9,12,3
139,4,home,12,18,6
139,5,shop,18,20,2
139,6,home,20,24,4
139,7,<ENDS>,24,24,0
140,0,<START>,0,0,0
140,1,home,0,8,8
140,2,work,8,15,7
140,3,home,15,21,6
140,4,work,21,22,1
140,5,home,22,24,2
140,6,<ENDS>,24,24,0
141,0,<START>,0,0,0
141,1,home,0,7,7
141,2,shop,7,8,1
141,3,education,8,11,3
141,4,home,11,18,7
141,5,shop,18,19,1
141,6,home,19,24,5
141,7,<ENDS>,24,24,0
142,0,<START>,0,0,0
142,1,home,0,7,7
142,2,education,7,11,4
142,3,home,11,17,6
142,4,shop,17,18,1
142,5,home,18,24,6
142,6,<ENDS>,24,24,0
143,0,<START>,0,0,0
143,1,home,0,6,6
143,2,shop,6,7,1
143,3,home,7,10,3
143,4,education,10,16,6
143,5,home,16,24,8
143,6,<ENDS>,24,24,0
144,0,<START>,0,0,0
144,1,home,0,8,8
144,2,education,8,13,5
144,3,work,13,19,6
144,4,home,19,24,5
144,5,<ENDS>,24,24,0
145,0,<START>,0,0,0
145,1,home,0,7,7
145,2,education,7,11,4
145,3,home,11,18,7
145,4,shop,18,20,2
145,5,home,20,24,4
145,6,<ENDS>,24,24,0
146,0,<START>,0,0,0
146,1,home,0,7,7
146,2,work,7,13,6
146,3,home,13,22,9
146,4,work,22,23,1
146,5,home,23,24,1
146,6,<ENDS>,24,24,0
147,0,<START>,0,0,0
147,1,home,0,8,8
147,2,work,8,14,6
147,3,shop,14,15,1
147,4,home,15,24,9
147,5,<ENDS>,24,24,0
148,0,<START>,0,0,0
148,1,home,0,8,8
148,2,work,8,16,8
148,3,shop,16,17,1
148,4,work,17,20,3
148,5,home,20,24,4
148,6,<ENDS>,24,24,0
149,0,<START>,0,0,0
149,1,home,0,7,7
149,2,work,7,14,7
149,3,home,14,24,10
149,4,<ENDS>,24,24,0
150,0,<START>,0,0,0
150,1,home,0,6,6
150,2,work,6,13,7
150,3,shop,13,14,1
150,4,home,14,24,10
150,5,<ENDS>,24,24,0
151,0,<START>,0,0,0
151,1,home,0,6,6
151,2,work,6,8,2
151,3,home,8,14,6
151,4,work,14,17,3
151,5,home,17,24,7
151,6,<ENDS>,24,24,0
152,0,<START>,0,0,0
152,1,home,0,6,6
152,2,work,6,8,2
152,3,home,8,14,6
152,4,work,14,16,2
152,5,home,16,22,6
152,6,work,22,23,1
152,7,home,23,24,1
152,8,<ENDS>,24,24,0
153,0,<START>,0,0,0
153,1,home,0,6,6
153,2,work,6,13,7
153,3,home,13,17,4
153,4,shop,17,18,1
153,5,home,18,23,5
153,6,work,23,24,1
153,7,<ENDS>,24,24,0
154,0,<START>,0,0,0
154,1,home,0,7,7
154,2,work,7,14,7
154,3,home,14,21,7
154,4,shop,21,22,1
154,5,home,22,24,2
154,6,<ENDS>,24,24,0
155,0,<START>,0,0,0
155,1,home,0,8,8
155,2,work,8,13,5
155,3,shop,13,14,1
155,4,home,14,18,4
155,5,work,18,19,1
155,6,home,19,24,5
155,7,<ENDS>,24,24,0
156,0,<START>,0,0,0
156,1,home,0,7,7
156,2,work,7,14,7
156,3,home,14,16,2
156,4,work,16,20,4
156,5,home,20,24,4
156,6,<ENDS>,24,24,0
157,0,<START>,0,0,0
157,1,home,0,6,6
157,2,work,6,13,7
157,3,shop,13,14,1
157,4,home,14,22,8
157,5,work,22,23,1
157,6,home,23,24,1
157,7,<ENDS>,24,24,0
158,0,<START>,0,0,0
158,1,home,0,6,6
158,2,shop,6,7,1
158,3,home,7,13,6
158,4,education,13,16,3
158,5,shop,16,17,1
158,6,home,17,21,4
158,7,shop,21,22,1
158,8,home,22,24,2
158,9,<ENDS>,24,24,0
159,0,<START>,0,0,0
159,1,home,0,6,6
159,2,shop,6,7,1
159,3,work,7,13,6
159,4,home,13,14,1
159,5,education,14,16,2
159,6,home,16,20,4
159,7,shop,20,21,1
159,8,home,21,24,3
159,9,<ENDS>,24,24,0
160,0,<START>,0,0,0
160,1,home,0,6,6
160,2,shop,6,7,1
160,3,work,7,14,7
160,4,shop,14,15,1
160,5,work,15,20,5
160,6,home,20,24,4
160,7,<ENDS>,24,24,0
161,0,<START>,0,0,0
161,1,home,0,8,8
161,2,education,8,11,3
161,3,home,11,16,5
161,4,work,16,20,4
161,5,home,20,24,4
161,6,<ENDS>,24,24,0
162,0,<START>,0,0,0
162,1,home,0,7,7
162,2,work,7,13,6
162,3,home,13,24,11
162,4,<ENDS>,24,24,0
163,0,<START>,0,0,0
163,1,home,0,6,6
163,2,shop,6,7,1
163,3,home,7,13,6
163,4,education,13,16,3
163,5,home,16,24,8
163,6,<ENDS>,24,24,0
164,0,<START>,0,0,0
164,1,home,0,8,8
164,2,education,8,12,4
164,3,home,12,17,5
164,4,work,17,20,3
164,5,home,20,24,4
164,6,<ENDS>,24,24,0
165,0,<START>,0,0,0
165,1,work,0,10,10
165,2,shop,10,11,1
165,3,home,11,23,12
165,4,work,23,24,1
165,5,<ENDS>,24,24,0
166,0,<START>,0,0,0
166,1,home,0,6,6
166,2,work,6,13,7
166,3,home,13,24,11
166,4,<ENDS>,24,24,0
167,0,<START>,0,0,0
167,1,home,0,6,6
167,2,work,6,8,2
167,3,home,8,14,6
167,4,work,14,17,3
167,5,home,17,22,5
167,6,work,22,23,1
167,7,home,23,24,1
167,8,<ENDS>,24,24,0
168,0,<START>,0,0,0
168,1,home,0,7,7
168,2,work,7,13,6
168,3,shop,13,14,1
168,4,work,14,20,6
168,5,home,20,24,4
168,6,<ENDS>,24,24,0
169,0,<START>,0,0,0
169,1,home,0,6,6
169,2,shop,6,7,1
169,3,work,7,13,6
169,4,home,13,17,4
169,5,shop,17,18,1
169,6,work,18,20,2
169,7,home,20,24,4
169,8,<ENDS>,24,24,0
170,0,<START>,0,0,0
170,1,home,0,7,7
170,2,work,7,14,7
170,3,home,14,20,6
170,4,shop,20,21,1
170,5,home,21,24,3
170,6,<ENDS>,24,24,0
171,0,<START>,0,0,0
171,1,home,0,8,8
171,2,work,8,14,6
171,3,home,14,24,10
171,4,<ENDS>,24,24,0
172,0,<START>,0,0,0
172,1,home,0,7,7
172,2,shop,7,8,1
172,3,work,8,15,7
172,4,home,15,21,6
172,5,work,21,22,1
172,6,home,22,24,2
172,7,<ENDS>,24,24,0
173,0,<START>,0,0,0
173,1,home,0,7,7
173,2,work,7,9,2
173,3,home,9,14,5
173,4,work,14,17,3
173,5,home,17,23,6
173,6,work,23,24,1
173,7,<ENDS>,24,24,0
174,0,<START>,0,0,0
174,1,home,0,9,9
174,2,work,9,17,8
174,3,home,17,21,4
174,4,shop,21,22,1
174,5,home,22,24,2
174,6,<ENDS>,24,24,0
175,0,<START>,0,0,0
175,1,home,0,7,7
175,2,education,7,12,5
175,3,shop,12,13,1
175,4,education,13,16,3
175,5,shop,16,18,2
175,6,home,18,24,6
175,7,<ENDS>,24,24,0
176,0,<START>,0,0,0
176,1,work,0,9,9
176,2,shop,9,10,1
176,3,work,10,17,7
176,4,home,17,24,7
176,5,<ENDS>,24,24,0
177,0,<START>,0,0,0
177,1,home,0,7,7
177,2,work,7,14,7
177,3,home,14,23,9
177,4,work,23,24,1
177,5,<ENDS>,24,24,0
178,0,<START>,0,0,0
178,1,home,0,7,7
178,2,education,7,11,4
178,3,home,11,17,6
178,4,shop,17,18,1
178,5,home,18,24,6
178,6,<ENDS>,24,24,0
179,0,<START>,0,0,0
179,1,home,0,7,7
179,2,work,7,16,9
179,3,home,16,24,8
179,4,<ENDS>,24,24,0
180,0,<START>,0,0,0
180,1,home,0,7,7
180,2,work,7,9,2
180,3,home,9,16,7
180,4,work,16,17,1
180,5,home,17,21,4
180,6,work,21,22,1
180,7,home,22,24,2
180,8,<ENDS>,24,24,0
181,0,<START>,0,0,0
181,1,home,0,7,7
181,2,work,7,13,6
181,3,home,13,15,2
181,4,shop,15,16,1
181,5,home,16,22,6
181,6,work,22,23,1
181,7,home,23,24,1
181,8,<ENDS>,24,24,0
182,0,<START>,0,0,0
182,1,home,0,8,8
182,2,education,8,12,4
182,3,home,12,16,4
182,4,work,16,20,4
182,5,home,20,24,4
182,6,<ENDS>,24,24,0
183,0,<START>,0,0,0
183,1,home,0,7,7
183,2,work,7,14,7
183,3,home,14,24,10
183,4,<ENDS>,24,24,0
184,0,<START>,0,0,0
184,1,home,0,6,6
184,2,work,6,13,7
184,3,home,13,24,11
184,4,<ENDS>,24,24,0
185,0,<START>,0,0,0
185,1,work,0,7,7
185,2,shop,7,8,1
185,3,work,8,13,5
185,4,home,13,24,11
185,5,<ENDS>,24,24,0
186,0,<START>,0,0,0
186,1,home,0,8,8
186,2,work,8,15,7
186,3,home,15,24,9
186,4,<ENDS>,24,24,0
187,0,<START>,0,0,0
187,1,home,0,7,7
187,2,education,7,12,5
187,3,home,12,21,9
187,4,shop,21,22,1
187,5,home,22,24,2
187,6,<ENDS>,24,24,0
188,0,<START>,0,0,0
188,1,home,0,7,7
188,2,work,7,14,7
188,3,shop,14,15,1
188,4,work,15,19,4
188,5,home,19,24,5
188,6,<ENDS>,24,24,0
189,0,<START>,0,0,0
189,1,home,0,7,7
189,2,shop,7,8,1
189,3,education,8,11,3
189,4,home,11,18,7
189,5,shop,18,19,1
189,6,home,19,24,5
189,7,<ENDS>,24,24,0
190,0,<START>,0,0,0
190,1,home,0,9,9
190,2,work,9,18,9
190,3,home,18,24,6
190,4,<ENDS>,24,24,0
191,0,<START>,0,0,0
191,1,home,0,9,9
191,2,education,9,12,3
191,3,shop,12,13,1
191,4,work,13,19,6
191,5,home,19,24,5
191,6,<ENDS>,24,24,0
192,0,<START>,0,0,0
192,1,home,0,7,7
192,2,education,7,11,4
192,3,home,11,19,8
192,4,shop,19,20,1
192,5,home,20,24,4
192,6,<ENDS>,24,24,0
193,0,<START>,0,0,0
193,1,home,0,6,6
193,2,work,6,13,7
193,3,shop,13,14,1
193,4,home,14,24,10
193,5,<ENDS>,24,24,0
194,0,<START>,0,0,0
194,1,home,0,6,6
194,2,work,6,13,7
194,3,shop,13,14,1
194,4,home,14,21,7
194,5,work,21,22,1
194,6,home,22,24,2
194,7,<ENDS>,24,24,0
195,0,<START>,0,0,0
195,1,home,0,7,7
195,2,education,7,11,4
195,3,home,11,16,5
195,4,shop,16,17,1
195,5,home,17,21,4
195,6,shop,21,22,1
195,7,home,22,24,2
195,8,<ENDS>,24,24,0
196,0,<START>,0,0,0
196,1,home,0,6,6
196,2,work,6,13,7
196,3,shop,13,14,1
196,4,work,14,19,5
196,5,home,19,24,5
196,6,<ENDS>,24,24,0
197,0,<START>,0,0,0
197,1,home,0,6,6
197,2,shop,6,7,1
197,3,home,7,9,2
197,4,education,9,12,3
197,5,home,12,19,7
197,6,shop,19,21,2
197,7,home,21,24,3
197,8,<ENDS>,24,24,0
198,0,<START>,0,0,0
198,1,home,0,6,6
198,2,shop,6,7,1
198,3,home,7,12,5
198,4,education,12,15,3
198,5,shop,15,16,1
198,6,home,16,24,8
198,7,<ENDS>,24,24,0
199,0,<START>,0,0,0
199,1,home,0,9,9
199,2,work,9,17,8
199,3,home,17,22,5
199,4,work,22,23,1
199,5,home,23,24,1
199,6,<ENDS>,24,24,0
200,0,<START>,0,0,0
200,1,home,0,7,7
200,2,work,7,13,6
200,3,home,13,18,5
200,4,work,18,20,2
200,5,home,20,24,4
200,6,<ENDS>,24,24,0
201,0,<START>,0,0,0
201,1,home,0,6,6
201,2,work,6,13,7
201,3,shop,13,14,1
201,4,work,14,20,6
201,5,home,20,24,4
201,6,<ENDS>,24,24,0
202,0,<START>,0,0,0
202,1,home,0,8,8
202,2,work,8,14,6
202,3,home,14,24,10
202,4,<ENDS>,24,24,0
203,0,<START>,0,0,0
203,1,home,0,7,7
203,2,work,7,13,6
203,3,home,13,17,4
203,4,work,17,20,3
203,5,home,20,24,4
203,6,<ENDS>,24,24,0
204,0,<START>,0,0,0
204,1,home,0,7,7
204,2,work,7,13,6
204,3,shop,13,14,1
204,4,home,14,22,8
204,5,work,22,23,1
204,6,home,23,24,1
204,7,<ENDS>,24,24,0
205,0,<START>,0,0,0
205,1,home,0,7,7
205,2,work,7,13,6
205,3,home,13,18,5
205,4,shop,18,19,1
205,5,home,19,24,5
205,6,<ENDS>,24,24,0
206,0,<START>,0,0,0
206,1,home,0,9,9
206,2,work,9,17,8
206,3,home,17,24,7
206,4,<ENDS>,24,24,0
207,0,<START>,0,0,0
207,1,home,0,9,9
207,2,shop,9,10,1
207,3,work,10,17,7
207,4,home,17,24,7
207,5,<ENDS>,24,24,0
208,0,<START>,0,0,0
208,1,home,0,8,8
208,2,work,8,15,7
208,3,shop,15,16,1
208,4,home,16,21,5
208,5,work,21,22,1
208,6,home,22,24,2
208,7,<ENDS>,24,24,0
209,0,<START>,0,0,0
209,1,home,0,8,8
209,2,work,8,15,7
209,3,shop,15,16,1
209,4,home,16,24,8
209,5,<ENDS>,24,24,0
210,0,<START>,0,0,0
210,1,home,0,8,8
210,2,work,8,15,7
210,3,shop,15,16,1
210,4,work,16,20,4
210,5,home,20,24,4
210,6,<ENDS>,24,24,0
211,0,<START>,0,0,0
211,1,home,0,6,6
211,2,work,6,13,7
211,3,home,13,21,8
211,4,work,21,22,1
211,5,home,22,24,2
211,6,<ENDS>,24,24,0
212,0,<START>,0,0,0
212,1,home,0,8,8
212,2,work,8,13,5
212,3,shop,13,14,1
212,4,work,14,19,5
212,5,home,19,24,5
212,6,<ENDS>,24,24,0
213,0,<START>,0,0,0
213,1,home,0,7,7
213,2,work,7,14,7
213,3,shop,14,15,1
213,4,work,15,20,5
213,5,home,20,24,4
213,6,<ENDS>,24,24,0
214,0,<START>,0,0,0
214,1,home,0,8,8
214,2,work,8,14,6
214,3,home,14,24,10
214,4,<ENDS>,24,24,0
215,0,<START>,0,0,0
215,1,home,0,6,6
215,2,shop,6,7,1
215,3,home,7,10,3
215,4,education,10,12,2
215,5,shop,12,13,1
215,6,education,13,15,2
215,7,shop,15,16,1
215,8,home,16,24,8
215,9,<ENDS>,24,24,0
216,0,<START>,0,0,0
216,1,home,0,9,9
216,2,work,9,16,7
216,3,shop,16,17,1
216,4,work,17,20,3
216,5,home,20,24,4
216,6,<ENDS>,24,24,0
217,0,<START>,0,0,0
217,1,home,0,8,8
217,2,work,8,14,6
217,3,home,14,18,4
217,4,shop,18,19,1
217,5,home,19,24,5
217,6,<ENDS>,24,24,0
218,0,<START>,0,0,0
218,1,home,0,7,7
218,2,work,7,14,7
218,3,home,14,23,9
218,4,work,23,24,1
218,5,<ENDS>,24,24,0
219,0,<START>,0,0,0
219,1,home,0,7,7
219,2,work,7,14,7
219,3,home,14,22,8
219,4,work,22,23,1
219,5,home,23,24,1
219,6,<ENDS>,24,24,0
220,0,<START>,0,0,0
220,1,home,0,6,6
220,2,shop,6,7,1
220,3,home,7,10,3
220,4,education,10,11,1
220,5,home,11,17,6
220,6,shop,17,18,1
220,7,home,18,24,6
220,8,<ENDS>,24,24,0
221,0,<START>,0,0,0
221,1,home,0,6,6
221,2,work,6,7,1
221,3,home,7,13,6
221,4,work,13,15,2
221,5,home,15,22,7
221,6,work,22,23,1
221,7,home,23,24,1
221,8,<ENDS>,24,24,0
222,0,<START>,0,0,0
222,1,home,0,8,8
222,2,work,8,15,7
222,3,home,15,22,7
222,4,work,22,23,1
222,5,home,23,24,1
222,6,<ENDS>,24,24,0
223,0,<START>,0,0,0
223,1,home,0,9,9
223,2,work,9,15,6
223,3,home,15,19,4
223,4,shop,19,20,1
223,5,home,20,24,4
223,6,<ENDS>,24,24,0
224,0,<START>,0,0,0
224,1,home,0,8,8
224,2,work,8,15,7
224,3,home,15,17,2
224,4,work,17,20,3
224,5,home,20,24,4
224,6,<ENDS>,24,24,0
225,0,<START>,0,0,0
225,1,home,0,7,7
225,2,education,7,12,5
225,3,home,12,19,7
225,4,shop,19,20,1
225,5,home,20,24,4
225,6,<ENDS>,24,24,0
226,0,<START>,0,0,0
226,1,home,0,8,8
226,2,work,8,15,7
226,3,home,15,21,6
226,4,shop,21,22,1
226,5,home,22,24,2
226,6,<ENDS>,24,24,0
227,0,<START>,0,0,0
227,1,home,0,7,7
227,2,shop,7,8,1
227,3,home,8,12,4
227,4,education,12,16,4
227,5,shop,16,17,1
227,6,home,17,24,7
227,7,<ENDS>,24,24,0
228,0,<START>,0,0,0
228,1,home,0,6,6
228,2,work,6,13,7
228,3,shop,13,14,1
228,4,home,14,22,8
228,5,work,22,23,1
228,6,home,23,24,1
228,7,<ENDS>,24,24,0
229,0,<START>,0,0,0
229,1,home,0,8,8
229,2,work,8,15,7
229,3,home,15,24,9
229,4,<ENDS>,24,24,0
230,0,<START>,0,0,0
230,1,home,0,8,8
230,2,work,8,15,7
230,3,shop,15,16,1
230,4,home,16,24,8
230,5,<ENDS>,24,24,0
231,0,<START>,0,0,0
231,1,home,0,6,6
231,2,work,6,9,3
231,3,home,9,15,6
231,4,work,15,17,2
231,5,home,17,23,6
231,6,work,23,24,1
231,7,<ENDS>,24,24,0
232,0,<START>,0,0,0
232,1,home,0,7,7
232,2,work,7,14,7
232,3,shop,14,15,1
232,4,work,15,19,4
232,5,home,19,24,5
232,6,<ENDS>,24,24,0
233,0,<START>,0,0,0
233,1,home,0,7,7
233,2,work,7,14,7
233,3,shop,14,15,1
233,4,work,15,20,5
233,5,home,20,24,4
233,6,<ENDS>,24,24,0
234,0,<START>,0,0,0
234,1,home,0,8,8
234,2,education,8,12,4
234,3,shop,12,14,2
234,4,education,14,15,1
234,5,shop,15,16,1
234,6,home,16,24,8
234,7,<ENDS>,24,24,0
235,0,<START>,0,0,0
235,1,home,0,8,8
235,2,work,8,14,6
235,3,home,14,24,10
235,4,<ENDS>,24,24,0
236,0,<START>,0,0,0
236,1,home,0,6,6
236,2,shop,6,7,1
236,3,work,7,13,6
236,4,home,13,17,4
236,5,work,17,20,3
236,6,home,20,24,4
236,7,<ENDS>,24,24,0
237,0,<START>,0,0,0
237,1,home,0,8,8
237,2,work,8,15,7
237,3,home,15,23,8
237,4,work,23,24,1
237,5,<ENDS>,24,24,0
238,0,<START>,0,0,0
238,1,home,0,7,7
238,2,work,7,13,6
238,3,home,13,17,4
238,4,work,17,20,3
238,5,home,20,24,4
238,6,<ENDS>,24,24,0
239,0,<START>,0,0,0
239,1,home,0,8,8
239,2,work,8,15,7
239,3,home,15,24,9
239,4,<ENDS>,24,24,0
240,0,<START>,0,0,0
240,1,home,0,8,8
240,2,work,8,15,7
240,3,home,15,22,7
240,4,work,22,23,1
240,5,home,23,24,1
240,6,<ENDS>,24,24,0
241,0,<START>,0,0,0
241,1,home,0,7,7
241,2,shop,7,9,2
241,3,education,9,12,3
241,4,home,12,18,6
241,5,shop,18,19,1
241,6,home,19,24,5
241,7,<ENDS>,24,24,0
242,0,<START>,0,0,0
242,1,home,0,7,7
242,2,shop,7,8,1
242,3,education,8,12,4
242,4,shop,12,14,2
242,5,education,14,16,2
242,6,shop,16,17,1
242,7,home,17,24,7
242,8,<ENDS>,24,24,0
243,0,<START>,0,0,0
243,1,home,0,7,7
243,2,education,7,13,6
243,3,shop,13,14,1
243,4,home,14,20,6
243,5,shop,20,21,1
243,6,home,21,24,3
243,7,<ENDS>,24,24,0
244,0,<START>,0,0,0
244,1,home,0,8,8
244,2,work,8,15,7
244,3,home,15,24,9
244,4,<ENDS>,24,24,0
245,0,<START>,0,0,0
245,1,home,0,8,8
245,2,work,8,14,6
245,3,home,14,24,10
245,4,<ENDS>,24,24,0
246,0,<START>,0,0,0
246,1,home,0,8,8
246,2,education,8,12,4
246,3,work,12,19,7
246,4,home,19,24,5
246,5,<ENDS>,24,24,0
247,0,<START>,0,0,0
247,1,home,0,6,6
247,2,shop,6,7,1
247,3,home,7,9,2
247,4,education,9,11,2
247,5,home,11,14,3
247,6,education,14,16,2
247,7,home,16,24,8
247,8,<ENDS>,24,24,0
248,0,<START>,0,0,0
248,1,home,0,7,7
248,2,work,7,9,2
248,3,home,9,15,6
248,4,work,15,17,2
248,5,home,17,23,6
248,6,work,23,24,1
248,7,<ENDS>,24,24,0
249,0,<START>,0,0,0
249,1,home,0,6,6
249,2,work,6,13,7
249,3,home,13,24,11
249,4,<ENDS>,24,24,0
250,0,<START>,0,0,0
250,1,home,0,6,6
250,2,work,6,13,7
250,3,home,13,16,3
250,4,work,16,20,4
250,5,home,20,24,4
250,6,<ENDS>,24,24,0
251,0,<START>,0,0,0
251,1,home,0,7,7
251,2,work,7,13,6
251,3,home,13,17,4
251,4,work,17,20,3
251,5,home,20,24,4
251,6,<ENDS>,24,24,0
252,0,<START>,0,0,0
252,1,home,0,7,7
252,2,work,7,13,6
252,3,shop,13,14,1
252,4,home,14,23,9
252,5,work,23,24,1
252,6,<ENDS>,24,24,0
253,0,<START>,0,0,0
253,1,home,0,6,6
253,2,work,6,13,7
253,3,shop,13,14,1
253,4,home,14,24,10
253,5,<ENDS>,24,24,0
254,0,<START>,0,0,0
254,1,home,0,6,6
254,2,work,6,13,7
254,3,home,13,17,4
254,4,work,17,19,2
254,5,home,19,24,5
254,6,<ENDS>,24,24,0
255,0,<START>,0,0,0
255,1,home,0,8,8
255,2,education,8,12,4
255,3,work,12,19,7
255,4,home,19,24,5
255,5,<ENDS>,24,24,0
256,0,<START>,0,0,0
256,1,home,0,8,8
256,2,work,8,14,6
256,3,home,14,18,4
256,4,shop,18,19,1
256,5,home,19,24,5
256,6,<ENDS>,24,24,0
257,0,<START>,0,0,0
257,1,home,0,7,7
257,2,work,7,14,7
257,3,shop,14,15,1
257,4,home,15,22,7
257,5,work,22,23,1
257,6,home,23,24,1
257,7,<ENDS>,24,24,0
258,0,<START>,0,0,0
258,1,home,0,7,7
258,2,education,7,12,5
258,3,shop,12,13,1
258,4,education,13,16,3
258,5,shop,16,17,1
258,6,home,17,24,7
258,7,<ENDS>,24,24,0
259,0,<START>,0,0,0
259,1,home,0,7,7
259,2,work,7,13,6
259,3,home,13,23,10
259,4,work,23,24,1
259,5,<ENDS>,24,24,0
260,0,<START>,0,0,0
260,1,home,0,7,7
260,2,shop,7,8,1
260,3,work,8,14,6
260,4,home,14,24,10
260,5,<ENDS>,24,24,0
261,0,<START>,0,0,0
261,1,home,0,8,8
261,2,work,8,16,8
261,3,home,16,22,6
261,4,work,22,23,1
261,5,home,23,24,1
261,6,<ENDS>,24,24,0
262,0,<START>,0,0,0
262,1,home,0,8,8
262,2,work,8,15,7
262,3,shop,15,16,1
262,4,work,16,20,4
262,5,home,20,24,4
262,6,<ENDS>,24,24,0
263,0,<START>,0,0,0
263,1,home,0,9,9
263,2,work,9,17,8
263,3,home,17,23,6
263,4,work,23,24,1
263,5,<ENDS>,24,24,0
264,0,<START>,0,0,0
264,1,home,0,7,7
264,2,shop,7,9,2
264,3,education,9,12,3
264,4,home,12,19,7
264,5,shop,19,20,1
264,6,home,20,24,4
264,7,<ENDS>,24,24,0
265,0,<START>,0,0,0
265,1,home,0,8,8
265,2,education,8,11,3
265,3,home,11,16,5
265,4,shop,16,17,1
265,5,home,17,24,7
265,6,<ENDS>,24,24,0
266,0,<START>,0,0,0
266,1,home,0,7,7
266,2,work,7,13,6
266,3,shop,13,14,1
266,4,work,14,19,5
266,5,home,19,24,5
266,6,<ENDS>,24,24,0
267,0,<START>,0,0,0
267,1,home,0,7,7
267,2,work,7,14,7
267,3,home,14,24,10
267,4,<ENDS>,24,24,0
268,0,<START>,0,0,0
268,1,home,0,7,7
268,2,work,7,14,7
268,3,shop,14,15,1
268,4,work,15,19,4
268,5,home,19,24,5
268,6,<ENDS>,24,24,0
269,0,<START>,0,0,0
269,1,home,0,7,7
269,2,shop,7,8,1
269,3,home,8,10,2
269,4,education,10,13,3
269,5,shop,13,15,2
269,6,home,15,21,6
269,7,shop,21,22,1
269,8,home,22,24,2
269,9,<ENDS>,24,24,0
270,0,<START>,0,0,0
270,1,home,0,7,7
270,2,work,7,8,1
270,3,home,8,14,6
270,4,work,14,15,1
270,5,home,15,22,7
270,6,work,22,23,1
270,7,home,23,24,1
270,8,<ENDS>,24,24,0
271,0,<START>,0,0,0
271,1,home,0,6,6
271,2,shop,6,7,1
271,3,work,7,13,6
271,4,home,13,17,4
271,5,work,17,20,3
271,6,home,20,24,4
271,7,<ENDS>,24,24,0
272,0,<START>,0,0,0
272,1,home,0,8,8
272,2,education,8,11,3
272,3,home,11,17,6
272,4,shop,17,18,1
272,5,home,18,24,6
272,6,<ENDS>,24,24,0
273,0,<START>,0,0,0
273,1,home,0,6,6
273,2,work,6,13,7
273,3,home,13,21,8
273,4,shop,21,22,1
273,5,home,22,24,2
273,6,<ENDS>,24,24,0
274,0,<START>,0,0,0
274,1,home,0,6,6
274,2,work,6,8,2
274,3,home,8,13,5
274,4,work,13,15,2
274,5,home,15,17,2
274,6,work,17,19,2
274,7,education,19,20,1
274,8,home,20,24,4
274,9,<ENDS>,24,24,0
275,0,<START>,0,0,0
275,1,home,0,6,6
275,2,work,6,13,7
275,3,shop,13,14,1
275,4,work,14,19,5
275,5,home,19,24,5
275,6,<ENDS>,24,24,0
276,0,<START>,0,0,0
276,1,home,0,7,7
276,2,work,7,16,9
276,3,shop,16,17,1
276,4,home,17,24,7
276,5,<ENDS>,24,24,0
277,0,<START>,0,0,0
277,1,home,0,6,6
277,2,work,6,8,2
277,3,home,8,9,1
277,4,work,9,10,1
277,5,home,10,16,6
277,6,shop,16,17,1
277,7,home,17,23,6
277,8,work,23,24,1
277,9,<ENDS>,24,24,0
278,0,<START>,0,0,0
278,1,home,0,8,8
278,2,work,8,16,8
278,3,home,16,21,5
278,4,work,21,22,1
278,5,home,22,24,2
278,6,<ENDS>,24,24,0
279,0,<START>,0,0,0
279,1,home,0,8,8
279,2,education,8,11,3
279,3,home,11,13,2
279,4,work,13,19,6
279,5,home,19,24,5
279,6,<ENDS>,24,24,0
280,0,<START>,0,0,0
280,1,home,0,7,7
280,2,work,7,15,8
280,3,shop,15,17,2
280,4,work,17,20,3
280,5,home,20,24,4
280,6,<ENDS>,24,24,0
281,0,<START>,0,0,0
281,1,home,0,7,7
281,2,work,7,14,7
281,3,shop,14,15,1
281,4,home,15,24,9
281,5,<ENDS>,24,24,0
282,0,<START>,0,0,0
282,1,home,0,8,8
282,2,work,8,14,6
282,3,home,14,24,10
282,4,<ENDS>,24,24,0
283,0,<START>,0,0,0
283,1,home,0,8,8
283,2,work,8,16,8
283,3,shop,16,17,1
283,4,home,17,24,7
283,5,<ENDS>,24,24,0
284,0,<START>,0,0,0
284,1,home,0,6,6
284,2,work,6,8,2
284,3,home,8,14,6
284,4,work,14,16,2
284,5,home,16,23,7
284,6,work,23,24,1
284,7,<ENDS>,24,24,0
285,0,<START>,0,0,0
285,1,home,0,8,8
285,2,education,8,11,3
285,3,home,11,17,6
285,4,work,17,20,3
285,5,home,20,24,4
285,6,<ENDS>,24,24,0
286,0,<START>,0,0,0
286,1,home,0,8,8
286,2,work,8,14,6
286,3,shop,14,15,1
286,4,work,15,19,4
286,5,home,19,24,5
286,6,<ENDS>,24,24,0
287,0,<START>,0,0,0
287,1,home,0,7,7
287,2,shop,7,8,1
287,3,home,8,13,5
287,4,work,13,20,7
287,5,home,20,24,4
287,6,<ENDS>,24,24,0
288,0,<START>,0,0,0
288,1,home,0,6,6
288,2,work,6,13,7
288,3,home,13,22,9
288,4,work,22,23,1
288,5,home,23,24,1
288,6,<ENDS>,24,24,0
289,0,<START>,0,0,0
289,1,home,0,6,6
289,2,work,6,13,7
289,3,home,13,24,11
289,4,<ENDS>,24,24,0
290,0,<START>,0,0,0
290,1,home,0,7,7
290,2,work,7,14,7
290,3,home,14,21,7
290,4,work,21,22,1
290,5,home,22,24,2
290,6,<ENDS>,24,24,0
291,0,<START>,0,0,0
291,1,home,0,8,8
291,2,education,8,11,3
291,3,shop,11,12,1
291,4,home,12,24,12
291,5,<ENDS>,24,24,0
292,0,<START>,0,0,0
292,1,home,0,7,7
292,2,shop,7,8,1
292,3,education,8,11,3
292,4,home,11,18,7
292,5,shop,18,19,1
292,6,home,19,24,5
292,7,<ENDS>,24,24,0
293,0,<START>,0,0,0
293,1,home,0,7,7
293,2,shop,7,8,1
293,3,education,8,11,3
293,4,home,11,18,7
293,5,shop,18,20,2
293,6,home,20,24,4
293,7,<ENDS>,24,24,0
294,0,<START>,0,0,0
294,1,home,0,7,7
294,2,work,7,14,7
294,3,home,14,24,10
294,4,<ENDS>,24,24,0
295,0,<START>,0,0,0
295,1,home,0,6,6
295,2,shop,6,7,1
295,3,home,7,10,3
295,4,education,10,11,1
295,5,home,11,18,7
295,6,shop,18,19,1
295,7,home,19,24,5
295,8,<ENDS>,24,24,0
296,0,<START>,0,0,0
296,1,home,0,7,7
296,2,work,7,9,2
296,3,home,9,15,6
296,4,work,15,17,2
296,5,home,17,23,6
296,6,work,23,24,1
296,7,<ENDS>,24,24,0
297,0,<START>,0,0,0
297,1,home,0,7,7
297,2,work,7,14,7
297,3,home,14,20,6
297,4,shop,20,21,1
297,5,home,21,24,3
297,6,<ENDS>,24,24,0
298,0,<START>,0,0,0
298,1,home,0,6,6
298,2,work,6,13,7
298,3,home,13,24,11
298,4,<ENDS>,24,24,0
299,0,<START>,0,0,0
299,1,home,0,8,8
299,2,work,8,15,7
299,3,shop,15,16,1
299,4,home,16,24,8
299,5,<ENDS>,24,24,0
300,0,<START>,0,0,0
300,1,home,0,6,6
300,2,shop,6,7,1
300,3,home,7,11,4
300,4,work,11,19,8
300,5,home,19,24,5
300,6,<ENDS>,24,24,0
301,0,<START>,0,0,0
301,1,home,0,7,7
301,2,shop,7,8,1
301,3,education,8,11,3
301,4,home,11,19,8
301,5,shop,19,20,1
301,6,home,20,24,4
301,7,<ENDS>,24,24,0
302,0,<START>,0,0,0
302,1,home,0,6,6
302,2,shop,6,7,1
302,3,home,7,10,3
302,4,education,10,16,6
302,5,shop,16,18,2
302,6,home,18,24,6
302,7,<ENDS>,24,24,0
303,0,<START>,0,0,0
303,1,home,0,6,6
303,2,work,6,13,7
303,3,home,13,24,11
303,4,<ENDS>,24,24,0
304,0,<START>,0,0,0
304,1,home,0,7,7
304,2,shop,7,8,1
304,3,work,8,15,7
304,4,home,15,24,9
304,5,<ENDS>,24,24,0
305,0,<START>,0,0,0
305,1,home,0,9,9
305,2,work,9,17,8
305,3,home,17,22,5
305,4,work,22,23,1
305,5,home,23,24,1
305,6,<ENDS>,24,24,0
306,0,<START>,0,0,0
306,1,home,0,6,6
306,2,work,6,13,7
306,3,shop,13,14,1
306,4,home,14,24,10
306,5,<ENDS>,24,24,0
307,0,<START>,0,0,0
307,1,home,0,6,6
307,2,work,6,13,7
307,3,shop,13,14,1
307,4,home,14,24,10
307,5,<ENDS>,24,24,0
308,0,<START>,0,0,0
308,1,home,0,7,7
308,2,work,7,14,7
308,3,home,14,20,6
308,4,shop,20,21,1
308,5,home,21,24,3
308,6,<ENDS>,24,24,0
309,0,<START>,0,0,0
309,1,home,0,7,7
309,2,education,7,12,5
309,3,shop,12,13,1
309,4,home,13,21,8
309,5,shop,21,22,1
309,6,home,22,24,2
309,7,<ENDS>,24,24,0
310,0,<START>,0,0,0
310,1,home,0,7,7
310,2,shop,7,8,1
310,3,work,8,14,6
310,4,home,14,21,7
310,5,work,21,22,1
310,6,home,22,24,2
310,7,<ENDS>,24,24,0
311,0,<START>,0,0,0
311,1,home,0,7,7
311,2,education,7,11,4
311,3,home,11,13,2
311,4,education,13,14,1
311,5,shop,14,15,1
311,6,home,15,24,9
311,7,<ENDS>,24,24,0
312,0,<START>,0,0,0
312,1,home,0,8,8
312,2,work,8,15,7
312,3,home,15,24,9
312,4,<ENDS>,24,24,0
313,0,<START>,0,0,0
313,1,home,0,7,7
313,2,work,7,14,7
313,3,home,14,24,10
313,4,<ENDS>,24,24,0
314,0,<START>,0,0,0
314,1,home,0,7,7
314,2,education,7,12,5
314,3,shop,12,14,2
314,4,education,14,16,2
314,5,home,16,24,8
314,6,<ENDS>,24,24,0
315,0,<START>,0,0,0
315,1,home,0,7,7
315,2,work,7,14,7
315,3,shop,14,15,1
315,4,home,15,24,9
315,5,<ENDS>,24,24,0
316,0,<START>,0,0,0
316,1,home,0,8,8
316,2,work,8,15,7
316,3,shop,15,16,1
316,4,work,16,20,4
316,5,home,20,24,4
316,6,<ENDS>,24,24,0
317,0,<START>,0,0,0
317,1,home,0,8,8
317,2,work,8,14,6
317,3,shop,14,15,1
317,4,home,15,24,9
317,5,<ENDS>,24,24,0
318,0,<START>,0,0,0
318,1,home,0,9,9
318,2,work,9,16,7
318,3,home,16,24,8
318,4,<ENDS>,24,24,0
319,0,<START>,0,0,0
319,1,work,0,10,10
319,2,shop,10,11,1
319,3,work,11,17,6
319,4,home,17,24,7
319,5,<ENDS>,24,24,0
320,0,<START>,0,0,0
320,1,home,0,6,6
320,2,work,6,8,2
320,3,home,8,9,1
320,4,work,9,11,2
320,5,home,11,15,4
320,6,work,15,19,4
320,7,home,19,24,5
320,8,<ENDS>,24,24,0
321,0,<START>,0,0,0
321,1,home,0,7,7
321,2,work,7,13,6
321,3,home,13,14,1
321,4,shop,14,15,1
321,5,work,15,19,4
321,6,home,19,24,5
321,7,<ENDS>,24,24,0
322,0,<START>,0,0,0
322,1,home,0,9,9
322,2,work,9,16,7
322,3,shop,16,17,1
322,4,work,17,20,3
322,5,home,20,24,4
322,6,<ENDS>,24,24,0
323,0,<START>,0,0,0
323,1,home,0,7,7
323,2,work,7,14,7
323,3,home,14,21,7
323,4,shop,21,22,1
323,5,home,22,24,2
323,6,<ENDS>,24,24,0
324,0,<START>,0,0,0
324,1,home,0,6,6
324,2,shop,6,7,1
324,3,home,7,13,6
324,4,education,13,16,3
324,5,shop,16,17,1
324,6,home,17,24,7
324,7,<ENDS>,24,24,0
325,0,<START>,0,0,0
325,1,home,0,9,9
325,2,work,9,16,7
325,3,home,16,24,8
325,4,<ENDS>,24,24,0
326,0,<START>,0,0,0
326,1,home,0,11,11
326,2,work,11,17,6
326,3,home,17,22,5
326,4,work,22,23,1
326,5,home,23,24,1
326,6,<ENDS>,24,24,0
327,0,<START>,0,0,0
327,1,home,0,7,7
327,2,work,7,13,6
327,3,home,13,24,11
327,4,<ENDS>,24,24,0
328,0,<START>,0,0,0
328,1,home,0,7,7
328,2,work,7,13,6
328,3,shop,13,14,1
328,4,home,14,23,9
328,5,work,23,24,1
328,6,<ENDS>,24,24,0
329,0,<START>,0,0,0
329,1,home,0,7,7
329,2,work,7,14,7
329,3,shop,14,15,1
329,4,home,15,22,7
329,5,work,22,23,1
329,6,home,23,24,1
329,7,<ENDS>,24,24,0
330,0,<START>,0,0,0
330,1,home,0,6,6
330,2,work,6,13,7
330,3,home,13,21,8
330,4,work,21,22,1
330,5,home,22,24,2
330,6,<ENDS>,24,24,0
331,0,<START>,0,0,0
331,1,home,0,8,8
331,2,shop,8,9,1
331,3,work,9,16,7
331,4,home,16,24,8
331,5,<ENDS>,24,24,0
332,0,<START>,0,0,0
332,1,home,0,6,6
332,2,shop,6,7,1
332,3,home,7,8,1
332,4,education,8,14,6
332,5,shop,14,15,1
332,6,home,15,24,9
332,7,<ENDS>,24,24,0
333,0,<START>,0,0,0
333,1,home,0,6,6
333,2,work,6,8,2
333,3,home,8,14,6
333,4,work,14,16,2
333,5,home,16,22,6
333,6,work,22,23,1
333,7,home,23,24,1
333,8,<ENDS>,24,24,0
334,0,<START>,0,0,0
334,1,home,0,7,7
334,2,shop,7,9,2
334,3,work,9,17,8
334,4,home,17,24,7
334,5,<ENDS>,24,24,0
335,0,<START>,0,0,0
335,1,home,0,6,6
335,2,work,6,13,7
335,3,shop,13,14,1
335,4,home,14,22,8
335,5,work,22,23,1
335,6,home,23,24,1
335,7,<ENDS>,24,24,0
336,0,<START>,0,0,0
336,1,home,0,8,8
336,2,work,8,15,7
336,3,home,15,24,9
336,4,<ENDS>,24,24,0
337,0,<START>,0,0,0
337,1,home,0,8,8
337,2,work,8,13,5
337,3,shop,13,15,2
337,4,home,15,24,9
337,5,<ENDS>,24,24,0
338,0,<START>,0,0,0
338,1,home,0,8,8
338,2,work,8,14,6
338,3,home,14,24,10
338,4,<ENDS>,24,24,0
339,0,<START>,0,0,0
339,1,home,0,8,8
339,2,work,8,15,7
339,3,shop,15,16,1
339,4,home,16,24,8
339,5,<ENDS>,24,24,0
340,0,<START>,0,0,0
340,1,home,0,8,8
340,2,work,8,15,7
340,3,shop,15,16,1
340,4,work,16,20,4
340,5,home,20,24,4
340,6,<ENDS>,24,24,0
341,0,<START>,0,0,0
341,1,home,0,6,6
341,2,shop,6,7,1
341,3,home,7,13,6
341,4,education,13,14,1
341,5,shop,14,15,1
341,6,home,15,24,9
341,7,<ENDS>,24,24,0
342,0,<START>,0,0,0
342,1,home,0,6,6
342,2,work,6,13,7
342,3,shop,13,14,1
342,4,work,14,20,6
342,5,home,20,24,4
342,6,<ENDS>,24,24,0
343,0,<START>,0,0,0
343,1,home,0,7,7
343,2,shop,7,8,1
343,3,home,8,12,4
343,4,work,12,18,6
343,5,home,18,24,6
343,6,<ENDS>,24,24,0
344,0,<START>,0,0,0
344,1,home,0,7,7
344,2,work,7,14,7
344,3,home,14,24,10
344,4,<ENDS>,24,24,0
345,0,<START>,0,0,0
345,1,home,0,7,7
345,2,education,7,11,4
345,3,home,11,14,3
345,4,education,14,16,2
345,5,home,16,24,8
345,6,<ENDS>,24,24,0
346,0,<START>,0,0,0
346,1,home,0,8,8
346,2,shop,8,9,1
346,3,work,9,16,7
346,4,home,16,23,7
346,5,work,23,24,1
346,6,<ENDS>,24,24,0
347,0,<START>,0,0,0
347,1,home,0,8,8
347,2,work,8,14,6
347,3,shop,14,16,2
347,4,home,16,21,5
347,5,work,21,22,1
347,6,home,22,24,2
347,7,<ENDS>,24,24,0
348,0,<START>,0,0,0
348,1,home,0,7,7
348,2,work,7,13,6
348,3,shop,13,14,1
348,4,work,14,20,6
348,5,home,20,24,4
348,6,<ENDS>,24,24,0
349,0,<START>,0,0,0
349,1,home,0,6,6
349,2,work,6,7,1
349,3,home,7,13,6
349,4,work,13,15,2
349,5,home,15,22,7
349,6,work,22,23,1
349,7,home,23,24,1
349,8,<ENDS>,24,24,0
350,0,<START>,0,0,0
350,1,home,0,12,12
350,2,work,12,19,7
350,3,home,19,23,4
350,4,work,23,24,1
350,5,<ENDS>,24,24,0
351,0,<START>,0,0,0
351,1,home,0,6,6
351,2,work,6,13,7
351,3,home,13,17,4
351,4,work,17,20,3
351,5,home,20,24,4
351,6,<ENDS>,24,24,0
352,0,<START>,0,0,0
352,1,home,0,7,7
352,2,work,7,13,6
352,3,home,13,22,9
352,4,work,22,23,1
352,5,home,23,24,1
352,6,<ENDS>,24,24,0
353,0,<START>,0,0,0
353,1,home,0,6,6
353,2,work,6,13,7
353,3,home,13,21,8
353,4,work,21,22,1
353,5,home,22,24,2
353,6,<ENDS>,24,24,0
354,0,<START>,0,0,0
354,1,home,0,8,8
354,2,work,8,15,7
354,3,home,15,24,9
354,4,<ENDS>,24,24,0
355,0,<START>,0,0,0
355,1,home,0,7,7
355,2,shop,7,8,1
355,3,work,8,15,7
355,4,home,15,24,9
355,5,<ENDS>,24,24,0
356,0,<START>,0,0,0
356,1,home,0,6,6
356,2,work,6,13,7
356,3,home,13,24,11
356,4,<ENDS>,24,24,0
357,0,<START>,0,0,0
357,1,home,0,7,7
357,2,work,7,14,7
357,3,shop,14,15,1
357,4,home,15,19,4
357,5,shop,19,20,1
357,6,home,20,24,4
357,7,<ENDS>,24,24,0
358,0,<START>,0,0,0
358,1,home,0,7,7
358,2,work,7,9,2
358,3,home,9,13,4
358,4,work,13,15,2
358,5,home,15,22,7
358,6,work,22,23,1
358,7,home,23,24,1
358,8,<ENDS>,24,24,0
359,0,<START>,0,0,0
359,1,home,0,8,8
359,2,work,8,15,7
359,3,home,15,24,9
359,4,<ENDS>,24,24,0
360,0,<START>,0,0,0
360,1,home,0,7,7
360,2,shop,7,8,1
360,3,education,8,12,4
360,4,shop,12,14,2
360,5,education,14,16,2
360,6,home,16,24,8
360,7,<ENDS>,24,24,0
361,0,<START>,0,0,0
361,1,home,0,6,6
361,2,shop,6,7,1
361,3,work,7,13,6
361,4,home,13,24,11
361,5,<ENDS>,24,24,0
362,0,<START>,0,0,0
362,1,home,0,7,7
362,2,work,7,14,7
362,3,home,14,24,10
362,4,<ENDS>,24,24,0
363,0,<START>,0,0,0
363,1,home,0,8,8
363,2,work,8,13,5
363,3,shop,13,14,1
363,4,work,14,17,3
363,5,home,17,24,7
363,6,<ENDS>,24,24,0
364,0,<START>,0,0,0
364,1,home,0,8,8
364,2,work,8,15,7
364,3,home,15,24,9
364,4,<ENDS>,24,24,0
365,0,<START>,0,0,0
365,1,home,0,7,7
365,2,work,7,14,7
365,3,shop,14,15,1
365,4,work,15,19,4
365,5,home,19,24,5
365,6,<ENDS>,24,24,0
366,0,<START>,0,0,0
366,1,home,0,6,6
366,2,work,6,8,2
366,3,home,8,15,7
366,4,work,15,17,2
366,5,home,17,23,6
366,6,work,23,24,1
366,7,<ENDS>,24,24,0
367,0,<START>,0,0,0
367,1,home,0,7,7
367,2,shop,7,8,1
367,3,home,8,14,6
367,4,work,14,20,6
367,5,home,20,24,4
367,6,<ENDS>,24,24,0
368,0,<START>,0,0,0
368,1,home,0,8,8
368,2,work,8,14,6
368,3,home,14,24,10
368,4,<ENDS>,24,24,0
369,0,<START>,0,0,0
369,1,home,0,6,6
369,2,work,6,13,7
369,3,shop,13,14,1
369,4,home,14,18,4
369,5,work,18,19,1
369,6,home,19,24,5
369,7,<ENDS>,24,24,0
370,0,<START>,0,0,0
370,1,home,0,7,7
370,2,shop,7,8,1
370,3,education,8,11,3
370,4,home,11,16,5
370,5,shop,16,18,2
370,6,home,18,24,6
370,7,<ENDS>,24,24,0
371,0,<START>,0,0,0
371,1,home,0,7,7
371,2,work,7,12,5
371,3,shop,12,13,1
371,4,work,13,19,6
371,5,home,19,24,5
371,6,<ENDS>,24,24,0
372,0,<START>,0,0,0
372,1,home,0,7,7
372,2,work,7,13,6
372,3,shop,13,14,1
372,4,home,14,21,7
372,5,shop,21,22,1
372,6,home,22,24,2
372,7,<ENDS>,24,24,0
373,0,<START>,0,0,0
373,1,home,0,7,7
373,2,work,7,13,6
373,3,shop,13,14,1
373,4,home,14,24,10
373,5,<ENDS>,24,24,0
374,0,<START>,0,0,0
374,1,home,0,8,8
374,2,education,8,12,4
374,3,shop,12,14,2
374,4,education,14,16,2
374,5,shop,16,17,1
374,6,home,17,24,7
374,7,<ENDS>,24,24,0
375,0,<START>,0,0,0
375,1,home,0,8,8
375,2,education,8,14,6
375,3,shop,14,15,1
375,4,work,15,20,5
375,5,home,20,24,4
375,6,<ENDS>,24,24,0
376,0,<START>,0,0,0
376,1,home,0,6,6
376,2,work,6,13,7
376,3,shop,13,14,1
376,4,home,14,24,10
376,5,<ENDS>,24,24,0
377,0,<START>,0,0,0
377,1,home,0,6,6
377,2,shop,6,7,1
377,3,work,7,9,2
377,4,home,9,15,6
377,5,work,15,17,2
377,6,home,17,23,6
377,7,work,23,24,1
377,8,<ENDS>,24,24,0
378,0,<START>,0,0,0
378,1,home,0,6,6
378,2,work,6,8,2
378,3,home,8,9,1
378,4,work,9,11,2
378,5,home,11,14,3
378,6,work,14,16,2
378,7,home,16,23,7
378,8,work,23,24,1
378,9,<ENDS>,24,24,0
379,0,<START>,0,0,0
379,1,home,0,6,6
379,2,work,6,13,7
379,3,shop,13,14,1
379,4,work,14,19,5
379,5,home,19,24,5
379,6,<ENDS>,24,24,0
380,0,<START>,0,0,0
380,1,home,0,6,6
380,2,work,6,13,7
380,3,shop,13,14,1
380,4,work,14,19,5
380,5,home,19,24,5
380,6,<ENDS>,24,24,0
381,0,<START>,0,0,0
381,1,home,0,6,6
381,2,shop,6,7,1
381,3,home,7,9,2
381,4,work,9,16,7
381,5,home,16,24,8
381,6,<ENDS>,24,24,0
382,0,<START>,0,0,0
382,1,home,0,8,8
382,2,education,8,12,4
382,3,shop,12,13,1
382,4,work,13,19,6
382,5,home,19,24,5
382,6,<ENDS>,24,24,0
383,0,<START>,0,0,0
383,1,home,0,8,8
383,2,work,8,15,7
383,3,shop,15,16,1
383,4,work,16,20,4
383,5,home,20,24,4
383,6,<ENDS>,24,24,0
384,0,<START>,0,0,0
384,1,home,0,7,7
384,2,education,7,11,4
384,3,home,11,18,7
384,4,shop,18,19,1
384,5,home,19,24,5
384,6,<ENDS>,24,24,0
385,0,<START>,0,0,0
385,1,home,0,6,6
385,2,work,6,13,7
385,3,shop,13,14,1
385,4,home,14,24,10
385,5,<ENDS>,24,24,0
386,0,<START>,0,0,0
386,1,home,0,8,8
386,2,work,8,14,6
386,3,home,14,23,9
386,4,work,23,24,1
386,5,<ENDS>,24,24,0
387,0,<START>,0,0,0
387,1,home,0,6,6
387,2,work,6,13,7
387,3,home,13,16,3
387,4,work,16,20,4
387,5,home,20,24,4
387,6,<ENDS>,24,24,0
388,0,<START>,0,0,0
388,1,home,0,7,7
388,2,shop,7,8,1
388,3,work,8,15,7
388,4,home,15,24,9
388,5,<ENDS>,24,24,0
389,0,<START>,0,0,0
389,1,home,0,8,8
389,2,work,8,15,7
389,3,home,15,22,7
389,4,work,22,23,1
389,5,home,23,24,1
389,6,<ENDS>,24,24,0
390,0,<START>,0,0,0
390,1,home,0,7,7
390,2,shop,7,9,2
390,3,education,9,14,5
390,4,shop,14,15,1
390,5,home,15,24,9
390,6,<ENDS>,24,24,0
391,0,<START>,0,0,0
391,1,home,0,8,8
391,2,education,8,11,3
391,3,home,11,17,6
391,4,shop,17,18,1
391,5,home,18,24,6
391,6,<ENDS>,24,24,0
392,0,<START>,0,0,0
392,1,home,0,7,7
392,2,education,7,11,4
392,3,home,11,14,3
392,4,education,14,16,2
392,5,home,16,24,8
392,6,<ENDS>,24,24,0
393,0,<START>,0,0,0
393,1,home,0,7,7
393,2,work,7,13,6
393,3,home,13,17,4
393,4,work,17,19,2
393,5,home,19,24,5
393,6,<ENDS>,24,24,0
394,0,<START>,0,0,0
394,1,home,0,8,8
394,2,shop,8,9,1
394,3,education,9,12,3
394,4,home,12,20,8
394,5,shop,20,21,1
394,6,home,21,24,3
394,7,<ENDS>,24,24,0
395,0,<START>,0,0,0
395,1,home,0,7,7
395,2,work,7,14,7
395,3,home,14,16,2
395,4,work,16,20,4
395,5,home,20,24,4
395,6,<ENDS>,24,24,0
396,0,<START>,0,0,0
396,1,home,0,6,6
396,2,work,6,7,1
396,3,home,7,10,3
396,4,work,10,11,1
396,5,home,11,17,6
396,6,work,17,19,2
396,7,home,19,23,4
396,8,work,23,24,1
396,9,<ENDS>,24,24,0
397,0,<START>,0,0,0
397,1,home,0,6,6
397,2,work,6,13,7
397,3,shop,13,14,1
397,4,work,14,19,5
397,5,home,19,24,5
397,6,<ENDS>,24,24,0
398,0,<START>,0,0,0
398,1,home,0,6,6
398,2,work,6,13,7
398,3,home,13,18,5
398,4,shop,18,19,1
398,5,home,19,24,5
398,6,<ENDS>,24,24,0
399,0,<START>,0,0,0
399,1,home,0,6,6
399,2,work,6,7,1
399,3,home,7,13,6
399,4,work,13,15,2
399,5,home,15,22,7
399,6,work,22,23,1
399,7,home,23,24,1
399,8,<ENDS>,24,24,0
400,0,<START>,0,0,0
400,1,home,0,8,8
400,2,work,8,15,7
400,3,shop,15,16,1
400,4,work,16,20,4
400,5,home,20,24,4
400,6,<ENDS>,24,24,0
401,0,<START>,0,0,0
401,1,home,0,7,7
401,2,work,7,13,6
401,3,home,13,24,11
401,4,<ENDS>,24,24,0
402,0,<START>,0,0,0
402,1,home,0,8,8
402,2,work,8,15,7
402,3,shop,15,17,2
402,4,work,17,20,3
402,5,home,20,24,4
402,6,<ENDS>,24,24,0
403,0,<START>,0,0,0
403,1,home,0,7,7
403,2,work,7,14,7
403,3,home,14,23,9
403,4,work,23,24,1
403,5,<ENDS>,24,24,0
404,0,<START>,0,0,0
404,1,home,0,7,7
404,2,shop,7,8,1
404,3,home,8,17,9
404,4,work,17,20,3
404,5,home,20,24,4
404,6,<ENDS>,24,24,0
405,0,<START>,0,0,0
405,1,home,0,6,6
405,2,work,6,13,7
405,3,shop,13,14,1
405,4,home,14,24,10
405,5,<ENDS>,24,24,0
406,0,<START>,0,0,0
406,1,home,0,8,8
406,2,work,8,15,7
406,3,home,15,24,9
406,4,<ENDS>,24,24,0
407,0,<START>,0,0,0
407,1,home,0,8,8
407,2,work,8,16,8
407,3,shop,16,17,1
407,4,home,17,24,7
407,5,<ENDS>,24,24,0
408,0,<START>,0,0,0
408,1,home,0,6,6
408,2,shop,6,7,1
408,3,home,7,10,3
408,4,education,10,12,2
408,5,home,12,19,7
408,6,shop,19,20,1
408,7,home,20,24,4
408,8,<ENDS>,24,24,0
409,0,<START>,0,0,0
409,1,home,0,7,7
409,2,work,7,13,6
409,3,home,13,17,4
409,4,work,17,20,3
409,5,home,20,24,4
409,6,<ENDS>,24,24,0
410,0,<START>,0,0,0
410,1,home,0,7,7
410,2,work,7,13,6
410,3,shop,13,15,2
410,4,work,15,20,5
410,5,home,20,24,4
410,6,<ENDS>,24,24,0
411,0,<START>,0,0,0
411,1,home,0,8,8
411,2,work,8,15,7
411,3,shop,15,16,1
411,4,work,16,20,4
411,5,home,20,24,4
411,6,<ENDS>,24,24,0
412,0,<START>,0,0,0
412,1,home,0,7,7
412,2,shop,7,8,1
412,3,work,8,15,7
412,4,home,15,24,9
412,5,<ENDS>,24,24,0
413,0,<START>,0,0,0
413,1,home,0,8,8
413,2,work,8,16,8
413,3,shop,16,17,1
413,4,work,17,20,3
413,5,home,20,24,4
413,6,<ENDS>,24,24,0
414,0,<START>,0,0,0
414,1,home,0,6,6
414,2,work,6,8,2
414,3,home,8,14,6
414,4,work,14,17,3
414,5,home,17,23,6
414,6,work,23,24,1
414,7,<ENDS>,24,24,0
415,0,<START>,0,0,0
415,1,home,0,7,7
415,2,shop,7,10,3
415,3,home,10,13,3
415,4,education,13,16,3
415,5,shop,16,17,1
415,6,home,17,24,7
415,7,<ENDS>,24,24,0
416,0,<START>,0,0,0
416,1,home,0,7,7
416,2,work,7,13,6
416,3,home,13,24,11
416,4,<ENDS>,24,24,0
417,0,<START>,0,0,0
417,1,home,0,6,6
417,2,work,6,12,6
417,3,shop,12,13,1
417,4,education,13,16,3
417,5,home,16,24,8
417,6,<ENDS>,24,24,0
418,0,<START>,0,0,0
418,1,home,0,7,7
418,2,work,7,15,8
418,3,home,15,24,9
418,4,<ENDS>,24,24,0
419,0,<START>,0,0,0
419,1,home,0,8,8
419,2,work,8,15,7
419,3,home,15,24,9
419,4,<ENDS>,24,24,0
420,0,<START>,0,0,0
420,1,home,0,7,7
420,2,work,7,13,6
420,3,shop,13,14,1
420,4,home,14,24,10
420,5,<ENDS>,24,24,0
421,0,<START>,0,0,0
421,1,home,0,7,7
421,2,education,7,11,4
421,3,home,11,19,8
421,4,shop,19,20,1
421,5,home,20,24,4
421,6,<ENDS>,24,24,0
422,0,<START>,0,0,0
422,1,home,0,8,8
422,2,work,8,14,6
422,3,home,14,24,10
422,4,<ENDS>,24,24,0
423,0,<START>,0,0,0
423,1,home,0,6,6
423,2,work,6,13,7
423,3,home,13,21,8
423,4,work,21,22,1
423,5,home,22,24,2
423,6,<ENDS>,24,24,0
424,0,<START>,0,0,0
424,1,home,0,7,7
424,2,shop,7,8,1
424,3,education,8,11,3
424,4,home,11,16,5
424,5,shop,16,18,2
424,6,home,18,24,6
424,7,<ENDS>,24,24,0
425,0,<START>,0,0,0
425,1,home,0,8,8
425,2,work,8,15,7
425,3,home,15,24,9
425,4,<ENDS>,24,24,0
426,0,<START>,0,0,0
426,1,home,0,8,8
426,2,education,8,13,5
426,3,home,13,19,6
426,4,shop,19,20,1
426,5,home,20,24,4
426,6,<ENDS>,24,24,0
427,0,<START>,0,0,0
427,1,home,0,8,8
427,2,work,8,14,6
427,3,shop,14,16,2
427,4,home,16,24,8
427,5,<ENDS>,24,24,0
428,0,<START>,0,0,0
428,1,home,0,8,8
428,2,education,8,11,3
428,3,home,11,16,5
428,4,work,16,20,4
428,5,home,20,24,4
428,6,<ENDS>,24,24,0
429,0,<START>,0,0,0
429,1,home,0,6,6
429,2,work,6,7,1
429,3,home,7,13,6
429,4,work,13,15,2
429,5,home,15,21,6
429,6,work,21,22,1
429,7,home,22,24,2
429,8,<ENDS>,24,24,0
430,0,<START>,0,0,0
430,1,home,0,7,7
430,2,work,7,14,7
430,3,home,14,16,2
430,4,work,16,19,3
430,5,home,19,24,5
430,6,<ENDS>,24,24,0
431,0,<START>,0,0,0
431,1,home,0,8,8
431,2,work,8,15,7
431,3,home,15,24,9
431,4,<ENDS>,24,24,0
432,0,<START>,0,0,0
432,1,home,0,8,8
432,2,work,8,17,9
432,3,home,17,24,7
432,4,<ENDS>,24,24,0
433,0,<START>,0,0,0
433,1,home,0,6,6
433,2,work,6,7,1
433,3,home,7,13,6
433,4,work,13,15,2
433,5,home,15,21,6
433,6,work,21,22,1
433,7,home,22,24,2
433,8,<ENDS>,24,24,0
434,0,<START>,0,0,0
434,1,home,0,8,8
434,2,shop,8,9,1
434,3,home,9,16,7
434,4,work,16,20,4
434,5,home,20,24,4
434,6,<ENDS>,24,24,0
435,0,<START>,0,0,0
435,1,home,0,7,7
435,2,work,7,15,8
435,3,home,15,24,9
435,4,<ENDS>,24,24,0
436,0,<START>,0,0,0
436,1,home,0,7,7
436,2,work,7,9,2
436,3,home,9,14,5
436,4,work,14,16,2
436,5,home,16,23,7
436,6,work,23,24,1
436,7,<ENDS>,24,24,0
437,0,<START>,0,0,0
437,1,home,0,9,9
437,2,work,9,16,7
437,3,home,16,22,6
437,4,work,22,23,1
437,5,home,23,24,1
437,6,<ENDS>,24,24,0
438,0,<START>,0,0,0
438,1,home,0,8,8
438,2,work,8,15,7
438,3,home,15,23,8
438,4,work,23,24,1
438,5,<ENDS>,24,24,0
439,0,<START>,0,0,0
439,1,home,0,7,7
439,2,work,7,13,6
439,3,shop,13,14,1
439,4,work,14,20,6
439,5,home,20,24,4
439,6,<ENDS>,24,24,0
440,0,<START>,0,0,0
440,1,home,0,8,8
440,2,work,8,13,5
440,3,home,13,17,4
440,4,work,17,20,3
440,5,home,20,24,4
440,6,<ENDS>,24,24,0
441,0,<START>,0,0,0
441,1,home,0,7,7
441,2,work,7,13,6
441,3,home,13,17,4
441,4,work,17,20,3
441,5,home,20,24,4
441,6,<ENDS>,24,24,0
442,0,<START>,0,0,0
442,1,home,0,7,7
442,2,work,7,14,7
442,3,shop,14,15,1
442,4,work,15,20,5
442,5,home,20,24,4
442,6,<ENDS>,24,24,0
443,0,<START>,0,0,0
443,1,home,0,6,6
443,2,work,6,13,7
443,3,shop,13,14,1
443,4,work,14,19,5
443,5,home,19,24,5
443,6,<ENDS>,24,24,0
444,0,<START>,0,0,0
444,1,home,0,4,4
444,2,work,4,6,2
444,3,home,6,8,2
444,4,work,8,9,1
444,5,home,9,15,6
444,6,work,15,17,2
444,7,home,17,22,5
444,8,work,22,23,1
444,9,home,23,24,1
444,10,<ENDS>,24,24,0
445,0,<START>,0,0,0
445,1,home,0,6,6
445,2,work,6,13,7
445,3,home,13,17,4
445,4,work,17,20,3
445,5,home,20,24,4
445,6,<ENDS>,24,24,0
446,0,<START>,0,0,0
446,1,home,0,7,7
446,2,work,7,13,6
446,3,home,13,24,11
446,4,<ENDS>,24,24,0
447,0,<START>,0,0,0
447,1,home,0,7,7
447,2,work,7,14,7
447,3,home,14,24,10
447,4,<ENDS>,24,24,0
448,0,<START>,0,0,0
448,1,home,0,6,6
448,2,work,6,13,7
448,3,shop,13,14,1
448,4,home,14,24,10
448,5,<ENDS>,24,24,0
449,0,<START>,0,0,0
449,1,home,0,7,7
449,2,work,7,14,7
449,3,home,14,24,10
449,4,<ENDS>,24,24,0
450,0,<START>,0,0,0
450,1,home,0,7,7
450,2,education,7,12,5
450,3,shop,12,14,2
450,4,home,14,18,4
450,5,shop,18,19,1
450,6,home,19,24,5
450,7,<ENDS>,24,24,0
451,0,<START>,0,0,0
451,1,home,0,7,7
451,2,work,7,9,2
451,3,home,9,13,4
451,4,work,13,15,2
451,5,home,15,22,7
451,6,work,22,23,1
451,7,home,23,24,1
451,8,<ENDS>,24,24,0
452,0,<START>,0,0,0
452,1,home,0,8,8
452,2,education,8,11,3
452,3,shop,11,12,1
452,4,work,12,19,7
452,5,home,19,24,5
452,6,<ENDS>,24,24,0
453,0,<START>,0,0,0
453,1,home,0,6,6
453,2,work,6,13,7
453,3,home,13,24,11
453,4,<ENDS>,24,24,0
454,0,<START>,0,0,0
454,1,home,0,6,6
454,2,work,6,8,2
454,3,home,8,13,5
454,4,work,13,15,2
454,5,home,15,21,6
454,6,work,21,22,1
454,7,home,22,24,2
454,8,<ENDS>,24,24,0
455,0,<START>,0,0,0
455,1,home,0,6,6
455,2,work,6,12,6
455,3,shop,12,13,1
455,4,work,13,19,6
455,5,home,19,24,5
455,6,<ENDS>,24,24,0
456,0,<START>,0,0,0
456,1,home,0,6,6
456,2,shop,6,7,1
456,3,home,7,10,3
456,4,education,10,12,2
456,5,shop,12,14,2
456,6,education,14,16,2
456,7,home,16,24,8
456,8,<ENDS>,24,24,0
457,0,<START>,0,0,0
457,1,home,0,6,6
457,2,work,6,13,7
457,3,shop,13,14,1
457,4,home,14,24,10
457,5,<ENDS>,24,24,0
458,0,<START>,0,0,0
458,1,home,0,8,8
458,2,education,8,11,3
458,3,home,11,17,6
458,4,shop,17,19,2
458,5,home,19,24,5
458,6,<ENDS>,24,24,0
459,0,<START>,0,0,0
459,1,home,0,7,7
459,2,work,7,13,6
459,3,shop,13,14,1
459,4,home,14,24,10
459,5,<ENDS>,24,24,0
460,0,<START>,0,0,0
460,1,home,0,6,6
460,2,shop,6,7,1
460,3,home,7,10,3
460,4,education,10,13,3
460,5,shop,13,15,2
460,6,home,15,20,5
460,7,shop,20,21,1
460,8,home,21,24,3
460,9,<ENDS>,24,24,0
461,0,<START>,0,0,0
461,1,home,0,6,6
461,2,shop,6,7,1
461,3,home,7,9,2
461,4,education,9,11,2
461,5,home,11,18,7
461,6,shop,18,19,1
461,7,home,19,24,5
461,8,<ENDS>,24,24,0
462,0,<START>,0,0,0
462,1,home,0,8,8
462,2,work,8,15,7
462,3,shop,15,16,1
462,4,work,16,18,2
462,5,home,18,24,6
462,6,<ENDS>,24,24,0
463,0,<START>,0,0,0
463,1,home,0,8,8
463,2,work,8,15,7
463,3,home,15,21,6
463,4,work,21,22,1
463,5,home,22,24,2
463,6,<ENDS>,24,24,0
464,0,<START>,0,0,0
464,1,home,0,7,7
464,2,work,7,14,7
464,3,home,14,16,2
464,4,work,16,20,4
464,5,home,20,24,4
464,6,<ENDS>,24,24,0
465,0,<START>,0,0,0
465,1,home,0,6,6
465,2,work,6,13,7
465,3,shop,13,14,1
465,4,home,14,24,10
465,5,<ENDS>,24,24,0
466,0,<START>,0,0,0
466,1,home,0,6,6
466,2,shop,6,7,1
466,3,home,7,13,6
466,4,education,13,16,3
466,5,home,16,24,8
466,6,<ENDS>,24,24,0
467,0,<START>,0,0,0
467,1,home,0,7,7
467,2,education,7,11,4
467,3,home,11,19,8
467,4,shop,19,21,2
467,5,home,21,24,3
467,6,<ENDS>,24,24,0
468,0,<START>,0,0,0
468,1,home,0,9,9
468,2,work,9,16,7
468,3,home,16,24,8
468,4,<ENDS>,24,24,0
469,0,<START>,0,0,0
469,1,home,0,10,10
469,2,work,10,17,7
469,3,home,17,23,6
469,4,work,23,24,1
469,5,<ENDS>,24,24,0
470,0,<START>,0,0,0
470,1,home,0,8,8
470,2,work,8,15,7
470,3,shop,15,16,1
470,4,work,16,19,3
470,5,home,19,24,5
470,6,<ENDS>,24,24,0
471,0,<START>,0,0,0
471,1,home,0,7,7
471,2,work,7,13,6
471,3,shop,13,14,1
471,4,home,14,24,10
471,5,<ENDS>,24,24,0
472,0,<START>,0,0,0
472,1,home,0,6,6
472,2,shop,6,7,1
472,3,work,7,13,6
472,4,home,13,24,11
472,5,<ENDS>,24,24,0
473,0,<START>,0,0,0
473,1,home,0,7,7
473,2,work,7,15,8
473,3,home,15,24,9
473,4,<ENDS>,24,24,0
474,0,<START>,0,0,0
474,1,home,0,8,8
474,2,work,8,14,6
474,3,home,14,24,10
474,4,<ENDS>,24,24,0
475,0,<START>,0,0,0
475,1,home,0,7,7
475,2,work,7,9,2
475,3,home,9,15,6
475,4,work,15,17,2
475,5,home,17,23,6
475,6,work,23,24,1
475,7,<ENDS>,24,24,0
476,0,<START>,0,0,0
476,1,home,0,7,7
476,2,work,7,8,1
476,3,home,8,9,1
476,4,work,9,11,2
476,5,home,11,17,6
476,6,work,17,19,2
476,7,home,19,24,5
476,8,<ENDS>,24,24,0
477,0,<START>,0,0,0
477,1,home,0,8,8
477,2,work,8,14,6
477,3,home,14,23,9
477,4,work,23,24,1
477,5,<ENDS>,24,24,0
478,0,<START>,0,0,0
478,1,home,0,6,6
478,2,work,6,13,7
478,3,shop,13,14,1
478,4,work,14,20,6
478,5,home,20,24,4
478,6,<ENDS>,24,24,0
479,0,<START>,0,0,0
479,1,home,0,8,8
479,2,work,8,15,7
479,3,home,15,20,5
479,4,shop,20,21,1
479,5,home,21,24,3
479,6,<ENDS>,24,24,0
480,0,<START>,0,0,0
480,1,home,0,7,7
480,2,education,7,12,5
480,3,shop,12,13,1
480,4,education,13,16,3
480,5,home,16,24,8
480,6,<ENDS>,24,24,0
481,0,<START>,0,0,0
481,1,home,0,6,6
481,2,work,6,13,7
481,3,home,13,18,5
481,4,work,18,20,2
481,5,home,20,24,4
481,6,<ENDS>,24,24,0
482,0,<START>,0,0,0
482,1,home,0,6,6
482,2,work,6,13,7
482,3,shop,13,14,1
482,4,home,14,17,3
482,5,work,17,20,3
482,6,home,20,24,4
482,7,<ENDS>,24,24,0
483,0,<START>,0,0,0
483,1,home,0,6,6
483,2,work,6,13,7
483,3,shop,13,14,1
483,4,home,14,20,6
483,5,shop,20,21,1
483,6,home,21,24,3
483,7,<ENDS>,24,24,0
484,0,<START>,0,0,0
484,1,home,0,7,7
484,2,work,7,13,6
484,3,home,13,17,4
484,4,work,17,20,3
484,5,home,20,24,4
484,6,<ENDS>,24,24,0
485,0,<START>,0,0,0
485,1,home,0,6,6
485,2,work,6,13,7
485,3,home,13,22,9
485,4,work,22,23,1
485,5,home,23,24,1
485,6,<ENDS>,24,24,0
486,0,<START>,0,0,0
486,1,home,0,7,7
486,2,shop,7,8,1
486,3,education,8,11,3
486,4,home,11,18,7
486,5,shop,18,19,1
486,6,home,19,24,5
486,7,<ENDS>,24,24,0
487,0,<START>,0,0,0
487,1,home,0,9,9
487,2,work,9,15,6
487,3,home,15,19,4
487,4,shop,19,20,1
487,5,home,20,24,4
487,6,<ENDS>,24,24,0
488,0,<START>,0,0,0
488,1,home,0,8,8
488,2,shop,8,9,1
488,3,home,9,10,1
488,4,work,10,17,7
488,5,home,17,24,7
488,6,<ENDS>,24,24,0
489,0,<START>,0,0,0
489,1,home,0,7,7
489,2,work,7,13,6
489,3,shop,13,14,1
489,4,home,14,24,10
489,5,<ENDS>,24,24,0
490,0,<START>,0,0,0
490,1,home,0,6,6
490,2,shop,6,7,1
490,3,home,7,10,3
490,4,education,10,12,2
490,5,shop,12,13,1
490,6,education,13,16,3
490,7,home,16,24,8
490,8,<ENDS>,24,24,0
491,0,<START>,0,0,0
491,1,home,0,8,8
491,2,work,8,14,6
491,3,home,14,18,4
491,4,work,18,20,2
491,5,home,20,24,4
491,6,<ENDS>,24,24,0
492,0,<START>,0,0,0
492,1,home,0,8,8
492,2,education,8,11,3
492,3,home,11,19,8
492,4,shop,19,20,1
492,5,home,20,24,4
492,6,<ENDS>,24,24,0
493,0,<START>,0,0,0
493,1,home,0,6,6
493,2,work,6,9,3
493,3,home,9,13,4
493,4,work,13,15,2
493,5,home,15,22,7
493,6,work,22,23,1
493,7,home,23,24,1
493,8,<ENDS>,24,24,0
494,0,<START>,0,0,0
494,1,home,0,8,8
494,2,work,8,15,7
494,3,home,15,21,6
494,4,work,21,22,1
494,5,home,22,24,2
494,6,<ENDS>,24,24,0
495,0,<START>,0,0,0
495,1,home,0,6,6
495,2,work,6,8,2
495,3,home,8,11,3
495,4,work,11,13,2
495,5,home,13,21,8
495,6,work,21,22,1
495,7,home,22,24,2
495,8,<ENDS>,24,24,0
496,0,<START>,0,0,0
496,1,home,0,7,7
496,2,work,7,14,7
496,3,shop,14,15,1
496,4,work,15,20,5
496,5,home,20,24,4
496,6,<ENDS>,24,24,0
497,0,<START>,0,0,0
497,1,home,0,7,7
497,2,work,7,9,2
497,3,home,9,12,3
497,4,shop,12,13,1
497,5,work,13,15,2
497,6,home,15,22,7
497,7,work,22,23,1
497,8,home,23,24,1
497,9,<ENDS>,24,24,0
498,0,<START>,0,0,0
498,1,home,0,8,8
498,2,education,8,15,7
498,3,shop,15,16,1
498,4,home,16,18,2
498,5,work,18,20,2
498,6,home,20,24,4
498,7,<ENDS>,24,24,0
499,0,<START>,0,0,0
499,1,home,0,8,8
499,2,work,8,13,5
499,3,home,13,24,11
499,4,<ENDS>,24,24,0
500,0,<START>,0,0,0
500,1,home,0,6,6
500,2,work,6,13,7
500,3,home,13,24,11
500,4,<ENDS>,24,24,0
501,0,<START>,0,0,0
501,1,home,0,7,7
501,2,work,7,13,6
501,3,home,13,17,4
501,4,work,17,20,3
501,5,home,20,24,4
501,6,<ENDS>,24,24,0
502,0,<START>,0,0,0
502,1,home,0,7,7
502,2,work,7,14,7
502,3,home,14,21,7
502,4,work,21,22,1
502,5,home,22,24,2
502,6,<ENDS>,24,24,0
503,0,<START>,0,0,0
503,1,home,0,6,6
503,2,work,6,13,7
503,3,home,13,17,4
503,4,work,17,20,3
503,5,home,20,24,4
503,6,<ENDS>,24,24,0
504,0,<START>,0,0,0
504,1,home,0,6,6
504,2,work,6,8,2
504,3,home,8,14,6
504,4,work,14,16,2
504,5,home,16,23,7
504,6,work,23,24,1
504,7,<ENDS>,24,24,0
505,0,<START>,0,0,0
505,1,home,0,8,8
505,2,shop,8,9,1
505,3,work,9,16,7
505,4,home,16,24,8
505,5,<ENDS>,24,24,0
506,0,<START>,0,0,0
506,1,home,0,6,6
506,2,work,6,13,7
506,3,home,13,21,8
506,4,work,21,22,1
506,5,home,22,24,2
506,6,<ENDS>,24,24,0
507,0,<START>,0,0,0
507,1,home,0,8,8
507,2,work,8,15,7
507,3,home,15,24,9
507,4,<ENDS>,24,24,0
508,0,<START>,0,0,0
508,1,home,0,6,6
508,2,work,6,13,7
508,3,home,13,21,8
508,4,work,21,22,1
508,5,home,22,24,2
508,6,<ENDS>,24,24,0
509,0,<START>,0,0,0
509,1,home,0,8,8
509,2,work,8,15,7
509,3,shop,15,16,1
509,4,home,16,24,8
509,5,<ENDS>,24,24,0
510,0,<START>,0,0,0
510,1,home,0,7,7
510,2,shop,7,8,1
510,3,education,8,11,3
510,4,home,11,18,7
510,5,shop,18,20,2
510,6,home,20,24,4
510,7,<ENDS>,24,24,0
511,0,<START>,0,0,0
511,1,home,0,7,7
511,2,work,7,14,7
511,3,home,14,24,10
511,4,<ENDS>,24,24,0
512,0,<START>,0,0,0
512,1,home,0,6,6
512,2,work,6,7,1
512,3,home,7,12,5
512,4,work,12,14,2
512,5,home,14,21,7
512,6,work,21,22,1
512,7,home,22,24,2
512,8,<ENDS>,24,24,0
513,0,<START>,0,0,0
513,1,home,0,7,7
513,2,education,7,11,4
513,3,home,11,15,4
513,4,shop,15,16,1
513,5,home,16,24,8
513,6,<ENDS>,24,24,0
514,0,<START>,0,0,0
514,1,home,0,9,9
514,2,work,9,15,6
514,3,home,15,24,9
514,4,<ENDS>,24,24,0
515,0,<START>,0,0,0
515,1,home,0,8,8
515,2,work,8,15,7
515,3,home,15,21,6
515,4,work,21,22,1
515,5,home,22,24,2
515,6,<ENDS>,24,24,0
516,0,<START>,0,0,0
516,1,home,0,7,7
516,2,work,7,13,6
516,3,home,13,23,10
516,4,work,23,24,1
516,5,<ENDS>,24,24,0
517,0,<START>,0,0,0
517,1,home,0,9,9
517,2,work,9,16,7
517,3,home,16,24,8
517,4,<ENDS>,24,24,0
518,0,<START>,0,0,0
518,1,home,0,8,8
518,2,work,8,14,6
518,3,home,14,24,10
518,4,<ENDS>,24,24,0
519,0,<START>,0,0,0
519,1,home,0,8,8
519,2,education,8,11,3
519,3,home,11,19,8
519,4,shop,19,20,1
519,5,home,20,24,4
519,6,<ENDS>,24,24,0
520,0,<START>,0,0,0
520,1,home,0,6,6
520,2,work,6,8,2
520,3,home,8,14,6
520,4,work,14,16,2
520,5,home,16,23,7
520,6,work,23,24,1
520,7,<ENDS>,24,24,0
521,0,<START>,0,0,0
521,1,home,0,8,8
521,2,work,8,16,8
521,3,home,16,22,6
521,4,work,22,23,1
521,5,home,23,24,1
521,6,<ENDS>,24,24,0
522,0,<START>,0,0,0
522,1,home,0,7,7
522,2,work,7,15,8
522,3,home,15,18,3
522,4,shop,18,19,1
522,5,home,19,24,5
522,6,<ENDS>,24,24,0
523,0,<START>,0,0,0
523,1,home,0,7,7
523,2,shop,7,8,1
523,3,home,8,12,4
523,4,work,12,19,7
523,5,home,19,24,5
523,6,<ENDS>,24,24,0
524,0,<START>,0,0,0
524,1,home,0,8,8
524,2,education,8,12,4
524,3,work,12,18,6
524,4,home,18,24,6
524,5,<ENDS>,24,24,0
525,0,<START>,0,0,0
525,1,home,0,8,8
525,2,work,8,13,5
525,3,home,13,17,4
525,4,shop,17,18,1
525,5,home,18,24,6
525,6,<ENDS>,24,24,0
526,0,<START>,0,0,0
526,1,home,0,8,8
526,2,work,8,15,7
526,3,home,15,24,9
526,4,<ENDS>,24,24,0
527,0,<START>,0,0,0
527,1,home,0,7,7
527,2,work,7,14,7
527,3,home,14,24,10
527,4,<ENDS>,24,24,0
528,0,<START>,0,0,0
528,1,home,0,7,7
528,2,work,7,13,6
528,3,home,13,24,11
528,4,<ENDS>,24,24,0
529,0,<START>,0,0,0
529,1,home,0,7,7
529,2,work,7,13,6
529,3,shop,13,14,1
529,4,home,14,24,10
529,5,<ENDS>,24,24,0
530,0,<START>,0,0,0
530,1,home,0,7,7
530,2,work,7,14,7
530,3,home,14,24,10
530,4,<ENDS>,24,24,0
531,0,<START>,0,0,0
531,1,home,0,7,7
531,2,shop,7,8,1
531,3,work,8,15,7
531,4,home,15,24,9
531,5,<ENDS>,24,24,0
532,0,<START>,0,0,0
532,1,home,0,6,6
532,2,work,6,13,7
532,3,home,13,23,10
532,4,work,23,24,1
532,5,<ENDS>,24,24,0
533,0,<START>,0,0,0
533,1,home,0,7,7
533,2,work,7,8,1
533,3,home,8,14,6
533,4,work,14,16,2
533,5,home,16,22,6
533,6,work,22,23,1
533,7,home,23,24,1
533,8,<ENDS>,24,24,0
534,0,<START>,0,0,0
534,1,home,0,9,9
534,2,work,9,16,7
534,3,home,16,24,8
534,4,<ENDS>,24,24,0
535,0,<START>,0,0,0
535,1,home,0,6,6
535,2,shop,6,7,1
535,3,home,7,13,6
535,4,education,13,16,3
535,5,shop,16,18,2
535,6,home,18,24,6
535,7,<ENDS>,24,24,0
536,0,<START>,0,0,0
536,1,home,0,6,6
536,2,work,6,13,7
536,3,home,13,24,11
536,4,<ENDS>,24,24,0
537,0,<START>,0,0,0
537,1,home,0,7,7
537,2,education,7,11,4
537,3,home,11,17,6
537,4,shop,17,19,2
537,5,home,19,24,5
537,6,<ENDS>,24,24,0
538,0,<START>,0,0,0
538,1,home,0,6,6
538,2,work,6,7,1
538,3,home,7,8,1
538,4,work,8,9,1
538,5,home,9,15,6
538,6,work,15,17,2
538,7,home,17,23,6
538,8,work,23,24,1
538,9,<ENDS>,24,24,0
539,0,<START>,0,0,0
539,1,home,0,8,8
539,2,education,8,11,3
539,3,home,11,19,8
539,4,shop,19,20,1
539,5,home,20,24,4
539,6,<ENDS>,24,24,0
540,0,<START>,0,0,0
540,1,home,0,6,6
540,2,work,6,8,2
540,3,home,8,13,5
540,4,work,13,16,3
540,5,home,16,21,5
540,6,work,21,22,1
540,7,home,22,24,2
540,8,<ENDS>,24,24,0
541,0,<START>,0,0,0
541,1,home,0,6,6
541,2,work,6,8,2
541,3,home,8,13,5
541,4,work,13,15,2
541,5,home,15,23,8
541,6,work,23,24,1
541,7,<ENDS>,24,24,0
542,0,<START>,0,0,0
542,1,home,0,7,7
542,2,work,7,13,6
542,3,home,13,24,11
542,4,<ENDS>,24,24,0
543,0,<START>,0,0,0
543,1,home,0,7,7
543,2,work,7,13,6
543,3,shop,13,14,1
543,4,work,14,20,6
543,5,home,20,24,4
543,6,<ENDS>,24,24,0
544,0,<START>,0,0,0
544,1,home,0,6,6
544,2,work,6,13,7
544,3,home,13,22,9
544,4,work,22,23,1
544,5,home,23,24,1
544,6,<ENDS>,24,24,0
545,0,<START>,0,0,0
545,1,home,0,7,7
545,2,work,7,13,6
545,3,shop,13,14,1
545,4,home,14,24,10
545,5,<ENDS>,24,24,0
546,0,<START>,0,0,0
546,1,home,0,8,8
546,2,work,8,15,7
546,3,home,15,24,9
546,4,<ENDS>,24,24,0
547,0,<START>,0,0,0
547,1,home,0,7,7
547,2,work,7,14,7
547,3,shop,14,15,1
547,4,home,15,21,6
547,5,work,21,22,1
547,6,home,22,24,2
547,7,<ENDS>,24,24,0
548,0,<START>,0,0,0
548,1,home,0,6,6
548,2,work,6,13,7
548,3,home,13,22,9
548,4,work,22,23,1
548,5,home,23,24,1
548,6,<ENDS>,24,24,0
549,0,<START>,0,0,0
549,1,home,0,6,6
549,2,work,6,14,8
549,3,home,14,24,10
549,4,<ENDS>,24,24,0
550,0,<START>,0,0,0
550,1,home,0,6,6
550,2,work,6,13,7
550,3,shop,13,14,1
550,4,home,14,24,10
550,5,<ENDS>,24,24,0
551,0,<START>,0,0,0
551,1,home,0,8,8
551,2,work,8,13,5
551,3,shop,13,14,1
551,4,work,14,19,5
551,5,home,19,24,5
551,6,<ENDS>,24,24,0
552,0,<START>,0,0,0
552,1,home,0,6,6
552,2,work,6,13,7
552,3,home,13,14,1
552,4,work,14,19,5
552,5,education,19,20,1
552,6,home,20,24,4
552,7,<ENDS>,24,24,0
553,0,<START>,0,0,0
553,1,home,0,8,8
553,2,work,8,15,7
553,3,home,15,24,9
553,4,<ENDS>,24,24,0
554,0,<START>,0,0,0
554,1,home,0,8,8
554,2,work,8,15,7
554,3,home,15,24,9
554,4,<ENDS>,24,24,0
555,0,<START>,0,0,0
555,1,home,0,6,6
555,2,shop,6,7,1
555,3,work,7,14,7
555,4,home,14,18,4
555,5,work,18,20,2
555,6,home,20,24,4
555,7,<ENDS>,24,24,0
556,0,<START>,0,0,0
556,1,home,0,6,6
556,2,shop,6,7,1
556,3,home,7,9,2
556,4,education,9,12,3
556,5,shop,12,14,2
556,6,education,14,16,2
556,7,home,16,24,8
556,8,<ENDS>,24,24,0
557,0,<START>,0,0,0
557,1,home,0,9,9
557,2,work,9,17,8
557,3,home,17,24,7
557,4,<ENDS>,24,24,0
558,0,<START>,0,0,0
558,1,home,0,7,7
558,2,shop,7,8,1
558,3,education,8,11,3
558,4,home,11,18,7
558,5,shop,18,20,2
558,6,home,20,24,4
558,7,<ENDS>,24,24,0
559,0,<START>,0,0,0
559,1,home,0,7,7
559,2,education,7,12,5
559,3,shop,12,13,1
559,4,education,13,16,3
559,5,shop,16,17,1
559,6,home,17,24,7
559,7,<ENDS>,24,24,0
560,0,<START>,0,0,0
560,1,home,0,8,8
560,2,work,8,14,6
560,3,home,14,24,10
560,4,<ENDS>,24,24,0
561,0,<START>,0,0,0
561,1,home,0,7,7
561,2,work,7,14,7
561,3,home,14,24,10
561,4,<ENDS>,24,24,0
562,0,<START>,0,0,0
562,1,home,0,7,7
562,2,work,7,13,6
562,3,shop,13,14,1
562,4,work,14,20,6
562,5,home,20,24,4
562,6,<ENDS>,24,24,0
563,0,<START>,0,0,0
563,1,home,0,6,6
563,2,work,6,13,7
563,3,shop,13,14,1
563,4,home,14,24,10
563,5,<ENDS>,24,24,0
564,0,<START>,0,0,0
564,1,home,0,7,7
564,2,work,7,14,7
564,3,shop,14,15,1
564,4,home,15,21,6
564,5,work,21,22,1
564,6,home,22,24,2
564,7,<ENDS>,24,24,0
565,0,<START>,0,0,0
565,1,home,0,7,7
565,2,work,7,14,7
565,3,home,14,24,10
565,4,<ENDS>,24,24,0
566,0,<START>,0,0,0
566,1,home,0,6,6
566,2,work,6,12,6
566,3,shop,12,13,1
566,4,work,13,18,5
566,5,home,18,24,6
566,6,<ENDS>,24,24,0
567,0,<START>,0,0,0
567,1,home,0,6,6
567,2,work,6,14,8
567,3,shop,14,15,1
567,4,home,15,18,3
567,5,work,18,20,2
567,6,home,20,24,4
567,7,<ENDS>,24,24,0
568,0,<START>,0,0,0
568,1,home,0,7,7
568,2,work,7,14,7
568,3,shop,14,15,1
568,4,work,15,19,4
568,5,home,19,24,5
568,6,<ENDS>,24,24,0
569,0,<START>,0,0,0
569,1,home,0,7,7
569,2,work,7,13,6
569,3,shop,13,14,1
569,4,home,14,21,7
569,5,work,21,22,1
569,6,home,22,24,2
569,7,<ENDS>,24,24,0
570,0,<START>,0,0,0
570,1,home,0,6,6
570,2,shop,6,7,1
570,3,work,7,13,6
570,4,home,13,24,11
570,5,<ENDS>,24,24,0
571,0,<START>,0,0,0
571,1,home,0,6,6
571,2,work,6,8,2
571,3,home,8,12,4
571,4,work,12,14,2
571,5,home,14,21,7
571,6,work,21,22,1
571,7,home,22,24,2
571,8,<ENDS>,24,24,0
572,0,<START>,0,0,0
572,1,home,0,7,7
572,2,work,7,13,6
572,3,shop,13,14,1
572,4,work,14,20,6
572,5,home,20,24,4
572,6,<ENDS>,24,24,0
573,0,<START>,0,0,0
573,1,home,0,6,6
573,2,shop,6,7,1
573,3,home,7,9,2
573,4,education,9,11,2
573,5,home,11,16,5
573,6,shop,16,17,1
573,7,home,17,24,7
573,8,<ENDS>,24,24,0
574,0,<START>,0,0,0
574,1,home,0,6,6
574,2,shop,6,7,1
574,3,home,7,10,3
574,4,education,10,12,2
574,5,shop,12,13,1
574,6,education,13,16,3
574,7,home,16,21,5
574,8,shop,21,22,1
574,9,home,22,24,2
574,10,<ENDS>,24,24,0
575,0,<START>,0,0,0
575,1,home,0,7,7
575,2,work,7,13,6
575,3,home,13,24,11
575,4,<ENDS>,24,24,0
576,0,<START>,0,0,0
576,1,home,0,6,6
576,2,work,6,8,2
576,3,home,8,12,4
576,4,work,12,13,1
576,5,home,13,21,8
576,6,work,21,22,1
576,7,home,22,24,2
576,8,<ENDS>,24,24,0
577,0,<START>,0,0,0
577,1,home,0,7,7
577,2,work,7,14,7
577,3,home,14,24,10
577,4,<ENDS>,24,24,0
578,0,<START>,0,0,0
578,1,home,0,6,6
578,2,work,6,13,7
578,3,home,13,24,11
578,4,<ENDS>,24,24,0
579,0,<START>,0,0,0
579,1,home,0,7,7
579,2,work,7,14,7
579,3,shop,14,15,1
579,4,home,15,24,9
579,5,<ENDS>,24,24,0
580,0,<START>,0,0,0
580,1,home,0,9,9
580,2,work,9,17,8
580,3,home,17,21,4
580,4,work,21,22,1
580,5,home,22,24,2
580,6,<ENDS>,24,24,0
581,0,<START>,0,0,0
581,1,home,0,7,7
581,2,work,7,14,7
581,3,home,14,20,6
581,4,shop,20,21,1
581,5,home,21,24,3
581,6,<ENDS>,24,24,0
582,0,<START>,0,0,0
582,1,home,0,8,8
582,2,education,8,11,3
582,3,home,11,14,3
582,4,education,14,16,2
582,5,home,16,24,8
582,6,<ENDS>,24,24,0
583,0,<START>,0,0,0
583,1,home,0,7,7
583,2,work,7,13,6
583,3,home,13,24,11
583,4,<ENDS>,24,24,0
584,0,<START>,0,0,0
584,1,home,0,8,8
584,2,education,8,11,3
584,3,home,11,19,8
584,4,shop,19,20,1
584,5,home,20,24,4
584,6,<ENDS>,24,24,0
585,0,<START>,0,0,0
585,1,home,0,6,6
585,2,work,6,13,7
585,3,home,13,24,11
585,4,<ENDS>,24,24,0
586,0,<START>,0,0,0
586,1,home,0,8,8
586,2,work,8,15,7
586,3,home,15,20,5
586,4,shop,20,21,1
586,5,home,21,24,3
586,6,<ENDS>,24,24,0
587,0,<START>,0,0,0
587,1,home,0,8,8
587,2,work,8,15,7
587,3,home,15,24,9
587,4,<ENDS>,24,24,0
588,0,<START>,0,0,0
588,1,home,0,6,6
588,2,shop,6,7,1
588,3,work,7,14,7
588,4,home,14,22,8
588,5,work,22,23,1
588,6,home,23,24,1
588,7,<ENDS>,24,24,0
589,0,<START>,0,0,0
589,1,home,0,7,7
589,2,shop,7,8,1
589,3,education,8,11,3
589,4,home,11,17,6
589,5,shop,17,18,1
589,6,home,18,24,6
589,7,<ENDS>,24,24,0
590,0,<START>,0,0,0
590,1,home,0,7,7
590,2,work,7,13,6
590,3,shop,13,14,1
590,4,home,14,24,10
590,5,<ENDS>,24,24,0
591,0,<START>,0,0,0
591,1,home,0,6,6
591,2,work,6,13,7
591,3,shop,13,14,1
591,4,work,14,20,6
591,5,home,20,24,4
591,6,<ENDS>,24,24,0
592,0,<START>,0,0,0
592,1,home,0,6,6
592,2,work,6,13,7
592,3,home,13,24,11
592,4,<ENDS>,24,24,0
593,0,<START>,0,0,0
593,1,home,0,7,7
593,2,education,7,11,4
593,3,home,11,19,8
593,4,shop,19,20,1
593,5,home,20,24,4
593,6,<ENDS>,24,24,0
594,0,<START>,0,0,0
594,1,home,0,8,8
594,2,work,8,14,6
594,3,home,14,18,4
594,4,work,18,20,2
594,5,home,20,24,4
594,6,<ENDS>,24,24,0
595,0,<START>,0,0,0
595,1,home,0,7,7
595,2,work,7,14,7
595,3,home,14,18,4
595,4,work,18,20,2
595,5,home,20,24,4
595,6,<ENDS>,24,24,0
596,0,<START>,0,0,0
596,1,home,0,7,7
596,2,work,7,13,6
596,3,home,13,18,5
596,4,work,18,20,2
596,5,home,20,24,4
596,6,<ENDS>,24,24,0
597,0,<START>,0,0,0
597,1,home,0,7,7
597,2,education,7,11,4
597,3,home,11,13,2
597,4,education,13,16,3
597,5,home,16,24,8
597,6,<ENDS>,24,24,0
598,0,<START>,0,0,0
598,1,home,0,8,8
598,2,work,8,13,5
598,3,shop,13,14,1
598,4,work,14,19,5
598,5,home,19,24,5
598,6,<ENDS>,24,24,0
599,0,<START>,0,0,0
599,1,home,0,8,8
599,2,work,8,15,7
599,3,home,15,24,9
599,4,<ENDS>,24,24,0
600,0,<START>,0,0,0
600,1,home,0,7,7
600,2,education,7,12,5
600,3,home,12,19,7
600,4,shop,19,20,1
600,5,home,20,24,4
600,6,<ENDS>,24,24,0
601,0,<START>,0,0,0
601,1,home,0,6,6
601,2,work,6,13,7
601,3,shop,13,14,1
601,4,work,14,19,5
601,5,home,19,24,5
601,6,<ENDS>,24,24,0
602,0,<START>,0,0,0
602,1,home,0,6,6
602,2,work,6,13,7
602,3,home,13,17,4
602,4,work,17,20,3
602,5,home,20,24,4
602,6,<ENDS>,24,24,0
603,0,<START>,0,0,0
603,1,home,0,7,7
603,2,education,7,11,4
603,3,home,11,14,3
603,4,education,14,16,2
603,5,home,16,24,8
603,6,<ENDS>,24,24,0
604,0,<START>,0,0,0
604,1,home,0,6,6
604,2,shop,6,7,1
604,3,home,7,10,3
604,4,education,10,16,6
604,5,home,16,21,5
604,6,shop,21,22,1
604,7,home,22,24,2
604,8,<ENDS>,24,24,0
605,0,<START>,0,0,0
605,1,home,0,6,6
605,2,shop,6,7,1
605,3,home,7,13,6
605,4,education,13,16,3
605,5,shop,16,18,2
605,6,home,18,24,6
605,7,<ENDS>,24,24,0
606,0,<START>,0,0,0
606,1,home,0,7,7
606,2,work,7,14,7
606,3,home,14,19,5
606,4,shop,19,20,1
606,5,home,20,24,4
606,6,<ENDS>,24,24,0
607,0,<START>,0,0,0
607,1,home,0,8,8
607,2,work,8,14,6
607,3,home,14,24,10
607,4,<ENDS>,24,24,0
608,0,<START>,0,0,0
608,1,home,0,6,6
608,2,work,6,13,7
608,3,shop,13,14,1
608,4,home,14,16,2
608,5,work,16,20,4
608,6,home,20,24,4
608,7,<ENDS>,24,24,0
609,0,<START>,0,0,0
609,1,home,0,7,7
609,2,shop,7,8,1
609,3,education,8,12,4
609,4,home,12,19,7
609,5,shop,19,21,2
609,6,home,21,24,3
609,7,<ENDS>,24,24,0
610,0,<START>,0,0,0
610,1,home,0,7,7
610,2,education,7,11,4
610,3,home,11,18,7
610,4,shop,18,19,1
610,5,home,19,24,5
610,6,<ENDS>,24,24,0
611,0,<START>,0,0,0
611,1,home,0,6,6
611,2,work,6,12,6
611,3,shop,12,13,1
611,4,work,13,19,6
611,5,home,19,24,5
611,6,<ENDS>,24,24,0
612,0,<START>,0,0,0
612,1,home,0,6,6
612,2,work,6,13,7
612,3,home,13,24,11
612,4,<ENDS>,24,24,0
613,0,<START>,0,0,0
613,1,home,0,7,7
613,2,work,7,14,7
613,3,shop,14,15,1
613,4,home,15,22,7
613,5,work,22,23,1
613,6,home,23,24,1
613,7,<ENDS>,24,24,0
614,0,<START>,0,0,0
614,1,home,0,7,7
614,2,work,7,13,6
614,3,shop,13,14,1
614,4,work,14,19,5
614,5,home,19,24,5
614,6,<ENDS>,24,24,0
615,0,<START>,0,0,0
615,1,home,0,7,7
615,2,work,7,13,6
615,3,home,13,22,9
615,4,work,22,23,1
615,5,home,23,24,1
615,6,<ENDS>,24,24,0
616,0,<START>,0,0,0
616,1,home,0,7,7
616,2,education,7,11,4
616,3,home,11,17,6
616,4,shop,17,18,1
616,5,home,18,24,6
616,6,<ENDS>,24,24,0
617,0,<START>,0,0,0
617,1,home,0,7,7
617,2,work,7,14,7
617,3,shop,14,15,1
617,4,home,15,23,8
617,5,work,23,24,1
617,6,<ENDS>,24,24,0
618,0,<START>,0,0,0
618,1,home,0,7,7
618,2,work,7,14,7
618,3,home,14,24,10
618,4,<ENDS>,24,24,0
619,0,<START>,0,0,0
619,1,home,0,8,8
619,2,education,8,11,3
619,3,home,11,17,6
619,4,shop,17,18,1
619,5,home,18,24,6
619,6,<ENDS>,24,24,0
620,0,<START>,0,0,0
620,1,home,0,6,6
620,2,work,6,13,7
620,3,home,13,24,11
620,4,<ENDS>,24,24,0
621,0,<START>,0,0,0
621,1,home,0,7,7
621,2,work,7,13,6
621,3,home,13,22,9
621,4,work,22,23,1
621,5,home,23,24,1
621,6,<ENDS>,24,24,0
622,0,<START>,0,0,0
622,1,home,0,6,6
622,2,shop,6,7,1
622,3,work,7,13,6
622,4,home,13,24,11
622,5,<ENDS>,24,24,0
623,0,<START>,0,0,0
623,1,home,0,8,8
623,2,work,8,15,7
623,3,home,15,24,9
623,4,<ENDS>,24,24,0
624,0,<START>,0,0,0
624,1,home,0,8,8
624,2,education,8,13,5
624,3,shop,13,14,1
624,4,education,14,17,3
624,5,home,17,24,7
624,6,<ENDS>,24,24,0
625,0,<START>,0,0,0
625,1,home,0,6,6
625,2,shop,6,7,1
625,3,work,7,14,7
625,4,home,14,22,8
625,5,work,22,23,1
625,6,home,23,24,1
625,7,<ENDS>,24,24,0
626,0,<START>,0,0,0
626,1,home,0,8,8
626,2,work,8,14,6
626,3,shop,14,15,1
626,4,home,15,23,8
626,5,work,23,24,1
626,6,<ENDS>,24,24,0
627,0,<START>,0,0,0
627,1,home,0,7,7
627,2,education,7,11,4
627,3,home,11,14,3
627,4,education,14,16,2
627,5,home,16,24,8
627,6,<ENDS>,24,24,0
628,0,<START>,0,0,0
628,1,home,0,9,9
628,2,work,9,16,7
628,3,home,16,21,5
628,4,work,21,22,1
628,5,home,22,24,2
628,6,<ENDS>,24,24,0
629,0,<START>,0,0,0
629,1,home,0,7,7
629,2,education,7,11,4
629,3,home,11,19,8
629,4,shop,19,20,1
629,5,home,20,24,4
629,6,<ENDS>,24,24,0
630,0,<START>,0,0,0
630,1,home,0,7,7
630,2,shop,7,8,1
630,3,education,8,11,3
630,4,home,11,17,6
630,5,shop,17,18,1
630,6,home,18,24,6
630,7,<ENDS>,24,24,0
631,0,<START>,0,0,0
631,1,home,0,8,8
631,2,education,8,11,3
631,3,home,11,15,4
631,4,work,15,20,5
631,5,home,20,24,4
631,6,<ENDS>,24,24,0
632,0,<START>,0,0,0
632,1,home,0,7,7
632,2,work,7,13,6
632,3,shop,13,14,1
632,4,work,14,19,5
632,5,home,19,24,5
632,6,<ENDS>,24,24,0
633,0,<START>,0,0,0
633,1,home,0,7,7
633,2,work,7,14,7
633,3,shop,14,15,1
633,4,home,15,24,9
633,5,<ENDS>,24,24,0
634,0,<START>,0,0,0
634,1,home,0,7,7
634,2,work,7,14,7
634,3,home,14,24,10
634,4,<ENDS>,24,24,0
635,0,<START>,0,0,0
635,1,home,0,7,7
635,2,shop,7,9,2
635,3,education,9,15,6
635,4,shop,15,17,2
635,5,home,17,24,7
635,6,<ENDS>,24,24,0
636,0,<START>,0,0,0
636,1,home,0,7,7
636,2,work,7,14,7
636,3,shop,14,15,1
636,4,home,15,24,9
636,5,<ENDS>,24,24,0
637,0,<START>,0,0,0
637,1,home,0,6,6
637,2,shop,6,7,1
637,3,work,7,15,8
637,4,home,15,21,6
637,5,work,21,22,1
637,6,home,22,24,2
637,7,<ENDS>,24,24,0
638,0,<START>,0,0,0
638,1,home,0,7,7
638,2,work,7,14,7
638,3,shop,14,16,2
638,4,work,16,20,4
638,5,home,20,24,4
638,6,<ENDS>,24,24,0
639,0,<START>,0,0,0
639,1,home,0,7,7
639,2,work,7,13,6
639,3,shop,13,14,1
639,4,work,14,20,6
639,5,home,20,24,4
639,6,<ENDS>,24,24,0
640,0,<START>,0,0,0
640,1,home,0,7,7
640,2,work,7,13,6
640,3,shop,13,14,1
640,4,work,14,19,5
640,5,home,19,24,5
640,6,<ENDS>,24,24,0
641,0,<START>,0,0,0
641,1,home,0,8,8
641,2,education,8,11,3
641,3,home,11,15,4
641,4,work,15,20,5
641,5,home,20,24,4
641,6,<ENDS>,24,24,0
642,0,<START>,0,0,0
642,1,home,0,6,6
642,2,work,6,8,2
642,3,home,8,14,6
642,4,work,14,16,2
642,5,home,16,22,6
642,6,work,22,23,1
642,7,home,23,24,1
642,8,<ENDS>,24,24,0
643,0,<START>,0,0,0
643,1,home,0,8,8
643,2,work,8,14,6
643,3,home,14,21,7
643,4,shop,21,22,1
643,5,home,22,24,2
643,6,<ENDS>,24,24,0
644,0,<START>,0,0,0
644,1,home,0,7,7
644,2,education,7,12,5
644,3,home,12,19,7
644,4,shop,19,20,1
644,5,home,20,24,4
644,6,<ENDS>,24,24,0
645,0,<START>,0,0,0
645,1,home,0,8,8
645,2,work,8,14,6
645,3,home,14,21,7
645,4,work,21,22,1
645,5,home,22,24,2
645,6,<ENDS>,24,24,0
646,0,<START>,0,0,0
646,1,home,0,7,7
646,2,work,7,13,6
646,3,home,13,23,10
646,4,work,23,24,1
646,5,<ENDS>,24,24,0
647,0,<START>,0,0,0
647,1,home,0,6,6
647,2,work,6,13,7
647,3,shop,13,14,1
647,4,home,14,24,10
647,5,<ENDS>,24,24,0
648,0,<START>,0,0,0
648,1,home,0,7,7
648,2,work,7,13,6
648,3,shop,13,14,1
648,4,home,14,24,10
648,5,<ENDS>,24,24,0
649,0,<START>,0,0,0
649,1,home,0,7,7
649,2,work,7,13,6
649,3,shop,13,15,2
649,4,home,15,24,9
649,5,<ENDS>,24,24,0
650,0,<START>,0,0,0
650,1,home,0,6,6
650,2,work,6,13,7
650,3,shop,13,14,1
650,4,work,14,17,3
650,5,home,17,21,4
650,6,work,21,22,1
650,7,home,22,24,2
650,8,<ENDS>,24,24,0
651,0,<START>,0,0,0
651,1,home,0,6,6
651,2,shop,6,7,1
651,3,home,7,10,3
651,4,education,10,12,2
651,5,shop,12,14,2
651,6,home,14,21,7
651,7,shop,21,22,1
651,8,home,22,24,2
651,9,<ENDS>,24,24,0
652,0,<START>,0,0,0
652,1,home,0,6,6
652,2,work,6,13,7
652,3,home,13,21,8
652,4,work,21,22,1
652,5,home,22,24,2
652,6,<ENDS>,24,24,0
653,0,<START>,0,0,0
653,1,home,0,9,9
653,2,work,9,16,7
653,3,home,16,21,5
653,4,work,21,22,1
653,5,home,22,24,2
653,6,<ENDS>,24,24,0
654,0,<START>,0,0,0
654,1,home,0,6,6
654,2,work,6,13,7
654,3,shop,13,14,1
654,4,work,14,19,5
654,5,home,19,24,5
654,6,<ENDS>,24,24,0
655,0,<START>,0,0,0
655,1,home,0,7,7
655,2,work,7,13,6
655,3,home,13,17,4
655,4,work,17,20,3
655,5,home,20,24,4
655,6,<ENDS>,24,24,0
656,0,<START>,0,0,0
656,1,home,0,6,6
656,2,work,6,7,1
656,3,home,7,10,3
656,4,work,10,12,2
656,5,home,12,17,5
656,6,work,17,19,2
656,7,home,19,24,5
656,8,<ENDS>,24,24,0
657,0,<START>,0,0,0
657,1,home,0,8,8
657,2,work,8,14,6
657,3,home,14,16,2
657,4,work,16,20,4
657,5,home,20,24,4
657,6,<ENDS>,24,24,0
658,0,<START>,0,0,0
658,1,home,0,7,7
658,2,education,7,11,4
658,3,home,11,15,4
658,4,shop,15,16,1
658,5,home,16,24,8
658,6,<ENDS>,24,24,0
659,0,<START>,0,0,0
659,1,home,0,8,8
659,2,shop,8,9,1
659,3,work,9,16,7
659,4,home,16,24,8
659,5,<ENDS>,24,24,0
660,0,<START>,0,0,0
660,1,home,0,6,6
660,2,shop,6,7,1
660,3,work,7,8,1
660,4,home,8,13,5
660,5,work,13,15,2
660,6,home,15,22,7
660,7,work,22,23,1
660,8,home,23,24,1
660,9,<ENDS>,24,24,0
661,0,<START>,0,0,0
661,1,home,0,8,8
661,2,work,8,13,5
661,3,home,13,24,11
661,4,<ENDS>,24,24,0
662,0,<START>,0,0,0
662,1,home,0,8,8
662,2,work,8,15,7
662,3,home,15,24,9
662,4,<ENDS>,24,24,0
663,0,<START>,0,0,0
663,1,home,0,7,7
663,2,work,7,14,7
663,3,home,14,24,10
663,4,<ENDS>,24,24,0
664,0,<START>,0,0,0
664,1,home,0,7,7
664,2,education,7,12,5
664,3,shop,12,13,1
664,4,education,13,16,3
664,5,home,16,20,4
664,6,shop,20,21,1
664,7,home,21,24,3
664,8,<ENDS>,24,24,0
665,0,<START>,0,0,0
665,1,home,0,8,8
665,2,work,8,14,6
665,3,home,14,23,9
665,4,work,23,24,1
665,5,<ENDS>,24,24,0
666,0,<START>,0,0,0
666,1,home,0,7,7
666,2,education,7,11,4
666,3,home,11,16,5
666,4,shop,16,17,1
666,5,home,17,24,7
666,6,<ENDS>,24,24,0
667,0,<START>,0,0,0
667,1,home,0,7,7
667,2,shop,7,8,1
667,3,work,8,15,7
667,4,home,15,24,9
667,5,<ENDS>,24,24,0
668,0,<START>,0,0,0
668,1,home,0,8,8
668,2,work,8,14,6
668,3,home,14,20,6
668,4,shop,20,21,1
668,5,home,21,24,3
668,6,<ENDS>,24,24,0
669,0,<START>,0,0,0
669,1,home,0,8,8
669,2,education,8,12,4
669,3,shop,12,13,1
669,4,education,13,16,3
669,5,home,16,24,8
669,6,<ENDS>,24,24,0
670,0,<START>,0,0,0
670,1,home,0,7,7
670,2,shop,7,8,1
670,3,home,8,13,5
670,4,work,13,19,6
670,5,home,19,24,5
670,6,<ENDS>,24,24,0
671,0,<START>,0,0,0
671,1,home,0,8,8
671,2,work,8,13,5
671,3,home,13,24,11
671,4,<ENDS>,24,24,0
672,0,<START>,0,0,0
672,1,home,0,7,7
672,2,work,7,13,6
672,3,shop,13,14,1
672,4,home,14,24,10
672,5,<ENDS>,24,24,0
673,0,<START>,0,0,0
673,1,home,0,7,7
673,2,work,7,12,5
673,3,shop,12,13,1
673,4,work,13,19,6
673,5,home,19,24,5
673,6,<ENDS>,24,24,0
674,0,<START>,0,0,0
674,1,home,0,6,6
674,2,shop,6,7,1
674,3,home,7,13,6
674,4,education,13,16,3
674,5,home,16,24,8
674,6,<ENDS>,24,24,0
675,0,<START>,0,0,0
675,1,home,0,8,8
675,2,education,8,11,3
675,3,home,11,14,3
675,4,education,14,16,2
675,5,home,16,24,8
675,6,<ENDS>,24,24,0
676,0,<START>,0,0,0
676,1,home,0,7,7
676,2,work,7,13,6
676,3,home,13,17,4
676,4,shop,17,18,1
676,5,home,18,24,6
676,6,<ENDS>,24,24,0
677,0,<START>,0,0,0
677,1,home,0,7,7
677,2,education,7,12,5
677,3,shop,12,14,2
677,4,education,14,16,2
677,5,home,16,24,8
677,6,<ENDS>,24,24,0
678,0,<START>,0,0,0
678,1,home,0,7,7
678,2,work,7,9,2
678,3,home,9,15,6
678,4,work,15,17,2
678,5,home,17,23,6
678,6,work,23,24,1
678,7,<ENDS>,24,24,0
679,0,<START>,0,0,0
679,1,home,0,8,8
679,2,work,8,14,6
679,3,home,14,21,7
679,4,work,21,22,1
679,5,home,22,24,2
679,6,<ENDS>,24,24,0
680,0,<START>,0,0,0
680,1,home,0,6,6
680,2,work,6,8,2
680,3,home,8,14,6
680,4,work,14,16,2
680,5,home,16,23,7
680,6,work,23,24,1
680,7,<ENDS>,24,24,0
681,0,<START>,0,0,0
681,1,home,0,7,7
681,2,work,7,13,6
681,3,home,13,21,8
681,4,work,21,22,1
681,5,home,22,24,2
681,6,<ENDS>,24,24,0
682,0,<START>,0,0,0
682,1,home,0,7,7
682,2,work,7,14,7
682,3,home,14,24,10
682,4,<ENDS>,24,24,0
683,0,<START>,0,0,0
683,1,home,0,7,7
683,2,shop,7,8,1
683,3,work,8,15,7
683,4,home,15,24,9
683,5,<ENDS>,24,24,0
684,0,<START>,0,0,0
684,1,home,0,8,8
684,2,education,8,11,3
684,3,home,11,23,12
684,4,work,23,24,1
684,5,<ENDS>,24,24,0
685,0,<START>,0,0,0
685,1,home,0,6,6
685,2,work,6,13,7
685,3,home,13,24,11
685,4,<ENDS>,24,24,0
686,0,<START>,0,0,0
686,1,home,0,8,8
686,2,work,8,15,7
686,3,home,15,17,2
686,4,shop,17,18,1
686,5,home,18,24,6
686,6,<ENDS>,24,24,0
687,0,<START>,0,0,0
687,1,home,0,7,7
687,2,work,7,9,2
687,3,home,9,15,6
687,4,work,15,18,3
687,5,home,18,23,5
687,6,work,23,24,1
687,7,<ENDS>,24,24,0
688,0,<START>,0,0,0
688,1,home,0,7,7
688,2,shop,7,9,2
688,3,education,9,12,3
688,4,shop,12,14,2
688,5,home,14,24,10
688,6,<ENDS>,24,24,0
689,0,<START>,0,0,0
689,1,home,0,6,6
689,2,work,6,7,1
689,3,home,7,9,2
689,4,work,9,11,2
689,5,home,11,17,6
689,6,work,17,19,2
689,7,home,19,24,5
689,8,<ENDS>,24,24,0
690,0,<START>,0,0,0
690,1,home,0,7,7
690,2,education,7,11,4
690,3,home,11,19,8
690,4,shop,19,20,1
690,5,home,20,24,4
690,6,<ENDS>,24,24,0
691,0,<START>,0,0,0
691,1,home,0,7,7
691,2,work,7,13,6
691,3,shop,13,15,2
691,4,home,15,24,9
691,5,<ENDS>,24,24,0
692,0,<START>,0,0,0
692,1,home,0,9,9
692,2,education,9,13,4
692,3,home,13,17,4
692,4,work,17,20,3
692,5,home,20,24,4
692,6,<ENDS>,24,24,0
693,0,<START>,0,0,0
693,1,home,0,7,7
693,2,work,7,13,6
693,3,home,13,24,11
693,4,<ENDS>,24,24,0
694,0,<START>,0,0,0
694,1,home,0,6,6
694,2,shop,6,7,1
694,3,home,7,13,6
694,4,education,13,16,3
694,5,home,16,20,4
694,6,shop,20,21,1
694,7,home,21,24,3
694,8,<ENDS>,24,24,0
695,0,<START>,0,0,0
695,1,home,0,6,6
695,2,shop,6,7,1
695,3,home,7,10,3
695,4,education,10,12,2
695,5,home,12,20,8
695,6,shop,20,21,1
695,7,home,21,24,3
695,8,<ENDS>,24,24,0
696,0,<START>,0,0,0
696,1,home,0,6,6
696,2,shop,6,7,1
696,3,home,7,13,6
696,4,education,13,16,3
696,5,home,16,24,8
696,6,<ENDS>,24,24,0
697,0,<START>,0,0,0
697,1,home,0,6,6
697,2,work,6,13,7
697,3,shop,13,15,2
697,4,home,15,24,9
697,5,<ENDS>,24,24,0
698,0,<START>,0,0,0
698,1,work,0,2,2
698,2,home,2,8,6
698,3,work,8,10,2
698,4,home,10,16,6
698,5,work,16,18,2
698,6,home,18,22,4
698,7,work,22,23,1
698,8,home,23,24,1
698,9,<ENDS>,24,24,0
699,0,<START>,0,0,0
699,1,home,0,6,6
699,2,work,6,7,1
699,3,home,7,9,2
699,4,work,9,10,1
699,5,home,10,17,7
699,6,work,17,19,2
699,7,education,19,20,1
699,8,home,20,21,1
699,9,work,21,22,1
699,10,home,22,24,2
699,11,<ENDS>,24,24,0
700,0,<START>,0,0,0
700,1,home,0,8,8
700,2,work,8,10,2
700,3,home,10,16,6
700,4,shop,16,17,1
700,5,home,17,23,6
700,6,work,23,24,1
700,7,<ENDS>,24,24,0
701,0,<START>,0,0,0
701,1,home,0,9,9
701,2,work,9,16,7
701,3,shop,16,17,1
701,4,work,17,20,3
701,5,home,20,24,4
701,6,<ENDS>,24,24,0
702,0,<START>,0,0,0
702,1,home,0,8,8
702,2,work,8,14,6
702,3,shop,14,15,1
702,4,home,15,24,9
702,5,<ENDS>,24,24,0
703,0,<START>,0,0,0
703,1,home,0,7,7
703,2,education,7,11,4
703,3,home,11,15,4
703,4,shop,15,16,1
703,5,home,16,24,8
703,6,<ENDS>,24,24,0
704,0,<START>,0,0,0
704,1,home,0,6,6
704,2,work,6,13,7
704,3,home,13,17,4
704,4,work,17,20,3
704,5,home,20,24,4
704,6,<ENDS>,24,24,0
705,0,<START>,0,0,0
705,1,home,0,6,6
705,2,work,6,7,1
705,3,home,7,13,6
705,4,work,13,14,1
705,5,home,14,21,7
705,6,work,21,22,1
705,7,home,22,24,2
705,8,<ENDS>,24,24,0
706,0,<START>,0,0,0
706,1,home,0,8,8
706,2,shop,8,9,1
706,3,home,9,12,3
706,4,education,12,16,4
706,5,home,16,24,8
706,6,<ENDS>,24,24,0
707,0,<START>,0,0,0
707,1,home,0,7,7
707,2,work,7,13,6
707,3,home,13,16,3
707,4,work,16,19,3
707,5,home,19,24,5
707,6,<ENDS>,24,24,0
708,0,<START>,0,0,0
708,1,home,0,8,8
708,2,work,8,15,7
708,3,home,15,24,9
708,4,<ENDS>,24,24,0
709,0,<START>,0,0,0
709,1,home,0,6,6
709,2,shop,6,7,1
709,3,home,7,13,6
709,4,education,13,16,3
709,5,home,16,24,8
709,6,<ENDS>,24,24,0
710,0,<START>,0,0,0
710,1,home,0,7,7
710,2,work,7,13,6
710,3,home,13,17,4
710,4,shop,17,18,1
710,5,home,18,24,6
710,6,<ENDS>,24,24,0
711,0,<START>,0,0,0
711,1,home,0,7,7
711,2,work,7,13,6
711,3,shop,13,14,1
711,4,work,14,19,5
711,5,home,19,24,5
711,6,<ENDS>,24,24,0
712,0,<START>,0,0,0
712,1,home,0,8,8
712,2,work,8,14,6
712,3,home,14,24,10
712,4,<ENDS>,24,24,0
713,0,<START>,0,0,0
713,1,home,0,7,7
713,2,work,7,14,7
713,3,home,14,24,10
713,4,<ENDS>,24,24,0
714,0,<START>,0,0,0
714,1,home,0,7,7
714,2,shop,7,8,1
714,3,home,8,16,8
714,4,work,16,20,4
714,5,home,20,24,4
714,6,<ENDS>,24,24,0
715,0,<START>,0,0,0
715,1,home,0,7,7
715,2,education,7,11,4
715,3,home,11,18,7
715,4,shop,18,19,1
715,5,home,19,24,5
715,6,<ENDS>,24,24,0
716,0,<START>,0,0,0
716,1,home,0,6,6
716,2,shop,6,7,1
716,3,home,7,9,2
716,4,work,9,15,6
716,5,home,15,24,9
716,6,<ENDS>,24,24,0
717,0,<START>,0,0,0
717,1,home,0,9,9
717,2,education,9,12,3
717,3,home,12,15,3
717,4,work,15,20,5
717,5,home,20,24,4
717,6,<ENDS>,24,24,0
718,0,<START>,0,0,0
718,1,home,0,7,7
718,2,work,7,13,6
718,3,shop,13,14,1
718,4,education,14,16,2
718,5,home,16,18,2
718,6,work,18,20,2
718,7,home,20,24,4
718,8,<ENDS>,24,24,0
719,0,<START>,0,0,0
719,1,home,0,7,7
719,2,work,7,13,6
719,3,shop,13,14,1
719,4,home,14,24,10
719,5,<ENDS>,24,24,0
720,0,<START>,0,0,0
720,1,home,0,7,7
720,2,work,7,15,8
720,3,shop,15,16,1
720,4,home,16,24,8
720,5,<ENDS>,24,24,0
721,0,<START>,0,0,0
721,1,home,0,8,8
721,2,education,8,12,4
721,3,home,12,20,8
721,4,shop,20,21,1
721,5,home,21,24,3
721,6,<ENDS>,24,24,0
722,0,<START>,0,0,0
722,1,home,0,6,6
722,2,shop,6,7,1
722,3,work,7,13,6
722,4,home,13,18,5
722,5,shop,18,19,1
722,6,home,19,24,5
722,7,<ENDS>,24,24,0
723,0,<START>,0,0,0
723,1,home,0,7,7
723,2,work,7,14,7
723,3,home,14,24,10
723,4,<ENDS>,24,24,0
724,0,<START>,0,0,0
724,1,home,0,6,6
724,2,work,6,8,2
724,3,home,8,9,1
724,4,work,9,10,1
724,5,home,10,16,6
724,6,work,16,19,3
724,7,home,19,24,5
724,8,<ENDS>,24,24,0
725,0,<START>,0,0,0
725,1,home,0,8,8
725,2,work,8,15,7
725,3,home,15,22,7
725,4,work,22,23,1
725,5,home,23,24,1
725,6,<ENDS>,24,24,0
726,0,<START>,0,0,0
726,1,home,0,6,6
726,2,work,6,7,1
726,3,home,7,11,4
726,4,work,11,13,2
726,5,home,13,21,8
726,6,work,21,22,1
726,7,home,22,24,2
726,8,<ENDS>,24,24,0
727,0,<START>,0,0,0
727,1,home,0,6,6
727,2,work,6,13,7
727,3,home,13,24,11
727,4,<ENDS>,24,24,0
728,0,<START>,0,0,0
728,1,home,0,8,8
728,2,shop,8,9,1
728,3,home,9,13,4
728,4,education,13,16,3
728,5,home,16,20,4
728,6,shop,20,21,1
728,7,home,21,24,3
728,8,<ENDS>,24,24,0
729,0,<START>,0,0,0
729,1,home,0,6,6
729,2,work,6,12,6
729,3,shop,12,13,1
729,4,work,13,19,6
729,5,home,19,24,5
729,6,<ENDS>,24,24,0
730,0,<START>,0,0,0
730,1,home,0,6,6
730,2,work,6,8,2
730,3,home,8,12,4
730,4,work,12,14,2
730,5,home,14,21,7
730,6,work,21,22,1
730,7,home,22,24,2
730,8,<ENDS>,24,24,0
731,0,<START>,0,0,0
731,1,home,0,7,7
731,2,education,7,11,4
731,3,home,11,19,8
731,4,shop,19,20,1
731,5,home,20,24,4
731,6,<ENDS>,24,24,0
732,0,<START>,0,0,0
732,1,home,0,6,6
732,2,work,6,8,2
732,3,home,8,11,3
732,4,work,11,13,2
732,5,home,13,17,4
732,6,work,17,19,2
732,7,home,19,23,4
732,8,work,23,24,1
732,9,<ENDS>,24,24,0
733,0,<START>,0,0,0
733,1,home,0,7,7
733,2,work,7,13,6
733,3,home,13,21,8
733,4,work,21,22,1
733,5,home,22,24,2
733,6,<ENDS>,24,24,0
734,0,<START>,0,0,0
734,1,home,0,6,6
734,2,shop,6,7,1
734,3,home,7,10,3
734,4,work,10,17,7
734,5,home,17,24,7
734,6,<ENDS>,24,24,0
735,0,<START>,0,0,0
735,1,home,0,8,8
735,2,education,8,13,5
735,3,shop,13,14,1
735,4,work,14,19,5
735,5,home,19,24,5
735,6,<ENDS>,24,24,0
736,0,<START>,0,0,0
736,1,home,0,7,7
736,2,shop,7,8,1
736,3,work,8,15,7
736,4,home,15,24,9
736,5,<ENDS>,24,24,0
737,0,<START>,0,0,0
737,1,home,0,7,7
737,2,work,7,9,2
737,3,home,9,13,4
737,4,work,13,15,2
737,5,home,15,23,8
737,6,work,23,24,1
737,7,<ENDS>,24,24,0
738,0,<START>,0,0,0
738,1,home,0,7,7
738,2,work,7,14,7
738,3,shop,14,15,1
738,4,work,15,20,5
738,5,home,20,24,4
738,6,<ENDS>,24,24,0
739,0,<START>,0,0,0
739,1,home,0,7,7
739,2,work,7,13,6
739,3,home,13,24,11
739,4,<ENDS>,24,24,0
740,0,<START>,0,0,0
740,1,home,0,6,6
740,2,work,6,13,7
740,3,home,13,15,2
740,4,shop,15,16,1
740,5,home,16,24,8
740,6,<ENDS>,24,24,0
741,0,<START>,0,0,0
741,1,home,0,7,7
741,2,work,7,13,6
741,3,home,13,24,11
741,4,<ENDS>,24,24,0
742,0,<START>,0,0,0
742,1,home,0,7,7
742,2,work,7,13,6
742,3,home,13,18,5
742,4,shop,18,19,1
742,5,home,19,24,5
742,6,<ENDS>,24,24,0
743,0,<START>,0,0,0
743,1,home,0,7,7
743,2,work,7,13,6
743,3,shop,13,14,1
743,4,work,14,19,5
743,5,home,19,24,5
743,6,<ENDS>,24,24,0
744,0,<START>,0,0,0
744,1,home,0,6,6
744,2,work,6,13,7
744,3,home,13,24,11
744,4,<ENDS>,24,24,0
745,0,<START>,0,0,0
745,1,home,0,7,7
745,2,shop,7,9,2
745,3,education,9,11,2
745,4,home,11,18,7
745,5,shop,18,20,2
745,6,home,20,24,4
745,7,<ENDS>,24,24,0
746,0,<START>,0,0,0
746,1,home,0,7,7
746,2,work,7,13,6
746,3,shop,13,14,1
746,4,home,14,18,4
746,5,work,18,20,2
746,6,home,20,24,4
746,7,<ENDS>,24,24,0
747,0,<START>,0,0,0
747,1,home,0,7,7
747,2,work,7,14,7
747,3,shop,14,15,1
747,4,home,15,24,9
747,5,<ENDS>,24,24,0
748,0,<START>,0,0,0
748,1,home,0,7,7
748,2,work,7,13,6
748,3,shop,13,14,1
748,4,home,14,23,9
748,5,work,23,24,1
748,6,<ENDS>,24,24,0
749,0,<START>,0,0,0
749,1,home,0,7,7
749,2,shop,7,8,1
749,3,work,8,15,7
749,4,home,15,24,9
749,5,<ENDS>,24,24,0
750,0,<START>,0,0,0
750,1,home,0,6,6
750,2,shop,6,7,1
750,3,home,7,13,6
750,4,education,13,16,3
750,5,home,16,24,8
750,6,<ENDS>,24,24,0
751,0,<START>,0,0,0
751,1,home,0,9,9
751,2,work,9,13,4
751,3,shop,13,14,1
751,4,home,14,24,10
751,5,<ENDS>,24,24,0
752,0,<START>,0,0,0
752,1,home,0,6,6
752,2,work,6,8,2
752,3,home,8,15,7
752,4,work,15,18,3
752,5,home,18,24,6
752,6,<ENDS>,24,24,0
753,0,<START>,0,0,0
753,1,home,0,8,8
753,2,education,8,11,3
753,3,home,11,18,7
753,4,shop,18,19,1
753,5,home,19,24,5
753,6,<ENDS>,24,24,0
754,0,<START>,0,0,0
754,1,home,0,7,7
754,2,shop,7,9,2
754,3,education,9,12,3
754,4,home,12,21,9
754,5,shop,21,22,1
754,6,home,22,24,2
754,7,<ENDS>,24,24,0
755,0,<START>,0,0,0
755,1,home,0,6,6
755,2,work,6,13,7
755,3,home,13,17,4
755,4,shop,17,18,1
755,5,work,18,20,2
755,6,home,20,24,4
755,7,<ENDS>,24,24,0
756,0,<START>,0,0,0
756,1,home,0,8,8
756,2,work,8,15,7
756,3,home,15,24,9
756,4,<ENDS>,24,24,0
757,0,<START>,0,0,0
757,1,home,0,6,6
757,2,work,6,8,2
757,3,home,8,12,4
757,4,shop,12,13,1
757,5,work,13,15,2
757,6,home,15,24,9
757,7,<ENDS>,24,24,0
758,0,<START>,0,0,0
758,1,home,0,8,8
758,2,work,8,15,7
758,3,home,15,21,6
758,4,work,21,22,1
758,5,home,22,24,2
758,6,<ENDS>,24,24,0
759,0,<START>,0,0,0
759,1,home,0,6,6
759,2,work,6,13,7
759,3,home,13,17,4
759,4,work,17,20,3
759,5,home,20,24,4
759,6,<ENDS>,24,24,0
760,0,<START>,0,0,0
760,1,home,0,8,8
760,2,work,8,14,6
760,3,home,14,18,4
760,4,work,18,20,2
760,5,home,20,24,4
760,6,<ENDS>,24,24,0
761,0,<START>,0,0,0
761,1,home,0,7,7
761,2,work,7,13,6
761,3,home,13,16,3
761,4,work,16,20,4
761,5,home,20,24,4
761,6,<ENDS>,24,24,0
762,0,<START>,0,0,0
762,1,home,0,6,6
762,2,work,6,14,8
762,3,shop,14,15,1
762,4,work,15,20,5
762,5,home,20,24,4
762,6,<ENDS>,24,24,0
763,0,<START>,0,0,0
763,1,home,0,7,7
763,2,work,7,14,7
763,3,home,14,18,4
763,4,shop,18,19,1
763,5,home,19,24,5
763,6,<ENDS>,24,24,0
764,0,<START>,0,0,0
764,1,home,0,7,7
764,2,work,7,14,7
764,3,shop,14,15,1
764,4,work,15,20,5
764,5,home,20,24,4
764,6,<ENDS>,24,24,0
765,0,<START>,0,0,0
765,1,home,0,6,6
765,2,shop,6,7,1
765,3,home,7,12,5
765,4,education,12,16,4
765,5,shop,16,17,1
765,6,home,17,24,7
765,7,<ENDS>,24,24,0
766,0,<START>,0,0,0
766,1,home,0,6,6
766,2,work,6,13,7
766,3,shop,13,14,1
766,4,work,14,20,6
766,5,home,20,24,4
766,6,<ENDS>,24,24,0
767,0,<START>,0,0,0
767,1,home,0,7,7
767,2,shop,7,8,1
767,3,education,8,11,3
767,4,home,11,17,6
767,5,shop,17,18,1
767,6,home,18,24,6
767,7,<ENDS>,24,24,0
768,0,<START>,0,0,0
768,1,home,0,8,8
768,2,work,8,13,5
768,3,home,13,19,6
768,4,shop,19,20,1
768,5,home,20,24,4
768,6,<ENDS>,24,24,0
769,0,<START>,0,0,0
769,1,home,0,6,6
769,2,work,6,13,7
769,3,home,13,16,3
769,4,work,16,20,4
769,5,home,20,24,4
769,6,<ENDS>,24,24,0
770,0,<START>,0,0,0
770,1,home,0,6,6
770,2,shop,6,7,1
770,3,home,7,16,9
770,4,work,16,20,4
770,5,home,20,24,4
770,6,<ENDS>,24,24,0
771,0,<START>,0,0,0
771,1,home,0,8,8
771,2,work,8,16,8
771,3,home,16,22,6
771,4,work,22,23,1
771,5,home,23,24,1
771,6,<ENDS>,24,24,0
772,0,<START>,0,0,0
772,1,home,0,8,8
772,2,work,8,15,7
772,3,home,15,21,6
772,4,shop,21,22,1
772,5,home,22,24,2
772,6,<ENDS>,24,24,0
773,0,<START>,0,0,0
773,1,home,0,7,7
773,2,education,7,11,4
773,3,home,11,15,4
773,4,shop,15,17,2
773,5,home,17,24,7
773,6,<ENDS>,24,24,0
774,0,<START>,0,0,0
774,1,home,0,8,8
774,2,work,8,15,7
774,3,home,15,24,9
774,4,<ENDS>,24,24,0
775,0,<START>,0,0,0
775,1,home,0,6,6
775,2,work,6,13,7
775,3,shop,13,14,1
775,4,work,14,19,5
775,5,home,19,24,5
775,6,<ENDS>,24,24,0
776,0,<START>,0,0,0
776,1,home,0,6,6
776,2,shop,6,7,1
776,3,home,7,10,3
776,4,education,10,12,2
776,5,shop,12,14,2
776,6,home,14,21,7
776,7,shop,21,22,1
776,8,home,22,24,2
776,9,<ENDS>,24,24,0
777,0,<START>,0,0,0
777,1,home,0,7,7
777,2,shop,7,8,1
777,3,education,8,11,3
777,4,home,11,19,8
777,5,shop,19,20,1
777,6,home,20,24,4
777,7,<ENDS>,24,24,0
778,0,<START>,0,0,0
778,1,home,0,8,8
778,2,education,8,11,3
778,3,home,11,14,3
778,4,education,14,16,2
778,5,home,16,24,8
778,6,<ENDS>,24,24,0
779,0,<START>,0,0,0
779,1,home,0,6,6
779,2,shop,6,7,1
779,3,home,7,11,4
779,4,work,11,18,7
779,5,education,18,20,2
779,6,home,20,24,4
779,7,<ENDS>,24,24,0
780,0,<START>,0,0,0
780,1,home,0,6,6
780,2,work,6,13,7
780,3,shop,13,14,1
780,4,home,14,24,10
780,5,<ENDS>,24,24,0
781,0,<START>,0,0,0
781,1,home,0,9,9
781,2,work,9,16,7
781,3,home,16,22,6
781,4,work,22,23,1
781,5,home,23,24,1
781,6,<ENDS>,24,24,0
782,0,<START>,0,0,0
782,1,home,0,7,7
782,2,work,7,13,6
782,3,shop,13,14,1
782,4,work,14,19,5
782,5,home,19,23,4
782,6,work,23,24,1
782,7,<ENDS>,24,24,0
783,0,<START>,0,0,0
783,1,home,0,8,8
783,2,work,8,14,6
783,3,shop,14,15,1
783,4,work,15,19,4
783,5,home,19,24,5
783,6,<ENDS>,24,24,0
784,0,<START>,0,0,0
784,1,home,0,7,7
784,2,work,7,12,5
784,3,shop,12,13,1
784,4,work,13,19,6
784,5,education,19,20,1
784,6,home,20,24,4
784,7,<ENDS>,24,24,0
785,0,<START>,0,0,0
785,1,home,0,6,6
785,2,shop,6,7,1
785,3,home,7,10,3
785,4,education,10,13,3
785,5,shop,13,14,1
785,6,home,14,21,7
785,7,shop,21,22,1
785,8,home,22,24,2
785,9,<ENDS>,24,24,0
786,0,<START>,0,0,0
786,1,home,0,6,6
786,2,work,6,13,7
786,3,home,13,24,11
786,4,<ENDS>,24,24,0
787,0,<START>,0,0,0
787,1,home,0,7,7
787,2,shop,7,8,1
787,3,education,8,11,3
787,4,home,11,19,8
787,5,shop,19,21,2
787,6,home,21,24,3
787,7,<ENDS>,24,24,0
788,0,<START>,0,0,0
788,1,home,0,8,8
788,2,education,8,14,6
788,3,shop,14,15,1
788,4,work,15,20,5
788,5,home,20,24,4
788,6,<ENDS>,24,24,0
789,0,<START>,0,0,0
789,1,home,0,6,6
789,2,shop,6,7,1
789,3,home,7,13,6
789,4,education,13,16,3
789,5,shop,16,17,1
789,6,home,17,24,7
789,7,<ENDS>,24,24,0
790,0,<START>,0,0,0
790,1,home,0,7,7
790,2,work,7,13,6
790,3,shop,13,14,1
790,4,work,14,19,5
790,5,home,19,23,4
790,6,work,23,24,1
790,7,<ENDS>,24,24,0
791,0,<START>,0,0,0
791,1,home,0,8,8
791,2,work,8,15,7
791,3,home,15,24,9
791,4,<ENDS>,24,24,0
792,0,<START>,0,0,0
792,1,home,0,7,7
792,2,work,7,14,7
792,3,home,14,21,7
792,4,shop,21,22,1
792,5,home,22,24,2
792,6,<ENDS>,24,24,0
793,0,<START>,0,0,0
793,1,home,0,8,8
793,2,work,8,14,6
793,3,home,14,21,7
793,4,work,21,22,1
793,5,home,22,24,2
793,6,<ENDS>,24,24,0
794,0,<START>,0,0,0
794,1,home,0,7,7
794,2,education,7,11,4
794,3,home,11,18,7
794,4,shop,18,19,1
794,5,home,19,24,5
794,6,<ENDS>,24,24,0
795,0,<START>,0,0,0
795,1,home,0,7,7
795,2,work,7,9,2
795,3,home,9,13,4
795,4,work,13,15,2
795,5,home,15,22,7
795,6,work,22,23,1
795,7,home,23,24,1
795,8,<ENDS>,24,24,0
796,0,<START>,0,0,0
796,1,home,0,7,7
796,2,work,7,16,9
796,3,home,16,24,8
796,4,<ENDS>,24,24,0
797,0,<START>,0,0,0
797,1,home,0,7,7
797,2,work,7,14,7
797,3,shop,14,15,1
797,4,work,15,19,4
797,5,home,19,24,5
797,6,<ENDS>,24,24,0
798,0,<START>,0,0,0
798,1,home,0,8,8
798,2,education,8,11,3
798,3,home,11,18,7
798,4,shop,18,20,2
798,5,home,20,24,4
798,6,<ENDS>,24,24,0
799,0,<START>,0,0,0
799,1,home,0,8,8
799,2,work,8,14,6
799,3,home,14,22,8
799,4,work,22,23,1
799,5,home,23,24,1
799,6,<ENDS>,24,24,0
800,0,<START>,0,0,0
800,1,home,0,8,8
800,2,work,8,15,7
800,3,home,15,23,8
800,4,work,23,24,1
800,5,<ENDS>,24,24,0
801,0,<START>,0,0,0
801,1,home,0,7,7
801,2,work,7,14,7
801,3,shop,14,15,1
801,4,work,15,17,2
801,5,home,17,24,7
801,6,<ENDS>,24,24,0
802,0,<START>,0,0,0
802,1,home,0,8,8
802,2,work,8,15,7
802,3,shop,15,16,1
802,4,work,16,20,4
802,5,home,20,24,4
802,6,<ENDS>,24,24,0
803,0,<START>,0,0,0
803,1,home,0,8,8
803,2,work,8,14,6
803,3,home,14,24,10
803,4,<ENDS>,24,24,0
804,0,<START>,0,0,0
804,1,home,0,6,6
804,2,shop,6,7,1
804,3,work,7,13,6
804,4,home,13,24,11
804,5,<ENDS>,24,24,0
805,0,<START>,0,0,0
805,1,home,0,7,7
805,2,work,7,9,2
805,3,home,9,15,6
805,4,work,15,17,2
805,5,home,17,21,4
805,6,work,21,22,1
805,7,home,22,24,2
805,8,<ENDS>,24,24,0
806,0,<START>,0,0,0
806,1,home,0,7,7
806,2,work,7,14,7
806,3,shop,14,15,1
806,4,home,15,21,6
806,5,work,21,22,1
806,6,home,22,24,2
806,7,<ENDS>,24,24,0
807,0,<START>,0,0,0
807,1,home,0,7,7
807,2,education,7,11,4
807,3,home,11,15,4
807,4,shop,15,16,1
807,5,home,16,24,8
807,6,<ENDS>,24,24,0
808,0,<START>,0,0,0
808,1,home,0,6,6
808,2,shop,6,8,2
808,3,work,8,15,7
808,4,home,15,24,9
808,5,<ENDS>,24,24,0
809,0,<START>,0,0,0
809,1,home,0,7,7
809,2,work,7,13,6
809,3,shop,13,14,1
809,4,work,14,20,6
809,5,home,20,24,4
809,6,<ENDS>,24,24,0
810,0,<START>,0,0,0
810,1,home,0,8,8
810,2,work,8,15,7
810,3,home,15,20,5
810,4,shop,20,21,1
810,5,home,21,24,3
810,6,<ENDS>,24,24,0
811,0,<START>,0,0,0
811,1,home,0,8,8
811,2,work,8,15,7
811,3,home,15,24,9
811,4,<ENDS>,24,24,0
812,0,<START>,0,0,0
812,1,home,0,9,9
812,2,education,9,12,3
812,3,home,12,24,12
812,4,<ENDS>,24,24,0
813,0,<START>,0,0,0
813,1,home,0,6,6
813,2,work,6,13,7
813,3,shop,13,14,1
813,4,home,14,24,10
813,5,<ENDS>,24,24,0
814,0,<START>,0,0,0
814,1,home,0,7,7
814,2,work,7,13,6
814,3,home,13,21,8
814,4,work,21,22,1
814,5,home,22,24,2
814,6,<ENDS>,24,24,0
815,0,<START>,0,0,0
815,1,home,0,8,8
815,2,education,8,12,4
815,3,work,12,18,6
815,4,home,18,24,6
815,5,<ENDS>,24,24,0
816,0,<START>,0,0,0
816,1,home,0,6,6
816,2,work,6,13,7
816,3,home,13,17,4
816,4,work,17,20,3
816,5,home,20,24,4
816,6,<ENDS>,24,24,0
817,0,<START>,0,0,0
817,1,home,0,7,7
817,2,education,7,12,5
817,3,shop,12,13,1
817,4,education,13,16,3
817,5,shop,16,17,1
817,6,home,17,24,7
817,7,<ENDS>,24,24,0
818,0,<START>,0,0,0
818,1,home,0,7,7
818,2,work,7,13,6
818,3,shop,13,14,1
818,4,home,14,24,10
818,5,<ENDS>,24,24,0
819,0,<START>,0,0,0
819,1,home,0,7,7
819,2,shop,7,9,2
819,3,education,9,13,4
819,4,home,13,21,8
819,5,shop,21,22,1
819,6,home,22,24,2
819,7,<ENDS>,24,24,0
820,0,<START>,0,0,0
820,1,home,0,8,8
820,2,education,8,14,6
820,3,shop,14,15,1
820,4,work,15,20,5
820,5,home,20,24,4
820,6,<ENDS>,24,24,0
821,0,<START>,0,0,0
821,1,home,0,6,6
821,2,work,6,8,2
821,3,home,8,10,2
821,4,work,10,12,2
821,5,home,12,21,9
821,6,work,21,22,1
821,7,home,22,24,2
821,8,<ENDS>,24,24,0
822,0,<START>,0,0,0
822,1,home,0,7,7
822,2,work,7,9,2
822,3,home,9,15,6
822,4,work,15,18,3
822,5,home,18,22,4
822,6,work,22,23,1
822,7,home,23,24,1
822,8,<ENDS>,24,24,0
823,0,<START>,0,0,0
823,1,home,0,8,8
823,2,work,8,15,7
823,3,home,15,24,9
823,4,<ENDS>,24,24,0
824,0,<START>,0,0,0
824,1,home,0,7,7
824,2,work,7,13,6
824,3,home,13,24,11
824,4,<ENDS>,24,24,0
825,0,<START>,0,0,0
825,1,home,0,6,6
825,2,work,6,8,2
825,3,home,8,13,5
825,4,work,13,16,3
825,5,home,16,22,6
825,6,work,22,23,1
825,7,home,23,24,1
825,8,<ENDS>,24,24,0
826,0,<START>,0,0,0
826,1,home,0,7,7
826,2,work,7,14,7
826,3,shop,14,15,1
826,4,home,15,24,9
826,5,<ENDS>,24,24,0
827,0,<START>,0,0,0
827,1,home,0,7,7
827,2,work,7,14,7
827,3,home,14,17,3
827,4,work,17,20,3
827,5,home,20,24,4
827,6,<ENDS>,24,24,0
828,0,<START>,0,0,0
828,1,home,0,7,7
828,2,work,7,14,7
828,3,shop,14,15,1
828,4,home,15,24,9
828,5,<ENDS>,24,24,0
829,0,<START>,0,0,0
829,1,home,0,8,8
829,2,work,8,14,6
829,3,home,14,18,4
829,4,work,18,20,2
829,5,home,20,24,4
829,6,<ENDS>,24,24,0
830,0,<START>,0,0,0
830,1,home,0,6,6
830,2,shop,6,7,1
830,3,home,7,9,2
830,4,education,9,12,3
830,5,shop,12,13,1
830,6,education,13,16,3
830,7,home,16,24,8
830,8,<ENDS>,24,24,0
831,0,<START>,0,0,0
831,1,home,0,7,7
831,2,work,7,14,7
831,3,home,14,24,10
831,4,<ENDS>,24,24,0
832,0,<START>,0,0,0
832,1,home,0,7,7
832,2,work,7,14,7
832,3,home,14,24,10
832,4,<ENDS>,24,24,0
833,0,<START>,0,0,0
833,1,home,0,7,7
833,2,education,7,12,5
833,3,shop,12,14,2
833,4,home,14,20,6
833,5,shop,20,21,1
833,6,home,21,24,3
833,7,<ENDS>,24,24,0
834,0,<START>,0,0,0
834,1,home,0,8,8
834,2,work,8,15,7
834,3,home,15,24,9
834,4,<ENDS>,24,24,0
835,0,<START>,0,0,0
835,1,home,0,7,7
835,2,work,7,14,7
835,3,home,14,20,6
835,4,shop,20,21,1
835,5,home,21,24,3
835,6,<ENDS>,24,24,0
836,0,<START>,0,0,0
836,1,home,0,6,6
836,2,work,6,13,7
836,3,shop,13,14,1
836,4,work,14,20,6
836,5,home,20,24,4
836,6,<ENDS>,24,24,0
837,0,<START>,0,0,0
837,1,home,0,8,8
837,2,work,8,15,7
837,3,shop,15,16,1
837,4,work,16,20,4
837,5,home,20,24,4
837,6,<ENDS>,24,24,0
838,0,<START>,0,0,0
838,1,home,0,6,6
838,2,work,6,13,7
838,3,shop,13,14,1
838,4,home,14,24,10
838,5,<ENDS>,24,24,0
839,0,<START>,0,0,0
839,1,home,0,7,7
839,2,work,7,13,6
839,3,shop,13,14,1
839,4,work,14,19,5
839,5,home,19,24,5
839,6,<ENDS>,24,24,0
840,0,<START>,0,0,0
840,1,home,0,7,7
840,2,work,7,13,6
840,3,home,13,18,5
840,4,shop,18,19,1
840,5,home,19,24,5
840,6,<ENDS>,24,24,0
841,0,<START>,0,0,0
841,1,home,0,6,6
841,2,work,6,13,7
841,3,home,13,17,4
841,4,shop,17,18,1
841,5,home,18,24,6
841,6,<ENDS>,24,24,0
842,0,<START>,0,0,0
842,1,home,0,9,9
842,2,work,9,17,8
842,3,home,17,24,7
842,4,<ENDS>,24,24,0
843,0,<START>,0,0,0
843,1,home,0,7,7
843,2,shop,7,8,1
843,3,home,8,21,13
843,4,work,21,22,1
843,5,home,22,24,2
843,6,<ENDS>,24,24,0
844,0,<START>,0,0,0
844,1,home,0,8,8
844,2,work,8,13,5
844,3,home,13,24,11
844,4,<ENDS>,24,24,0
845,0,<START>,0,0,0
845,1,home,0,6,6
845,2,shop,6,7,1
845,3,work,7,13,6
845,4,shop,13,14,1
845,5,work,14,19,5
845,6,home,19,24,5
845,7,<ENDS>,24,24,0
846,0,<START>,0,0,0
846,1,home,0,7,7
846,2,education,7,11,4
846,3,home,11,18,7
846,4,shop,18,19,1
846,5,home,19,24,5
846,6,<ENDS>,24,24,0
847,0,<START>,0,0,0
847,1,home,0,7,7
847,2,work,7,14,7
847,3,home,14,24,10
847,4,<ENDS>,24,24,0
848,0,<START>,0,0,0
848,1,home,0,7,7
848,2,work,7,13,6
848,3,home,13,18,5
848,4,work,18,20,2
848,5,home,20,24,4
848,6,<ENDS>,24,24,0
849,0,<START>,0,0,0
849,1,home,0,8,8
849,2,work,8,14,6
849,3,home,14,17,3
849,4,work,17,20,3
849,5,home,20,24,4
849,6,<ENDS>,24,24,0
850,0,<START>,0,0,0
850,1,home,0,7,7
850,2,work,7,13,6
850,3,home,13,22,9
850,4,work,22,23,1
850,5,home,23,24,1
850,6,<ENDS>,24,24,0
851,0,<START>,0,0,0
851,1,home,0,8,8
851,2,work,8,15,7
851,3,home,15,24,9
851,4,<ENDS>,24,24,0
852,0,<START>,0,0,0
852,1,home,0,9,9
852,2,work,9,15,6
852,3,shop,15,16,1
852,4,work,16,20,4
852,5,home,20,24,4
852,6,<ENDS>,24,24,0
853,0,<START>,0,0,0
853,1,home,0,8,8
853,2,work,8,15,7
853,3,home,15,24,9
853,4,<ENDS>,24,24,0
854,0,<START>,0,0,0
854,1,home,0,8,8
854,2,work,8,14,6
854,3,shop,14,15,1
854,4,work,15,20,5
854,5,home,20,24,4
854,6,<ENDS>,24,24,0
855,0,<START>,0,0,0
855,1,home,0,7,7
855,2,work,7,13,6
855,3,home,13,24,11
855,4,<ENDS>,24,24,0
856,0,<START>,0,0,0
856,1,home,0,8,8
856,2,work,8,15,7
856,3,home,15,21,6
856,4,work,21,22,1
856,5,home,22,24,2
856,6,<ENDS>,24,24,0
857,0,<START>,0,0,0
857,1,home,0,6,6
857,2,work,6,13,7
857,3,shop,13,14,1
857,4,home,14,21,7
857,5,work,21,22,1
857,6,home,22,24,2
857,7,<ENDS>,24,24,0
858,0,<START>,0,0,0
858,1,home,0,6,6
858,2,shop,6,7,1
858,3,work,7,13,6
858,4,home,13,24,11
858,5,<ENDS>,24,24,0
859,0,<START>,0,0,0
859,1,home,0,7,7
859,2,work,7,14,7
859,3,home,14,23,9
859,4,work,23,24,1
859,5,<ENDS>,24,24,0
860,0,<START>,0,0,0
860,1,home,0,9,9
860,2,education,9,12,3
860,3,home,12,24,12
860,4,<ENDS>,24,24,0
861,0,<START>,0,0,0
861,1,home,0,7,7
861,2,shop,7,9,2
861,3,education,9,13,4
861,4,shop,13,14,1
861,5,education,14,16,2
861,6,home,16,24,8
861,7,<ENDS>,24,24,0
862,0,<START>,0,0,0
862,1,home,0,6,6
862,2,work,6,13,7
862,3,home,13,24,11
862,4,<ENDS>,24,24,0
863,0,<START>,0,0,0
863,1,home,0,8,8
863,2,work,8,15,7
863,3,home,15,24,9
863,4,<ENDS>,24,24,0
864,0,<START>,0,0,0
864,1,home,0,7,7
864,2,work,7,13,6
864,3,home,13,24,11
864,4,<ENDS>,24,24,0
865,0,<START>,0,0,0
865,1,home,0,8,8
865,2,work,8,15,7
865,3,home,15,23,8
865,4,work,23,24,1
865,5,<ENDS>,24,24,0
866,0,<START>,0,0,0
866,1,home,0,8,8
866,2,work,8,15,7
866,3,home,15,24,9
866,4,<ENDS>,24,24,0
867,0,<START>,0,0,0
867,1,home,0,7,7
867,2,shop,7,9,2
867,3,education,9,12,3
867,4,shop,12,14,2
867,5,education,14,16,2
867,6,home,16,24,8
867,7,<ENDS>,24,24,0
868,0,<START>,0,0,0
868,1,home,0,6,6
868,2,work,6,14,8
868,3,shop,14,15,1
868,4,home,15,24,9
868,5,<ENDS>,24,24,0
869,0,<START>,0,0,0
869,1,home,0,7,7
869,2,education,7,12,5
869,3,home,12,18,6
869,4,shop,18,19,1
869,5,home,19,24,5
869,6,<ENDS>,24,24,0
870,0,<START>,0,0,0
870,1,home,0,6,6
870,2,shop,6,7,1
870,3,work,7,14,7
870,4,home,14,24,10
870,5,<ENDS>,24,24,0
871,0,<START>,0,0,0
871,1,home,0,7,7
871,2,work,7,13,6
871,3,home,13,24,11
871,4,<ENDS>,24,24,0
872,0,<START>,0,0,0
872,1,home,0,8,8
872,2,work,8,14,6
872,3,shop,14,15,1
872,4,home,15,24,9
872,5,<ENDS>,24,24,0
873,0,<START>,0,0,0
873,1,home,0,7,7
873,2,work,7,13,6
873,3,home,13,18,5
873,4,work,18,20,2
873,5,home,20,24,4
873,6,<ENDS>,24,24,0
874,0,<START>,0,0,0
874,1,home,0,6,6
874,2,work,6,13,7
874,3,home,13,24,11
874,4,<ENDS>,24,24,0
875,0,<START>,0,0,0
875,1,home,0,7,7
875,2,work,7,13,6
875,3,shop,13,14,1
875,4,work,14,16,2
875,5,home,16,23,7
875,6,work,23,24,1
875,7,<ENDS>,24,24,0
876,0,<START>,0,0,0
876,1,home,0,6,6
876,2,work,6,13,7
876,3,shop,13,14,1
876,4,work,14,19,5
876,5,home,19,24,5
876,6,<ENDS>,24,24,0
877,0,<START>,0,0,0
877,1,home,0,7,7
877,2,work,7,13,6
877,3,shop,13,14,1
877,4,home,14,24,10
877,5,<ENDS>,24,24,0
878,0,<START>,0,0,0
878,1,home,0,7,7
878,2,work,7,15,8
878,3,home,15,24,9
878,4,<ENDS>,24,24,0
879,0,<START>,0,0,0
879,1,home,0,6,6
879,2,work,6,8,2
879,3,home,8,12,4
879,4,work,12,14,2
879,5,shop,14,15,1
879,6,home,15,21,6
879,7,work,21,22,1
879,8,home,22,24,2
879,9,<ENDS>,24,24,0
880,0,<START>,0,0,0
880,1,home,0,7,7
880,2,work,7,13,6
880,3,home,13,18,5
880,4,work,18,20,2
880,5,home,20,24,4
880,6,<ENDS>,24,24,0
881,0,<START>,0,0,0
881,1,home,0,6,6
881,2,shop,6,7,1
881,3,home,7,10,3
881,4,education,10,14,4
881,5,shop,14,15,1
881,6,home,15,21,6
881,7,shop,21,22,1
881,8,home,22,24,2
881,9,<ENDS>,24,24,0
882,0,<START>,0,0,0
882,1,home,0,6,6
882,2,work,6,7,1
882,3,home,7,9,2
882,4,work,9,10,1
882,5,home,10,16,6
882,6,work,16,18,2
882,7,home,18,24,6
882,8,<ENDS>,24,24,0
883,0,<START>,0,0,0
883,1,home,0,7,7
883,2,work,7,13,6
883,3,home,13,17,4
883,4,work,17,20,3
883,5,home,20,24,4
883,6,<ENDS>,24,24,0
884,0,<START>,0,0,0
884,1,home,0,6,6
884,2,shop,6,7,1
884,3,home,7,9,2
884,4,education,9,12,3
884,5,shop,12,13,1
884,6,education,13,16,3
884,7,home,16,24,8
884,8,<ENDS>,24,24,0
885,0,<START>,0,0,0
885,1,home,0,7,7
885,2,shop,7,9,2
885,3,education,9,12,3
885,4,shop,12,14,2
885,5,education,14,17,3
885,6,shop,17,18,1
885,7,home,18,24,6
885,8,<ENDS>,24,24,0
886,0,<START>,0,0,0
886,1,home,0,6,6
886,2,work,6,8,2
886,3,home,8,13,5
886,4,work,13,15,2
886,5,home,15,21,6
886,6,work,21,22,1
886,7,home,22,24,2
886,8,<ENDS>,24,24,0
887,0,<START>,0,0,0
887,1,home,0,8,8
887,2,work,8,14,6
887,3,shop,14,15,1
887,4,home,15,21,6
887,5,work,21,22,1
887,6,home,22,24,2
887,7,<ENDS>,24,24,0
888,0,<START>,0,0,0
888,1,home,0,6,6
888,2,work,6,13,7
888,3,shop,13,15,2
888,4,home,15,24,9
888,5,<ENDS>,24,24,0
889,0,<START>,0,0,0
889,1,home,0,7,7
889,2,education,7,11,4
889,3,home,11,13,2
889,4,education,13,15,2
889,5,shop,15,16,1
889,6,home,16,24,8
889,7,<ENDS>,24,24,0
890,0,<START>,0,0,0
890,1,home,0,7,7
890,2,work,7,13,6
890,3,home,13,20,7
890,4,shop,20,21,1
890,5,home,21,24,3
890,6,<ENDS>,24,24,0
891,0,<START>,0,0,0
891,1,home,0,7,7
891,2,work,7,8,1
891,3,home,8,14,6
891,4,work,14,16,2
891,5,home,16,21,5
891,6,work,21,22,1
891,7,home,22,24,2
891,8,<ENDS>,24,24,0
892,0,<START>,0,0,0
892,1,home,0,6,6
892,2,work,6,8,2
892,3,home,8,12,4
892,4,work,12,14,2
892,5,home,14,21,7
892,6,work,21,22,1
892,7,home,22,24,2
892,8,<ENDS>,24,24,0
893,0,<START>,0,0,0
893,1,home,0,6,6
893,2,shop,6,7,1
893,3,home,7,9,2
893,4,education,9,12,3
893,5,home,12,18,6
893,6,shop,18,20,2
893,7,home,20,24,4
893,8,<ENDS>,24,24,0
894,0,<START>,0,0,0
894,1,home,0,8,8
894,2,work,8,15,7
894,3,shop,15,16,1
894,4,work,16,20,4
894,5,home,20,24,4
894,6,<ENDS>,24,24,0
895,0,<START>,0,0,0
895,1,home,0,7,7
895,2,education,7,11,4
895,3,home,11,18,7
895,4,shop,18,20,2
895,5,home,20,24,4
895,6,<ENDS>,24,24,0
896,0,<START>,0,0,0
896,1,home,0,7,7
896,2,work,7,13,6
896,3,shop,13,14,1
896,4,work,14,20,6
896,5,home,20,24,4
896,6,<ENDS>,24,24,0
897,0,<START>,0,0,0
897,1,home,0,6,6
897,2,shop,6,7,1
897,3,home,7,9,2
897,4,education,9,12,3
897,5,home,12,19,7
897,6,shop,19,20,1
897,7,home,20,24,4
897,8,<ENDS>,24,24,0
898,0,<START>,0,0,0
898,1,home,0,8,8
898,2,education,8,12,4
898,3,home,12,24,12
898,4,<ENDS>,24,24,0
899,0,<START>,0,0,0
899,1,home,0,7,7
899,2,work,7,9,2
899,3,home,9,15,6
899,4,work,15,18,3
899,5,home,18,24,6
899,6,<ENDS>,24,24,0
900,0,<START>,0,0,0
900,1,home,0,6,6
900,2,work,6,13,7
900,3,shop,13,14,1
900,4,work,14,19,5
900,5,home,19,24,5
900,6,<ENDS>,24,24,0
901,0,<START>,0,0,0
901,1,home,0,6,6
901,2,shop,6,7,1
901,3,home,7,9,2
901,4,education,9,12,3
901,5,shop,12,14,2
901,6,education,14,16,2
901,7,home,16,24,8
901,8,<ENDS>,24,24,0
902,0,<START>,0,0,0
902,1,home,0,7,7
902,2,work,7,13,6
902,3,shop,13,14,1
902,4,work,14,18,4
902,5,home,18,24,6
902,6,<ENDS>,24,24,0
903,0,<START>,0,0,0
903,1,home,0,7,7
903,2,shop,7,8,1
903,3,education,8,11,3
903,4,home,11,17,6
903,5,shop,17,18,1
903,6,home,18,24,6
903,7,<ENDS>,24,24,0
904,0,<START>,0,0,0
904,1,home,0,8,8
904,2,work,8,15,7
904,3,home,15,18,3
904,4,shop,18,19,1
904,5,home,19,24,5
904,6,<ENDS>,24,24,0
905,0,<START>,0,0,0
905,1,home,0,7,7
905,2,shop,7,8,1
905,3,home,8,12,4
905,4,work,12,19,7
905,5,home,19,24,5
905,6,<ENDS>,24,24,0
906,0,<START>,0,0,0
906,1,home,0,8,8
906,2,work,8,14,6
906,3,home,14,24,10
906,4,<ENDS>,24,24,0
907,0,<START>,0,0,0
907,1,home,0,6,6
907,2,work,6,8,2
907,3,home,8,14,6
907,4,work,14,17,3
907,5,home,17,24,7
907,6,<ENDS>,24,24,0
908,0,<START>,0,0,0
908,1,home,0,6,6
908,2,work,6,13,7
908,3,shop,13,14,1
908,4,home,14,22,8
908,5,work,22,23,1
908,6,home,23,24,1
908,7,<ENDS>,24,24,0
909,0,<START>,0,0,0
909,1,home,0,6,6
909,2,work,6,8,2
909,3,home,8,14,6
909,4,work,14,16,2
909,5,home,16,23,7
909,6,work,23,24,1
909,7,<ENDS>,24,24,0
910,0,<START>,0,0,0
910,1,home,0,6,6
910,2,work,6,13,7
910,3,home,13,24,11
910,4,<ENDS>,24,24,0
911,0,<START>,0,0,0
911,1,home,0,8,8
911,2,work,8,15,7
911,3,home,15,19,4
911,4,shop,19,20,1
911,5,home,20,24,4
911,6,<ENDS>,24,24,0
912,0,<START>,0,0,0
912,1,home,0,7,7
912,2,work,7,13,6
912,3,shop,13,14,1
912,4,home,14,18,4
912,5,work,18,20,2
912,6,home,20,24,4
912,7,<ENDS>,24,24,0
913,0,<START>,0,0,0
913,1,home,0,7,7
913,2,work,7,14,7
913,3,home,14,19,5
913,4,shop,19,20,1
913,5,home,20,24,4
913,6,<ENDS>,24,24,0
914,0,<START>,0,0,0
914,1,home,0,8,8
914,2,work,8,14,6
914,3,shop,14,15,1
914,4,work,15,20,5
914,5,home,20,24,4
914,6,<ENDS>,24,24,0
915,0,<START>,0,0,0
915,1,home,0,8,8
915,2,work,8,15,7
915,3,home,15,21,6
915,4,work,21,22,1
915,5,home,22,24,2
915,6,<ENDS>,24,24,0
916,0,<START>,0,0,0
916,1,home,0,8,8
916,2,work,8,14,6
916,3,home,14,24,10
916,4,<ENDS>,24,24,0
917,0,<START>,0,0,0
917,1,home,0,7,7
917,2,work,7,8,1
917,3,home,8,13,5
917,4,work,13,15,2
917,5,home,15,22,7
917,6,work,22,23,1
917,7,home,23,24,1
917,8,<ENDS>,24,24,0
918,0,<START>,0,0,0
918,1,home,0,9,9
918,2,work,9,16,7
918,3,home,16,24,8
918,4,<ENDS>,24,24,0
919,0,<START>,0,0,0
919,1,home,0,7,7
919,2,work,7,13,6
919,3,home,13,24,11
919,4,<ENDS>,24,24,0
920,0,<START>,0,0,0
920,1,home,0,7,7
920,2,work,7,14,7
920,3,home,14,21,7
920,4,work,21,22,1
920,5,home,22,24,2
920,6,<ENDS>,24,24,0
921,0,<START>,0,0,0
921,1,home,0,8,8
921,2,work,8,14,6
921,3,home,14,24,10
921,4,<ENDS>,24,24,0
922,0,<START>,0,0,0
922,1,home,0,6,6
922,2,work,6,14,8
922,3,home,14,24,10
922,4,<ENDS>,24,24,0
923,0,<START>,0,0,0
923,1,home,0,6,6
923,2,work,6,8,2
923,3,home,8,15,7
923,4,work,15,17,2
923,5,home,17,23,6
923,6,work,23,24,1
923,7,<ENDS>,24,24,0
924,0,<START>,0,0,0
924,1,home,0,7,7
924,2,shop,7,8,1
924,3,work,8,15,7
924,4,home,15,24,9
924,5,<ENDS>,24,24,0
925,0,<START>,0,0,0
925,1,home,0,6,6
925,2,work,6,13,7
925,3,home,13,24,11
925,4,<ENDS>,24,24,0
926,0,<START>,0,0,0
926,1,home,0,7,7
926,2,work,7,13,6
926,3,home,13,24,11
926,4,<ENDS>,24,24,0
927,0,<START>,0,0,0
927,1,home,0,7,7
927,2,work,7,13,6
927,3,shop,13,14,1
927,4,home,14,22,8
927,5,work,22,23,1
927,6,home,23,24,1
927,7,<ENDS>,24,24,0
928,0,<START>,0,0,0
928,1,home,0,8,8
928,2,work,8,15,7
928,3,home,15,20,5
928,4,shop,20,21,1
928,5,home,21,24,3
928,6,<ENDS>,24,24,0
929,0,<START>,0,0,0
929,1,home,0,6,6
929,2,shop,6,7,1
929,3,home,7,13,6
929,4,education,13,16,3
929,5,shop,16,17,1
929,6,home,17,21,4
929,7,shop,21,22,1
929,8,home,22,24,2
929,9,<ENDS>,24,24,0
930,0,<START>,0,0,0
930,1,home,0,6,6
930,2,work,6,8,2
930,3,home,8,9,1
930,4,work,9,10,1
930,5,home,10,16,6
930,6,work,16,18,2
930,7,home,18,24,6
930,8,<ENDS>,24,24,0
931,0,<START>,0,0,0
931,1,home,0,6,6
931,2,shop,6,7,1
931,3,home,7,13,6
931,4,education,13,16,3
931,5,home,16,21,5
931,6,shop,21,22,1
931,7,home,22,24,2
931,8,<ENDS>,24,24,0
932,0,<START>,0,0,0
932,1,home,0,8,8
932,2,work,8,15,7
932,3,shop,15,16,1
932,4,home,16,24,8
932,5,<ENDS>,24,24,0
933,0,<START>,0,0,0
933,1,home,0,7,7
933,2,shop,7,9,2
933,3,education,9,12,3
933,4,shop,12,14,2
933,5,home,14,20,6
933,6,shop,20,21,1
933,7,home,21,24,3
933,8,<ENDS>,24,24,0
934,0,<START>,0,0,0
934,1,home,0,7,7
934,2,shop,7,9,2
934,3,education,9,11,2
934,4,home,11,19,8
934,5,shop,19,21,2
934,6,home,21,24,3
934,7,<ENDS>,24,24,0
935,0,<START>,0,0,0
935,1,home,0,8,8
935,2,work,8,13,5
935,3,shop,13,14,1
935,4,work,14,19,5
935,5,home,19,24,5
935,6,<ENDS>,24,24,0
936,0,<START>,0,0,0
936,1,home,0,8,8
936,2,work,8,14,6
936,3,shop,14,15,1
936,4,home,15,23,8
936,5,work,23,24,1
936,6,<ENDS>,24,24,0
937,0,<START>,0,0,0
937,1,home,0,7,7
937,2,work,7,13,6
937,3,home,13,16,3
937,4,work,16,19,3
937,5,education,19,20,1
937,6,home,20,24,4
937,7,<ENDS>,24,24,0
938,0,<START>,0,0,0
938,1,home,0,9,9
938,2,work,9,16,7
938,3,shop,16,17,1
938,4,home,17,24,7
938,5,<ENDS>,24,24,0
939,0,<START>,0,0,0
939,1,home,0,6,6
939,2,shop,6,7,1
939,3,home,7,10,3
939,4,education,10,12,2
939,5,shop,12,14,2
939,6,education,14,16,2
939,7,home,16,24,8
939,8,<ENDS>,24,24,0
940,0,<START>,0,0,0
940,1,home,0,7,7
940,2,work,7,15,8
940,3,home,15,24,9
940,4,<ENDS>,24,24,0
941,0,<START>,0,0,0
941,1,home,0,7,7
941,2,work,7,13,6
941,3,home,13,17,4
941,4,work,17,20,3
941,5,home,20,24,4
941,6,<ENDS>,24,24,0
942,0,<START>,0,0,0
942,1,home,0,6,6
942,2,work,6,13,7
942,3,home,13,24,11
942,4,<ENDS>,24,24,0
943,0,<START>,0,0,0
943,1,home,0,7,7
943,2,work,7,13,6
943,3,shop,13,14,1
943,4,home,14,24,10
943,5,<ENDS>,24,24,0
944,0,<START>,0,0,0
944,1,home,0,8,8
944,2,work,8,15,7
944,3,home,15,24,9
944,4,<ENDS>,24,24,0
945,0,<START>,0,0,0
945,1,home,0,7,7
945,2,work,7,14,7
945,3,home,14,18,4
945,4,work,18,20,2
945,5,home,20,24,4
945,6,<ENDS>,24,24,0
946,0,<START>,0,0,0
946,1,home,0,7,7
946,2,education,7,12,5
946,3,home,12,20,8
946,4,shop,20,21,1
946,5,home,21,24,3
946,6,<ENDS>,24,24,0
947,0,<START>,0,0,0
947,1,home,0,6,6
947,2,work,6,8,2
947,3,home,8,13,5
947,4,work,13,15,2
947,5,home,15,21,6
947,6,work,21,22,1
947,7,home,22,24,2
947,8,<ENDS>,24,24,0
948,0,<START>,0,0,0
948,1,home,0,6,6
948,2,work,6,13,7
948,3,home,13,19,6
948,4,shop,19,20,1
948,5,home,20,24,4
948,6,<ENDS>,24,24,0
949,0,<START>,0,0,0
949,1,home,0,7,7
949,2,work,7,9,2
949,3,home,9,14,5
949,4,work,14,16,2
949,5,home,16,22,6
949,6,work,22,23,1
949,7,home,23,24,1
949,8,<ENDS>,24,24,0
950,0,<START>,0,0,0
950,1,home,0,6,6
950,2,work,6,8,2
950,3,home,8,9,1
950,4,work,9,11,2
950,5,home,11,14,3
950,6,work,14,17,3
950,7,home,17,24,7
950,8,<ENDS>,24,24,0
951,0,<START>,0,0,0
951,1,home,0,7,7
951,2,work,7,13,6
951,3,home,13,21,8
951,4,work,21,22,1
951,5,home,22,24,2
951,6,<ENDS>,24,24,0
952,0,<START>,0,0,0
952,1,home,0,7,7
952,2,work,7,14,7
952,3,home,14,24,10
952,4,<ENDS>,24,24,0
953,0,<START>,0,0,0
953,1,home,0,7,7
953,2,work,7,13,6
953,3,home,13,23,10
953,4,work,23,24,1
953,5,<ENDS>,24,24,0
954,0,<START>,0,0,0
954,1,home,0,7,7
954,2,work,7,13,6
954,3,home,13,18,5
954,4,shop,18,19,1
954,5,home,19,24,5
954,6,<ENDS>,24,24,0
955,0,<START>,0,0,0
955,1,home,0,6,6
955,2,work,6,13,7
955,3,home,13,17,4
955,4,work,17,20,3
955,5,home,20,24,4
955,6,<ENDS>,24,24,0
956,0,<START>,0,0,0
956,1,home,0,7,7
956,2,work,7,13,6
956,3,home,13,24,11
956,4,<ENDS>,24,24,0
957,0,<START>,0,0,0
957,1,home,0,8,8
957,2,work,8,15,7
957,3,home,15,23,8
957,4,work,23,24,1
957,5,<ENDS>,24,24,0
958,0,<START>,0,0,0
958,1,home,0,9,9
958,2,work,9,16,7
958,3,home,16,24,8
958,4,<ENDS>,24,24,0
959,0,<START>,0,0,0
959,1,home,0,7,7
959,2,work,7,13,6
959,3,home,13,24,11
959,4,<ENDS>,24,24,0
960,0,<START>,0,0,0
960,1,home,0,7,7
960,2,work,7,13,6
960,3,home,13,24,11
960,4,<ENDS>,24,24,0
961,0,<START>,0,0,0
961,1,home,0,7,7
961,2,work,7,14,7
961,3,home,14,21,7
961,4,work,21,22,1
961,5,home,22,24,2
961,6,<ENDS>,24,24,0
962,0,<START>,0,0,0
962,1,home,0,6,6
962,2,work,6,13,7
962,3,shop,13,14,1
962,4,home,14,18,4
962,5,work,18,20,2
962,6,home,20,24,4
962,7,<ENDS>,24,24,0
963,0,<START>,0,0,0
963,1,home,0,7,7
963,2,work,7,13,6
963,3,shop,13,14,1
963,4,home,14,18,4
963,5,work,18,19,1
963,6,home,19,23,4
963,7,work,23,24,1
963,8,<ENDS>,24,24,0
964,0,<START>,0,0,0
964,1,home,0,7,7
964,2,work,7,13,6
964,3,home,13,17,4
964,4,work,17,19,2
964,5,home,19,24,5
964,6,<ENDS>,24,24,0
965,0,<START>,0,0,0
965,1,home,0,7,7
965,2,work,7,8,1
965,3,home,8,11,3
965,4,work,11,13,2
965,5,home,13,21,8
965,6,work,21,22,1
965,7,home,22,24,2
965,8,<ENDS>,24,24,0
966,0,<START>,0,0,0
966,1,home,0,6,6
966,2,work,6,9,3
966,3,shop,9,10,1
966,4,work,10,17,7
966,5,home,17,24,7
966,6,<ENDS>,24,24,0
967,0,<START>,0,0,0
967,1,home,0,7,7
967,2,work,7,9,2
967,3,home,9,13,4
967,4,work,13,15,2
967,5,home,15,22,7
967,6,work,22,23,1
967,7,home,23,24,1
967,8,<ENDS>,24,24,0
968,0,<START>,0,0,0
968,1,home,0,8,8
968,2,work,8,15,7
968,3,home,15,20,5
968,4,shop,20,21,1
968,5,home,21,24,3
968,6,<ENDS>,24,24,0
969,0,<START>,0,0,0
969,1,home,0,7,7
969,2,work,7,14,7
969,3,home,14,24,10
969,4,<ENDS>,24,24,0
970,0,<START>,0,0,0
970,1,home,0,6,6
970,2,work,6,13,7
970,3,home,13,17,4
970,4,shop,17,18,1
970,5,home,18,24,6
970,6,<ENDS>,24,24,0
971,0,<START>,0,0,0
971,1,home,0,8,8
971,2,shop,8,9,1
971,3,home,9,10,1
971,4,work,10,17,7
971,5,home,17,21,4
971,6,work,21,22,1
971,7,home,22,24,2
971,8,<ENDS>,24,24,0
972,0,<START>,0,0,0
972,1,home,0,8,8
972,2,work,8,10,2
972,3,home,10,16,6
972,4,work,16,19,3
972,5,home,19,24,5
972,6,<ENDS>,24,24,0
973,0,<START>,0,0,0
973,1,home,0,7,7
973,2,work,7,14,7
973,3,home,14,18,4
973,4,work,18,20,2
973,5,home,20,24,4
973,6,<ENDS>,24,24,0
974,0,<START>,0,0,0
974,1,home,0,7,7
974,2,work,7,13,6
974,3,home,13,14,1
974,4,work,14,19,5
974,5,home,19,24,5
974,6,<ENDS>,24,24,0
975,0,<START>,0,0,0
975,1,home,0,7,7
975,2,work,7,14,7
975,3,home,14,22,8
975,4,work,22,23,1
975,5,home,23,24,1
975,6,<ENDS>,24,24,0
976,0,<START>,0,0,0
976,1,home,0,6,6
976,2,work,6,13,7
976,3,home,13,19,6
976,4,shop,19,20,1
976,5,home,20,24,4
976,6,<ENDS>,24,24,0
977,0,<START>,0,0,0
977,1,home,0,6,6
977,2,work,6,7,1
977,3,home,7,8,1
977,4,work,8,10,2
977,5,home,10,15,5
977,6,work,15,17,2
977,7,home,17,21,4
977,8,work,21,22,1
977,9,home,22,24,2
977,10,<ENDS>,24,24,0
978,0,<START>,0,0,0
978,1,home,0,7,7
978,2,shop,7,8,1
978,3,home,8,9,1
978,4,education,9,12,3
978,5,work,12,18,6
978,6,home,18,24,6
978,7,<ENDS>,24,24,0
979,0,<START>,0,0,0
979,1,home,0,6,6
979,2,work,6,13,7
979,3,home,13,16,3
979,4,shop,16,17,1
979,5,work,17,20,3
979,6,home,20,24,4
979,7,<ENDS>,24,24,0
980,0,<START>,0,0,0
980,1,home,0,7,7
980,2,work,7,15,8
980,3,home,15,23,8
980,4,work,23,24,1
980,5,<ENDS>,24,24,0
981,0,<START>,0,0,0
981,1,home,0,7,7
981,2,shop,7,8,1
981,3,work,8,15,7
981,4,home,15,24,9
981,5,<ENDS>,24,24,0
982,0,<START>,0,0,0
982,1,home,0,6,6
982,2,work,6,13,7
982,3,shop,13,14,1
982,4,work,14,20,6
982,5,home,20,24,4
982,6,<ENDS>,24,24,0
983,0,<START>,0,0,0
983,1,home,0,8,8
983,2,work,8,14,6
983,3,shop,14,15,1
983,4,home,15,24,9
983,5,<ENDS>,24,24,0
984,0,<START>,0,0,0
984,1,home,0,9,9
984,2,work,9,17,8
984,3,home,17,24,7
984,4,<ENDS>,24,24,0
985,0,<START>,0,0,0
985,1,home,0,8,8
985,2,work,8,13,5
985,3,shop,13,14,1
985,4,home,14,15,1
985,5,work,15,19,4
985,6,home,19,24,5
985,7,<ENDS>,24,24,0
986,0,<START>,0,0,0
986,1,home,0,8,8
986,2,education,8,12,4
986,3,home,12,17,5
986,4,shop,17,19,2
986,5,home,19,24,5
986,6,<ENDS>,24,24,0
987,0,<START>,0,0,0
987,1,home,0,7,7
987,2,education,7,12,5
987,3,shop,12,13,1
987,4,home,13,16,3
987,5,shop,16,17,1
987,6,home,17,24,7
987,7,<ENDS>,24,24,0
988,0,<START>,0,0,0
988,1,home,0,7,7
988,2,education,7,11,4
988,3,home,11,17,6
988,4,shop,17,18,1
988,5,home,18,24,6
988,6,<ENDS>,24,24,0
989,0,<START>,0,0,0
989,1,home,0,7,7
989,2,education,7,11,4
989,3,home,11,18,7
989,4,shop,18,19,1
989,5,home,19,24,5
989,6,<ENDS>,24,24,0
990,0,<START>,0,0,0
990,1,home,0,6,6
990,2,work,6,13,7
990,3,home,13,18,5
990,4,work,18,20,2
990,5,home,20,24,4
990,6,<ENDS>,24,24,0
991,0,<START>,0,0,0
991,1,home,0,9,9
991,2,shop,9,10,1
991,3,home,10,14,4
991,4,work,14,20,6
991,5,home,20,24,4
991,6,<ENDS>,24,24,0
992,0,<START>,0,0,0
992,1,home,0,7,7
992,2,work,7,13,6
992,3,shop,13,14,1
992,4,home,14,17,3
992,5,work,17,19,2
992,6,home,19,24,5
992,7,<ENDS>,24,24,0
993,0,<START>,0,0,0
993,1,home,0,6,6
993,2,work,6,8,2
993,3,home,8,13,5
993,4,shop,13,14,1
993,5,home,14,18,4
993,6,work,18,19,1
993,7,home,19,22,3
993,8,work,22,23,1
993,9,home,23,24,1
993,10,<ENDS>,24,24,0
994,0,<START>,0,0,0
994,1,home,0,7,7
994,2,shop,7,8,1
994,3,education,8,13,5
994,4,home,13,19,6
994,5,shop,19,20,1
994,6,home,20,24,4
994,7,<ENDS>,24,24,0
995,0,<START>,0,0,0
995,1,home,0,7,7
995,2,work,7,13,6
995,3,shop,13,14,1
995,4,work,14,19,5
995,5,home,19,24,5
995,6,<ENDS>,24,24,0
996,0,<START>,0,0,0
996,1,home,0,8,8
996,2,shop,8,9,1
996,3,work,9,16,7
996,4,home,16,21,5
996,5,work,21,22,1
996,6,home,22,24,2
996,7,<ENDS>,24,24,0
997,0,<START>,0,0,0
997,1,home,0,6,6
997,2,shop,6,7,1
997,3,home,7,13,6
997,4,education,13,16,3
997,5,shop,16,17,1
997,6,home,17,24,7
997,7,<ENDS>,24,24,0
998,0,<START>,0,0,0
998,1,home,0,8,8
998,2,education,8,12,4
998,3,home,12,24,12
998,4,<ENDS>,24,24,0
999,0,<START>,0,0,0
999,1,home,0,7,7
999,2,work,7,13,6
999,3,home,13,24,11
999,4,<ENDS>,24,24,0
1000,0,<START>,0,0,0
1000,1,home,0,8,8
1000,2,shop,8,9,1
1000,3,work,9,16,7
1000,4,home,16,24,8
1000,5,<ENDS>,24,24,0
1001,0,<START>,0,0,0
1001,1,home,0,6,6
1001,2,work,6,8,2
1001,3,home,8,13,5
1001,4,work,13,15,2
1001,5,shop,15,16,1
1001,6,home,16,21,5
1001,7,work,21,22,1
1001,8,home,22,24,2
1001,9,<ENDS>,24,24,0
1002,0,<START>,0,0,0
1002,1,home,0,7,7
1002,2,work,7,15,8
1002,3,home,15,21,6
1002,4,work,21,22,1
1002,5,home,22,24,2
1002,6,<ENDS>,24,24,0
1003,0,<START>,0,0,0
1003,1,home,0,7,7
1003,2,work,7,13,6
1003,3,shop,13,14,1
1003,4,home,14,24,10
1003,5,<ENDS>,24,24,0
1004,0,<START>,0,0,0
1004,1,home,0,6,6
1004,2,work,6,13,7
1004,3,home,13,24,11
1004,4,<ENDS>,24,24,0
1005,0,<START>,0,0,0
1005,1,home,0,8,8
1005,2,work,8,15,7
1005,3,home,15,24,9
1005,4,<ENDS>,24,24,0
1006,0,<START>,0,0,0
1006,1,home,0,7,7
1006,2,shop,7,8,1
1006,3,education,8,11,3
1006,4,home,11,18,7
1006,5,shop,18,19,1
1006,6,home,19,24,5
1006,7,<ENDS>,24,24,0
1007,0,<START>,0,0,0
1007,1,home,0,6,6
1007,2,work,6,8,2
1007,3,home,8,13,5
1007,4,work,13,15,2
1007,5,home,15,21,6
1007,6,work,21,22,1
1007,7,home,22,24,2
1007,8,<ENDS>,24,24,0
1008,0,<START>,0,0,0
1008,1,home,0,8,8
1008,2,education,8,12,4
1008,3,home,12,17,5
1008,4,shop,17,18,1
1008,5,home,18,24,6
1008,6,<ENDS>,24,24,0
1009,0,<START>,0,0,0
1009,1,home,0,8,8
1009,2,work,8,15,7
1009,3,home,15,24,9
1009,4,<ENDS>,24,24,0
1010,0,<START>,0,0,0
1010,1,home,0,6,6
1010,2,work,6,13,7
1010,3,shop,13,14,1
1010,4,home,14,22,8
1010,5,work,22,23,1
1010,6,home,23,24,1
1010,7,<ENDS>,24,24,0
1011,0,<START>,0,0,0
1011,1,home,0,6,6
1011,2,work,6,13,7
1011,3,shop,13,14,1
1011,4,education,14,17,3
1011,5,home,17,24,7
1011,6,<ENDS>,24,24,0
1012,0,<START>,0,0,0
1012,1,home,0,8,8
1012,2,work,8,14,6
1012,3,home,14,24,10
1012,4,<ENDS>,24,24,0
1013,0,<START>,0,0,0
1013,1,home,0,7,7
1013,2,education,7,12,5
1013,3,shop,12,14,2
1013,4,education,14,16,2
1013,5,home,16,24,8
1013,6,<ENDS>,24,24,0
1014,0,<START>,0,0,0
1014,1,home,0,8,8
1014,2,work,8,14,6
1014,3,shop,14,15,1
1014,4,home,15,24,9
1014,5,<ENDS>,24,24,0
1015,0,<START>,0,0,0
1015,1,home,0,6,6
1015,2,work,6,8,2
1015,3,home,8,12,4
1015,4,work,12,14,2
1015,5,home,14,21,7
1015,6,work,21,22,1
1015,7,home,22,24,2
1015,8,<ENDS>,24,24,0
1016,0,<START>,0,0,0
1016,1,home,0,8,8
1016,2,work,8,14,6
1016,3,shop,14,15,1
1016,4,home,15,24,9
1016,5,<ENDS>,24,24,0
1017,0,<START>,0,0,0
1017,1,home,0,7,7
1017,2,work,7,10,3
1017,3,home,10,14,4
1017,4,work,14,15,1
1017,5,home,15,22,7
1017,6,work,22,23,1
1017,7,home,23,24,1
1017,8,<ENDS>,24,24,0
1018,0,<START>,0,0,0
1018,1,home,0,8,8
1018,2,work,8,15,7
1018,3,home,15,23,8
1018,4,work,23,24,1
1018,5,<ENDS>,24,24,0
1019,0,<START>,0,0,0
1019,1,home,0,7,7
1019,2,work,7,13,6
1019,3,shop,13,14,1
1019,4,work,14,19,5
1019,5,home,19,24,5
1019,6,<ENDS>,24,24,0
1020,0,<START>,0,0,0
1020,1,home,0,7,7
1020,2,shop,7,8,1
1020,3,education,8,11,3
1020,4,home,11,18,7
1020,5,shop,18,20,2
1020,6,home,20,24,4
1020,7,<ENDS>,24,24,0
1021,0,<START>,0,0,0
1021,1,home,0,8,8
1021,2,work,8,15,7
1021,3,home,15,23,8
1021,4,work,23,24,1
1021,5,<ENDS>,24,24,0
1022,0,<START>,0,0,0
1022,1,home,0,6,6
1022,2,work,6,8,2
1022,3,home,8,9,1
1022,4,work,9,10,1
1022,5,home,10,16,6
1022,6,work,16,18,2
1022,7,home,18,23,5
1022,8,work,23,24,1
1022,9,<ENDS>,24,24,0
1023,0,<START>,0,0,0
1023,1,home,0,6,6
1023,2,shop,6,7,1
1023,3,home,7,10,3
1023,4,education,10,12,2
1023,5,home,12,20,8
1023,6,shop,20,21,1
1023,7,home,21,24,3
1023,8,<ENDS>,24,24,0
1024,0,<START>,0,0,0
1024,1,home,0,6,6
1024,2,shop,6,7,1
1024,3,home,7,10,3
1024,4,education,10,12,2
1024,5,shop,12,14,2
1024,6,education,14,16,2
1024,7,home,16,24,8
1024,8,<ENDS>,24,24,0
1025,0,<START>,0,0,0
1025,1,home,0,6,6
1025,2,work,6,8,2
1025,3,home,8,14,6
1025,4,work,14,16,2
1025,5,home,16,21,5
1025,6,work,21,22,1
1025,7,home,22,24,2
1025,8,<ENDS>,24,24,0
1026,0,<START>,0,0,0
1026,1,home,0,8,8
1026,2,work,8,14,6
1026,3,shop,14,15,1
1026,4,home,15,22,7
1026,5,work,22,23,1
1026,6,home,23,24,1
1026,7,<ENDS>,24,24,0
1027,0,<START>,0,0,0
1027,1,home,0,7,7
1027,2,work,7,14,7
1027,3,home,14,20,6
1027,4,shop,20,21,1
1027,5,home,21,24,3
1027,6,<ENDS>,24,24,0
1028,0,<START>,0,0,0
1028,1,home,0,7,7
1028,2,work,7,14,7
1028,3,home,14,15,1
1028,4,work,15,20,5
1028,5,home,20,24,4
1028,6,<ENDS>,24,24,0
1029,0,<START>,0,0,0
1029,1,home,0,7,7
1029,2,work,7,9,2
1029,3,home,9,15,6
1029,4,work,15,17,2
1029,5,home,17,24,7
1029,6,<ENDS>,24,24,0
1030,0,<START>,0,0,0
1030,1,home,0,8,8
1030,2,education,8,12,4
1030,3,home,12,23,11
1030,4,work,23,24,1
1030,5,<ENDS>,24,24,0
1031,0,<START>,0,0,0
1031,1,home,0,6,6
1031,2,work,6,13,7
1031,3,home,13,24,11
1031,4,<ENDS>,24,24,0
1032,0,<START>,0,0,0
1032,1,home,0,8,8
1032,2,education,8,11,3
1032,3,shop,11,12,1
1032,4,work,12,19,7
1032,5,home,19,24,5
1032,6,<ENDS>,24,24,0
1033,0,<START>,0,0,0
1033,1,home,0,7,7
1033,2,education,7,13,6
1033,3,home,13,20,7
1033,4,shop,20,21,1
1033,5,home,21,24,3
1033,6,<ENDS>,24,24,0
1034,0,<START>,0,0,0
1034,1,home,0,7,7
1034,2,work,7,14,7
1034,3,home,14,21,7
1034,4,work,21,22,1
1034,5,home,22,24,2
1034,6,<ENDS>,24,24,0
1035,0,<START>,0,0,0
1035,1,home,0,6,6
1035,2,work,6,13,7
1035,3,shop,13,14,1
1035,4,home,14,23,9
1035,5,work,23,24,1
1035,6,<ENDS>,24,24,0
1036,0,<START>,0,0,0
1036,1,home,0,8,8
1036,2,work,8,14,6
1036,3,shop,14,15,1
1036,4,work,15,20,5
1036,5,home,20,24,4
1036,6,<ENDS>,24,24,0
1037,0,<START>,0,0,0
1037,1,home,0,9,9
1037,2,work,9,17,8
1037,3,home,17,18,1
1037,4,shop,18,19,1
1037,5,home,19,24,5
1037,6,<ENDS>,24,24,0
1038,0,<START>,0,0,0
1038,1,home,0,7,7
1038,2,work,7,13,6
1038,3,shop,13,14,1
1038,4,work,14,19,5
1038,5,home,19,24,5
1038,6,<ENDS>,24,24,0
1039,0,<START>,0,0,0
1039,1,home,0,6,6
1039,2,work,6,13,7
1039,3,shop,13,14,1
1039,4,work,14,19,5
1039,5,home,19,24,5
1039,6,<ENDS>,24,24,0
1040,0,<START>,0,0,0
1040,1,home,0,8,8
1040,2,work,8,15,7
1040,3,home,15,22,7
1040,4,work,22,23,1
1040,5,home,23,24,1
1040,6,<ENDS>,24,24,0
1041,0,<START>,0,0,0
1041,1,home,0,7,7
1041,2,shop,7,8,1
1041,3,education,8,11,3
1041,4,home,11,17,6
1041,5,shop,17,18,1
1041,6,home,18,24,6
1041,7,<ENDS>,24,24,0
1042,0,<START>,0,0,0
1042,1,home,0,8,8
1042,2,work,8,15,7
1042,3,home,15,24,9
1042,4,<ENDS>,24,24,0
1043,0,<START>,0,0,0
1043,1,home,0,7,7
1043,2,education,7,12,5
1043,3,home,12,19,7
1043,4,shop,19,20,1
1043,5,home,20,24,4
1043,6,<ENDS>,24,24,0
1044,0,<START>,0,0,0
1044,1,home,0,6,6
1044,2,work,6,13,7
1044,3,home,13,24,11
1044,4,<ENDS>,24,24,0
1045,0,<START>,0,0,0
1045,1,home,0,6,6
1045,2,work,6,13,7
1045,3,home,13,17,4
1045,4,work,17,20,3
1045,5,home,20,24,4
1045,6,<ENDS>,24,24,0
1046,0,<START>,0,0,0
1046,1,home,0,7,7
1046,2,work,7,13,6
1046,3,home,13,24,11
1046,4,<ENDS>,24,24,0
1047,0,<START>,0,0,0
1047,1,home,0,6,6
1047,2,shop,6,7,1
1047,3,home,7,12,5
1047,4,shop,12,13,1
1047,5,work,13,19,6
1047,6,home,19,24,5
1047,7,<ENDS>,24,24,0
1048,0,<START>,0,0,0
1048,1,home,0,6,6
1048,2,work,6,8,2
1048,3,home,8,12,4
1048,4,work,12,14,2
1048,5,home,14,21,7
1048,6,work,21,22,1
1048,7,home,22,24,2
1048,8,<ENDS>,24,24,0
1049,0,<START>,0,0,0
1049,1,home,0,8,8
1049,2,shop,8,9,1
1049,3,home,9,12,3
1049,4,work,12,19,7
1049,5,home,19,23,4
1049,6,work,23,24,1
1049,7,<ENDS>,24,24,0
1050,0,<START>,0,0,0
1050,1,home,0,6,6
1050,2,work,6,12,6
1050,3,shop,12,13,1
1050,4,work,13,19,6
1050,5,home,19,24,5
1050,6,<ENDS>,24,24,0
1051,0,<START>,0,0,0
1051,1,home,0,7,7
1051,2,work,7,14,7
1051,3,home,14,24,10
1051,4,<ENDS>,24,24,0
1052,0,<START>,0,0,0
1052,1,home,0,7,7
1052,2,shop,7,8,1
1052,3,home,8,9,1
1052,4,work,9,16,7
1052,5,shop,16,17,1
1052,6,home,17,24,7
1052,7,<ENDS>,24,24,0
1053,0,<START>,0,0,0
1053,1,home,0,6,6
1053,2,shop,6,7,1
1053,3,home,7,13,6
1053,4,education,13,16,3
1053,5,home,16,24,8
1053,6,<ENDS>,24,24,0
1054,0,<START>,0,0,0
1054,1,home,0,6,6
1054,2,work,6,13,7
1054,3,shop,13,14,1
1054,4,work,14,17,3
1054,5,home,17,24,7
1054,6,<ENDS>,24,24,0
1055,0,<START>,0,0,0
1055,1,home,0,7,7
1055,2,work,7,14,7
1055,3,home,14,23,9
1055,4,work,23,24,1
1055,5,<ENDS>,24,24,0
1056,0,<START>,0,0,0
1056,1,home,0,7,7
1056,2,education,7,11,4
1056,3,home,11,18,7
1056,4,shop,18,19,1
1056,5,home,19,24,5
1056,6,<ENDS>,24,24,0
1057,0,<START>,0,0,0
1057,1,home,0,6,6
1057,2,work,6,13,7
1057,3,home,13,16,3
1057,4,work,16,20,4
1057,5,home,20,24,4
1057,6,<ENDS>,24,24,0
1058,0,<START>,0,0,0
1058,1,home,0,6,6
1058,2,shop,6,7,1
1058,3,work,7,13,6
1058,4,home,13,23,10
1058,5,work,23,24,1
1058,6,<ENDS>,24,24,0
1059,0,<START>,0,0,0
1059,1,work,0,1,1
1059,2,home,1,7,6
1059,3,education,7,12,5
1059,4,home,12,17,5
1059,5,shop,17,18,1
1059,6,home,18,24,6
1059,7,<ENDS>,24,24,0
1060,0,<START>,0,0,0
1060,1,home,0,7,7
1060,2,work,7,14,7
1060,3,shop,14,15,1
1060,4,work,15,20,5
1060,5,home,20,24,4
1060,6,<ENDS>,24,24,0
1061,0,<START>,0,0,0
1061,1,home,0,6,6
1061,2,work,6,8,2
1061,3,home,8,12,4
1061,4,work,12,14,2
1061,5,home,14,21,7
1061,6,work,21,22,1
1061,7,home,22,24,2
1061,8,<ENDS>,24,24,0
1062,0,<START>,0,0,0
1062,1,home,0,7,7
1062,2,work,7,13,6
1062,3,home,13,24,11
1062,4,<ENDS>,24,24,0
1063,0,<START>,0,0,0
1063,1,home,0,9,9
1063,2,work,9,15,6
1063,3,shop,15,16,1
1063,4,home,16,24,8
1063,5,<ENDS>,24,24,0
1064,0,<START>,0,0,0
1064,1,home,0,7,7
1064,2,work,7,9,2
1064,3,home,9,12,3
1064,4,work,12,14,2
1064,5,home,14,21,7
1064,6,work,21,22,1
1064,7,home,22,24,2
1064,8,<ENDS>,24,24,0
1065,0,<START>,0,0,0
1065,1,home,0,7,7
1065,2,work,7,13,6
1065,3,shop,13,14,1
1065,4,home,14,24,10
1065,5,<ENDS>,24,24,0
1066,0,<START>,0,0,0
1066,1,home,0,8,8
1066,2,work,8,15,7
1066,3,shop,15,16,1
1066,4,home,16,24,8
1066,5,<ENDS>,24,24,0
1067,0,<START>,0,0,0
1067,1,home,0,6,6
1067,2,shop,6,7,1
1067,3,work,7,9,2
1067,4,home,9,15,6
1067,5,work,15,17,2
1067,6,home,17,23,6
1067,7,work,23,24,1
1067,8,<ENDS>,24,24,0
1068,0,<START>,0,0,0
1068,1,home,0,9,9
1068,2,work,9,17,8
1068,3,home,17,24,7
1068,4,<ENDS>,24,24,0
1069,0,<START>,0,0,0
1069,1,home,0,8,8
1069,2,shop,8,9,1
1069,3,work,9,16,7
1069,4,home,16,24,8
1069,5,<ENDS>,24,24,0
1070,0,<START>,0,0,0
1070,1,home,0,6,6
1070,2,shop,6,7,1
1070,3,work,7,14,7
1070,4,home,14,24,10
1070,5,<ENDS>,24,24,0
1071,0,<START>,0,0,0
1071,1,home,0,6,6
1071,2,work,6,13,7
1071,3,home,13,17,4
1071,4,work,17,20,3
1071,5,home,20,24,4
1071,6,<ENDS>,24,24,0
1072,0,<START>,0,0,0
1072,1,home,0,8,8
1072,2,work,8,14,6
1072,3,home,14,24,10
1072,4,<ENDS>,24,24,0
1073,0,<START>,0,0,0
1073,1,home,0,8,8
1073,2,education,8,11,3
1073,3,home,11,18,7
1073,4,work,18,20,2
1073,5,home,20,24,4
1073,6,<ENDS>,24,24,0
1074,0,<START>,0,0,0
1074,1,home,0,6,6
1074,2,work,6,7,1
1074,3,home,7,12,5
1074,4,work,12,13,1
1074,5,home,13,17,4
1074,6,work,17,19,2
1074,7,home,19,23,4
1074,8,work,23,24,1
1074,9,<ENDS>,24,24,0
1075,0,<START>,0,0,0
1075,1,home,0,7,7
1075,2,work,7,13,6
1075,3,home,13,18,5
1075,4,shop,18,19,1
1075,5,home,19,24,5
1075,6,<ENDS>,24,24,0
1076,0,<START>,0,0,0
1076,1,home,0,7,7
1076,2,work,7,13,6
1076,3,home,13,24,11
1076,4,<ENDS>,24,24,0
1077,0,<START>,0,0,0
1077,1,home,0,8,8
1077,2,work,8,13,5
1077,3,shop,13,14,1
1077,4,work,14,18,4
1077,5,home,18,24,6
1077,6,<ENDS>,24,24,0
1078,0,<START>,0,0,0
1078,1,home,0,6,6
1078,2,work,6,8,2
1078,3,home,8,9,1
1078,4,work,9,11,2
1078,5,home,11,12,1
1078,6,work,12,14,2
1078,7,shop,14,15,1
1078,8,home,15,21,6
1078,9,work,21,22,1
1078,10,home,22,24,2
1078,11,<ENDS>,24,24,0
1079,0,<START>,0,0,0
1079,1,home,0,8,8
1079,2,work,8,15,7
1079,3,home,15,24,9
1079,4,<ENDS>,24,24,0
1080,0,<START>,0,0,0
1080,1,home,0,6,6
1080,2,work,6,13,7
1080,3,home,13,24,11
1080,4,<ENDS>,24,24,0
1081,0,<START>,0,0,0
1081,1,home,0,7,7
1081,2,work,7,14,7
1081,3,home,14,20,6
1081,4,shop,20,21,1
1081,5,home,21,24,3
1081,6,<ENDS>,24,24,0
1082,0,<START>,0,0,0
1082,1,home,0,6,6
1082,2,work,6,13,7
1082,3,home,13,24,11
1082,4,<ENDS>,24,24,0
1083,0,<START>,0,0,0
1083,1,home,0,6,6
1083,2,work,6,14,8
1083,3,shop,14,15,1
1083,4,home,15,24,9
1083,5,<ENDS>,24,24,0
1084,0,<START>,0,0,0
1084,1,home,0,8,8
1084,2,work,8,14,6
1084,3,shop,14,15,1
1084,4,home,15,22,7
1084,5,work,22,23,1
1084,6,home,23,24,1
1084,7,<ENDS>,24,24,0
1085,0,<START>,0,0,0
1085,1,home,0,7,7
1085,2,work,7,13,6
1085,3,shop,13,14,1
1085,4,education,14,17,3
1085,5,home,17,24,7
1085,6,<ENDS>,24,24,0
1086,0,<START>,0,0,0
1086,1,home,0,7,7
1086,2,work,7,13,6
1086,3,shop,13,14,1
1086,4,work,14,20,6
1086,5,home,20,24,4
1086,6,<ENDS>,24,24,0
1087,0,<START>,0,0,0
1087,1,home,0,7,7
1087,2,work,7,8,1
1087,3,home,8,9,1
1087,4,work,9,11,2
1087,5,home,11,17,6
1087,6,work,17,19,2
1087,7,home,19,24,5
1087,8,<ENDS>,24,24,0
1088,0,<START>,0,0,0
1088,1,home,0,6,6
1088,2,work,6,8,2
1088,3,home,8,9,1
1088,4,work,9,11,2
1088,5,home,11,15,4
1088,6,work,15,17,2
1088,7,home,17,24,7
1088,8,<ENDS>,24,24,0
1089,0,<START>,0,0,0
1089,1,home,0,8,8
1089,2,work,8,15,7
1089,3,home,15,24,9
1089,4,<ENDS>,24,24,0
1090,0,<START>,0,0,0
1090,1,home,0,8,8
1090,2,work,8,14,6
1090,3,home,14,21,7
1090,4,work,21,22,1
1090,5,home,22,24,2
1090,6,<ENDS>,24,24,0
1091,0,<START>,0,0,0
1091,1,home,0,7,7
1091,2,work,7,13,6
1091,3,shop,13,14,1
1091,4,home,14,21,7
1091,5,work,21,22,1
1091,6,home,22,24,2
1091,7,<ENDS>,24,24,0
1092,0,<START>,0,0,0
1092,1,home,0,7,7
1092,2,work,7,14,7
1092,3,shop,14,15,1
1092,4,work,15,20,5
1092,5,home,20,24,4
1092,6,<ENDS>,24,24,0
1093,0,<START>,0,0,0
1093,1,home,0,7,7
1093,2,work,7,14,7
1093,3,home,14,24,10
1093,4,<ENDS>,24,24,0
1094,0,<START>,0,0,0
1094,1,home,0,6,6
1094,2,work,6,13,7
1094,3,home,13,24,11
1094,4,<ENDS>,24,24,0
1095,0,<START>,0,0,0
1095,1,home,0,7,7
1095,2,education,7,12,5
1095,3,home,12,20,8
1095,4,shop,20,21,1
1095,5,home,21,24,3
1095,6,<ENDS>,24,24,0
1096,0,<START>,0,0,0
1096,1,home,0,7,7
1096,2,work,7,13,6
1096,3,home,13,24,11
1096,4,<ENDS>,24,24,0
1097,0,<START>,0,0,0
1097,1,home,0,8,8
1097,2,work,8,15,7
1097,3,home,15,21,6
1097,4,shop,21,22,1
1097,5,home,22,24,2
1097,6,<ENDS>,24,24,0
1098,0,<START>,0,0,0
1098,1,home,0,8,8
1098,2,shop,8,9,1
1098,3,home,9,16,7
1098,4,work,16,20,4
1098,5,home,20,24,4
1098,6,<ENDS>,24,24,0
1099,0,<START>,0,0,0
1099,1,home,0,6,6
1099,2,work,6,7,1
1099,3,shop,7,8,1
1099,4,home,8,13,5
1099,5,work,13,19,6
1099,6,education,19,20,1
1099,7,home,20,24,4
1099,8,<ENDS>,24,24,0
1100,0,<START>,0,0,0
1100,1,home,0,6,6
1100,2,work,6,8,2
1100,3,home,8,15,7
1100,4,work,15,16,1
1100,5,home,16,22,6
1100,6,work,22,23,1
1100,7,home,23,24,1
1100,8,<ENDS>,24,24,0
1101,0,<START>,0,0,0
1101,1,home,0,6,6
1101,2,shop,6,7,1
1101,3,home,7,9,2
1101,4,work,9,17,8
1101,5,home,17,24,7
1101,6,<ENDS>,24,24,0
1102,0,<START>,0,0,0
1102,1,home,0,6,6
1102,2,work,6,13,7
1102,3,home,13,17,4
1102,4,work,17,20,3
1102,5,home,20,24,4
1102,6,<ENDS>,24,24,0
1103,0,<START>,0,0,0
1103,1,home,0,6,6
1103,2,work,6,13,7
1103,3,home,13,18,5
1103,4,work,18,20,2
1103,5,home,20,24,4
1103,6,<ENDS>,24,24,0
1104,0,<START>,0,0,0
1104,1,home,0,6,6
1104,2,shop,6,7,1
1104,3,home,7,10,3
1104,4,education,10,12,2
1104,5,shop,12,14,2
1104,6,education,14,16,2
1104,7,shop,16,17,1
1104,8,home,17,24,7
1104,9,<ENDS>,24,24,0
1105,0,<START>,0,0,0
1105,1,home,0,7,7
1105,2,education,7,12,5
1105,3,shop,12,13,1
1105,4,education,13,16,3
1105,5,home,16,24,8
1105,6,<ENDS>,24,24,0
1106,0,<START>,0,0,0
1106,1,home,0,7,7
1106,2,shop,7,8,1
1106,3,education,8,12,4
1106,4,shop,12,15,3
1106,5,home,15,24,9
1106,6,<ENDS>,24,24,0
1107,0,<START>,0,0,0
1107,1,home,0,7,7
1107,2,work,7,14,7
1107,3,shop,14,15,1
1107,4,home,15,21,6
1107,5,work,21,22,1
1107,6,home,22,24,2
1107,7,<ENDS>,24,24,0
1108,0,<START>,0,0,0
1108,1,home,0,6,6
1108,2,work,6,13,7
1108,3,shop,13,14,1
1108,4,work,14,20,6
1108,5,home,20,24,4
1108,6,<ENDS>,24,24,0
1109,0,<START>,0,0,0
1109,1,home,0,7,7
1109,2,education,7,11,4
1109,3,home,11,14,3
1109,4,education,14,17,3
1109,5,shop,17,18,1
1109,6,home,18,24,6
1109,7,<ENDS>,24,24,0
1110,0,<START>,0,0,0
1110,1,home,0,6,6
1110,2,work,6,12,6
1110,3,shop,12,13,1
1110,4,work,13,19,6
1110,5,home,19,24,5
1110,6,<ENDS>,24,24,0
1111,0,<START>,0,0,0
1111,1,home,0,6,6
1111,2,work,6,13,7
1111,3,shop,13,14,1
1111,4,work,14,19,5
1111,5,education,19,20,1
1111,6,home,20,24,4
1111,7,<ENDS>,24,24,0
1112,0,<START>,0,0,0
1112,1,home,0,7,7
1112,2,work,7,13,6
1112,3,shop,13,14,1
1112,4,work,14,19,5
1112,5,home,19,24,5
1112,6,<ENDS>,24,24,0
1113,0,<START>,0,0,0
1113,1,home,0,6,6
1113,2,shop,6,7,1
1113,3,home,7,9,2
1113,4,education,9,11,2
1113,5,home,11,18,7
1113,6,shop,18,20,2
1113,7,home,20,24,4
1113,8,<ENDS>,24,24,0
1114,0,<START>,0,0,0
1114,1,home,0,6,6
1114,2,work,6,7,1
1114,3,home,7,9,2
1114,4,work,9,10,1
1114,5,home,10,17,7
1114,6,work,17,18,1
1114,7,home,18,21,3
1114,8,work,21,22,1
1114,9,home,22,24,2
1114,10,<ENDS>,24,24,0
1115,0,<START>,0,0,0
1115,1,home,0,7,7
1115,2,work,7,14,7
1115,3,home,14,24,10
1115,4,<ENDS>,24,24,0
1116,0,<START>,0,0,0
1116,1,home,0,6,6
1116,2,work,6,7,1
1116,3,home,7,13,6
1116,4,work,13,15,2
1116,5,home,15,22,7
1116,6,work,22,23,1
1116,7,home,23,24,1
1116,8,<ENDS>,24,24,0
1117,0,<START>,0,0,0
1117,1,home,0,8,8
1117,2,education,8,11,3
1117,3,home,11,20,9
1117,4,shop,20,21,1
1117,5,home,21,24,3
1117,6,<ENDS>,24,24,0
1118,0,<START>,0,0,0
1118,1,home,0,8,8
1118,2,education,8,12,4
1118,3,shop,12,14,2
1118,4,education,14,16,2
1118,5,shop,16,18,2
1118,6,home,18,24,6
1118,7,<ENDS>,24,24,0
1119,0,<START>,0,0,0
1119,1,home,0,6,6
1119,2,shop,6,7,1
1119,3,work,7,13,6
1119,4,home,13,24,11
1119,5,<ENDS>,24,24,0
1120,0,<START>,0,0,0
1120,1,home,0,8,8
1120,2,work,8,15,7
1120,3,home,15,21,6
1120,4,work,21,22,1
1120,5,home,22,24,2
1120,6,<ENDS>,24,24,0
1121,0,<START>,0,0,0
1121,1,home,0,6,6
1121,2,shop,6,7,1
1121,3,home,7,9,2
1121,4,education,9,12,3
1121,5,home,12,24,12
1121,6,<ENDS>,24,24,0
1122,0,<START>,0,0,0
1122,1,home,0,6,6
1122,2,work,6,13,7
1122,3,shop,13,14,1
1122,4,home,14,24,10
1122,5,<ENDS>,24,24,0
1123,0,<START>,0,0,0
1123,1,home,0,8,8
1123,2,work,8,15,7
1123,3,home,15,24,9
1123,4,<ENDS>,24,24,0
1124,0,<START>,0,0,0
1124,1,home,0,8,8
1124,2,work,8,15,7
1124,3,shop,15,16,1
1124,4,work,16,20,4
1124,5,home,20,24,4
1124,6,<ENDS>,24,24,0
1125,0,<START>,0,0,0
1125,1,home,0,6,6
1125,2,work,6,13,7
1125,3,shop,13,14,1
1125,4,work,14,20,6
1125,5,home,20,24,4
1125,6,<ENDS>,24,24,0
1126,0,<START>,0,0,0
1126,1,home,0,7,7
1126,2,shop,7,8,1
1126,3,education,8,11,3
1126,4,home,11,14,3
1126,5,education,14,18,4
1126,6,home,18,24,6
1126,7,<ENDS>,24,24,0
1127,0,<START>,0,0,0
1127,1,home,0,7,7
1127,2,shop,7,8,1
1127,3,education,8,11,3
1127,4,home,11,19,8
1127,5,shop,19,21,2
1127,6,home,21,24,3
1127,7,<ENDS>,24,24,0
1128,0,<START>,0,0,0
1128,1,home,0,7,7
1128,2,work,7,8,1
1128,3,home,8,13,5
1128,4,work,13,16,3
1128,5,home,16,22,6
1128,6,work,22,23,1
1128,7,home,23,24,1
1128,8,<ENDS>,24,24,0
1129,0,<START>,0,0,0
1129,1,home,0,6,6
1129,2,work,6,7,1
1129,3,home,7,13,6
1129,4,work,13,15,2
1129,5,home,15,21,6
1129,6,work,21,22,1
1129,7,home,22,24,2
1129,8,<ENDS>,24,24,0
1130,0,<START>,0,0,0
1130,1,home,0,8,8
1130,2,work,8,14,6
1130,3,home,14,24,10
1130,4,<ENDS>,24,24,0
1131,0,<START>,0,0,0
1131,1,home,0,7,7
1131,2,shop,7,8,1
1131,3,work,8,14,6
1131,4,home,14,23,9
1131,5,work,23,24,1
1131,6,<ENDS>,24,24,0
1132,0,<START>,0,0,0
1132,1,home,0,6,6
1132,2,work,6,13,7
1132,3,shop,13,14,1
1132,4,home,14,22,8
1132,5,work,22,23,1
1132,6,home,23,24,1
1132,7,<ENDS>,24,24,0
1133,0,<START>,0,0,0
1133,1,home,0,8,8
1133,2,education,8,12,4
1133,3,home,12,24,12
1133,4,<ENDS>,24,24,0
1134,0,<START>,0,0,0
1134,1,home,0,6,6
1134,2,shop,6,7,1
1134,3,home,7,10,3
1134,4,education,10,13,3
1134,5,shop,13,15,2
1134,6,home,15,24,9
1134,7,<ENDS>,24,24,0
1135,0,<START>,0,0,0
1135,1,home,0,6,6
1135,2,shop,6,7,1
1135,3,home,7,12,5
1135,4,education,12,16,4
1135,5,home,16,24,8
1135,6,<ENDS>,24,24,0
1136,0,<START>,0,0,0
1136,1,home,0,8,8
1136,2,education,8,11,3
1136,3,home,11,15,4
1136,4,work,15,20,5
1136,5,home,20,24,4
1136,6,<ENDS>,24,24,0
1137,0,<START>,0,0,0
1137,1,home,0,7,7
1137,2,shop,7,8,1
1137,3,education,8,11,3
1137,4,home,11,17,6
1137,5,shop,17,19,2
1137,6,home,19,24,5
1137,7,<ENDS>,24,24,0
1138,0,<START>,0,0,0
1138,1,home,0,6,6
1138,2,work,6,8,2
1138,3,home,8,14,6
1138,4,work,14,16,2
1138,5,home,16,22,6
1138,6,work,22,23,1
1138,7,home,23,24,1
1138,8,<ENDS>,24,24,0
1139,0,<START>,0,0,0
1139,1,home,0,6,6
1139,2,work,6,13,7
1139,3,shop,13,14,1
1139,4,work,14,19,5
1139,5,home,19,24,5
1139,6,<ENDS>,24,24,0
1140,0,<START>,0,0,0
1140,1,home,0,8,8
1140,2,work,8,15,7
1140,3,home,15,24,9
1140,4,<ENDS>,24,24,0
1141,0,<START>,0,0,0
1141,1,home,0,6,6
1141,2,work,6,13,7
1141,3,shop,13,14,1
1141,4,work,14,19,5
1141,5,home,19,24,5
1141,6,<ENDS>,24,24,0
1142,0,<START>,0,0,0
1142,1,home,0,7,7
1142,2,work,7,14,7
1142,3,home,14,24,10
1142,4,<ENDS>,24,24,0
1143,0,<START>,0,0,0
1143,1,home,0,7,7
1143,2,work,7,14,7
1143,3,home,14,23,9
1143,4,work,23,24,1
1143,5,<ENDS>,24,24,0
1144,0,<START>,0,0,0
1144,1,home,0,6,6
1144,2,work,6,13,7
1144,3,shop,13,14,1
1144,4,home,14,21,7
1144,5,work,21,22,1
1144,6,home,22,24,2
1144,7,<ENDS>,24,24,0
1145,0,<START>,0,0,0
1145,1,home,0,8,8
1145,2,work,8,14,6
1145,3,home,14,24,10
1145,4,<ENDS>,24,24,0
1146,0,<START>,0,0,0
1146,1,home,0,8,8
1146,2,work,8,14,6
1146,3,home,14,24,10
1146,4,<ENDS>,24,24,0
1147,0,<START>,0,0,0
1147,1,home,0,8,8
1147,2,work,8,15,7
1147,3,home,15,24,9
1147,4,<ENDS>,24,24,0
1148,0,<START>,0,0,0
1148,1,home,0,6,6
1148,2,work,6,14,8
1148,3,shop,14,15,1
1148,4,work,15,19,4
1148,5,home,19,24,5
1148,6,<ENDS>,24,24,0
1149,0,<START>,0,0,0
1149,1,home,0,6,6
1149,2,shop,6,7,1
1149,3,home,7,13,6
1149,4,education,13,15,2
1149,5,shop,15,16,1
1149,6,home,16,20,4
1149,7,shop,20,21,1
1149,8,home,21,24,3
1149,9,<ENDS>,24,24,0
1150,0,<START>,0,0,0
1150,1,home,0,6,6
1150,2,work,6,13,7
1150,3,shop,13,14,1
1150,4,work,14,19,5
1150,5,home,19,24,5
1150,6,<ENDS>,24,24,0
1151,0,<START>,0,0,0
1151,1,home,0,7,7
1151,2,work,7,13,6
1151,3,shop,13,14,1
1151,4,home,14,24,10
1151,5,<ENDS>,24,24,0
1152,0,<START>,0,0,0
1152,1,home,0,8,8
1152,2,work,8,15,7
1152,3,shop,15,17,2
1152,4,home,17,24,7
1152,5,<ENDS>,24,24,0
1153,0,<START>,0,0,0
1153,1,home,0,7,7
1153,2,education,7,13,6
1153,3,shop,13,15,2
1153,4,home,15,21,6
1153,5,shop,21,22,1
1153,6,home,22,24,2
1153,7,<ENDS>,24,24,0
1154,0,<START>,0,0,0
1154,1,home,0,6,6
1154,2,work,6,9,3
1154,3,home,9,14,5
1154,4,work,14,16,2
1154,5,home,16,21,5
1154,6,work,21,22,1
1154,7,home,22,24,2
1154,8,<ENDS>,24,24,0
1155,0,<START>,0,0,0
1155,1,home,0,9,9
1155,2,work,9,16,7
1155,3,home,16,20,4
1155,4,shop,20,21,1
1155,5,home,21,24,3
1155,6,<ENDS>,24,24,0
1156,0,<START>,0,0,0
1156,1,home,0,8,8
1156,2,work,8,14,6
1156,3,home,14,24,10
1156,4,<ENDS>,24,24,0
1157,0,<START>,0,0,0
1157,1,home,0,6,6
1157,2,shop,6,7,1
1157,3,work,7,14,7
1157,4,home,14,24,10
1157,5,<ENDS>,24,24,0
1158,0,<START>,0,0,0
1158,1,home,0,6,6
1158,2,work,6,8,2
1158,3,home,8,12,4
1158,4,work,12,14,2
1158,5,home,14,21,7
1158,6,work,21,22,1
1158,7,home,22,24,2
1158,8,<ENDS>,24,24,0
1159,0,<START>,0,0,0
1159,1,home,0,7,7
1159,2,shop,7,8,1
1159,3,work,8,15,7
1159,4,shop,15,16,1
1159,5,home,16,24,8
1159,6,<ENDS>,24,24,0
1160,0,<START>,0,0,0
1160,1,home,0,7,7
1160,2,education,7,12,5
1160,3,shop,12,13,1
1160,4,home,13,19,6
1160,5,shop,19,20,1
1160,6,home,20,24,4
1160,7,<ENDS>,24,24,0
1161,0,<START>,0,0,0
1161,1,home,0,7,7
1161,2,shop,7,9,2
1161,3,education,9,12,3
1161,4,home,12,20,8
1161,5,shop,20,21,1
1161,6,home,21,24,3
1161,7,<ENDS>,24,24,0
1162,0,<START>,0,0,0
1162,1,home,0,7,7
1162,2,work,7,13,6
1162,3,shop,13,14,1
1162,4,home,14,23,9
1162,5,work,23,24,1
1162,6,<ENDS>,24,24,0
1163,0,<START>,0,0,0
1163,1,home,0,8,8
1163,2,education,8,12,4
1163,3,shop,12,13,1
1163,4,work,13,20,7
1163,5,home,20,24,4
1163,6,<ENDS>,24,24,0
1164,0,<START>,0,0,0
1164,1,home,0,9,9
1164,2,education,9,12,3
1164,3,work,12,19,7
1164,4,home,19,24,5
1164,5,<ENDS>,24,24,0
1165,0,<START>,0,0,0
1165,1,home,0,8,8
1165,2,education,8,11,3
1165,3,home,11,18,7
1165,4,shop,18,20,2
1165,5,home,20,24,4
1165,6,<ENDS>,24,24,0
1166,0,<START>,0,0,0
1166,1,home,0,8,8
1166,2,work,8,17,9
1166,3,home,17,24,7
1166,4,<ENDS>,24,24,0
1167,0,<START>,0,0,0
1167,1,home,0,7,7
1167,2,education,7,11,4
1167,3,home,11,19,8
1167,4,shop,19,20,1
1167,5,home,20,24,4
1167,6,<ENDS>,24,24,0
1168,0,<START>,0,0,0
1168,1,home,0,7,7
1168,2,work,7,13,6
1168,3,home,13,24,11
1168,4,<ENDS>,24,24,0
1169,0,<START>,0,0,0
1169,1,home,0,7,7
1169,2,work,7,13,6
1169,3,home,13,21,8
1169,4,work,21,22,1
1169,5,home,22,24,2
1169,6,<ENDS>,24,24,0
1170,0,<START>,0,0,0
1170,1,home,0,6,6
1170,2,work,6,13,7
1170,3,home,13,24,11
1170,4,<ENDS>,24,24,0
1171,0,<START>,0,0,0
1171,1,home,0,7,7
1171,2,work,7,14,7
1171,3,home,14,19,5
1171,4,shop,19,20,1
1171,5,home,20,24,4
1171,6,<ENDS>,24,24,0
1172,0,<START>,0,0,0
1172,1,home,0,7,7
1172,2,work,7,14,7
1172,3,shop,14,15,1
1172,4,work,15,20,5
1172,5,home,20,24,4
1172,6,<ENDS>,24,24,0
1173,0,<START>,0,0,0
1173,1,home,0,6,6
1173,2,work,6,13,7
1173,3,home,13,17,4
1173,4,work,17,20,3
1173,5,home,20,24,4
1173,6,<ENDS>,24,24,0
1174,0,<START>,0,0,0
1174,1,home,0,8,8
1174,2,education,8,12,4
1174,3,shop,12,14,2
1174,4,education,14,17,3
1174,5,home,17,24,7
1174,6,<ENDS>,24,24,0
1175,0,<START>,0,0,0
1175,1,home,0,6,6
1175,2,work,6,13,7
1175,3,home,13,24,11
1175,4,<ENDS>,24,24,0
1176,0,<START>,0,0,0
1176,1,home,0,6,6
1176,2,shop,6,7,1
1176,3,home,7,9,2
1176,4,work,9,16,7
1176,5,home,16,24,8
1176,6,<ENDS>,24,24,0
1177,0,<START>,0,0,0
1177,1,home,0,6,6
1177,2,work,6,13,7
1177,3,shop,13,14,1
1177,4,work,14,19,5
1177,5,education,19,20,1
1177,6,home,20,24,4
1177,7,<ENDS>,24,24,0
1178,0,<START>,0,0,0
1178,1,home,0,9,9
1178,2,work,9,16,7
1178,3,home,16,24,8
1178,4,<ENDS>,24,24,0
1179,0,<START>,0,0,0
1179,1,home,0,6,6
1179,2,work,6,8,2
1179,3,home,8,14,6
1179,4,work,14,17,3
1179,5,home,17,21,4
1179,6,work,21,22,1
1179,7,home,22,24,2
1179,8,<ENDS>,24,24,0
1180,0,<START>,0,0,0
1180,1,home,0,7,7
1180,2,work,7,15,8
1180,3,home,15,18,3
1180,4,work,18,20,2
1180,5,home,20,24,4
1180,6,<ENDS>,24,24,0
1181,0,<START>,0,0,0
1181,1,home,0,8,8
1181,2,work,8,14,6
1181,3,shop,14,15,1
1181,4,home,15,24,9
1181,5,<ENDS>,24,24,0
1182,0,<START>,0,0,0
1182,1,home,0,8,8
1182,2,work,8,15,7
1182,3,home,15,24,9
1182,4,<ENDS>,24,24,0
1183,0,<START>,0,0,0
1183,1,home,0,6,6
1183,2,work,6,13,7
1183,3,shop,13,14,1
1183,4,home,14,24,10
1183,5,<ENDS>,24,24,0
1184,0,<START>,0,0,0
1184,1,home,0,7,7
1184,2,work,7,8,1
1184,3,home,8,13,5
1184,4,work,13,15,2
1184,5,home,15,22,7
1184,6,work,22,23,1
1184,7,home,23,24,1
1184,8,<ENDS>,24,24,0
1185,0,<START>,0,0,0
1185,1,home,0,6,6
1185,2,work,6,13,7
1185,3,home,13,18,5
1185,4,work,18,20,2
1185,5,home,20,24,4
1185,6,<ENDS>,24,24,0
1186,0,<START>,0,0,0
1186,1,home,0,7,7
1186,2,education,7,11,4
1186,3,home,11,19,8
1186,4,shop,19,20,1
1186,5,home,20,24,4
1186,6,<ENDS>,24,24,0
1187,0,<START>,0,0,0
1187,1,home,0,6,6
1187,2,work,6,13,7
1187,3,home,13,18,5
1187,4,work,18,20,2
1187,5,home,20,24,4
1187,6,<ENDS>,24,24,0
1188,0,<START>,0,0,0
1188,1,home,0,6,6
1188,2,work,6,13,7
1188,3,shop,13,14,1
1188,4,education,14,16,2
1188,5,home,16,24,8
1188,6,<ENDS>,24,24,0
1189,0,<START>,0,0,0
1189,1,home,0,8,8
1189,2,work,8,15,7
1189,3,home,15,24,9
1189,4,<ENDS>,24,24,0
1190,0,<START>,0,0,0
1190,1,home,0,8,8
1190,2,work,8,15,7
1190,3,home,15,24,9
1190,4,<ENDS>,24,24,0
1191,0,<START>,0,0,0
1191,1,home,0,8,8
1191,2,work,8,15,7
1191,3,home,15,24,9
1191,4,<ENDS>,24,24,0
1192,0,<START>,0,0,0
1192,1,home,0,6,6
1192,2,work,6,14,8
1192,3,shop,14,15,1
1192,4,home,15,24,9
1192,5,<ENDS>,24,24,0
1193,0,<START>,0,0,0
1193,1,home,0,7,7
1193,2,work,7,14,7
1193,3,shop,14,15,1
1193,4,work,15,19,4
1193,5,education,19,20,1
1193,6,home,20,24,4
1193,7,<ENDS>,24,24,0
1194,0,<START>,0,0,0
1194,1,home,0,7,7
1194,2,education,7,11,4
1194,3,home,11,18,7
1194,4,shop,18,19,1
1194,5,home,19,24,5
1194,6,<ENDS>,24,24,0
1195,0,<START>,0,0,0
1195,1,home,0,6,6
1195,2,work,6,12,6
1195,3,shop,12,13,1
1195,4,work,13,19,6
1195,5,home,19,24,5
1195,6,<ENDS>,24,24,0
1196,0,<START>,0,0,0
1196,1,home,0,6,6
1196,2,work,6,13,7
1196,3,home,13,24,11
1196,4,<ENDS>,24,24,0
1197,0,<START>,0,0,0
1197,1,home,0,8,8
1197,2,education,8,11,3
1197,3,home,11,14,3
1197,4,education,14,16,2
1197,5,home,16,24,8
1197,6,<ENDS>,24,24,0
1198,0,<START>,0,0,0
1198,1,home,0,7,7
1198,2,work,7,14,7
1198,3,home,14,24,10
1198,4,<ENDS>,24,24,0
1199,0,<START>,0,0,0
1199,1,home,0,7,7
1199,2,work,7,8,1
1199,3,home,8,9,1
1199,4,work,9,10,1
1199,5,home,10,15,5
1199,6,work,15,18,3
1199,7,home,18,21,3
1199,8,work,21,22,1
1199,9,home,22,24,2
1199,10,<ENDS>,24,24,0
1200,0,<START>,0,0,0
1200,1,home,0,6,6
1200,2,work,6,7,1
1200,3,home,7,13,6
1200,4,work,13,15,2
1200,5,home,15,21,6
1200,6,work,21,22,1
1200,7,home,22,24,2
1200,8,<ENDS>,24,24,0
1201,0,<START>,0,0,0
1201,1,home,0,7,7
1201,2,education,7,11,4
1201,3,home,11,14,3
1201,4,education,14,16,2
1201,5,home,16,20,4
1201,6,shop,20,21,1
1201,7,home,21,24,3
1201,8,<ENDS>,24,24,0
1202,0,<START>,0,0,0
1202,1,home,0,7,7
1202,2,shop,7,9,2
1202,3,education,9,14,5
1202,4,shop,14,15,1
1202,5,home,15,24,9
1202,6,<ENDS>,24,24,0
1203,0,<START>,0,0,0
1203,1,home,0,7,7
1203,2,work,7,14,7
1203,3,home,14,22,8
1203,4,work,22,23,1
1203,5,home,23,24,1
1203,6,<ENDS>,24,24,0
1204,0,<START>,0,0,0
1204,1,home,0,6,6
1204,2,work,6,8,2
1204,3,home,8,12,4
1204,4,shop,12,13,1
1204,5,work,13,15,2
1204,6,home,15,22,7
1204,7,work,22,23,1
1204,8,home,23,24,1
1204,9,<ENDS>,24,24,0
1205,0,<START>,0,0,0
1205,1,home,0,8,8
1205,2,work,8,15,7
1205,3,home,15,22,7
1205,4,work,22,23,1
1205,5,home,23,24,1
1205,6,<ENDS>,24,24,0
1206,0,<START>,0,0,0
1206,1,home,0,6,6
1206,2,shop,6,7,1
1206,3,home,7,10,3
1206,4,education,10,11,1
1206,5,home,11,19,8
1206,6,shop,19,20,1
1206,7,home,20,24,4
1206,8,<ENDS>,24,24,0
1207,0,<START>,0,0,0
1207,1,home,0,6,6
1207,2,shop,6,7,1
1207,3,home,7,10,3
1207,4,education,10,12,2
1207,5,home,12,19,7
1207,6,shop,19,20,1
1207,7,home,20,24,4
1207,8,<ENDS>,24,24,0
1208,0,<START>,0,0,0
1208,1,home,0,7,7
1208,2,work,7,13,6
1208,3,shop,13,14,1
1208,4,work,14,20,6
1208,5,home,20,24,4
1208,6,<ENDS>,24,24,0
1209,0,<START>,0,0,0
1209,1,home,0,7,7
1209,2,work,7,13,6
1209,3,home,13,15,2
1209,4,work,15,20,5
1209,5,home,20,24,4
1209,6,<ENDS>,24,24,0
1210,0,<START>,0,0,0
1210,1,home,0,7,7
1210,2,education,7,11,4
1210,3,home,11,14,3
1210,4,education,14,16,2
1210,5,home,16,24,8
1210,6,<ENDS>,24,24,0
1211,0,<START>,0,0,0
1211,1,home,0,7,7
1211,2,shop,7,8,1
1211,3,education,8,11,3
1211,4,home,11,18,7
1211,5,shop,18,19,1
1211,6,home,19,24,5
1211,7,<ENDS>,24,24,0
1212,0,<START>,0,0,0
1212,1,home,0,7,7
1212,2,work,7,14,7
1212,3,home,14,18,4
1212,4,shop,18,19,1
1212,5,home,19,23,4
1212,6,work,23,24,1
1212,7,<ENDS>,24,24,0
1213,0,<START>,0,0,0
1213,1,home,0,6,6
1213,2,shop,6,7,1
1213,3,home,7,10,3
1213,4,education,10,13,3
1213,5,shop,13,14,1
1213,6,education,14,16,2
1213,7,shop,16,17,1
1213,8,home,17,24,7
1213,9,<ENDS>,24,24,0
1214,0,<START>,0,0,0
1214,1,home,0,8,8
1214,2,work,8,13,5
1214,3,home,13,24,11
1214,4,<ENDS>,24,24,0
1215,0,<START>,0,0,0
1215,1,home,0,7,7
1215,2,education,7,10,3
1215,3,home,10,14,4
1215,4,education,14,16,2
1215,5,home,16,24,8
1215,6,<ENDS>,24,24,0
1216,0,<START>,0,0,0
1216,1,home,0,6,6
1216,2,work,6,13,7
1216,3,home,13,21,8
1216,4,work,21,22,1
1216,5,home,22,24,2
1216,6,<ENDS>,24,24,0
1217,0,<START>,0,0,0
1217,1,home,0,6,6
1217,2,work,6,8,2
1217,3,home,8,11,3
1217,4,work,11,13,2
1217,5,home,13,17,4
1217,6,work,17,19,2
1217,7,home,19,24,5
1217,8,<ENDS>,24,24,0
1218,0,<START>,0,0,0
1218,1,home,0,7,7
1218,2,shop,7,8,1
1218,3,home,8,9,1
1218,4,education,9,12,3
1218,5,work,12,19,7
1218,6,home,19,24,5
1218,7,<ENDS>,24,24,0
1219,0,<START>,0,0,0
1219,1,home,0,7,7
1219,2,work,7,13,6
1219,3,home,13,24,11
1219,4,<ENDS>,24,24,0
1220,0,<START>,0,0,0
1220,1,home,0,7,7
1220,2,shop,7,8,1
1220,3,home,8,14,6
1220,4,work,14,19,5
1220,5,home,19,24,5
1220,6,<ENDS>,24,24,0
1221,0,<START>,0,0,0
1221,1,home,0,7,7
1221,2,work,7,13,6
1221,3,home,13,16,3
1221,4,work,16,19,3
1221,5,home,19,24,5
1221,6,<ENDS>,24,24,0
1222,0,<START>,0,0,0
1222,1,home,0,8,8
1222,2,work,8,10,2
1222,3,home,10,13,3
1222,4,work,13,15,2
1222,5,home,15,21,6
1222,6,work,21,22,1
1222,7,home,22,24,2
1222,8,<ENDS>,24,24,0
1223,0,<START>,0,0,0
1223,1,home,0,7,7
1223,2,education,7,12,5
1223,3,shop,12,14,2
1223,4,home,14,21,7
1223,5,shop,21,22,1
1223,6,home,22,24,2
1223,7,<ENDS>,24,24,0
1224,0,<START>,0,0,0
1224,1,home,0,8,8
1224,2,work,8,14,6
1224,3,home,14,24,10
1224,4,<ENDS>,24,24,0
1225,0,<START>,0,0,0
1225,1,home,0,6,6
1225,2,work,6,13,7
1225,3,home,13,17,4
1225,4,shop,17,18,1
1225,5,home,18,23,5
1225,6,work,23,24,1
1225,7,<ENDS>,24,24,0
1226,0,<START>,0,0,0
1226,1,home,0,8,8
1226,2,work,8,15,7
1226,3,shop,15,16,1
1226,4,home,16,24,8
1226,5,<ENDS>,24,24,0
1227,0,<START>,0,0,0
1227,1,home,0,8,8
1227,2,work,8,14,6
1227,3,home,14,18,4
1227,4,work,18,20,2
1227,5,home,20,24,4
1227,6,<ENDS>,24,24,0
1228,0,<START>,0,0,0
1228,1,home,0,8,8
1228,2,education,8,11,3
1228,3,home,11,17,6
1228,4,work,17,20,3
1228,5,home,20,24,4
1228,6,<ENDS>,24,24,0
1229,0,<START>,0,0,0
1229,1,home,0,6,6
1229,2,shop,6,7,1
1229,3,home,7,13,6
1229,4,work,13,20,7
1229,5,home,20,24,4
1229,6,<ENDS>,24,24,0
1230,0,<START>,0,0,0
1230,1,home,0,7,7
1230,2,work,7,9,2
1230,3,home,9,14,5
1230,4,work,14,17,3
1230,5,home,17,23,6
1230,6,work,23,24,1
1230,7,<ENDS>,24,24,0
1231,0,<START>,0,0,0
1231,1,home,0,9,9
1231,2,work,9,16,7
1231,3,home,16,20,4
1231,4,shop,20,21,1
1231,5,home,21,24,3
1231,6,<ENDS>,24,24,0
1232,0,<START>,0,0,0
1232,1,home,0,7,7
1232,2,work,7,13,6
1232,3,shop,13,14,1
1232,4,home,14,24,10
1232,5,<ENDS>,24,24,0
1233,0,<START>,0,0,0
1233,1,home,0,6,6
1233,2,shop,6,7,1
1233,3,home,7,9,2
1233,4,education,9,12,3
1233,5,home,12,20,8
1233,6,shop,20,21,1
1233,7,home,21,24,3
1233,8,<ENDS>,24,24,0
1234,0,<START>,0,0,0
1234,1,home,0,8,8
1234,2,work,8,15,7
1234,3,home,15,24,9
1234,4,<ENDS>,24,24,0
1235,0,<START>,0,0,0
1235,1,home,0,8,8
1235,2,work,8,15,7
1235,3,home,15,23,8
1235,4,work,23,24,1
1235,5,<ENDS>,24,24,0
1236,0,<START>,0,0,0
1236,1,home,0,6,6
1236,2,work,6,8,2
1236,3,home,8,13,5
1236,4,work,13,16,3
1236,5,home,16,20,4
1236,6,shop,20,21,1
1236,7,home,21,24,3
1236,8,<ENDS>,24,24,0
1237,0,<START>,0,0,0
1237,1,home,0,6,6
1237,2,work,6,13,7
1237,3,shop,13,14,1
1237,4,home,14,15,1
1237,5,work,15,20,5
1237,6,home,20,24,4
1237,7,<ENDS>,24,24,0
1238,0,<START>,0,0,0
1238,1,home,0,7,7
1238,2,work,7,14,7
1238,3,shop,14,15,1
1238,4,home,15,24,9
1238,5,<ENDS>,24,24,0
1239,0,<START>,0,0,0
1239,1,home,0,8,8
1239,2,work,8,15,7
1239,3,shop,15,16,1
1239,4,work,16,19,3
1239,5,home,19,24,5
1239,6,<ENDS>,24,24,0
1240,0,<START>,0,0,0
1240,1,home,0,6,6
1240,2,work,6,13,7
1240,3,shop,13,14,1
1240,4,home,14,24,10
1240,5,<ENDS>,24,24,0
1241,0,<START>,0,0,0
1241,1,home,0,6,6
1241,2,shop,6,7,1
1241,3,home,7,10,3
1241,4,education,10,16,6
1241,5,home,16,24,8
1241,6,<ENDS>,24,24,0
1242,0,<START>,0,0,0
1242,1,home,0,7,7
1242,2,work,7,13,6
1242,3,home,13,24,11
1242,4,<ENDS>,24,24,0
1243,0,<START>,0,0,0
1243,1,home,0,8,8
1243,2,work,8,14,6
1243,3,home,14,22,8
1243,4,work,22,23,1
1243,5,home,23,24,1
1243,6,<ENDS>,24,24,0
1244,0,<START>,0,0,0
1244,1,home,0,8,8
1244,2,work,8,15,7
1244,3,home,15,24,9
1244,4,<ENDS>,24,24,0
1245,0,<START>,0,0,0
1245,1,home,0,7,7
1245,2,shop,7,8,1
1245,3,home,8,13,5
1245,4,work,13,19,6
1245,5,home,19,23,4
1245,6,work,23,24,1
1245,7,<ENDS>,24,24,0
1246,0,<START>,0,0,0
1246,1,home,0,6,6
1246,2,work,6,13,7
1246,3,shop,13,14,1
1246,4,home,14,23,9
1246,5,work,23,24,1
1246,6,<ENDS>,24,24,0
1247,0,<START>,0,0,0
1247,1,home,0,8,8
1247,2,work,8,15,7
1247,3,home,15,24,9
1247,4,<ENDS>,24,24,0
1248,0,<START>,0,0,0
1248,1,home,0,7,7
1248,2,work,7,14,7
1248,3,home,14,18,4
1248,4,work,18,20,2
1248,5,home,20,24,4
1248,6,<ENDS>,24,24,0
1249,0,<START>,0,0,0
1249,1,home,0,6,6
1249,2,shop,6,7,1
1249,3,home,7,10,3
1249,4,education,10,11,1
1249,5,home,11,18,7
1249,6,shop,18,19,1
1249,7,home,19,24,5
1249,8,<ENDS>,24,24,0
1250,0,<START>,0,0,0
1250,1,home,0,6,6
1250,2,work,6,13,7
1250,3,shop,13,14,1
1250,4,home,14,24,10
1250,5,<ENDS>,24,24,0
1251,0,<START>,0,0,0
1251,1,home,0,6,6
1251,2,work,6,8,2
1251,3,home,8,9,1
1251,4,work,9,11,2
1251,5,home,11,15,4
1251,6,work,15,18,3
1251,7,home,18,24,6
1251,8,<ENDS>,24,24,0
1252,0,<START>,0,0,0
1252,1,home,0,8,8
1252,2,work,8,14,6
1252,3,shop,14,15,1
1252,4,home,15,24,9
1252,5,<ENDS>,24,24,0
1253,0,<START>,0,0,0
1253,1,home,0,7,7
1253,2,shop,7,8,1
1253,3,education,8,11,3
1253,4,home,11,18,7
1253,5,shop,18,20,2
1253,6,home,20,24,4
1253,7,<ENDS>,24,24,0
1254,0,<START>,0,0,0
1254,1,home,0,6,6
1254,2,shop,6,7,1
1254,3,home,7,9,2
1254,4,education,9,12,3
1254,5,shop,12,14,2
1254,6,education,14,17,3
1254,7,home,17,24,7
1254,8,<ENDS>,24,24,0
1255,0,<START>,0,0,0
1255,1,home,0,6,6
1255,2,work,6,13,7
1255,3,shop,13,14,1
1255,4,home,14,21,7
1255,5,work,21,22,1
1255,6,home,22,24,2
1255,7,<ENDS>,24,24,0
1256,0,<START>,0,0,0
1256,1,home,0,6,6
1256,2,shop,6,8,2
1256,3,home,8,14,6
1256,4,work,14,20,6
1256,5,home,20,24,4
1256,6,<ENDS>,24,24,0
1257,0,<START>,0,0,0
1257,1,home,0,6,6
1257,2,shop,6,8,2
1257,3,work,8,15,7
1257,4,home,15,24,9
1257,5,<ENDS>,24,24,0
1258,0,<START>,0,0,0
1258,1,home,0,6,6
1258,2,work,6,8,2
1258,3,home,8,11,3
1258,4,work,11,12,1
1258,5,home,12,17,5
1258,6,work,17,19,2
1258,7,home,19,24,5
1258,8,<ENDS>,24,24,0
1259,0,<START>,0,0,0
1259,1,home,0,7,7
1259,2,work,7,13,6
1259,3,home,13,18,5
1259,4,shop,18,19,1
1259,5,home,19,24,5
1259,6,<ENDS>,24,24,0
1260,0,<START>,0,0,0
1260,1,home,0,7,7
1260,2,education,7,11,4
1260,3,home,11,18,7
1260,4,shop,18,19,1
1260,5,home,19,24,5
1260,6,<ENDS>,24,24,0
1261,0,<START>,0,0,0
1261,1,home,0,6,6
1261,2,work,6,13,7
1261,3,shop,13,14,1
1261,4,work,14,20,6
1261,5,home,20,24,4
1261,6,<ENDS>,24,24,0
1262,0,<START>,0,0,0
1262,1,home,0,6,6
1262,2,shop,6,7,1
1262,3,work,7,13,6
1262,4,shop,13,14,1
1262,5,work,14,20,6
1262,6,home,20,24,4
1262,7,<ENDS>,24,24,0
1263,0,<START>,0,0,0
1263,1,home,0,6,6
1263,2,work,6,12,6
1263,3,shop,12,13,1
1263,4,work,13,19,6
1263,5,education,19,20,1
1263,6,home,20,24,4
1263,7,<ENDS>,24,24,0
1264,0,<START>,0,0,0
1264,1,home,0,6,6
1264,2,shop,6,7,1
1264,3,home,7,10,3
1264,4,education,10,13,3
1264,5,home,13,21,8
1264,6,shop,21,22,1
1264,7,home,22,24,2
1264,8,<ENDS>,24,24,0
1265,0,<START>,0,0,0
1265,1,home,0,6,6
1265,2,shop,6,7,1
1265,3,work,7,13,6
1265,4,home,13,21,8
1265,5,work,21,22,1
1265,6,home,22,24,2
1265,7,<ENDS>,24,24,0
1266,0,<START>,0,0,0
1266,1,home,0,9,9
1266,2,work,9,15,6
1266,3,shop,15,16,1
1266,4,home,16,24,8
1266,5,<ENDS>,24,24,0
1267,0,<START>,0,0,0
1267,1,home,0,7,7
1267,2,work,7,10,3
1267,3,home,10,14,4
1267,4,work,14,16,2
1267,5,home,16,22,6
1267,6,work,22,23,1
1267,7,home,23,24,1
1267,8,<ENDS>,24,24,0
1268,0,<START>,0,0,0
1268,1,home,0,6,6
1268,2,work,6,13,7
1268,3,shop,13,14,1
1268,4,home,14,24,10
1268,5,<ENDS>,24,24,0
1269,0,<START>,0,0,0
1269,1,home,0,7,7
1269,2,work,7,14,7
1269,3,shop,14,15,1
1269,4,home,15,16,1
1269,5,work,16,20,4
1269,6,home,20,24,4
1269,7,<ENDS>,24,24,0
1270,0,<START>,0,0,0
1270,1,home,0,7,7
1270,2,work,7,14,7
1270,3,home,14,24,10
1270,4,<ENDS>,24,24,0
1271,0,<START>,0,0,0
1271,1,home,0,7,7
1271,2,work,7,9,2
1271,3,home,9,13,4
1271,4,work,13,15,2
1271,5,home,15,22,7
1271,6,work,22,23,1
1271,7,home,23,24,1
1271,8,<ENDS>,24,24,0
1272,0,<START>,0,0,0
1272,1,home,0,6,6
1272,2,shop,6,7,1
1272,3,home,7,11,4
1272,4,work,11,18,7
1272,5,home,18,24,6
1272,6,<ENDS>,24,24,0
1273,0,<START>,0,0,0
1273,1,home,0,8,8
1273,2,education,8,12,4
1273,3,home,12,16,4
1273,4,shop,16,18,2
1273,5,home,18,24,6
1273,6,<ENDS>,24,24,0
1274,0,<START>,0,0,0
1274,1,home,0,6,6
1274,2,work,6,8,2
1274,3,home,8,12,4
1274,4,work,12,13,1
1274,5,home,13,21,8
1274,6,work,21,22,1
1274,7,home,22,24,2
1274,8,<ENDS>,24,24,0
1275,0,<START>,0,0,0
1275,1,home,0,7,7
1275,2,work,7,14,7
1275,3,home,14,18,4
1275,4,shop,18,19,1
1275,5,home,19,24,5
1275,6,<ENDS>,24,24,0
1276,0,<START>,0,0,0
1276,1,home,0,7,7
1276,2,work,7,13,6
1276,3,home,13,22,9
1276,4,work,22,23,1
1276,5,home,23,24,1
1276,6,<ENDS>,24,24,0
1277,0,<START>,0,0,0
1277,1,home,0,6,6
1277,2,shop,6,7,1
1277,3,home,7,10,3
1277,4,education,10,12,2
1277,5,home,12,20,8
1277,6,shop,20,21,1
1277,7,home,21,24,3
1277,8,<ENDS>,24,24,0
1278,0,<START>,0,0,0
1278,1,home,0,7,7
1278,2,work,7,13,6
1278,3,home,13,17,4
1278,4,work,17,20,3
1278,5,home,20,24,4
1278,6,<ENDS>,24,24,0
1279,0,<START>,0,0,0
1279,1,home,0,6,6
1279,2,shop,6,7,1
1279,3,home,7,9,2
1279,4,education,9,12,3
1279,5,work,12,19,7
1279,6,home,19,24,5
1279,7,<ENDS>,24,24,0
1280,0,<START>,0,0,0
1280,1,home,0,7,7
1280,2,work,7,13,6
1280,3,shop,13,14,1
1280,4,home,14,24,10
1280,5,<ENDS>,24,24,0
1281,0,<START>,0,0,0
1281,1,home,0,7,7
1281,2,work,7,13,6
1281,3,home,13,22,9
1281,4,work,22,23,1
1281,5,home,23,24,1
1281,6,<ENDS>,24,24,0
1282,0,<START>,0,0,0
1282,1,home,0,7,7
1282,2,work,7,14,7
1282,3,home,14,23,9
1282,4,work,23,24,1
1282,5,<ENDS>,24,24,0
1283,0,<START>,0,0,0
1283,1,home,0,7,7
1283,2,work,7,9,2
1283,3,home,9,13,4
1283,4,work,13,15,2
1283,5,home,15,22,7
1283,6,work,22,23,1
1283,7,home,23,24,1
1283,8,<ENDS>,24,24,0
1284,0,<START>,0,0,0
1284,1,home,0,8,8
1284,2,work,8,15,7
1284,3,home,15,24,9
1284,4,<ENDS>,24,24,0
1285,0,<START>,0,0,0
1285,1,home,0,6,6
1285,2,work,6,13,7
1285,3,home,13,24,11
1285,4,<ENDS>,24,24,0
1286,0,<START>,0,0,0
1286,1,home,0,7,7
1286,2,work,7,14,7
1286,3,home,14,24,10
1286,4,<ENDS>,24,24,0
1287,0,<START>,0,0,0
1287,1,home,0,6,6
1287,2,work,6,13,7
1287,3,home,13,21,8
1287,4,work,21,22,1
1287,5,home,22,24,2
1287,6,<ENDS>,24,24,0
1288,0,<START>,0,0,0
1288,1,home,0,8,8
1288,2,work,8,14,6
1288,3,home,14,24,10
1288,4,<ENDS>,24,24,0
1289,0,<START>,0,0,0
1289,1,home,0,8,8
1289,2,education,8,12,4
1289,3,shop,12,13,1
1289,4,work,13,20,7
1289,5,home,20,24,4
1289,6,<ENDS>,24,24,0
1290,0,<START>,0,0,0
1290,1,home,0,6,6
1290,2,work,6,13,7
1290,3,home,13,24,11
1290,4,<ENDS>,24,24,0
1291,0,<START>,0,0,0
1291,1,home,0,6,6
1291,2,work,6,13,7
1291,3,shop,13,14,1
1291,4,work,14,19,5
1291,5,home,19,24,5
1291,6,<ENDS>,24,24,0
1292,0,<START>,0,0,0
1292,1,home,0,7,7
1292,2,work,7,13,6
1292,3,home,13,18,5
1292,4,shop,18,19,1
1292,5,home,19,24,5
1292,6,<ENDS>,24,24,0
1293,0,<START>,0,0,0
1293,1,home,0,6,6
1293,2,work,6,8,2
1293,3,home,8,9,1
1293,4,work,9,11,2
1293,5,home,11,16,5
1293,6,work,16,17,1
1293,7,home,17,24,7
1293,8,<ENDS>,24,24,0
1294,0,<START>,0,0,0
1294,1,home,0,8,8
1294,2,work,8,14,6
1294,3,home,14,21,7
1294,4,work,21,22,1
1294,5,home,22,24,2
1294,6,<ENDS>,24,24,0
1295,0,<START>,0,0,0
1295,1,home,0,7,7
1295,2,work,7,14,7
1295,3,home,14,24,10
1295,4,<ENDS>,24,24,0
1296,0,<START>,0,0,0
1296,1,home,0,7,7
1296,2,work,7,13,6
1296,3,home,13,21,8
1296,4,work,21,22,1
1296,5,home,22,24,2
1296,6,<ENDS>,24,24,0
1297,0,<START>,0,0,0
1297,1,home,0,7,7
1297,2,work,7,13,6
1297,3,shop,13,14,1
1297,4,work,14,20,6
1297,5,home,20,24,4
1297,6,<ENDS>,24,24,0
1298,0,<START>,0,0,0
1298,1,home,0,6,6
1298,2,shop,6,7,1
1298,3,home,7,13,6
1298,4,education,13,16,3
1298,5,home,16,24,8
1298,6,<ENDS>,24,24,0
1299,0,<START>,0,0,0
1299,1,home,0,6,6
1299,2,work,6,8,2
1299,3,home,8,13,5
1299,4,education,13,15,2
1299,5,work,15,17,2
1299,6,home,17,24,7
1299,7,<ENDS>,24,24,0
1300,0,<START>,0,0,0
1300,1,home,0,6,6
1300,2,work,6,7,1
1300,3,home,7,12,5
1300,4,work,12,15,3
1300,5,shop,15,16,1
1300,6,work,16,18,2
1300,7,home,18,24,6
1300,8,<ENDS>,24,24,0
1301,0,<START>,0,0,0
1301,1,home,0,6,6
1301,2,work,6,13,7
1301,3,home,13,17,4
1301,4,work,17,20,3
1301,5,home,20,24,4
1301,6,<ENDS>,24,24,0
1302,0,<START>,0,0,0
1302,1,home,0,6,6
1302,2,shop,6,7,1
1302,3,home,7,10,3
1302,4,education,10,12,2
1302,5,shop,12,14,2
1302,6,education,14,16,2
1302,7,home,16,24,8
1302,8,<ENDS>,24,24,0
1303,0,<START>,0,0,0
1303,1,home,0,7,7
1303,2,work,7,10,3
1303,3,home,10,14,4
1303,4,work,14,16,2
1303,5,home,16,21,5
1303,6,work,21,22,1
1303,7,home,22,24,2
1303,8,<ENDS>,24,24,0
1304,0,<START>,0,0,0
1304,1,home,0,7,7
1304,2,shop,7,8,1
1304,3,education,8,11,3
1304,4,home,11,18,7
1304,5,shop,18,19,1
1304,6,home,19,24,5
1304,7,<ENDS>,24,24,0
1305,0,<START>,0,0,0
1305,1,home,0,6,6
1305,2,work,6,13,7
1305,3,shop,13,14,1
1305,4,home,14,24,10
1305,5,<ENDS>,24,24,0
1306,0,<START>,0,0,0
1306,1,home,0,7,7
1306,2,work,7,13,6
1306,3,home,13,23,10
1306,4,work,23,24,1
1306,5,<ENDS>,24,24,0
1307,0,<START>,0,0,0
1307,1,home,0,8,8
1307,2,work,8,14,6
1307,3,home,14,23,9
1307,4,work,23,24,1
1307,5,<ENDS>,24,24,0
1308,0,<START>,0,0,0
1308,1,home,0,8,8
1308,2,work,8,15,7
1308,3,home,15,24,9
1308,4,<ENDS>,24,24,0
1309,0,<START>,0,0,0
1309,1,home,0,8,8
1309,2,work,8,15,7
1309,3,shop,15,16,1
1309,4,home,16,24,8
1309,5,<ENDS>,24,24,0
1310,0,<START>,0,0,0
1310,1,home,0,9,9
1310,2,education,9,11,2
1310,3,home,11,15,4
1310,4,work,15,20,5
1310,5,home,20,24,4
1310,6,<ENDS>,24,24,0
1311,0,<START>,0,0,0
1311,1,home,0,7,7
1311,2,education,7,11,4
1311,3,home,11,19,8
1311,4,shop,19,20,1
1311,5,home,20,24,4
1311,6,<ENDS>,24,24,0
1312,0,<START>,0,0,0
1312,1,home,0,7,7
1312,2,work,7,13,6
1312,3,home,13,17,4
1312,4,work,17,20,3
1312,5,home,20,24,4
1312,6,<ENDS>,24,24,0
1313,0,<START>,0,0,0
1313,1,home,0,6,6
1313,2,shop,6,7,1
1313,3,home,7,10,3
1313,4,education,10,11,1
1313,5,home,11,18,7
1313,6,shop,18,19,1
1313,7,home,19,24,5
1313,8,<ENDS>,24,24,0
1314,0,<START>,0,0,0
1314,1,home,0,9,9
1314,2,work,9,16,7
1314,3,shop,16,17,1
1314,4,home,17,24,7
1314,5,<ENDS>,24,24,0
1315,0,<START>,0,0,0
1315,1,home,0,9,9
1315,2,work,9,17,8
1315,3,home,17,24,7
1315,4,<ENDS>,24,24,0
1316,0,<START>,0,0,0
1316,1,home,0,6,6
1316,2,shop,6,7,1
1316,3,home,7,10,3
1316,4,education,10,12,2
1316,5,shop,12,14,2
1316,6,education,14,15,1
1316,7,shop,15,16,1
1316,8,home,16,20,4
1316,9,shop,20,21,1
1316,10,home,21,24,3
1316,11,<ENDS>,24,24,0
1317,0,<START>,0,0,0
1317,1,home,0,6,6
1317,2,shop,6,7,1
1317,3,home,7,13,6
1317,4,education,13,16,3
1317,5,home,16,24,8
1317,6,<ENDS>,24,24,0
1318,0,<START>,0,0,0
1318,1,home,0,6,6
1318,2,shop,6,7,1
1318,3,home,7,9,2
1318,4,work,9,16,7
1318,5,home,16,23,7
1318,6,work,23,24,1
1318,7,<ENDS>,24,24,0
1319,0,<START>,0,0,0
1319,1,home,0,7,7
1319,2,work,7,14,7
1319,3,shop,14,15,1
1319,4,work,15,20,5
1319,5,home,20,24,4
1319,6,<ENDS>,24,24,0
1320,0,<START>,0,0,0
1320,1,home,0,7,7
1320,2,shop,7,8,1
1320,3,education,8,11,3
1320,4,home,11,15,4
1320,5,shop,15,16,1
1320,6,home,16,24,8
1320,7,<ENDS>,24,24,0
1321,0,<START>,0,0,0
1321,1,home,0,7,7
1321,2,work,7,8,1
1321,3,home,8,14,6
1321,4,work,14,16,2
1321,5,home,16,23,7
1321,6,work,23,24,1
1321,7,<ENDS>,24,24,0
1322,0,<START>,0,0,0
1322,1,home,0,8,8
1322,2,work,8,15,7
1322,3,shop,15,16,1
1322,4,home,16,21,5
1322,5,work,21,22,1
1322,6,home,22,24,2
1322,7,<ENDS>,24,24,0
1323,0,<START>,0,0,0
1323,1,home,0,7,7
1323,2,work,7,13,6
1323,3,home,13,17,4
1323,4,work,17,20,3
1323,5,home,20,24,4
1323,6,<ENDS>,24,24,0
1324,0,<START>,0,0,0
1324,1,home,0,6,6
1324,2,work,6,13,7
1324,3,home,13,22,9
1324,4,work,22,23,1
1324,5,home,23,24,1
1324,6,<ENDS>,24,24,0
1325,0,<START>,0,0,0
1325,1,home,0,7,7
1325,2,work,7,9,2
1325,3,home,9,15,6
1325,4,work,15,18,3
1325,5,home,18,22,4
1325,6,work,22,23,1
1325,7,home,23,24,1
1325,8,<ENDS>,24,24,0
1326,0,<START>,0,0,0
1326,1,home,0,6,6
1326,2,work,6,13,7
1326,3,home,13,17,4
1326,4,work,17,20,3
1326,5,home,20,24,4
1326,6,<ENDS>,24,24,0
1327,0,<START>,0,0,0
1327,1,home,0,7,7
1327,2,education,7,11,4
1327,3,home,11,18,7
1327,4,shop,18,19,1
1327,5,home,19,24,5
1327,6,<ENDS>,24,24,0
1328,0,<START>,0,0,0
1328,1,home,0,6,6
1328,2,work,6,8,2
1328,3,home,8,14,6
1328,4,work,14,16,2
1328,5,home,16,23,7
1328,6,work,23,24,1
1328,7,<ENDS>,24,24,0
1329,0,<START>,0,0,0
1329,1,home,0,8,8
1329,2,work,8,15,7
1329,3,home,15,24,9
1329,4,<ENDS>,24,24,0
1330,0,<START>,0,0,0
1330,1,home,0,7,7
1330,2,work,7,13,6
1330,3,home,13,18,5
1330,4,work,18,20,2
1330,5,home,20,24,4
1330,6,<ENDS>,24,24,0
1331,0,<START>,0,0,0
1331,1,home,0,8,8
1331,2,work,8,14,6
1331,3,home,14,24,10
1331,4,<ENDS>,24,24,0
1332,0,<START>,0,0,0
1332,1,home,0,8,8
1332,2,work,8,14,6
1332,3,shop,14,15,1
1332,4,work,15,20,5
1332,5,home,20,24,4
1332,6,<ENDS>,24,24,0
1333,0,<START>,0,0,0
1333,1,home,0,6,6
1333,2,work,6,8,2
1333,3,home,8,14,6
1333,4,work,14,17,3
1333,5,home,17,23,6
1333,6,work,23,24,1
1333,7,<ENDS>,24,24,0
1334,0,<START>,0,0,0
1334,1,home,0,8,8
1334,2,work,8,15,7
1334,3,home,15,19,4
1334,4,shop,19,20,1
1334,5,home,20,24,4
1334,6,<ENDS>,24,24,0
1335,0,<START>,0,0,0
1335,1,home,0,8,8
1335,2,work,8,15,7
1335,3,home,15,16,1
1335,4,work,16,19,3
1335,5,home,19,24,5
1335,6,<ENDS>,24,24,0
1336,0,<START>,0,0,0
1336,1,home,0,6,6
1336,2,work,6,13,7
1336,3,home,13,24,11
1336,4,<ENDS>,24,24,0
1337,0,<START>,0,0,0
1337,1,home,0,6,6
1337,2,work,6,8,2
1337,3,home,8,9,1
1337,4,work,9,10,1
1337,5,home,10,14,4
1337,6,work,14,17,3
1337,7,home,17,23,6
1337,8,work,23,24,1
1337,9,<ENDS>,24,24,0
1338,0,<START>,0,0,0
1338,1,home,0,7,7
1338,2,education,7,11,4
1338,3,home,11,18,7
1338,4,shop,18,19,1
1338,5,home,19,24,5
1338,6,<ENDS>,24,24,0
1339,0,<START>,0,0,0
1339,1,home,0,6,6
1339,2,work,6,13,7
1339,3,home,13,17,4
1339,4,work,17,20,3
1339,5,home,20,24,4
1339,6,<ENDS>,24,24,0
1340,0,<START>,0,0,0
1340,1,home,0,7,7
1340,2,work,7,13,6
1340,3,home,13,17,4
1340,4,shop,17,18,1
1340,5,home,18,24,6
1340,6,<ENDS>,24,24,0
1341,0,<START>,0,0,0
1341,1,home,0,7,7
1341,2,shop,7,8,1
1341,3,work,8,15,7
1341,4,home,15,23,8
1341,5,work,23,24,1
1341,6,<ENDS>,24,24,0
1342,0,<START>,0,0,0
1342,1,home,0,6,6
1342,2,shop,6,7,1
1342,3,home,7,13,6
1342,4,education,13,16,3
1342,5,home,16,24,8
1342,6,<ENDS>,24,24,0
1343,0,<START>,0,0,0
1343,1,home,0,7,7
1343,2,work,7,13,6
1343,3,home,13,15,2
1343,4,work,15,20,5
1343,5,home,20,24,4
1343,6,<ENDS>,24,24,0
1344,0,<START>,0,0,0
1344,1,home,0,6,6
1344,2,shop,6,7,1
1344,3,work,7,13,6
1344,4,home,13,21,8
1344,5,work,21,22,1
1344,6,home,22,24,2
1344,7,<ENDS>,24,24,0
1345,0,<START>,0,0,0
1345,1,home,0,7,7
1345,2,work,7,14,7
1345,3,shop,14,15,1
1345,4,home,15,21,6
1345,5,work,21,22,1
1345,6,home,22,24,2
1345,7,<ENDS>,24,24,0
1346,0,<START>,0,0,0
1346,1,home,0,7,7
1346,2,shop,7,8,1
1346,3,work,8,14,6
1346,4,home,14,24,10
1346,5,<ENDS>,24,24,0
1347,0,<START>,0,0,0
1347,1,home,0,7,7
1347,2,work,7,14,7
1347,3,shop,14,15,1
1347,4,home,15,24,9
1347,5,<ENDS>,24,24,0
1348,0,<START>,0,0,0
1348,1,home,0,7,7
1348,2,education,7,11,4
1348,3,home,11,19,8
1348,4,shop,19,20,1
1348,5,home,20,24,4
1348,6,<ENDS>,24,24,0
1349,0,<START>,0,0,0
1349,1,home,0,8,8
1349,2,work,8,13,5
1349,3,shop,13,14,1
1349,4,home,14,24,10
1349,5,<ENDS>,24,24,0
1350,0,<START>,0,0,0
1350,1,home,0,7,7
1350,2,work,7,13,6
1350,3,shop,13,14,1
1350,4,home,14,24,10
1350,5,<ENDS>,24,24,0
1351,0,<START>,0,0,0
1351,1,home,0,6,6
1351,2,work,6,12,6
1351,3,shop,12,13,1
1351,4,work,13,19,6
1351,5,home,19,24,5
1351,6,<ENDS>,24,24,0
1352,0,<START>,0,0,0
1352,1,home,0,8,8
1352,2,work,8,14,6
1352,3,shop,14,15,1
1352,4,home,15,24,9
1352,5,<ENDS>,24,24,0
1353,0,<START>,0,0,0
1353,1,home,0,6,6
1353,2,work,6,8,2
1353,3,home,8,13,5
1353,4,work,13,15,2
1353,5,home,15,23,8
1353,6,work,23,24,1
1353,7,<ENDS>,24,24,0
1354,0,<START>,0,0,0
1354,1,home,0,7,7
1354,2,work,7,14,7
1354,3,home,14,24,10
1354,4,<ENDS>,24,24,0
1355,0,<START>,0,0,0
1355,1,home,0,6,6
1355,2,work,6,8,2
1355,3,home,8,12,4
1355,4,work,12,14,2
1355,5,home,14,21,7
1355,6,work,21,22,1
1355,7,home,22,24,2
1355,8,<ENDS>,24,24,0
1356,0,<START>,0,0,0
1356,1,home,0,8,8
1356,2,work,8,15,7
1356,3,shop,15,17,2
1356,4,home,17,23,6
1356,5,work,23,24,1
1356,6,<ENDS>,24,24,0
1357,0,<START>,0,0,0
1357,1,home,0,6,6
1357,2,work,6,13,7
1357,3,home,13,24,11
1357,4,<ENDS>,24,24,0
1358,0,<START>,0,0,0
1358,1,home,0,6,6
1358,2,work,6,7,1
1358,3,home,7,10,3
1358,4,work,10,11,1
1358,5,home,11,16,5
1358,6,work,16,17,1
1358,7,home,17,24,7
1358,8,<ENDS>,24,24,0
1359,0,<START>,0,0,0
1359,1,home,0,6,6
1359,2,shop,6,7,1
1359,3,work,7,15,8
1359,4,home,15,22,7
1359,5,work,22,23,1
1359,6,home,23,24,1
1359,7,<ENDS>,24,24,0
1360,0,<START>,0,0,0
1360,1,home,0,8,8
1360,2,work,8,15,7
1360,3,shop,15,16,1
1360,4,home,16,24,8
1360,5,<ENDS>,24,24,0
1361,0,<START>,0,0,0
1361,1,home,0,8,8
1361,2,shop,8,9,1
1361,3,work,9,16,7
1361,4,home,16,20,4
1361,5,shop,20,21,1
1361,6,home,21,24,3
1361,7,<ENDS>,24,24,0
1362,0,<START>,0,0,0
1362,1,home,0,6,6
1362,2,work,6,13,7
1362,3,home,13,17,4
1362,4,work,17,20,3
1362,5,home,20,24,4
1362,6,<ENDS>,24,24,0
1363,0,<START>,0,0,0
1363,1,home,0,8,8
1363,2,work,8,15,7
1363,3,home,15,24,9
1363,4,<ENDS>,24,24,0
1364,0,<START>,0,0,0
1364,1,home,0,6,6
1364,2,shop,6,7,1
1364,3,home,7,13,6
1364,4,education,13,15,2
1364,5,shop,15,16,1
1364,6,home,16,24,8
1364,7,<ENDS>,24,24,0
1365,0,<START>,0,0,0
1365,1,home,0,6,6
1365,2,shop,6,7,1
1365,3,home,7,9,2
1365,4,work,9,17,8
1365,5,home,17,24,7
1365,6,<ENDS>,24,24,0
1366,0,<START>,0,0,0
1366,1,home,0,7,7
1366,2,work,7,14,7
1366,3,shop,14,15,1
1366,4,home,15,24,9
1366,5,<ENDS>,24,24,0
1367,0,<START>,0,0,0
1367,1,home,0,7,7
1367,2,shop,7,9,2
1367,3,education,9,12,3
1367,4,shop,12,14,2
1367,5,education,14,16,2
1367,6,home,16,24,8
1367,7,<ENDS>,24,24,0
1368,0,<START>,0,0,0
1368,1,home,0,6,6
1368,2,shop,6,7,1
1368,3,home,7,10,3
1368,4,education,10,13,3
1368,5,home,13,24,11
1368,6,<ENDS>,24,24,0
1369,0,<START>,0,0,0
1369,1,home,0,8,8
1369,2,work,8,15,7
1369,3,shop,15,16,1
1369,4,work,16,20,4
1369,5,home,20,24,4
1369,6,<ENDS>,24,24,0
1370,0,<START>,0,0,0
1370,1,home,0,7,7
1370,2,work,7,14,7
1370,3,home,14,24,10
1370,4,<ENDS>,24,24,0
1371,0,<START>,0,0,0
1371,1,home,0,7,7
1371,2,work,7,13,6
1371,3,shop,13,14,1
1371,4,home,14,24,10
1371,5,<ENDS>,24,24,0
1372,0,<START>,0,0,0
1372,1,home,0,6,6
1372,2,work,6,13,7
1372,3,home,13,24,11
1372,4,<ENDS>,24,24,0
1373,0,<START>,0,0,0
1373,1,home,0,7,7
1373,2,education,7,11,4
1373,3,home,11,17,6
1373,4,shop,17,19,2
1373,5,home,19,24,5
1373,6,<ENDS>,24,24,0
1374,0,<START>,0,0,0
1374,1,home,0,7,7
1374,2,education,7,11,4
1374,3,home,11,20,9
1374,4,shop,20,21,1
1374,5,home,21,24,3
1374,6,<ENDS>,24,24,0
1375,0,<START>,0,0,0
1375,1,home,0,7,7
1375,2,education,7,11,4
1375,3,home,11,14,3
1375,4,education,14,16,2
1375,5,shop,16,17,1
1375,6,home,17,24,7
1375,7,<ENDS>,24,24,0
1376,0,<START>,0,0,0
1376,1,home,0,9,9
1376,2,shop,9,10,1
1376,3,work,10,17,7
1376,4,home,17,21,4
1376,5,work,21,22,1
1376,6,home,22,24,2
1376,7,<ENDS>,24,24,0
1377,0,<START>,0,0,0
1377,1,home,0,7,7
1377,2,education,7,11,4
1377,3,home,11,13,2
1377,4,education,13,16,3
1377,5,home,16,21,5
1377,6,shop,21,22,1
1377,7,home,22,24,2
1377,8,<ENDS>,24,24,0
1378,0,<START>,0,0,0
1378,1,home,0,6,6
1378,2,work,6,13,7
1378,3,shop,13,14,1
1378,4,work,14,20,6
1378,5,home,20,24,4
1378,6,<ENDS>,24,24,0
1379,0,<START>,0,0,0
1379,1,home,0,7,7
1379,2,work,7,14,7
1379,3,shop,14,15,1
1379,4,home,15,24,9
1379,5,<ENDS>,24,24,0
1380,0,<START>,0,0,0
1380,1,home,0,7,7
1380,2,work,7,9,2
1380,3,home,9,12,3
1380,4,work,12,13,1
1380,5,home,13,21,8
1380,6,work,21,22,1
1380,7,home,22,24,2
1380,8,<ENDS>,24,24,0
1381,0,<START>,0,0,0
1381,1,home,0,6,6
1381,2,shop,6,7,1
1381,3,work,7,14,7
1381,4,home,14,18,4
1381,5,work,18,20,2
1381,6,home,20,24,4
1381,7,<ENDS>,24,24,0
1382,0,<START>,0,0,0
1382,1,home,0,7,7
1382,2,work,7,14,7
1382,3,home,14,20,6
1382,4,shop,20,21,1
1382,5,home,21,24,3
1382,6,<ENDS>,24,24,0
1383,0,<START>,0,0,0
1383,1,home,0,8,8
1383,2,work,8,13,5
1383,3,shop,13,14,1
1383,4,home,14,24,10
1383,5,<ENDS>,24,24,0
1384,0,<START>,0,0,0
1384,1,home,0,6,6
1384,2,work,6,13,7
1384,3,shop,13,14,1
1384,4,education,14,17,3
1384,5,home,17,24,7
1384,6,<ENDS>,24,24,0
1385,0,<START>,0,0,0
1385,1,home,0,6,6
1385,2,work,6,7,1
1385,3,home,7,13,6
1385,4,work,13,15,2
1385,5,home,15,21,6
1385,6,work,21,22,1
1385,7,home,22,24,2
1385,8,<ENDS>,24,24,0
1386,0,<START>,0,0,0
1386,1,home,0,7,7
1386,2,work,7,13,6
1386,3,shop,13,14,1
1386,4,home,14,17,3
1386,5,work,17,20,3
1386,6,home,20,24,4
1386,7,<ENDS>,24,24,0
1387,0,<START>,0,0,0
1387,1,home,0,6,6
1387,2,work,6,13,7
1387,3,shop,13,14,1
1387,4,work,14,19,5
1387,5,home,19,24,5
1387,6,<ENDS>,24,24,0
1388,0,<START>,0,0,0
1388,1,home,0,7,7
1388,2,education,7,11,4
1388,3,home,11,19,8
1388,4,shop,19,20,1
1388,5,home,20,24,4
1388,6,<ENDS>,24,24,0
1389,0,<START>,0,0,0
1389,1,home,0,7,7
1389,2,work,7,13,6
1389,3,shop,13,14,1
1389,4,work,14,20,6
1389,5,home,20,24,4
1389,6,<ENDS>,24,24,0
1390,0,<START>,0,0,0
1390,1,home,0,7,7
1390,2,education,7,11,4
1390,3,home,11,19,8
1390,4,shop,19,20,1
1390,5,home,20,24,4
1390,6,<ENDS>,24,24,0
1391,0,<START>,0,0,0
1391,1,home,0,7,7
1391,2,work,7,16,9
1391,3,home,16,24,8
1391,4,<ENDS>,24,24,0
1392,0,<START>,0,0,0
1392,1,home,0,9,9
1392,2,work,9,16,7
1392,3,home,16,24,8
1392,4,<ENDS>,24,24,0
1393,0,<START>,0,0,0
1393,1,home,0,6,6
1393,2,work,6,13,7
1393,3,shop,13,14,1
1393,4,home,14,24,10
1393,5,<ENDS>,24,24,0
1394,0,<START>,0,0,0
1394,1,home,0,7,7
1394,2,work,7,15,8
1394,3,home,15,18,3
1394,4,shop,18,19,1
1394,5,home,19,24,5
1394,6,<ENDS>,24,24,0
1395,0,<START>,0,0,0
1395,1,home,0,9,9
1395,2,work,9,15,6
1395,3,home,15,20,5
1395,4,shop,20,21,1
1395,5,home,21,24,3
1395,6,<ENDS>,24,24,0
1396,0,<START>,0,0,0
1396,1,home,0,8,8
1396,2,work,8,15,7
1396,3,home,15,23,8
1396,4,work,23,24,1
1396,5,<ENDS>,24,24,0
1397,0,<START>,0,0,0
1397,1,home,0,8,8
1397,2,work,8,15,7
1397,3,home,15,19,4
1397,4,shop,19,20,1
1397,5,home,20,24,4
1397,6,<ENDS>,24,24,0
1398,0,<START>,0,0,0
1398,1,home,0,6,6
1398,2,work,6,8,2
1398,3,home,8,14,6
1398,4,work,14,16,2
1398,5,home,16,23,7
1398,6,work,23,24,1
1398,7,<ENDS>,24,24,0
1399,0,<START>,0,0,0
1399,1,home,0,8,8
1399,2,education,8,11,3
1399,3,home,11,17,6
1399,4,shop,17,18,1
1399,5,home,18,24,6
1399,6,<ENDS>,24,24,0
1400,0,<START>,0,0,0
1400,1,home,0,8,8
1400,2,work,8,16,8
1400,3,home,16,22,6
1400,4,work,22,23,1
1400,5,home,23,24,1
1400,6,<ENDS>,24,24,0
1401,0,<START>,0,0,0
1401,1,home,0,7,7
1401,2,work,7,14,7
1401,3,home,14,21,7
1401,4,work,21,22,1
1401,5,home,22,24,2
1401,6,<ENDS>,24,24,0
1402,0,<START>,0,0,0
1402,1,home,0,7,7
1402,2,shop,7,8,1
1402,3,work,8,14,6
1402,4,shop,14,15,1
1402,5,work,15,19,4
1402,6,home,19,24,5
1402,7,<ENDS>,24,24,0
1403,0,<START>,0,0,0
1403,1,home,0,6,6
1403,2,shop,6,7,1
1403,3,home,7,10,3
1403,4,education,10,12,2
1403,5,shop,12,14,2
1403,6,home,14,20,6
1403,7,shop,20,21,1
1403,8,home,21,24,3
1403,9,<ENDS>,24,24,0
1404,0,<START>,0,0,0
1404,1,home,0,7,7
1404,2,work,7,13,6
1404,3,home,13,24,11
1404,4,<ENDS>,24,24,0
1405,0,<START>,0,0,0
1405,1,home,0,6,6
1405,2,shop,6,7,1
1405,3,home,7,10,3
1405,4,education,10,13,3
1405,5,shop,13,15,2
1405,6,home,15,24,9
1405,7,<ENDS>,24,24,0
1406,0,<START>,0,0,0
1406,1,home,0,9,9
1406,2,work,9,13,4
1406,3,home,13,24,11
1406,4,<ENDS>,24,24,0
1407,0,<START>,0,0,0
1407,1,home,0,8,8
1407,2,work,8,15,7
1407,3,shop,15,16,1
1407,4,work,16,20,4
1407,5,home,20,24,4
1407,6,<ENDS>,24,24,0
1408,0,<START>,0,0,0
1408,1,home,0,7,7
1408,2,work,7,13,6
1408,3,home,13,23,10
1408,4,work,23,24,1
1408,5,<ENDS>,24,24,0
1409,0,<START>,0,0,0
1409,1,home,0,7,7
1409,2,work,7,14,7
1409,3,shop,14,15,1
1409,4,work,15,20,5
1409,5,home,20,24,4
1409,6,<ENDS>,24,24,0
1410,0,<START>,0,0,0
1410,1,home,0,6,6
1410,2,shop,6,7,1
1410,3,home,7,13,6
1410,4,education,13,16,3
1410,5,home,16,24,8
1410,6,<ENDS>,24,24,0
1411,0,<START>,0,0,0
1411,1,home,0,7,7
1411,2,work,7,13,6
1411,3,home,13,21,8
1411,4,work,21,22,1
1411,5,home,22,24,2
1411,6,<ENDS>,24,24,0
1412,0,<START>,0,0,0
1412,1,home,0,6,6
1412,2,work,6,8,2
1412,3,home,8,15,7
1412,4,work,15,18,3
1412,5,home,18,22,4
1412,6,work,22,23,1
1412,7,home,23,24,1
1412,8,<ENDS>,24,24,0
1413,0,<START>,0,0,0
1413,1,home,0,7,7
1413,2,work,7,13,6
1413,3,home,13,23,10
1413,4,work,23,24,1
1413,5,<ENDS>,24,24,0
1414,0,<START>,0,0,0
1414,1,home,0,6,6
1414,2,work,6,13,7
1414,3,home,13,21,8
1414,4,work,21,22,1
1414,5,home,22,24,2
1414,6,<ENDS>,24,24,0
1415,0,<START>,0,0,0
1415,1,home,0,7,7
1415,2,work,7,13,6
1415,3,shop,13,14,1
1415,4,work,14,17,3
1415,5,home,17,24,7
1415,6,<ENDS>,24,24,0
1416,0,<START>,0,0,0
1416,1,home,0,6,6
1416,2,shop,6,7,1
1416,3,home,7,10,3
1416,4,education,10,13,3
1416,5,shop,13,15,2
1416,6,home,15,24,9
1416,7,<ENDS>,24,24,0
1417,0,<START>,0,0,0
1417,1,home,0,7,7
1417,2,work,7,14,7
1417,3,shop,14,16,2
1417,4,home,16,24,8
1417,5,<ENDS>,24,24,0
1418,0,<START>,0,0,0
1418,1,home,0,8,8
1418,2,work,8,14,6
1418,3,home,14,23,9
1418,4,work,23,24,1
1418,5,<ENDS>,24,24,0
1419,0,<START>,0,0,0
1419,1,home,0,8,8
1419,2,work,8,15,7
1419,3,shop,15,16,1
1419,4,work,16,20,4
1419,5,home,20,24,4
1419,6,<ENDS>,24,24,0
1420,0,<START>,0,0,0
1420,1,home,0,7,7
1420,2,work,7,13,6
1420,3,shop,13,14,1
1420,4,work,14,19,5
1420,5,home,19,24,5
1420,6,<ENDS>,24,24,0
1421,0,<START>,0,0,0
1421,1,home,0,6,6
1421,2,shop,6,7,1
1421,3,home,7,9,2
1421,4,education,9,12,3
1421,5,home,12,19,7
1421,6,shop,19,20,1
1421,7,home,20,24,4
1421,8,<ENDS>,24,24,0
1422,0,<START>,0,0,0
1422,1,home,0,7,7
1422,2,work,7,13,6
1422,3,shop,13,14,1
1422,4,work,14,20,6
1422,5,home,20,24,4
1422,6,<ENDS>,24,24,0
1423,0,<START>,0,0,0
1423,1,home,0,7,7
1423,2,education,7,11,4
1423,3,home,11,18,7
1423,4,shop,18,19,1
1423,5,home,19,24,5
1423,6,<ENDS>,24,24,0
1424,0,<START>,0,0,0
1424,1,home,0,6,6
1424,2,work,6,13,7
1424,3,home,13,24,11
1424,4,<ENDS>,24,24,0
1425,0,<START>,0,0,0
1425,1,home,0,7,7
1425,2,work,7,14,7
1425,3,home,14,18,4
1425,4,shop,18,19,1
1425,5,home,19,24,5
1425,6,<ENDS>,24,24,0
1426,0,<START>,0,0,0
1426,1,home,0,7,7
1426,2,work,7,9,2
1426,3,home,9,13,4
1426,4,work,13,16,3
1426,5,home,16,23,7
1426,6,work,23,24,1
1426,7,<ENDS>,24,24,0
1427,0,<START>,0,0,0
1427,1,home,0,8,8
1427,2,work,8,14,6
1427,3,shop,14,15,1
1427,4,home,15,23,8
1427,5,work,23,24,1
1427,6,<ENDS>,24,24,0
1428,0,<START>,0,0,0
1428,1,home,0,6,6
1428,2,work,6,7,1
1428,3,home,7,13,6
1428,4,work,13,15,2
1428,5,home,15,22,7
1428,6,work,22,23,1
1428,7,home,23,24,1
1428,8,<ENDS>,24,24,0
1429,0,<START>,0,0,0
1429,1,home,0,8,8
1429,2,education,8,11,3
1429,3,home,11,16,5
1429,4,work,16,20,4
1429,5,home,20,24,4
1429,6,<ENDS>,24,24,0
1430,0,<START>,0,0,0
1430,1,home,0,6,6
1430,2,work,6,13,7
1430,3,shop,13,14,1
1430,4,home,14,24,10
1430,5,<ENDS>,24,24,0
1431,0,<START>,0,0,0
1431,1,home,0,7,7
1431,2,work,7,13,6
1431,3,home,13,16,3
1431,4,shop,16,17,1
1431,5,work,17,20,3
1431,6,home,20,24,4
1431,7,<ENDS>,24,24,0
1432,0,<START>,0,0,0
1432,1,home,0,7,7
1432,2,education,7,12,5
1432,3,shop,12,14,2
1432,4,home,14,21,7
1432,5,shop,21,22,1
1432,6,home,22,24,2
1432,7,<ENDS>,24,24,0
1433,0,<START>,0,0,0
1433,1,home,0,8,8
1433,2,education,8,11,3
1433,3,shop,11,12,1
1433,4,work,12,18,6
1433,5,home,18,24,6
1433,6,<ENDS>,24,24,0
1434,0,<START>,0,0,0
1434,1,home,0,8,8
1434,2,work,8,15,7
1434,3,home,15,24,9
1434,4,<ENDS>,24,24,0
1435,0,<START>,0,0,0
1435,1,home,0,7,7
1435,2,work,7,14,7
1435,3,home,14,24,10
1435,4,<ENDS>,24,24,0
1436,0,<START>,0,0,0
1436,1,home,0,6,6
1436,2,work,6,13,7
1436,3,home,13,23,10
1436,4,work,23,24,1
1436,5,<ENDS>,24,24,0
1437,0,<START>,0,0,0
1437,1,home,0,7,7
1437,2,work,7,13,6
1437,3,shop,13,15,2
1437,4,home,15,24,9
1437,5,<ENDS>,24,24,0
1438,0,<START>,0,0,0
1438,1,home,0,7,7
1438,2,work,7,13,6
1438,3,shop,13,14,1
1438,4,home,14,24,10
1438,5,<ENDS>,24,24,0
1439,0,<START>,0,0,0
1439,1,home,0,6,6
1439,2,work,6,13,7
1439,3,home,13,17,4
1439,4,work,17,20,3
1439,5,home,20,24,4
1439,6,<ENDS>,24,24,0
1440,0,<START>,0,0,0
1440,1,home,0,8,8
1440,2,education,8,11,3
1440,3,home,11,18,7
1440,4,shop,18,19,1
1440,5,home,19,24,5
1440,6,<ENDS>,24,24,0
1441,0,<START>,0,0,0
1441,1,home,0,7,7
1441,2,work,7,13,6
1441,3,home,13,16,3
1441,4,work,16,20,4
1441,5,home,20,24,4
1441,6,<ENDS>,24,24,0
1442,0,<START>,0,0,0
1442,1,home,0,7,7
1442,2,shop,7,9,2
1442,3,work,9,15,6
1442,4,home,15,24,9
1442,5,<ENDS>,24,24,0
1443,0,<START>,0,0,0
1443,1,home,0,7,7
1443,2,work,7,13,6
1443,3,home,13,24,11
1443,4,<ENDS>,24,24,0
1444,0,<START>,0,0,0
1444,1,home,0,8,8
1444,2,work,8,15,7
1444,3,shop,15,16,1
1444,4,home,16,24,8
1444,5,<ENDS>,24,24,0
1445,0,<START>,0,0,0
1445,1,home,0,7,7
1445,2,shop,7,8,1
1445,3,work,8,13,5
1445,4,home,13,24,11
1445,5,<ENDS>,24,24,0
1446,0,<START>,0,0,0
1446,1,home,0,6,6
1446,2,work,6,13,7
1446,3,home,13,21,8
1446,4,work,21,22,1
1446,5,home,22,24,2
1446,6,<ENDS>,24,24,0
1447,0,<START>,0,0,0
1447,1,home,0,7,7
1447,2,work,7,13,6
1447,3,home,13,24,11
1447,4,<ENDS>,24,24,0
1448,0,<START>,0,0,0
1448,1,home,0,7,7
1448,2,education,7,11,4
1448,3,home,11,18,7
1448,4,shop,18,19,1
1448,5,home,19,24,5
1448,6,<ENDS>,24,24,0
1449,0,<START>,0,0,0
1449,1,home,0,8,8
1449,2,work,8,14,6
1449,3,shop,14,16,2
1449,4,work,16,19,3
1449,5,education,19,20,1
1449,6,home,20,24,4
1449,7,<ENDS>,24,24,0
1450,0,<START>,0,0,0
1450,1,home,0,8,8
1450,2,work,8,15,7
1450,3,home,15,21,6
1450,4,work,21,22,1
1450,5,home,22,24,2
1450,6,<ENDS>,24,24,0
1451,0,<START>,0,0,0
1451,1,home,0,7,7
1451,2,work,7,14,7
1451,3,home,14,23,9
1451,4,work,23,24,1
1451,5,<ENDS>,24,24,0
1452,0,<START>,0,0,0
1452,1,home,0,7,7
1452,2,work,7,13,6
1452,3,home,13,24,11
1452,4,<ENDS>,24,24,0
1453,0,<START>,0,0,0
1453,1,home,0,7,7
1453,2,work,7,13,6
1453,3,home,13,24,11
1453,4,<ENDS>,24,24,0
1454,0,<START>,0,0,0
1454,1,home,0,7,7
1454,2,work,7,14,7
1454,3,shop,14,15,1
1454,4,work,15,19,4
1454,5,home,19,24,5
1454,6,<ENDS>,24,24,0
1455,0,<START>,0,0,0
1455,1,home,0,8,8
1455,2,work,8,13,5
1455,3,shop,13,14,1
1455,4,work,14,20,6
1455,5,home,20,24,4
1455,6,<ENDS>,24,24,0
1456,0,<START>,0,0,0
1456,1,home,0,7,7
1456,2,education,7,11,4
1456,3,home,11,18,7
1456,4,shop,18,19,1
1456,5,home,19,24,5
1456,6,<ENDS>,24,24,0
1457,0,<START>,0,0,0
1457,1,home,0,7,7
1457,2,work,7,14,7
1457,3,shop,14,15,1
1457,4,home,15,24,9
1457,5,<ENDS>,24,24,0
1458,0,<START>,0,0,0
1458,1,home,0,7,7
1458,2,work,7,14,7
1458,3,home,14,21,7
1458,4,work,21,22,1
1458,5,home,22,24,2
1458,6,<ENDS>,24,24,0
1459,0,<START>,0,0,0
1459,1,home,0,8,8
1459,2,work,8,16,8
1459,3,shop,16,17,1
1459,4,home,17,24,7
1459,5,<ENDS>,24,24,0
1460,0,<START>,0,0,0
1460,1,home,0,6,6
1460,2,work,6,14,8
1460,3,home,14,22,8
1460,4,work,22,23,1
1460,5,home,23,24,1
1460,6,<ENDS>,24,24,0
1461,0,<START>,0,0,0
1461,1,home,0,6,6
1461,2,shop,6,7,1
1461,3,home,7,10,3
1461,4,education,10,13,3
1461,5,shop,13,15,2
1461,6,home,15,21,6
1461,7,shop,21,22,1
1461,8,home,22,24,2
1461,9,<ENDS>,24,24,0
1462,0,<START>,0,0,0
1462,1,home,0,7,7
1462,2,work,7,13,6
1462,3,shop,13,14,1
1462,4,work,14,20,6
1462,5,home,20,24,4
1462,6,<ENDS>,24,24,0
1463,0,<START>,0,0,0
1463,1,home,0,8,8
1463,2,work,8,14,6
1463,3,home,14,24,10
1463,4,<ENDS>,24,24,0
1464,0,<START>,0,0,0
1464,1,home,0,6,6
1464,2,work,6,8,2
1464,3,home,8,12,4
1464,4,work,12,14,2
1464,5,home,14,21,7
1464,6,work,21,22,1
1464,7,home,22,24,2
1464,8,<ENDS>,24,24,0
1465,0,<START>,0,0,0
1465,1,home,0,7,7
1465,2,work,7,13,6
1465,3,home,13,24,11
1465,4,<ENDS>,24,24,0
1466,0,<START>,0,0,0
1466,1,home,0,7,7
1466,2,work,7,14,7
1466,3,shop,14,15,1
1466,4,home,15,21,6
1466,5,work,21,22,1
1466,6,home,22,24,2
1466,7,<ENDS>,24,24,0
1467,0,<START>,0,0,0
1467,1,home,0,7,7
1467,2,work,7,14,7
1467,3,home,14,24,10
1467,4,<ENDS>,24,24,0
1468,0,<START>,0,0,0
1468,1,home,0,7,7
1468,2,education,7,11,4
1468,3,home,11,17,6
1468,4,shop,17,18,1
1468,5,home,18,24,6
1468,6,<ENDS>,24,24,0
1469,0,<START>,0,0,0
1469,1,home,0,8,8
1469,2,work,8,14,6
1469,3,shop,14,15,1
1469,4,home,15,24,9
1469,5,<ENDS>,24,24,0
1470,0,<START>,0,0,0
1470,1,home,0,8,8
1470,2,education,8,11,3
1470,3,shop,11,12,1
1470,4,work,12,18,6
1470,5,home,18,24,6
1470,6,<ENDS>,24,24,0
1471,0,<START>,0,0,0
1471,1,home,0,6,6
1471,2,work,6,13,7
1471,3,home,13,17,4
1471,4,shop,17,18,1
1471,5,home,18,24,6
1471,6,<ENDS>,24,24,0
1472,0,<START>,0,0,0
1472,1,home,0,7,7
1472,2,work,7,14,7
1472,3,shop,14,15,1
1472,4,home,15,23,8
1472,5,work,23,24,1
1472,6,<ENDS>,24,24,0
1473,0,<START>,0,0,0
1473,1,home,0,6,6
1473,2,work,6,8,2
1473,3,home,8,12,4
1473,4,work,12,14,2
1473,5,home,14,21,7
1473,6,work,21,22,1
1473,7,home,22,24,2
1473,8,<ENDS>,24,24,0
1474,0,<START>,0,0,0
1474,1,home,0,8,8
1474,2,shop,8,9,1
1474,3,work,9,17,8
1474,4,home,17,24,7
1474,5,<ENDS>,24,24,0
1475,0,<START>,0,0,0
1475,1,home,0,6,6
1475,2,work,6,8,2
1475,3,home,8,9,1
1475,4,work,9,11,2
1475,5,home,11,16,5
1475,6,work,16,18,2
1475,7,home,18,22,4
1475,8,work,22,23,1
1475,9,home,23,24,1
1475,10,<ENDS>,24,24,0
1476,0,<START>,0,0,0
1476,1,home,0,6,6
1476,2,work,6,9,3
1476,3,home,9,15,6
1476,4,work,15,17,2
1476,5,home,17,21,4
1476,6,work,21,22,1
1476,7,home,22,24,2
1476,8,<ENDS>,24,24,0
1477,0,<START>,0,0,0
1477,1,home,0,6,6
1477,2,work,6,12,6
1477,3,shop,12,13,1
1477,4,work,13,18,5
1477,5,home,18,24,6
1477,6,<ENDS>,24,24,0
1478,0,<START>,0,0,0
1478,1,home,0,7,7
1478,2,work,7,13,6
1478,3,shop,13,14,1
1478,4,home,14,24,10
1478,5,<ENDS>,24,24,0
1479,0,<START>,0,0,0
1479,1,home,0,8,8
1479,2,education,8,12,4
1479,3,work,12,19,7
1479,4,home,19,24,5
1479,5,<ENDS>,24,24,0
1480,0,<START>,0,0,0
1480,1,home,0,8,8
1480,2,work,8,13,5
1480,3,home,13,24,11
1480,4,<ENDS>,24,24,0
1481,0,<START>,0,0,0
1481,1,home,0,6,6
1481,2,work,6,8,2
1481,3,home,8,13,5
1481,4,shop,13,14,1
1481,5,work,14,16,2
1481,6,home,16,23,7
1481,7,work,23,24,1
1481,8,<ENDS>,24,24,0
1482,0,<START>,0,0,0
1482,1,home,0,7,7
1482,2,work,7,13,6
1482,3,shop,13,14,1
1482,4,education,14,17,3
1482,5,home,17,24,7
1482,6,<ENDS>,24,24,0
1483,0,<START>,0,0,0
1483,1,home,0,9,9
1483,2,work,9,16,7
1483,3,home,16,24,8
1483,4,<ENDS>,24,24,0
1484,0,<START>,0,0,0
1484,1,home,0,6,6
1484,2,work,6,13,7
1484,3,shop,13,14,1
1484,4,education,14,16,2
1484,5,home,16,24,8
1484,6,<ENDS>,24,24,0
1485,0,<START>,0,0,0
1485,1,home,0,7,7
1485,2,shop,7,8,1
1485,3,education,8,11,3
1485,4,home,11,18,7
1485,5,shop,18,20,2
1485,6,home,20,24,4
1485,7,<ENDS>,24,24,0
1486,0,<START>,0,0,0
1486,1,home,0,6,6
1486,2,shop,6,7,1
1486,3,work,7,15,8
1486,4,home,15,24,9
1486,5,<ENDS>,24,24,0
1487,0,<START>,0,0,0
1487,1,home,0,7,7
1487,2,education,7,12,5
1487,3,home,12,20,8
1487,4,shop,20,21,1
1487,5,home,21,24,3
1487,6,<ENDS>,24,24,0
1488,0,<START>,0,0,0
1488,1,home,0,7,7
1488,2,work,7,9,2
1488,3,home,9,13,4
1488,4,work,13,15,2
1488,5,home,15,21,6
1488,6,work,21,22,1
1488,7,home,22,24,2
1488,8,<ENDS>,24,24,0
1489,0,<START>,0,0,0
1489,1,home,0,7,7
1489,2,education,7,12,5
1489,3,home,12,20,8
1489,4,shop,20,21,1
1489,5,home,21,24,3
1489,6,<ENDS>,24,24,0
1490,0,<START>,0,0,0
1490,1,home,0,8,8
1490,2,work,8,15,7
1490,3,home,15,19,4
1490,4,shop,19,20,1
1490,5,home,20,24,4
1490,6,<ENDS>,24,24,0
1491,0,<START>,0,0,0
1491,1,home,0,6,6
1491,2,shop,6,7,1
1491,3,home,7,16,9
1491,4,work,16,20,4
1491,5,home,20,24,4
1491,6,<ENDS>,24,24,0
1492,0,<START>,0,0,0
1492,1,home,0,6,6
1492,2,work,6,14,8
1492,3,home,14,24,10
1492,4,<ENDS>,24,24,0
1493,0,<START>,0,0,0
1493,1,home,0,7,7
1493,2,work,7,8,1
1493,3,home,8,14,6
1493,4,work,14,16,2
1493,5,home,16,24,8
1493,6,<ENDS>,24,24,0
1494,0,<START>,0,0,0
1494,1,home,0,6,6
1494,2,work,6,13,7
1494,3,home,13,15,2
1494,4,work,15,20,5
1494,5,home,20,24,4
1494,6,<ENDS>,24,24,0
1495,0,<START>,0,0,0
1495,1,home,0,8,8
1495,2,work,8,15,7
1495,3,home,15,24,9
1495,4,<ENDS>,24,24,0
1496,0,<START>,0,0,0
1496,1,home,0,9,9
1496,2,work,9,15,6
1496,3,home,15,19,4
1496,4,shop,19,20,1
1496,5,home,20,24,4
1496,6,<ENDS>,24,24,0
1497,0,<START>,0,0,0
1497,1,home,0,7,7
1497,2,work,7,14,7
1497,3,home,14,24,10
1497,4,<ENDS>,24,24,0
1498,0,<START>,0,0,0
1498,1,home,0,7,7
1498,2,work,7,13,6
1498,3,home,13,24,11
1498,4,<ENDS>,24,24,0
1499,0,<START>,0,0,0
1499,1,home,0,8,8
1499,2,work,8,15,7
1499,3,home,15,22,7
1499,4,work,22,23,1
1499,5,home,23,24,1
1499,6,<ENDS>,24,24,0
1500,0,<START>,0,0,0
1500,1,home,0,9,9
1500,2,education,9,13,4
1500,3,shop,13,14,1
1500,4,work,14,20,6
1500,5,home,20,24,4
1500,6,<ENDS>,24,24,0
1501,0,<START>,0,0,0
1501,1,home,0,8,8
1501,2,shop,8,9,1
1501,3,work,9,16,7
1501,4,home,16,24,8
1501,5,<ENDS>,24,24,0
1502,0,<START>,0,0,0
1502,1,home,0,7,7
1502,2,education,7,12,5
1502,3,shop,12,13,1
1502,4,home,13,20,7
1502,5,shop,20,21,1
1502,6,home,21,24,3
1502,7,<ENDS>,24,24,0
1503,0,<START>,0,0,0
1503,1,home,0,6,6
1503,2,work,6,13,7
1503,3,home,13,24,11
1503,4,<ENDS>,24,24,0
1504,0,<START>,0,0,0
1504,1,home,0,9,9
1504,2,work,9,15,6
1504,3,home,15,24,9
1504,4,<ENDS>,24,24,0
1505,0,<START>,0,0,0
1505,1,home,0,8,8
1505,2,work,8,15,7
1505,3,home,15,24,9
1505,4,<ENDS>,24,24,0
1506,0,<START>,0,0,0
1506,1,home,0,8,8
1506,2,work,8,14,6
1506,3,home,14,17,3
1506,4,work,17,20,3
1506,5,home,20,24,4
1506,6,<ENDS>,24,24,0
1507,0,<START>,0,0,0
1507,1,home,0,7,7
1507,2,work,7,13,6
1507,3,shop,13,14,1
1507,4,work,14,19,5
1507,5,home,19,24,5
1507,6,<ENDS>,24,24,0
1508,0,<START>,0,0,0
1508,1,home,0,7,7
1508,2,work,7,13,6
1508,3,shop,13,14,1
1508,4,work,14,20,6
1508,5,home,20,24,4
1508,6,<ENDS>,24,24,0
1509,0,<START>,0,0,0
1509,1,home,0,8,8
1509,2,work,8,15,7
1509,3,home,15,19,4
1509,4,shop,19,20,1
1509,5,home,20,24,4
1509,6,<ENDS>,24,24,0
1510,0,<START>,0,0,0
1510,1,home,0,6,6
1510,2,shop,6,7,1
1510,3,home,7,11,4
1510,4,work,11,18,7
1510,5,education,18,20,2
1510,6,home,20,24,4
1510,7,<ENDS>,24,24,0
1511,0,<START>,0,0,0
1511,1,home,0,8,8
1511,2,work,8,14,6
1511,3,home,14,24,10
1511,4,<ENDS>,24,24,0
1512,0,<START>,0,0,0
1512,1,home,0,6,6
1512,2,work,6,8,2
1512,3,home,8,10,2
1512,4,work,10,12,2
1512,5,home,12,16,4
1512,6,work,16,18,2
1512,7,home,18,24,6
1512,8,<ENDS>,24,24,0
1513,0,<START>,0,0,0
1513,1,home,0,7,7
1513,2,shop,7,8,1
1513,3,home,8,9,1
1513,4,work,9,16,7
1513,5,home,16,24,8
1513,6,<ENDS>,24,24,0
1514,0,<START>,0,0,0
1514,1,home,0,6,6
1514,2,work,6,8,2
1514,3,home,8,9,1
1514,4,work,9,11,2
1514,5,home,11,17,6
1514,6,work,17,19,2
1514,7,home,19,24,5
1514,8,<ENDS>,24,24,0
1515,0,<START>,0,0,0
1515,1,home,0,9,9
1515,2,education,9,12,3
1515,3,home,12,21,9
1515,4,work,21,22,1
1515,5,home,22,24,2
1515,6,<ENDS>,24,24,0
1516,0,<START>,0,0,0
1516,1,home,0,8,8
1516,2,work,8,16,8
1516,3,home,16,24,8
1516,4,<ENDS>,24,24,0
1517,0,<START>,0,0,0
1517,1,home,0,6,6
1517,2,shop,6,7,1
1517,3,home,7,9,2
1517,4,education,9,11,2
1517,5,home,11,17,6
1517,6,shop,17,19,2
1517,7,home,19,24,5
1517,8,<ENDS>,24,24,0
1518,0,<START>,0,0,0
1518,1,home,0,6,6
1518,2,shop,6,7,1
1518,3,home,7,10,3
1518,4,education,10,13,3
1518,5,shop,13,15,2
1518,6,home,15,21,6
1518,7,shop,21,22,1
1518,8,home,22,24,2
1518,9,<ENDS>,24,24,0
1519,0,<START>,0,0,0
1519,1,home,0,8,8
1519,2,work,8,15,7
1519,3,home,15,24,9
1519,4,<ENDS>,24,24,0
1520,0,<START>,0,0,0
1520,1,home,0,6,6
1520,2,shop,6,7,1
1520,3,home,7,8,1
1520,4,education,8,11,3
1520,5,home,11,16,5
1520,6,shop,16,17,1
1520,7,home,17,24,7
1520,8,<ENDS>,24,24,0
1521,0,<START>,0,0,0
1521,1,home,0,8,8
1521,2,work,8,14,6
1521,3,home,14,20,6
1521,4,shop,20,21,1
1521,5,home,21,24,3
1521,6,<ENDS>,24,24,0
1522,0,<START>,0,0,0
1522,1,home,0,8,8
1522,2,work,8,15,7
1522,3,home,15,24,9
1522,4,<ENDS>,24,24,0
1523,0,<START>,0,0,0
1523,1,home,0,7,7
1523,2,work,7,14,7
1523,3,shop,14,15,1
1523,4,home,15,24,9
1523,5,<ENDS>,24,24,0
1524,0,<START>,0,0,0
1524,1,home,0,9,9
1524,2,work,9,16,7
1524,3,home,16,23,7
1524,4,work,23,24,1
1524,5,<ENDS>,24,24,0
1525,0,<START>,0,0,0
1525,1,home,0,6,6
1525,2,work,6,7,1
1525,3,home,7,13,6
1525,4,work,13,15,2
1525,5,home,15,23,8
1525,6,work,23,24,1
1525,7,<ENDS>,24,24,0
1526,0,<START>,0,0,0
1526,1,home,0,6,6
1526,2,work,6,13,7
1526,3,home,13,17,4
1526,4,work,17,20,3
1526,5,home,20,24,4
1526,6,<ENDS>,24,24,0
1527,0,<START>,0,0,0
1527,1,home,0,8,8
1527,2,education,8,11,3
1527,3,home,11,18,7
1527,4,shop,18,19,1
1527,5,home,19,24,5
1527,6,<ENDS>,24,24,0
1528,0,<START>,0,0,0
1528,1,home,0,7,7
1528,2,work,7,15,8
1528,3,shop,15,17,2
1528,4,work,17,20,3
1528,5,home,20,24,4
1528,6,<ENDS>,24,24,0
1529,0,<START>,0,0,0
1529,1,home,0,6,6
1529,2,work,6,13,7
1529,3,shop,13,14,1
1529,4,home,14,24,10
1529,5,<ENDS>,24,24,0
1530,0,<START>,0,0,0
1530,1,home,0,8,8
1530,2,work,8,15,7
1530,3,shop,15,16,1
1530,4,home,16,23,7
1530,5,work,23,24,1
1530,6,<ENDS>,24,24,0
1531,0,<START>,0,0,0
1531,1,home,0,6,6
1531,2,work,6,13,7
1531,3,home,13,17,4
1531,4,work,17,20,3
1531,5,home,20,24,4
1531,6,<ENDS>,24,24,0
1532,0,<START>,0,0,0
1532,1,home,0,6,6
1532,2,work,6,7,1
1532,3,home,7,10,3
1532,4,work,10,11,1
1532,5,home,11,18,7
1532,6,work,18,20,2
1532,7,home,20,24,4
1532,8,<ENDS>,24,24,0
1533,0,<START>,0,0,0
1533,1,home,0,7,7
1533,2,work,7,14,7
1533,3,home,14,24,10
1533,4,<ENDS>,24,24,0
1534,0,<START>,0,0,0
1534,1,home,0,7,7
1534,2,education,7,11,4
1534,3,home,11,17,6
1534,4,shop,17,19,2
1534,5,home,19,24,5
1534,6,<ENDS>,24,24,0
1535,0,<START>,0,0,0
1535,1,home,0,8,8
1535,2,education,8,14,6
1535,3,shop,14,16,2
1535,4,home,16,23,7
1535,5,work,23,24,1
1535,6,<ENDS>,24,24,0
1536,0,<START>,0,0,0
1536,1,home,0,8,8
1536,2,work,8,14,6
1536,3,home,14,18,4
1536,4,work,18,20,2
1536,5,home,20,24,4
1536,6,<ENDS>,24,24,0
1537,0,<START>,0,0,0
1537,1,home,0,7,7
1537,2,work,7,13,6
1537,3,home,13,21,8
1537,4,work,21,22,1
1537,5,home,22,24,2
1537,6,<ENDS>,24,24,0
1538,0,<START>,0,0,0
1538,1,home,0,7,7
1538,2,work,7,13,6
1538,3,home,13,24,11
1538,4,<ENDS>,24,24,0
1539,0,<START>,0,0,0
1539,1,home,0,7,7
1539,2,work,7,14,7
1539,3,home,14,24,10
1539,4,<ENDS>,24,24,0
1540,0,<START>,0,0,0
1540,1,home,0,8,8
1540,2,work,8,14,6
1540,3,shop,14,15,1
1540,4,home,15,24,9
1540,5,<ENDS>,24,24,0
1541,0,<START>,0,0,0
1541,1,home,0,7,7
1541,2,shop,7,8,1
1541,3,education,8,12,4
1541,4,home,12,18,6
1541,5,shop,18,20,2
1541,6,home,20,24,4
1541,7,<ENDS>,24,24,0
1542,0,<START>,0,0,0
1542,1,home,0,7,7
1542,2,work,7,13,6
1542,3,home,13,15,2
1542,4,work,15,20,5
1542,5,home,20,24,4
1542,6,<ENDS>,24,24,0
1543,0,<START>,0,0,0
1543,1,home,0,8,8
1543,2,work,8,15,7
1543,3,home,15,18,3
1543,4,work,18,20,2
1543,5,home,20,24,4
1543,6,<ENDS>,24,24,0
1544,0,<START>,0,0,0
1544,1,home,0,7,7
1544,2,education,7,11,4
1544,3,home,11,18,7
1544,4,shop,18,19,1
1544,5,home,19,24,5
1544,6,<ENDS>,24,24,0
1545,0,<START>,0,0,0
1545,1,home,0,7,7
1545,2,work,7,14,7
1545,3,shop,14,15,1
1545,4,home,15,21,6
1545,5,work,21,22,1
1545,6,home,22,24,2
1545,7,<ENDS>,24,24,0
1546,0,<START>,0,0,0
1546,1,home,0,7,7
1546,2,shop,7,9,2
1546,3,education,9,11,2
1546,4,home,11,19,8
1546,5,shop,19,20,1
1546,6,home,20,24,4
1546,7,<ENDS>,24,24,0
1547,0,<START>,0,0,0
1547,1,home,0,8,8
1547,2,education,8,11,3
1547,3,home,11,18,7
1547,4,shop,18,19,1
1547,5,home,19,24,5
1547,6,<ENDS>,24,24,0
1548,0,<START>,0,0,0
1548,1,home,0,7,7
1548,2,shop,7,8,1
1548,3,education,8,12,4
1548,4,shop,12,14,2
1548,5,education,14,16,2
1548,6,home,16,24,8
1548,7,<ENDS>,24,24,0
1549,0,<START>,0,0,0
1549,1,home,0,6,6
1549,2,work,6,12,6
1549,3,shop,12,13,1
1549,4,work,13,19,6
1549,5,education,19,20,1
1549,6,home,20,24,4
1549,7,<ENDS>,24,24,0
1550,0,<START>,0,0,0
1550,1,home,0,8,8
1550,2,shop,8,9,1
1550,3,education,9,12,3
1550,4,shop,12,13,1
1550,5,education,13,16,3
1550,6,shop,16,18,2
1550,7,home,18,24,6
1550,8,<ENDS>,24,24,0
1551,0,<START>,0,0,0
1551,1,home,0,6,6
1551,2,work,6,13,7
1551,3,home,13,23,10
1551,4,work,23,24,1
1551,5,<ENDS>,24,24,0
1552,0,<START>,0,0,0
1552,1,home,0,8,8
1552,2,work,8,15,7
1552,3,home,15,24,9
1552,4,<ENDS>,24,24,0
1553,0,<START>,0,0,0
1553,1,home,0,7,7
1553,2,work,7,13,6
1553,3,home,13,18,5
1553,4,shop,18,19,1
1553,5,home,19,24,5
1553,6,<ENDS>,24,24,0
1554,0,<START>,0,0,0
1554,1,home,0,8,8
1554,2,work,8,15,7
1554,3,home,15,19,4
1554,4,shop,19,20,1
1554,5,home,20,24,4
1554,6,<ENDS>,24,24,0
1555,0,<START>,0,0,0
1555,1,home,0,7,7
1555,2,work,7,13,6
1555,3,shop,13,14,1
1555,4,work,14,20,6
1555,5,home,20,24,4
1555,6,<ENDS>,24,24,0
1556,0,<START>,0,0,0
1556,1,home,0,7,7
1556,2,education,7,12,5
1556,3,home,12,19,7
1556,4,shop,19,20,1
1556,5,home,20,24,4
1556,6,<ENDS>,24,24,0
1557,0,<START>,0,0,0
1557,1,home,0,7,7
1557,2,shop,7,8,1
1557,3,education,8,12,4
1557,4,shop,12,14,2
1557,5,education,14,17,3
1557,6,home,17,24,7
1557,7,<ENDS>,24,24,0
1558,0,<START>,0,0,0
1558,1,home,0,6,6
1558,2,work,6,13,7
1558,3,home,13,18,5
1558,4,shop,18,19,1
1558,5,home,19,24,5
1558,6,<ENDS>,24,24,0
1559,0,<START>,0,0,0
1559,1,home,0,6,6
1559,2,shop,6,8,2
1559,3,work,8,15,7
1559,4,home,15,24,9
1559,5,<ENDS>,24,24,0
1560,0,<START>,0,0,0
1560,1,home,0,8,8
1560,2,education,8,11,3
1560,3,home,11,17,6
1560,4,shop,17,19,2
1560,5,home,19,24,5
1560,6,<ENDS>,24,24,0
1561,0,<START>,0,0,0
1561,1,home,0,6,6
1561,2,work,6,13,7
1561,3,home,13,24,11
1561,4,<ENDS>,24,24,0
1562,0,<START>,0,0,0
1562,1,home,0,8,8
1562,2,work,8,14,6
1562,3,home,14,23,9
1562,4,work,23,24,1
1562,5,<ENDS>,24,24,0
1563,0,<START>,0,0,0
1563,1,home,0,7,7
1563,2,work,7,13,6
1563,3,home,13,24,11
1563,4,<ENDS>,24,24,0
1564,0,<START>,0,0,0
1564,1,home,0,8,8
1564,2,work,8,14,6
1564,3,home,14,24,10
1564,4,<ENDS>,24,24,0
1565,0,<START>,0,0,0
1565,1,home,0,9,9
1565,2,work,9,17,8
1565,3,home,17,24,7
1565,4,<ENDS>,24,24,0
1566,0,<START>,0,0,0
1566,1,home,0,7,7
1566,2,shop,7,8,1
1566,3,work,8,14,6
1566,4,home,14,24,10
1566,5,<ENDS>,24,24,0
1567,0,<START>,0,0,0
1567,1,home,0,7,7
1567,2,work,7,13,6
1567,3,shop,13,14,1
1567,4,home,14,24,10
1567,5,<ENDS>,24,24,0
1568,0,<START>,0,0,0
1568,1,home,0,7,7
1568,2,shop,7,8,1
1568,3,education,8,11,3
1568,4,home,11,17,6
1568,5,shop,17,18,1
1568,6,home,18,24,6
1568,7,<ENDS>,24,24,0
1569,0,<START>,0,0,0
1569,1,home,0,7,7
1569,2,education,7,11,4
1569,3,home,11,20,9
1569,4,shop,20,21,1
1569,5,home,21,24,3
1569,6,<ENDS>,24,24,0
1570,0,<START>,0,0,0
1570,1,home,0,7,7
1570,2,work,7,9,2
1570,3,home,9,13,4
1570,4,work,13,16,3
1570,5,home,16,22,6
1570,6,work,22,23,1
1570,7,home,23,24,1
1570,8,<ENDS>,24,24,0
1571,0,<START>,0,0,0
1571,1,home,0,7,7
1571,2,work,7,8,1
1571,3,home,8,9,1
1571,4,work,9,11,2
1571,5,home,11,17,6
1571,6,shop,17,18,1
1571,7,home,18,24,6
1571,8,<ENDS>,24,24,0
1572,0,<START>,0,0,0
1572,1,home,0,8,8
1572,2,work,8,16,8
1572,3,shop,16,17,1
1572,4,home,17,24,7
1572,5,<ENDS>,24,24,0
1573,0,<START>,0,0,0
1573,1,home,0,8,8
1573,2,work,8,15,7
1573,3,home,15,21,6
1573,4,work,21,22,1
1573,5,home,22,24,2
1573,6,<ENDS>,24,24,0
1574,0,<START>,0,0,0
1574,1,home,0,6,6
1574,2,shop,6,7,1
1574,3,home,7,10,3
1574,4,education,10,12,2
1574,5,shop,12,13,1
1574,6,education,13,16,3
1574,7,home,16,20,4
1574,8,shop,20,21,1
1574,9,home,21,24,3
1574,10,<ENDS>,24,24,0
1575,0,<START>,0,0,0
1575,1,home,0,6,6
1575,2,work,6,8,2
1575,3,home,8,13,5
1575,4,work,13,14,1
1575,5,home,14,21,7
1575,6,work,21,22,1
1575,7,home,22,24,2
1575,8,<ENDS>,24,24,0
1576,0,<START>,0,0,0
1576,1,home,0,8,8
1576,2,education,8,11,3
1576,3,shop,11,12,1
1576,4,work,12,19,7
1576,5,home,19,24,5
1576,6,<ENDS>,24,24,0
1577,0,<START>,0,0,0
1577,1,home,0,8,8
1577,2,work,8,15,7
1577,3,home,15,23,8
1577,4,work,23,24,1
1577,5,<ENDS>,24,24,0
1578,0,<START>,0,0,0
1578,1,home,0,8,8
1578,2,work,8,15,7
1578,3,shop,15,16,1
1578,4,home,16,24,8
1578,5,<ENDS>,24,24,0
1579,0,<START>,0,0,0
1579,1,home,0,7,7
1579,2,work,7,13,6
1579,3,home,13,18,5
1579,4,work,18,20,2
1579,5,home,20,24,4
1579,6,<ENDS>,24,24,0
1580,0,<START>,0,0,0
1580,1,home,0,6,6
1580,2,work,6,13,7
1580,3,home,13,16,3
1580,4,work,16,20,4
1580,5,home,20,24,4
1580,6,<ENDS>,24,24,0
1581,0,<START>,0,0,0
1581,1,home,0,6,6
1581,2,work,6,13,7
1581,3,shop,13,14,1
1581,4,home,14,24,10
1581,5,<ENDS>,24,24,0
1582,0,<START>,0,0,0
1582,1,home,0,7,7
1582,2,work,7,9,2
1582,3,home,9,15,6
1582,4,work,15,17,2
1582,5,home,17,24,7
1582,6,<ENDS>,24,24,0
1583,0,<START>,0,0,0
1583,1,home,0,7,7
1583,2,work,7,14,7
1583,3,home,14,21,7
1583,4,work,21,22,1
1583,5,home,22,24,2
1583,6,<ENDS>,24,24,0
1584,0,<START>,0,0,0
1584,1,home,0,7,7
1584,2,work,7,13,6
1584,3,home,13,24,11
1584,4,<ENDS>,24,24,0
1585,0,<START>,0,0,0
1585,1,home,0,6,6
1585,2,shop,6,7,1
1585,3,home,7,10,3
1585,4,education,10,13,3
1585,5,shop,13,15,2
1585,6,home,15,19,4
1585,7,shop,19,20,1
1585,8,home,20,24,4
1585,9,<ENDS>,24,24,0
1586,0,<START>,0,0,0
1586,1,home,0,7,7
1586,2,work,7,8,1
1586,3,home,8,13,5
1586,4,work,13,15,2
1586,5,home,15,22,7
1586,6,work,22,23,1
1586,7,home,23,24,1
1586,8,<ENDS>,24,24,0
1587,0,<START>,0,0,0
1587,1,home,0,8,8
1587,2,work,8,15,7
1587,3,home,15,24,9
1587,4,<ENDS>,24,24,0
1588,0,<START>,0,0,0
1588,1,home,0,7,7
1588,2,work,7,14,7
1588,3,home,14,24,10
1588,4,<ENDS>,24,24,0
1589,0,<START>,0,0,0
1589,1,home,0,6,6
1589,2,shop,6,7,1
1589,3,home,7,9,2
1589,4,education,9,15,6
1589,5,shop,15,16,1
1589,6,home,16,24,8
1589,7,<ENDS>,24,24,0
1590,0,<START>,0,0,0
1590,1,home,0,7,7
1590,2,work,7,13,6
1590,3,shop,13,14,1
1590,4,work,14,19,5
1590,5,home,19,24,5
1590,6,<ENDS>,24,24,0
1591,0,<START>,0,0,0
1591,1,home,0,7,7
1591,2,work,7,13,6
1591,3,shop,13,14,1
1591,4,home,14,24,10
1591,5,<ENDS>,24,24,0
1592,0,<START>,0,0,0
1592,1,home,0,7,7
1592,2,work,7,14,7
1592,3,shop,14,15,1
1592,4,home,15,24,9
1592,5,<ENDS>,24,24,0
1593,0,<START>,0,0,0
1593,1,home,0,7,7
1593,2,work,7,9,2
1593,3,home,9,13,4
1593,4,work,13,15,2
1593,5,home,15,21,6
1593,6,work,21,22,1
1593,7,home,22,24,2
1593,8,<ENDS>,24,24,0
1594,0,<START>,0,0,0
1594,1,home,0,7,7
1594,2,work,7,14,7
1594,3,home,14,24,10
1594,4,<ENDS>,24,24,0
1595,0,<START>,0,0,0
1595,1,home,0,6,6
1595,2,shop,6,7,1
1595,3,home,7,10,3
1595,4,education,10,16,6
1595,5,home,16,24,8
1595,6,<ENDS>,24,24,0
1596,0,<START>,0,0,0
1596,1,home,0,8,8
1596,2,work,8,15,7
1596,3,shop,15,16,1
1596,4,home,16,21,5
1596,5,work,21,22,1
1596,6,home,22,24,2
1596,7,<ENDS>,24,24,0
1597,0,<START>,0,0,0
1597,1,home,0,7,7
1597,2,shop,7,8,1
1597,3,education,8,11,3
1597,4,home,11,18,7
1597,5,shop,18,19,1
1597,6,home,19,24,5
1597,7,<ENDS>,24,24,0
1598,0,<START>,0,0,0
1598,1,home,0,6,6
1598,2,work,6,13,7
1598,3,home,13,16,3
1598,4,work,16,20,4
1598,5,home,20,24,4
1598,6,<ENDS>,24,24,0
1599,0,<START>,0,0,0
1599,1,home,0,7,7
1599,2,work,7,14,7
1599,3,shop,14,15,1
1599,4,home,15,24,9
1599,5,<ENDS>,24,24,0
1600,0,<START>,0,0,0
1600,1,home,0,7,7
1600,2,work,7,14,7
1600,3,shop,14,15,1
1600,4,work,15,19,4
1600,5,home,19,24,5
1600,6,<ENDS>,24,24,0
1601,0,<START>,0,0,0
1601,1,home,0,7,7
1601,2,work,7,15,8
1601,3,shop,15,16,1
1601,4,home,16,24,8
1601,5,<ENDS>,24,24,0
1602,0,<START>,0,0,0
1602,1,home,0,8,8
1602,2,work,8,14,6
1602,3,home,14,20,6
1602,4,shop,20,21,1
1602,5,home,21,24,3
1602,6,<ENDS>,24,24,0
1603,0,<START>,0,0,0
1603,1,home,0,8,8
1603,2,work,8,15,7
1603,3,home,15,18,3
1603,4,work,18,20,2
1603,5,home,20,24,4
1603,6,<ENDS>,24,24,0
1604,0,<START>,0,0,0
1604,1,home,0,6,6
1604,2,shop,6,7,1
1604,3,home,7,10,3
1604,4,education,10,16,6
1604,5,home,16,24,8
1604,6,<ENDS>,24,24,0
1605,0,<START>,0,0,0
1605,1,home,0,6,6
1605,2,shop,6,7,1
1605,3,home,7,13,6
1605,4,education,13,16,3
1605,5,home,16,24,8
1605,6,<ENDS>,24,24,0
1606,0,<START>,0,0,0
1606,1,home,0,7,7
1606,2,work,7,13,6
1606,3,shop,13,14,1
1606,4,home,14,24,10
1606,5,<ENDS>,24,24,0
1607,0,<START>,0,0,0
1607,1,home,0,8,8
1607,2,work,8,15,7
1607,3,home,15,24,9
1607,4,<ENDS>,24,24,0
1608,0,<START>,0,0,0
1608,1,home,0,6,6
1608,2,work,6,8,2
1608,3,home,8,11,3
1608,4,work,11,13,2
1608,5,home,13,21,8
1608,6,work,21,22,1
1608,7,home,22,24,2
1608,8,<ENDS>,24,24,0
1609,0,<START>,0,0,0
1609,1,home,0,7,7
1609,2,work,7,13,6
1609,3,home,13,16,3
1609,4,work,16,20,4
1609,5,home,20,24,4
1609,6,<ENDS>,24,24,0
1610,0,<START>,0,0,0
1610,1,home,0,7,7
1610,2,work,7,13,6
1610,3,home,13,24,11
1610,4,<ENDS>,24,24,0
1611,0,<START>,0,0,0
1611,1,home,0,7,7
1611,2,education,7,11,4
1611,3,home,11,17,6
1611,4,shop,17,18,1
1611,5,home,18,24,6
1611,6,<ENDS>,24,24,0
1612,0,<START>,0,0,0
1612,1,home,0,6,6
1612,2,work,6,8,2
1612,3,home,8,9,1
1612,4,work,9,11,2
1612,5,home,11,17,6
1612,6,work,17,19,2
1612,7,home,19,24,5
1612,8,<ENDS>,24,24,0
1613,0,<START>,0,0,0
1613,1,home,0,7,7
1613,2,work,7,14,7
1613,3,home,14,18,4
1613,4,work,18,20,2
1613,5,home,20,24,4
1613,6,<ENDS>,24,24,0
1614,0,<START>,0,0,0
1614,1,home,0,6,6
1614,2,work,6,13,7
1614,3,home,13,16,3
1614,4,work,16,20,4
1614,5,home,20,24,4
1614,6,<ENDS>,24,24,0
1615,0,<START>,0,0,0
1615,1,home,0,8,8
1615,2,work,8,15,7
1615,3,home,15,24,9
1615,4,<ENDS>,24,24,0
1616,0,<START>,0,0,0
1616,1,home,0,8,8
1616,2,work,8,15,7
1616,3,home,15,17,2
1616,4,work,17,20,3
1616,5,home,20,24,4
1616,6,<ENDS>,24,24,0
1617,0,<START>,0,0,0
1617,1,home,0,7,7
1617,2,work,7,13,6
1617,3,shop,13,14,1
1617,4,work,14,19,5
1617,5,home,19,24,5
1617,6,<ENDS>,24,24,0
1618,0,<START>,0,0,0
1618,1,home,0,7,7
1618,2,work,7,13,6
1618,3,shop,13,14,1
1618,4,home,14,18,4
1618,5,work,18,20,2
1618,6,home,20,24,4
1618,7,<ENDS>,24,24,0
1619,0,<START>,0,0,0
1619,1,home,0,7,7
1619,2,work,7,13,6
1619,3,shop,13,14,1
1619,4,work,14,19,5
1619,5,education,19,20,1
1619,6,home,20,24,4
1619,7,<ENDS>,24,24,0
1620,0,<START>,0,0,0
1620,1,home,0,7,7
1620,2,work,7,13,6
1620,3,home,13,18,5
1620,4,work,18,20,2
1620,5,home,20,24,4
1620,6,<ENDS>,24,24,0
1621,0,<START>,0,0,0
1621,1,home,0,6,6
1621,2,work,6,13,7
1621,3,home,13,17,4
1621,4,shop,17,18,1
1621,5,home,18,24,6
1621,6,<ENDS>,24,24,0
1622,0,<START>,0,0,0
1622,1,home,0,7,7
1622,2,work,7,13,6
1622,3,shop,13,14,1
1622,4,home,14,24,10
1622,5,<ENDS>,24,24,0
1623,0,<START>,0,0,0
1623,1,home,0,8,8
1623,2,work,8,15,7
1623,3,home,15,22,7
1623,4,work,22,23,1
1623,5,home,23,24,1
1623,6,<ENDS>,24,24,0
1624,0,<START>,0,0,0
1624,1,home,0,6,6
1624,2,shop,6,7,1
1624,3,home,7,12,5
1624,4,work,12,19,7
1624,5,home,19,24,5
1624,6,<ENDS>,24,24,0
1625,0,<START>,0,0,0
1625,1,home,0,7,7
1625,2,education,7,11,4
1625,3,home,11,13,2
1625,4,education,13,16,3
1625,5,home,16,24,8
1625,6,<ENDS>,24,24,0
1626,0,<START>,0,0,0
1626,1,home,0,8,8
1626,2,education,8,11,3
1626,3,home,11,19,8
1626,4,shop,19,20,1
1626,5,home,20,24,4
1626,6,<ENDS>,24,24,0
1627,0,<START>,0,0,0
1627,1,home,0,7,7
1627,2,work,7,14,7
1627,3,home,14,24,10
1627,4,<ENDS>,24,24,0
1628,0,<START>,0,0,0
1628,1,home,0,6,6
1628,2,work,6,12,6
1628,3,shop,12,13,1
1628,4,work,13,19,6
1628,5,home,19,24,5
1628,6,<ENDS>,24,24,0
1629,0,<START>,0,0,0
1629,1,home,0,7,7
1629,2,education,7,12,5
1629,3,home,12,19,7
1629,4,shop,19,20,1
1629,5,home,20,24,4
1629,6,<ENDS>,24,24,0
1630,0,<START>,0,0,0
1630,1,home,0,7,7
1630,2,work,7,14,7
1630,3,home,14,24,10
1630,4,<ENDS>,24,24,0
1631,0,<START>,0,0,0
1631,1,home,0,7,7
1631,2,education,7,11,4
1631,3,home,11,18,7
1631,4,shop,18,19,1
1631,5,home,19,24,5
1631,6,<ENDS>,24,24,0
1632,0,<START>,0,0,0
1632,1,home,0,6,6
1632,2,work,6,13,7
1632,3,shop,13,14,1
1632,4,work,14,20,6
1632,5,home,20,24,4
1632,6,<ENDS>,24,24,0
1633,0,<START>,0,0,0
1633,1,home,0,8,8
1633,2,work,8,14,6
1633,3,home,14,24,10
1633,4,<ENDS>,24,24,0
1634,0,<START>,0,0,0
1634,1,home,0,7,7
1634,2,shop,7,8,1
1634,3,education,8,11,3
1634,4,home,11,16,5
1634,5,shop,16,17,1
1634,6,home,17,24,7
1634,7,<ENDS>,24,24,0
1635,0,<START>,0,0,0
1635,1,home,0,7,7
1635,2,education,7,12,5
1635,3,home,12,18,6
1635,4,shop,18,19,1
1635,5,home,19,24,5
1635,6,<ENDS>,24,24,0
1636,0,<START>,0,0,0
1636,1,home,0,8,8
1636,2,work,8,16,8
1636,3,home,16,21,5
1636,4,work,21,22,1
1636,5,home,22,24,2
1636,6,<ENDS>,24,24,0
1637,0,<START>,0,0,0
1637,1,home,0,7,7
1637,2,work,7,13,6
1637,3,home,13,24,11
1637,4,<ENDS>,24,24,0
1638,0,<START>,0,0,0
1638,1,home,0,8,8
1638,2,work,8,15,7
1638,3,home,15,20,5
1638,4,shop,20,21,1
1638,5,home,21,24,3
1638,6,<ENDS>,24,24,0
1639,0,<START>,0,0,0
1639,1,home,0,8,8
1639,2,work,8,15,7
1639,3,home,15,23,8
1639,4,work,23,24,1
1639,5,<ENDS>,24,24,0
1640,0,<START>,0,0,0
1640,1,home,0,7,7
1640,2,education,7,11,4
1640,3,home,11,19,8
1640,4,shop,19,21,2
1640,5,home,21,24,3
1640,6,<ENDS>,24,24,0
1641,0,<START>,0,0,0
1641,1,home,0,7,7
1641,2,work,7,13,6
1641,3,shop,13,14,1
1641,4,home,14,24,10
1641,5,<ENDS>,24,24,0
1642,0,<START>,0,0,0
1642,1,home,0,7,7
1642,2,shop,7,9,2
1642,3,education,9,12,3
1642,4,home,12,19,7
1642,5,shop,19,21,2
1642,6,home,21,24,3
1642,7,<ENDS>,24,24,0
1643,0,<START>,0,0,0
1643,1,home,0,7,7
1643,2,shop,7,8,1
1643,3,home,8,13,5
1643,4,shop,13,14,1
1643,5,home,14,24,10
1643,6,<ENDS>,24,24,0
1644,0,<START>,0,0,0
1644,1,home,0,6,6
1644,2,work,6,12,6
1644,3,shop,12,13,1
1644,4,work,13,19,6
1644,5,home,19,24,5
1644,6,<ENDS>,24,24,0
1645,0,<START>,0,0,0
1645,1,home,0,7,7
1645,2,work,7,13,6
1645,3,shop,13,14,1
1645,4,work,14,19,5
1645,5,home,19,24,5
1645,6,<ENDS>,24,24,0
1646,0,<START>,0,0,0
1646,1,home,0,7,7
1646,2,work,7,14,7
1646,3,home,14,24,10
1646,4,<ENDS>,24,24,0
1647,0,<START>,0,0,0
1647,1,home,0,6,6
1647,2,work,6,8,2
1647,3,home,8,15,7
1647,4,work,15,17,2
1647,5,home,17,23,6
1647,6,work,23,24,1
1647,7,<ENDS>,24,24,0
1648,0,<START>,0,0,0
1648,1,home,0,6,6
1648,2,shop,6,7,1
1648,3,work,7,13,6
1648,4,shop,13,14,1
1648,5,home,14,24,10
1648,6,<ENDS>,24,24,0
1649,0,<START>,0,0,0
1649,1,home,0,7,7
1649,2,work,7,14,7
1649,3,shop,14,16,2
1649,4,work,16,18,2
1649,5,home,18,24,6
1649,6,<ENDS>,24,24,0
1650,0,<START>,0,0,0
1650,1,home,0,7,7
1650,2,work,7,8,1
1650,3,home,8,12,4
1650,4,work,12,14,2
1650,5,home,14,21,7
1650,6,work,21,22,1
1650,7,home,22,24,2
1650,8,<ENDS>,24,24,0
1651,0,<START>,0,0,0
1651,1,home,0,7,7
1651,2,work,7,13,6
1651,3,shop,13,14,1
1651,4,work,14,19,5
1651,5,home,19,24,5
1651,6,<ENDS>,24,24,0
1652,0,<START>,0,0,0
1652,1,home,0,6,6
1652,2,work,6,8,2
1652,3,home,8,14,6
1652,4,work,14,16,2
1652,5,home,16,22,6
1652,6,work,22,23,1
1652,7,home,23,24,1
1652,8,<ENDS>,24,24,0
1653,0,<START>,0,0,0
1653,1,home,0,7,7
1653,2,shop,7,9,2
1653,3,education,9,12,3
1653,4,shop,12,14,2
1653,5,education,14,16,2
1653,6,home,16,24,8
1653,7,<ENDS>,24,24,0
1654,0,<START>,0,0,0
1654,1,home,0,7,7
1654,2,education,7,12,5
1654,3,home,12,19,7
1654,4,shop,19,20,1
1654,5,home,20,24,4
1654,6,<ENDS>,24,24,0
1655,0,<START>,0,0,0
1655,1,home,0,7,7
1655,2,work,7,14,7
1655,3,home,14,18,4
1655,4,work,18,20,2
1655,5,home,20,24,4
1655,6,<ENDS>,24,24,0
1656,0,<START>,0,0,0
1656,1,home,0,7,7
1656,2,work,7,14,7
1656,3,home,14,24,10
1656,4,<ENDS>,24,24,0
1657,0,<START>,0,0,0
1657,1,home,0,8,8
1657,2,work,8,15,7
1657,3,home,15,24,9
1657,4,<ENDS>,24,24,0
1658,0,<START>,0,0,0
1658,1,home,0,7,7
1658,2,work,7,14,7
1658,3,home,14,24,10
1658,4,<ENDS>,24,24,0
1659,0,<START>,0,0,0
1659,1,home,0,8,8
1659,2,work,8,15,7
1659,3,home,15,24,9
1659,4,<ENDS>,24,24,0
1660,0,<START>,0,0,0
1660,1,home,0,7,7
1660,2,shop,7,8,1
1660,3,work,8,15,7
1660,4,home,15,23,8
1660,5,work,23,24,1
1660,6,<ENDS>,24,24,0
1661,0,<START>,0,0,0
1661,1,home,0,7,7
1661,2,education,7,12,5
1661,3,home,12,19,7
1661,4,shop,19,20,1
1661,5,home,20,24,4
1661,6,<ENDS>,24,24,0
1662,0,<START>,0,0,0
1662,1,home,0,8,8
1662,2,work,8,15,7
1662,3,home,15,24,9
1662,4,<ENDS>,24,24,0
1663,0,<START>,0,0,0
1663,1,home,0,6,6
1663,2,shop,6,7,1
1663,3,home,7,10,3
1663,4,education,10,15,5
1663,5,shop,15,16,1
1663,6,home,16,24,8
1663,7,<ENDS>,24,24,0
1664,0,<START>,0,0,0
1664,1,home,0,7,7
1664,2,work,7,13,6
1664,3,home,13,24,11
1664,4,<ENDS>,24,24,0
1665,0,<START>,0,0,0
1665,1,home,0,6,6
1665,2,work,6,13,7
1665,3,shop,13,14,1
1665,4,home,14,24,10
1665,5,<ENDS>,24,24,0
1666,0,<START>,0,0,0
1666,1,home,0,7,7
1666,2,education,7,12,5
1666,3,home,12,19,7
1666,4,shop,19,21,2
1666,5,home,21,24,3
1666,6,<ENDS>,24,24,0
1667,0,<START>,0,0,0
1667,1,home,0,8,8
1667,2,work,8,14,6
1667,3,home,14,24,10
1667,4,<ENDS>,24,24,0
1668,0,<START>,0,0,0
1668,1,home,0,6,6
1668,2,shop,6,7,1
1668,3,home,7,11,4
1668,4,work,11,18,7
1668,5,education,18,20,2
1668,6,home,20,24,4
1668,7,<ENDS>,24,24,0
1669,0,<START>,0,0,0
1669,1,home,0,8,8
1669,2,work,8,17,9
1669,3,home,17,24,7
1669,4,<ENDS>,24,24,0
1670,0,<START>,0,0,0
1670,1,home,0,7,7
1670,2,work,7,15,8
1670,3,home,15,24,9
1670,4,<ENDS>,24,24,0
1671,0,<START>,0,0,0
1671,1,home,0,6,6
1671,2,shop,6,7,1
1671,3,home,7,13,6
1671,4,education,13,16,3
1671,5,home,16,24,8
1671,6,<ENDS>,24,24,0
1672,0,<START>,0,0,0
1672,1,home,0,7,7
1672,2,shop,7,9,2
1672,3,education,9,12,3
1672,4,home,12,18,6
1672,5,shop,18,19,1
1672,6,home,19,24,5
1672,7,<ENDS>,24,24,0
1673,0,<START>,0,0,0
1673,1,home,0,7,7
1673,2,work,7,13,6
1673,3,home,13,24,11
1673,4,<ENDS>,24,24,0
1674,0,<START>,0,0,0
1674,1,home,0,6,6
1674,2,shop,6,7,1
1674,3,home,7,10,3
1674,4,education,10,11,1
1674,5,home,11,19,8
1674,6,shop,19,20,1
1674,7,home,20,24,4
1674,8,<ENDS>,24,24,0
1675,0,<START>,0,0,0
1675,1,home,0,7,7
1675,2,work,7,14,7
1675,3,home,14,18,4
1675,4,work,18,20,2
1675,5,home,20,24,4
1675,6,<ENDS>,24,24,0
1676,0,<START>,0,0,0
1676,1,home,0,7,7
1676,2,shop,7,8,1
1676,3,education,8,11,3
1676,4,home,11,17,6
1676,5,shop,17,19,2
1676,6,home,19,24,5
1676,7,<ENDS>,24,24,0
1677,0,<START>,0,0,0
1677,1,home,0,7,7
1677,2,work,7,9,2
1677,3,home,9,13,4
1677,4,work,13,16,3
1677,5,home,16,22,6
1677,6,work,22,23,1
1677,7,home,23,24,1
1677,8,<ENDS>,24,24,0
1678,0,<START>,0,0,0
1678,1,home,0,7,7
1678,2,work,7,13,6
1678,3,shop,13,14,1
1678,4,home,14,24,10
1678,5,<ENDS>,24,24,0
1679,0,<START>,0,0,0
1679,1,home,0,7,7
1679,2,work,7,13,6
1679,3,home,13,24,11
1679,4,<ENDS>,24,24,0
1680,0,<START>,0,0,0
1680,1,home,0,7,7
1680,2,work,7,13,6
1680,3,home,13,23,10
1680,4,work,23,24,1
1680,5,<ENDS>,24,24,0
1681,0,<START>,0,0,0
1681,1,home,0,7,7
1681,2,shop,7,8,1
1681,3,work,8,14,6
1681,4,home,14,24,10
1681,5,<ENDS>,24,24,0
1682,0,<START>,0,0,0
1682,1,home,0,6,6
1682,2,work,6,13,7
1682,3,shop,13,14,1
1682,4,home,14,18,4
1682,5,work,18,20,2
1682,6,home,20,24,4
1682,7,<ENDS>,24,24,0
1683,0,<START>,0,0,0
1683,1,home,0,6,6
1683,2,shop,6,7,1
1683,3,work,7,14,7
1683,4,home,14,23,9
1683,5,work,23,24,1
1683,6,<ENDS>,24,24,0
1684,0,<START>,0,0,0
1684,1,home,0,6,6
1684,2,work,6,8,2
1684,3,home,8,15,7
1684,4,work,15,17,2
1684,5,home,17,23,6
1684,6,work,23,24,1
1684,7,<ENDS>,24,24,0
1685,0,<START>,0,0,0
1685,1,home,0,6,6
1685,2,shop,6,7,1
1685,3,work,7,10,3
1685,4,home,10,16,6
1685,5,work,16,18,2
1685,6,home,18,24,6
1685,7,<ENDS>,24,24,0
1686,0,<START>,0,0,0
1686,1,home,0,8,8
1686,2,work,8,15,7
1686,3,home,15,24,9
1686,4,<ENDS>,24,24,0
1687,0,<START>,0,0,0
1687,1,home,0,7,7
1687,2,education,7,10,3
1687,3,home,10,14,4
1687,4,education,14,16,2
1687,5,home,16,24,8
1687,6,<ENDS>,24,24,0
1688,0,<START>,0,0,0
1688,1,home,0,7,7
1688,2,work,7,13,6
1688,3,shop,13,14,1
1688,4,home,14,20,6
1688,5,shop,20,21,1
1688,6,home,21,24,3
1688,7,<ENDS>,24,24,0
1689,0,<START>,0,0,0
1689,1,home,0,7,7
1689,2,work,7,13,6
1689,3,shop,13,14,1
1689,4,home,14,24,10
1689,5,<ENDS>,24,24,0
1690,0,<START>,0,0,0
1690,1,home,0,9,9
1690,2,work,9,16,7
1690,3,shop,16,17,1
1690,4,work,17,20,3
1690,5,home,20,24,4
1690,6,<ENDS>,24,24,0
1691,0,<START>,0,0,0
1691,1,home,0,8,8
1691,2,education,8,11,3
1691,3,home,11,19,8
1691,4,shop,19,20,1
1691,5,home,20,24,4
1691,6,<ENDS>,24,24,0
1692,0,<START>,0,0,0
1692,1,home,0,8,8
1692,2,work,8,14,6
1692,3,home,14,18,4
1692,4,shop,18,19,1
1692,5,home,19,24,5
1692,6,<ENDS>,24,24,0
1693,0,<START>,0,0,0
1693,1,home,0,6,6
1693,2,work,6,13,7
1693,3,shop,13,14,1
1693,4,home,14,24,10
1693,5,<ENDS>,24,24,0
1694,0,<START>,0,0,0
1694,1,home,0,6,6
1694,2,shop,6,7,1
1694,3,home,7,13,6
1694,4,education,13,16,3
1694,5,shop,16,17,1
1694,6,home,17,24,7
1694,7,<ENDS>,24,24,0
1695,0,<START>,0,0,0
1695,1,home,0,5,5
1695,2,work,5,13,8
1695,3,home,13,17,4
1695,4,work,17,20,3
1695,5,home,20,24,4
1695,6,<ENDS>,24,24,0
1696,0,<START>,0,0,0
1696,1,home,0,8,8
1696,2,shop,8,9,1
1696,3,home,9,15,6
1696,4,work,15,20,5
1696,5,home,20,24,4
1696,6,<ENDS>,24,24,0
1697,0,<START>,0,0,0
1697,1,home,0,7,7
1697,2,work,7,14,7
1697,3,shop,14,15,1
1697,4,work,15,20,5
1697,5,home,20,24,4
1697,6,<ENDS>,24,24,0
1698,0,<START>,0,0,0
1698,1,home,0,7,7
1698,2,work,7,14,7
1698,3,home,14,23,9
1698,4,work,23,24,1
1698,5,<ENDS>,24,24,0
1699,0,<START>,0,0,0
1699,1,home,0,8,8
1699,2,work,8,14,6
1699,3,home,14,18,4
1699,4,work,18,20,2
1699,5,home,20,24,4
1699,6,<ENDS>,24,24,0
1700,0,<START>,0,0,0
1700,1,home,0,9,9
1700,2,work,9,16,7
1700,3,home,16,24,8
1700,4,<ENDS>,24,24,0
1701,0,<START>,0,0,0
1701,1,home,0,6,6
1701,2,shop,6,7,1
1701,3,work,7,14,7
1701,4,home,14,24,10
1701,5,<ENDS>,24,24,0
1702,0,<START>,0,0,0
1702,1,home,0,7,7
1702,2,work,7,15,8
1702,3,home,15,21,6
1702,4,work,21,22,1
1702,5,home,22,24,2
1702,6,<ENDS>,24,24,0
1703,0,<START>,0,0,0
1703,1,home,0,6,6
1703,2,work,6,8,2
1703,3,home,8,9,1
1703,4,work,9,11,2
1703,5,home,11,17,6
1703,6,work,17,19,2
1703,7,home,19,23,4
1703,8,work,23,24,1
1703,9,<ENDS>,24,24,0
1704,0,<START>,0,0,0
1704,1,home,0,6,6
1704,2,work,6,8,2
1704,3,home,8,12,4
1704,4,work,12,14,2
1704,5,home,14,21,7
1704,6,work,21,22,1
1704,7,home,22,24,2
1704,8,<ENDS>,24,24,0
1705,0,<START>,0,0,0
1705,1,home,0,6,6
1705,2,work,6,12,6
1705,3,shop,12,13,1
1705,4,work,13,19,6
1705,5,home,19,24,5
1705,6,<ENDS>,24,24,0
1706,0,<START>,0,0,0
1706,1,home,0,8,8
1706,2,work,8,16,8
1706,3,home,16,23,7
1706,4,work,23,24,1
1706,5,<ENDS>,24,24,0
1707,0,<START>,0,0,0
1707,1,home,0,7,7
1707,2,work,7,13,6
1707,3,shop,13,14,1
1707,4,home,14,16,2
1707,5,work,16,20,4
1707,6,home,20,24,4
1707,7,<ENDS>,24,24,0
1708,0,<START>,0,0,0
1708,1,home,0,8,8
1708,2,work,8,14,6
1708,3,home,14,20,6
1708,4,shop,20,21,1
1708,5,home,21,24,3
1708,6,<ENDS>,24,24,0
1709,0,<START>,0,0,0
1709,1,home,0,6,6
1709,2,shop,6,7,1
1709,3,home,7,13,6
1709,4,education,13,16,3
1709,5,home,16,24,8
1709,6,<ENDS>,24,24,0
1710,0,<START>,0,0,0
1710,1,home,0,7,7
1710,2,work,7,14,7
1710,3,home,14,24,10
1710,4,<ENDS>,24,24,0
1711,0,<START>,0,0,0
1711,1,home,0,6,6
1711,2,work,6,13,7
1711,3,home,13,18,5
1711,4,shop,18,19,1
1711,5,home,19,24,5
1711,6,<ENDS>,24,24,0
1712,0,<START>,0,0,0
1712,1,home,0,8,8
1712,2,work,8,15,7
1712,3,home,15,24,9
1712,4,<ENDS>,24,24,0
1713,0,<START>,0,0,0
1713,1,home,0,7,7
1713,2,education,7,11,4
1713,3,home,11,18,7
1713,4,shop,18,19,1
1713,5,home,19,24,5
1713,6,<ENDS>,24,24,0
1714,0,<START>,0,0,0
1714,1,home,0,7,7
1714,2,work,7,14,7
1714,3,home,14,24,10
1714,4,<ENDS>,24,24,0
1715,0,<START>,0,0,0
1715,1,home,0,7,7
1715,2,work,7,13,6
1715,3,shop,13,14,1
1715,4,work,14,20,6
1715,5,home,20,24,4
1715,6,<ENDS>,24,24,0
1716,0,<START>,0,0,0
1716,1,home,0,7,7
1716,2,shop,7,8,1
1716,3,work,8,14,6
1716,4,home,14,17,3
1716,5,work,17,20,3
1716,6,home,20,24,4
1716,7,<ENDS>,24,24,0
1717,0,<START>,0,0,0
1717,1,home,0,8,8
1717,2,education,8,11,3
1717,3,shop,11,12,1
1717,4,work,12,19,7
1717,5,home,19,23,4
1717,6,work,23,24,1
1717,7,<ENDS>,24,24,0
1718,0,<START>,0,0,0
1718,1,home,0,8,8
1718,2,work,8,14,6
1718,3,shop,14,15,1
1718,4,work,15,19,4
1718,5,home,19,23,4
1718,6,work,23,24,1
1718,7,<ENDS>,24,24,0
1719,0,<START>,0,0,0
1719,1,home,0,6,6
1719,2,work,6,13,7
1719,3,shop,13,14,1
1719,4,home,14,22,8
1719,5,work,22,23,1
1719,6,home,23,24,1
1719,7,<ENDS>,24,24,0
1720,0,<START>,0,0,0
1720,1,home,0,8,8
1720,2,work,8,15,7
1720,3,home,15,24,9
1720,4,<ENDS>,24,24,0
1721,0,<START>,0,0,0
1721,1,home,0,7,7
1721,2,education,7,11,4
1721,3,home,11,18,7
1721,4,shop,18,19,1
1721,5,home,19,24,5
1721,6,<ENDS>,24,24,0
1722,0,<START>,0,0,0
1722,1,home,0,8,8
1722,2,work,8,15,7
1722,3,home,15,24,9
1722,4,<ENDS>,24,24,0
1723,0,<START>,0,0,0
1723,1,home,0,7,7
1723,2,shop,7,8,1
1723,3,home,8,13,5
1723,4,education,13,16,3
1723,5,home,16,23,7
1723,6,work,23,24,1
1723,7,<ENDS>,24,24,0
1724,0,<START>,0,0,0
1724,1,home,0,7,7
1724,2,shop,7,9,2
1724,3,education,9,13,4
1724,4,shop,13,14,1
1724,5,home,14,20,6
1724,6,shop,20,21,1
1724,7,home,21,24,3
1724,8,<ENDS>,24,24,0
1725,0,<START>,0,0,0
1725,1,home,0,8,8
1725,2,shop,8,9,1
1725,3,home,9,13,4
1725,4,work,13,19,6
1725,5,home,19,24,5
1725,6,<ENDS>,24,24,0
1726,0,<START>,0,0,0
1726,1,home,0,7,7
1726,2,work,7,13,6
1726,3,shop,13,14,1
1726,4,home,14,24,10
1726,5,<ENDS>,24,24,0
1727,0,<START>,0,0,0
1727,1,home,0,8,8
1727,2,work,8,15,7
1727,3,home,15,24,9
1727,4,<ENDS>,24,24,0
1728,0,<START>,0,0,0
1728,1,home,0,6,6
1728,2,shop,6,7,1
1728,3,work,7,13,6
1728,4,home,13,17,4
1728,5,shop,17,18,1
1728,6,home,18,24,6
1728,7,<ENDS>,24,24,0
1729,0,<START>,0,0,0
1729,1,home,0,7,7
1729,2,education,7,12,5
1729,3,shop,12,14,2
1729,4,education,14,16,2
1729,5,home,16,24,8
1729,6,<ENDS>,24,24,0
1730,0,<START>,0,0,0
1730,1,home,0,7,7
1730,2,education,7,12,5
1730,3,home,12,20,8
1730,4,shop,20,21,1
1730,5,home,21,24,3
1730,6,<ENDS>,24,24,0
1731,0,<START>,0,0,0
1731,1,home,0,6,6
1731,2,work,6,13,7
1731,3,home,13,24,11
1731,4,<ENDS>,24,24,0
1732,0,<START>,0,0,0
1732,1,home,0,7,7
1732,2,education,7,11,4
1732,3,home,11,19,8
1732,4,shop,19,20,1
1732,5,home,20,24,4
1732,6,<ENDS>,24,24,0
1733,0,<START>,0,0,0
1733,1,home,0,8,8
1733,2,shop,8,9,1
1733,3,home,9,21,12
1733,4,work,21,22,1
1733,5,home,22,24,2
1733,6,<ENDS>,24,24,0
1734,0,<START>,0,0,0
1734,1,home,0,7,7
1734,2,work,7,9,2
1734,3,home,9,15,6
1734,4,work,15,17,2
1734,5,home,17,23,6
1734,6,work,23,24,1
1734,7,<ENDS>,24,24,0
1735,0,<START>,0,0,0
1735,1,home,0,8,8
1735,2,work,8,15,7
1735,3,shop,15,16,1
1735,4,home,16,24,8
1735,5,<ENDS>,24,24,0
1736,0,<START>,0,0,0
1736,1,home,0,7,7
1736,2,work,7,9,2
1736,3,home,9,13,4
1736,4,work,13,15,2
1736,5,home,15,24,9
1736,6,<ENDS>,24,24,0
1737,0,<START>,0,0,0
1737,1,home,0,7,7
1737,2,education,7,10,3
1737,3,home,10,14,4
1737,4,education,14,16,2
1737,5,home,16,24,8
1737,6,<ENDS>,24,24,0
1738,0,<START>,0,0,0
1738,1,home,0,6,6
1738,2,work,6,8,2
1738,3,home,8,9,1
1738,4,work,9,11,2
1738,5,home,11,17,6
1738,6,work,17,18,1
1738,7,home,18,24,6
1738,8,<ENDS>,24,24,0
1739,0,<START>,0,0,0
1739,1,home,0,7,7
1739,2,work,7,13,6
1739,3,home,13,21,8
1739,4,work,21,22,1
1739,5,home,22,24,2
1739,6,<ENDS>,24,24,0
1740,0,<START>,0,0,0
1740,1,home,0,6,6
1740,2,work,6,7,1
1740,3,home,7,9,2
1740,4,work,9,11,2
1740,5,home,11,18,7
1740,6,work,18,19,1
1740,7,home,19,24,5
1740,8,<ENDS>,24,24,0
1741,0,<START>,0,0,0
1741,1,home,0,7,7
1741,2,shop,7,8,1
1741,3,home,8,12,4
1741,4,work,12,19,7
1741,5,home,19,24,5
1741,6,<ENDS>,24,24,0
1742,0,<START>,0,0,0
1742,1,home,0,7,7
1742,2,education,7,11,4
1742,3,home,11,20,9
1742,4,shop,20,21,1
1742,5,home,21,24,3
1742,6,<ENDS>,24,24,0
1743,0,<START>,0,0,0
1743,1,home,0,8,8
1743,2,work,8,16,8
1743,3,home,16,24,8
1743,4,<ENDS>,24,24,0
1744,0,<START>,0,0,0
1744,1,home,0,6,6
1744,2,work,6,13,7
1744,3,home,13,17,4
1744,4,work,17,20,3
1744,5,home,20,24,4
1744,6,<ENDS>,24,24,0
1745,0,<START>,0,0,0
1745,1,home,0,8,8
1745,2,work,8,15,7
1745,3,shop,15,16,1
1745,4,home,16,24,8
1745,5,<ENDS>,24,24,0
1746,0,<START>,0,0,0
1746,1,home,0,8,8
1746,2,work,8,14,6
1746,3,home,14,18,4
1746,4,work,18,20,2
1746,5,home,20,24,4
1746,6,<ENDS>,24,24,0
1747,0,<START>,0,0,0
1747,1,home,0,6,6
1747,2,work,6,7,1
1747,3,home,7,12,5
1747,4,work,12,13,1
1747,5,home,13,22,9
1747,6,work,22,23,1
1747,7,home,23,24,1
1747,8,<ENDS>,24,24,0
1748,0,<START>,0,0,0
1748,1,home,0,6,6
1748,2,shop,6,7,1
1748,3,home,7,10,3
1748,4,education,10,12,2
1748,5,home,12,19,7
1748,6,shop,19,20,1
1748,7,home,20,24,4
1748,8,<ENDS>,24,24,0
1749,0,<START>,0,0,0
1749,1,home,0,7,7
1749,2,work,7,14,7
1749,3,shop,14,15,1
1749,4,work,15,20,5
1749,5,home,20,24,4
1749,6,<ENDS>,24,24,0
1750,0,<START>,0,0,0
1750,1,home,0,6,6
1750,2,work,6,13,7
1750,3,home,13,17,4
1750,4,work,17,20,3
1750,5,home,20,24,4
1750,6,<ENDS>,24,24,0
1751,0,<START>,0,0,0
1751,1,home,0,7,7
1751,2,work,7,13,6
1751,3,home,13,24,11
1751,4,<ENDS>,24,24,0
1752,0,<START>,0,0,0
1752,1,home,0,7,7
1752,2,work,7,14,7
1752,3,home,14,20,6
1752,4,shop,20,21,1
1752,5,home,21,24,3
1752,6,<ENDS>,24,24,0
1753,0,<START>,0,0,0
1753,1,home,0,8,8
1753,2,work,8,16,8
1753,3,home,16,24,8
1753,4,<ENDS>,24,24,0
1754,0,<START>,0,0,0
1754,1,home,0,6,6
1754,2,work,6,7,1
1754,3,home,7,12,5
1754,4,work,12,14,2
1754,5,home,14,15,1
1754,6,work,15,18,3
1754,7,home,18,24,6
1754,8,<ENDS>,24,24,0
1755,0,<START>,0,0,0
1755,1,home,0,8,8
1755,2,education,8,12,4
1755,3,home,12,19,7
1755,4,shop,19,21,2
1755,5,home,21,24,3
1755,6,<ENDS>,24,24,0
1756,0,<START>,0,0,0
1756,1,home,0,6,6
1756,2,work,6,13,7
1756,3,shop,13,14,1
1756,4,home,14,21,7
1756,5,work,21,22,1
1756,6,home,22,24,2
1756,7,<ENDS>,24,24,0
1757,0,<START>,0,0,0
1757,1,home,0,7,7
1757,2,work,7,14,7
1757,3,home,14,24,10
1757,4,<ENDS>,24,24,0
1758,0,<START>,0,0,0
1758,1,home,0,7,7
1758,2,work,7,13,6
1758,3,home,13,17,4
1758,4,work,17,20,3
1758,5,home,20,24,4
1758,6,<ENDS>,24,24,0
1759,0,<START>,0,0,0
1759,1,home,0,6,6
1759,2,shop,6,7,1
1759,3,home,7,10,3
1759,4,education,10,13,3
1759,5,home,13,20,7
1759,6,shop,20,21,1
1759,7,home,21,24,3
1759,8,<ENDS>,24,24,0
1760,0,<START>,0,0,0
1760,1,home,0,6,6
1760,2,work,6,8,2
1760,3,home,8,13,5
1760,4,work,13,16,3
1760,5,home,16,24,8
1760,6,<ENDS>,24,24,0
1761,0,<START>,0,0,0
1761,1,home,0,7,7
1761,2,work,7,13,6
1761,3,shop,13,14,1
1761,4,work,14,19,5
1761,5,home,19,24,5
1761,6,<ENDS>,24,24,0
1762,0,<START>,0,0,0
1762,1,home,0,7,7
1762,2,work,7,14,7
1762,3,shop,14,15,1
1762,4,home,15,24,9
1762,5,<ENDS>,24,24,0
1763,0,<START>,0,0,0
1763,1,home,0,7,7
1763,2,education,7,12,5
1763,3,shop,12,13,1
1763,4,education,13,15,2
1763,5,shop,15,17,2
1763,6,home,17,20,3
1763,7,shop,20,21,1
1763,8,home,21,24,3
1763,9,<ENDS>,24,24,0
1764,0,<START>,0,0,0
1764,1,home,0,6,6
1764,2,shop,6,7,1
1764,3,home,7,9,2
1764,4,education,9,12,3
1764,5,shop,12,13,1
1764,6,home,13,21,8
1764,7,shop,21,22,1
1764,8,home,22,24,2
1764,9,<ENDS>,24,24,0
1765,0,<START>,0,0,0
1765,1,home,0,8,8
1765,2,education,8,11,3
1765,3,home,11,19,8
1765,4,shop,19,21,2
1765,5,home,21,24,3
1765,6,<ENDS>,24,24,0
1766,0,<START>,0,0,0
1766,1,home,0,7,7
1766,2,work,7,14,7
1766,3,shop,14,15,1
1766,4,work,15,19,4
1766,5,home,19,24,5
1766,6,<ENDS>,24,24,0
1767,0,<START>,0,0,0
1767,1,home,0,7,7
1767,2,work,7,9,2
1767,3,home,9,13,4
1767,4,work,13,14,1
1767,5,home,14,21,7
1767,6,work,21,22,1
1767,7,home,22,24,2
1767,8,<ENDS>,24,24,0
1768,0,<START>,0,0,0
1768,1,home,0,7,7
1768,2,work,7,14,7
1768,3,home,14,18,4
1768,4,shop,18,19,1
1768,5,home,19,24,5
1768,6,<ENDS>,24,24,0
1769,0,<START>,0,0,0
1769,1,home,0,6,6
1769,2,shop,6,7,1
1769,3,home,7,11,4
1769,4,work,11,12,1
1769,5,home,12,17,5
1769,6,work,17,19,2
1769,7,home,19,24,5
1769,8,<ENDS>,24,24,0
1770,0,<START>,0,0,0
1770,1,home,0,8,8
1770,2,work,8,16,8
1770,3,shop,16,17,1
1770,4,home,17,24,7
1770,5,<ENDS>,24,24,0
1771,0,<START>,0,0,0
1771,1,home,0,6,6
1771,2,work,6,13,7
1771,3,home,13,14,1
1771,4,work,14,19,5
1771,5,home,19,24,5
1771,6,<ENDS>,24,24,0
1772,0,<START>,0,0,0
1772,1,home,0,7,7
1772,2,education,7,12,5
1772,3,home,12,19,7
1772,4,shop,19,20,1
1772,5,home,20,24,4
1772,6,<ENDS>,24,24,0
1773,0,<START>,0,0,0
1773,1,home,0,6,6
1773,2,work,6,8,2
1773,3,home,8,10,2
1773,4,work,10,12,2
1773,5,home,12,21,9
1773,6,work,21,22,1
1773,7,home,22,24,2
1773,8,<ENDS>,24,24,0
1774,0,<START>,0,0,0
1774,1,home,0,8,8
1774,2,work,8,13,5
1774,3,shop,13,14,1
1774,4,home,14,24,10
1774,5,<ENDS>,24,24,0
1775,0,<START>,0,0,0
1775,1,home,0,7,7
1775,2,work,7,13,6
1775,3,home,13,17,4
1775,4,work,17,20,3
1775,5,home,20,24,4
1775,6,<ENDS>,24,24,0
1776,0,<START>,0,0,0
1776,1,home,0,7,7
1776,2,work,7,13,6
1776,3,home,13,24,11
1776,4,<ENDS>,24,24,0
1777,0,<START>,0,0,0
1777,1,home,0,6,6
1777,2,work,6,7,1
1777,3,home,7,10,3
1777,4,work,10,11,1
1777,5,home,11,15,4
1777,6,work,15,17,2
1777,7,home,17,24,7
1777,8,<ENDS>,24,24,0
1778,0,<START>,0,0,0
1778,1,home,0,8,8
1778,2,work,8,16,8
1778,3,shop,16,17,1
1778,4,home,17,24,7
1778,5,<ENDS>,24,24,0
1779,0,<START>,0,0,0
1779,1,home,0,6,6
1779,2,shop,6,7,1
1779,3,home,7,13,6
1779,4,education,13,16,3
1779,5,home,16,24,8
1779,6,<ENDS>,24,24,0
1780,0,<START>,0,0,0
1780,1,home,0,7,7
1780,2,work,7,13,6
1780,3,home,13,17,4
1780,4,work,17,19,2
1780,5,home,19,24,5
1780,6,<ENDS>,24,24,0
1781,0,<START>,0,0,0
1781,1,home,0,7,7
1781,2,work,7,9,2
1781,3,home,9,13,4
1781,4,work,13,15,2
1781,5,home,15,22,7
1781,6,work,22,23,1
1781,7,home,23,24,1
1781,8,<ENDS>,24,24,0
1782,0,<START>,0,0,0
1782,1,home,0,7,7
1782,2,work,7,9,2
1782,3,home,9,14,5
1782,4,work,14,17,3
1782,5,home,17,24,7
1782,6,<ENDS>,24,24,0
1783,0,<START>,0,0,0
1783,1,home,0,6,6
1783,2,shop,6,7,1
1783,3,home,7,16,9
1783,4,work,16,20,4
1783,5,home,20,24,4
1783,6,<ENDS>,24,24,0
1784,0,<START>,0,0,0
1784,1,home,0,6,6
1784,2,work,6,13,7
1784,3,shop,13,14,1
1784,4,work,14,19,5
1784,5,home,19,24,5
1784,6,<ENDS>,24,24,0
1785,0,<START>,0,0,0
1785,1,home,0,6,6
1785,2,shop,6,7,1
1785,3,home,7,13,6
1785,4,education,13,16,3
1785,5,home,16,24,8
1785,6,<ENDS>,24,24,0
1786,0,<START>,0,0,0
1786,1,home,0,6,6
1786,2,work,6,13,7
1786,3,home,13,18,5
1786,4,shop,18,19,1
1786,5,home,19,24,5
1786,6,<ENDS>,24,24,0
1787,0,<START>,0,0,0
1787,1,home,0,7,7
1787,2,work,7,14,7
1787,3,home,14,24,10
1787,4,<ENDS>,24,24,0
1788,0,<START>,0,0,0
1788,1,home,0,9,9
1788,2,work,9,15,6
1788,3,home,15,21,6
1788,4,work,21,22,1
1788,5,home,22,24,2
1788,6,<ENDS>,24,24,0
1789,0,<START>,0,0,0
1789,1,home,0,6,6
1789,2,work,6,13,7
1789,3,shop,13,14,1
1789,4,work,14,19,5
1789,5,home,19,24,5
1789,6,<ENDS>,24,24,0
1790,0,<START>,0,0,0
1790,1,home,0,7,7
1790,2,shop,7,8,1
1790,3,education,8,11,3
1790,4,home,11,17,6
1790,5,shop,17,19,2
1790,6,home,19,24,5
1790,7,<ENDS>,24,24,0
1791,0,<START>,0,0,0
1791,1,home,0,7,7
1791,2,work,7,14,7
1791,3,shop,14,15,1
1791,4,home,15,24,9
1791,5,<ENDS>,24,24,0
1792,0,<START>,0,0,0
1792,1,home,0,7,7
1792,2,education,7,11,4
1792,3,home,11,20,9
1792,4,shop,20,21,1
1792,5,home,21,24,3
1792,6,<ENDS>,24,24,0
1793,0,<START>,0,0,0
1793,1,home,0,7,7
1793,2,work,7,13,6
1793,3,home,13,17,4
1793,4,shop,17,18,1
1793,5,home,18,24,6
1793,6,<ENDS>,24,24,0
1794,0,<START>,0,0,0
1794,1,home,0,6,6
1794,2,shop,6,7,1
1794,3,home,7,10,3
1794,4,education,10,13,3
1794,5,home,13,20,7
1794,6,shop,20,21,1
1794,7,home,21,24,3
1794,8,<ENDS>,24,24,0
1795,0,<START>,0,0,0
1795,1,home,0,8,8
1795,2,work,8,14,6
1795,3,home,14,23,9
1795,4,work,23,24,1
1795,5,<ENDS>,24,24,0
1796,0,<START>,0,0,0
1796,1,home,0,7,7
1796,2,work,7,13,6
1796,3,home,13,18,5
1796,4,work,18,20,2
1796,5,home,20,24,4
1796,6,<ENDS>,24,24,0
1797,0,<START>,0,0,0
1797,1,home,0,8,8
1797,2,education,8,12,4
1797,3,home,12,24,12
1797,4,<ENDS>,24,24,0
1798,0,<START>,0,0,0
1798,1,home,0,8,8
1798,2,work,8,14,6
1798,3,shop,14,15,1
1798,4,home,15,24,9
1798,5,<ENDS>,24,24,0
1799,0,<START>,0,0,0
1799,1,home,0,7,7
1799,2,work,7,14,7
1799,3,home,14,18,4
1799,4,shop,18,19,1
1799,5,home,19,24,5
1799,6,<ENDS>,24,24,0
1800,0,<START>,0,0,0
1800,1,home,0,7,7
1800,2,education,7,12,5
1800,3,shop,12,13,1
1800,4,education,13,16,3
1800,5,home,16,24,8
1800,6,<ENDS>,24,24,0
1801,0,<START>,0,0,0
1801,1,home,0,7,7
1801,2,work,7,13,6
1801,3,home,13,21,8
1801,4,work,21,22,1
1801,5,home,22,24,2
1801,6,<ENDS>,24,24,0
1802,0,<START>,0,0,0
1802,1,home,0,7,7
1802,2,work,7,13,6
1802,3,home,13,20,7
1802,4,shop,20,21,1
1802,5,home,21,24,3
1802,6,<ENDS>,24,24,0
1803,0,<START>,0,0,0
1803,1,home,0,7,7
1803,2,work,7,14,7
1803,3,shop,14,15,1
1803,4,work,15,19,4
1803,5,home,19,24,5
1803,6,<ENDS>,24,24,0
1804,0,<START>,0,0,0
1804,1,home,0,7,7
1804,2,work,7,14,7
1804,3,home,14,22,8
1804,4,work,22,23,1
1804,5,home,23,24,1
1804,6,<ENDS>,24,24,0
1805,0,<START>,0,0,0
1805,1,home,0,7,7
1805,2,work,7,14,7
1805,3,shop,14,15,1
1805,4,home,15,24,9
1805,5,<ENDS>,24,24,0
1806,0,<START>,0,0,0
1806,1,home,0,7,7
1806,2,work,7,14,7
1806,3,shop,14,15,1
1806,4,home,15,21,6
1806,5,work,21,22,1
1806,6,home,22,24,2
1806,7,<ENDS>,24,24,0
1807,0,<START>,0,0,0
1807,1,home,0,6,6
1807,2,work,6,13,7
1807,3,home,13,18,5
1807,4,shop,18,19,1
1807,5,home,19,24,5
1807,6,<ENDS>,24,24,0
1808,0,<START>,0,0,0
1808,1,home,0,8,8
1808,2,work,8,15,7
1808,3,home,15,22,7
1808,4,work,22,23,1
1808,5,home,23,24,1
1808,6,<ENDS>,24,24,0
1809,0,<START>,0,0,0
1809,1,home,0,6,6
1809,2,work,6,9,3
1809,3,home,9,15,6
1809,4,work,15,19,4
1809,5,home,19,24,5
1809,6,<ENDS>,24,24,0
1810,0,<START>,0,0,0
1810,1,home,0,6,6
1810,2,work,6,13,7
1810,3,home,13,24,11
1810,4,<ENDS>,24,24,0
1811,0,<START>,0,0,0
1811,1,home,0,7,7
1811,2,education,7,10,3
1811,3,home,10,13,3
1811,4,education,13,16,3
1811,5,home,16,24,8
1811,6,<ENDS>,24,24,0
1812,0,<START>,0,0,0
1812,1,home,0,8,8
1812,2,work,8,15,7
1812,3,home,15,21,6
1812,4,work,21,22,1
1812,5,home,22,24,2
1812,6,<ENDS>,24,24,0
1813,0,<START>,0,0,0
1813,1,home,0,7,7
1813,2,work,7,14,7
1813,3,home,14,17,3
1813,4,work,17,20,3
1813,5,home,20,24,4
1813,6,<ENDS>,24,24,0
1814,0,<START>,0,0,0
1814,1,home,0,6,6
1814,2,shop,6,7,1
1814,3,work,7,14,7
1814,4,shop,14,15,1
1814,5,home,15,24,9
1814,6,<ENDS>,24,24,0
1815,0,<START>,0,0,0
1815,1,home,0,8,8
1815,2,work,8,15,7
1815,3,home,15,20,5
1815,4,shop,20,21,1
1815,5,home,21,24,3
1815,6,<ENDS>,24,24,0
1816,0,<START>,0,0,0
1816,1,home,0,6,6
1816,2,work,6,8,2
1816,3,home,8,13,5
1816,4,work,13,14,1
1816,5,home,14,21,7
1816,6,work,21,22,1
1816,7,home,22,24,2
1816,8,<ENDS>,24,24,0
1817,0,<START>,0,0,0
1817,1,home,0,6,6
1817,2,shop,6,7,1
1817,3,work,7,13,6
1817,4,shop,13,14,1
1817,5,work,14,19,5
1817,6,education,19,20,1
1817,7,home,20,24,4
1817,8,<ENDS>,24,24,0
1818,0,<START>,0,0,0
1818,1,home,0,7,7
1818,2,shop,7,8,1
1818,3,education,8,11,3
1818,4,home,11,19,8
1818,5,shop,19,20,1
1818,6,home,20,24,4
1818,7,<ENDS>,24,24,0
1819,0,<START>,0,0,0
1819,1,home,0,8,8
1819,2,work,8,16,8
1819,3,home,16,24,8
1819,4,<ENDS>,24,24,0
1820,0,<START>,0,0,0
1820,1,home,0,7,7
1820,2,work,7,9,2
1820,3,home,9,15,6
1820,4,work,15,18,3
1820,5,home,18,24,6
1820,6,<ENDS>,24,24,0
1821,0,<START>,0,0,0
1821,1,home,0,7,7
1821,2,work,7,14,7
1821,3,home,14,19,5
1821,4,shop,19,20,1
1821,5,home,20,24,4
1821,6,<ENDS>,24,24,0
1822,0,<START>,0,0,0
1822,1,home,0,7,7
1822,2,work,7,9,2
1822,3,home,9,15,6
1822,4,work,15,17,2
1822,5,home,17,22,5
1822,6,work,22,23,1
1822,7,home,23,24,1
1822,8,<ENDS>,24,24,0
1823,0,<START>,0,0,0
1823,1,home,0,7,7
1823,2,work,7,13,6
1823,3,home,13,24,11
1823,4,<ENDS>,24,24,0
1824,0,<START>,0,0,0
1824,1,home,0,9,9
1824,2,work,9,15,6
1824,3,home,15,24,9
1824,4,<ENDS>,24,24,0
1825,0,<START>,0,0,0
1825,1,home,0,8,8
1825,2,work,8,14,6
1825,3,shop,14,15,1
1825,4,home,15,21,6
1825,5,work,21,22,1
1825,6,home,22,24,2
1825,7,<ENDS>,24,24,0
1826,0,<START>,0,0,0
1826,1,home,0,7,7
1826,2,work,7,14,7
1826,3,home,14,23,9
1826,4,work,23,24,1
1826,5,<ENDS>,24,24,0
1827,0,<START>,0,0,0
1827,1,home,0,6,6
1827,2,shop,6,7,1
1827,3,home,7,10,3
1827,4,education,10,13,3
1827,5,shop,13,15,2
1827,6,home,15,24,9
1827,7,<ENDS>,24,24,0
1828,0,<START>,0,0,0
1828,1,home,0,8,8
1828,2,education,8,12,4
1828,3,shop,12,13,1
1828,4,work,13,20,7
1828,5,home,20,24,4
1828,6,<ENDS>,24,24,0
1829,0,<START>,0,0,0
1829,1,home,0,7,7
1829,2,education,7,12,5
1829,3,shop,12,13,1
1829,4,education,13,16,3
1829,5,home,16,24,8
1829,6,<ENDS>,24,24,0
1830,0,<START>,0,0,0
1830,1,home,0,9,9
1830,2,education,9,13,4
1830,3,shop,13,14,1
1830,4,home,14,24,10
1830,5,<ENDS>,24,24,0
1831,0,<START>,0,0,0
1831,1,home,0,7,7
1831,2,shop,7,8,1
1831,3,education,8,12,4
1831,4,home,12,19,7
1831,5,shop,19,20,1
1831,6,home,20,24,4
1831,7,<ENDS>,24,24,0
1832,0,<START>,0,0,0
1832,1,home,0,7,7
1832,2,shop,7,8,1
1832,3,education,8,13,5
1832,4,shop,13,15,2
1832,5,home,15,24,9
1832,6,<ENDS>,24,24,0
1833,0,<START>,0,0,0
1833,1,home,0,9,9
1833,2,work,9,16,7
1833,3,home,16,24,8
1833,4,<ENDS>,24,24,0
1834,0,<START>,0,0,0
1834,1,home,0,6,6
1834,2,work,6,14,8
1834,3,shop,14,15,1
1834,4,home,15,24,9
1834,5,<ENDS>,24,24,0
1835,0,<START>,0,0,0
1835,1,home,0,6,6
1835,2,shop,6,7,1
1835,3,home,7,9,2
1835,4,education,9,13,4
1835,5,shop,13,15,2
1835,6,home,15,24,9
1835,7,<ENDS>,24,24,0
1836,0,<START>,0,0,0
1836,1,home,0,6,6
1836,2,work,6,12,6
1836,3,shop,12,13,1
1836,4,work,13,19,6
1836,5,home,19,24,5
1836,6,<ENDS>,24,24,0
1837,0,<START>,0,0,0
1837,1,home,0,7,7
1837,2,work,7,13,6
1837,3,home,13,18,5
1837,4,shop,18,19,1
1837,5,home,19,24,5
1837,6,<ENDS>,24,24,0
1838,0,<START>,0,0,0
1838,1,home,0,6,6
1838,2,shop,6,7,1
1838,3,home,7,13,6
1838,4,education,13,17,4
1838,5,home,17,21,4
1838,6,shop,21,22,1
1838,7,home,22,24,2
1838,8,<ENDS>,24,24,0
1839,0,<START>,0,0,0
1839,1,home,0,8,8
1839,2,work,8,14,6
1839,3,home,14,24,10
1839,4,<ENDS>,24,24,0
1840,0,<START>,0,0,0
1840,1,home,0,8,8
1840,2,work,8,16,8
1840,3,home,16,24,8
1840,4,<ENDS>,24,24,0
1841,0,<START>,0,0,0
1841,1,home,0,7,7
1841,2,education,7,12,5
1841,3,shop,12,14,2
1841,4,education,14,16,2
1841,5,home,16,24,8
1841,6,<ENDS>,24,24,0
1842,0,<START>,0,0,0
1842,1,home,0,6,6
1842,2,work,6,8,2
1842,3,home,8,9,1
1842,4,work,9,11,2
1842,5,home,11,16,5
1842,6,work,16,18,2
1842,7,home,18,23,5
1842,8,work,23,24,1
1842,9,<ENDS>,24,24,0
1843,0,<START>,0,0,0
1843,1,home,0,7,7
1843,2,education,7,12,5
1843,3,shop,12,14,2
1843,4,home,14,20,6
1843,5,shop,20,21,1
1843,6,home,21,24,3
1843,7,<ENDS>,24,24,0
1844,0,<START>,0,0,0
1844,1,home,0,6,6
1844,2,work,6,8,2
1844,3,home,8,14,6
1844,4,work,14,15,1
1844,5,home,15,21,6
1844,6,work,21,22,1
1844,7,home,22,24,2
1844,8,<ENDS>,24,24,0
1845,0,<START>,0,0,0
1845,1,home,0,6,6
1845,2,work,6,7,1
1845,3,home,7,14,7
1845,4,work,14,17,3
1845,5,home,17,24,7
1845,6,<ENDS>,24,24,0
1846,0,<START>,0,0,0
1846,1,home,0,7,7
1846,2,work,7,14,7
1846,3,home,14,18,4
1846,4,work,18,20,2
1846,5,home,20,24,4
1846,6,<ENDS>,24,24,0
1847,0,<START>,0,0,0
1847,1,home,0,6,6
1847,2,work,6,13,7
1847,3,home,13,21,8
1847,4,work,21,22,1
1847,5,home,22,24,2
1847,6,<ENDS>,24,24,0
1848,0,<START>,0,0,0
1848,1,home,0,7,7
1848,2,work,7,9,2
1848,3,home,9,16,7
1848,4,work,16,18,2
1848,5,home,18,24,6
1848,6,<ENDS>,24,24,0
1849,0,<START>,0,0,0
1849,1,home,0,7,7
1849,2,work,7,14,7
1849,3,home,14,24,10
1849,4,<ENDS>,24,24,0
1850,0,<START>,0,0,0
1850,1,home,0,6,6
1850,2,work,6,13,7
1850,3,shop,13,14,1
1850,4,home,14,24,10
1850,5,<ENDS>,24,24,0
1851,0,<START>,0,0,0
1851,1,home,0,6,6
1851,2,shop,6,7,1
1851,3,work,7,13,6
1851,4,home,13,23,10
1851,5,work,23,24,1
1851,6,<ENDS>,24,24,0
1852,0,<START>,0,0,0
1852,1,home,0,8,8
1852,2,work,8,15,7
1852,3,shop,15,16,1
1852,4,work,16,20,4
1852,5,home,20,24,4
1852,6,<ENDS>,24,24,0
1853,0,<START>,0,0,0
1853,1,home,0,6,6
1853,2,work,6,7,1
1853,3,home,7,12,5
1853,4,work,12,14,2
1853,5,home,14,22,8
1853,6,work,22,23,1
1853,7,home,23,24,1
1853,8,<ENDS>,24,24,0
1854,0,<START>,0,0,0
1854,1,home,0,8,8
1854,2,work,8,14,6
1854,3,shop,14,15,1
1854,4,work,15,20,5
1854,5,home,20,24,4
1854,6,<ENDS>,24,24,0
1855,0,<START>,0,0,0
1855,1,home,0,7,7
1855,2,work,7,13,6
1855,3,home,13,20,7
1855,4,shop,20,21,1
1855,5,home,21,24,3
1855,6,<ENDS>,24,24,0
1856,0,<START>,0,0,0
1856,1,home,0,8,8
1856,2,education,8,12,4
1856,3,work,12,19,7
1856,4,home,19,23,4
1856,5,work,23,24,1
1856,6,<ENDS>,24,24,0
1857,0,<START>,0,0,0
1857,1,home,0,7,7
1857,2,education,7,13,6
1857,3,shop,13,15,2
1857,4,home,15,24,9
1857,5,<ENDS>,24,24,0
1858,0,<START>,0,0,0
1858,1,home,0,7,7
1858,2,work,7,14,7
1858,3,shop,14,15,1
1858,4,home,15,21,6
1858,5,work,21,22,1
1858,6,home,22,24,2
1858,7,<ENDS>,24,24,0
1859,0,<START>,0,0,0
1859,1,home,0,7,7
1859,2,work,7,14,7
1859,3,shop,14,15,1
1859,4,home,15,24,9
1859,5,<ENDS>,24,24,0
1860,0,<START>,0,0,0
1860,1,home,0,7,7
1860,2,work,7,13,6
1860,3,home,13,24,11
1860,4,<ENDS>,24,24,0
1861,0,<START>,0,0,0
1861,1,home,0,7,7
1861,2,work,7,13,6
1861,3,shop,13,14,1
1861,4,work,14,19,5
1861,5,home,19,21,2
1861,6,work,21,22,1
1861,7,home,22,24,2
1861,8,<ENDS>,24,24,0
1862,0,<START>,0,0,0
1862,1,home,0,8,8
1862,2,education,8,12,4
1862,3,work,12,19,7
1862,4,home,19,24,5
1862,5,<ENDS>,24,24,0
1863,0,<START>,0,0,0
1863,1,home,0,6,6
1863,2,work,6,13,7
1863,3,home,13,21,8
1863,4,work,21,22,1
1863,5,home,22,24,2
1863,6,<ENDS>,24,24,0
1864,0,<START>,0,0,0
1864,1,home,0,7,7
1864,2,work,7,14,7
1864,3,home,14,24,10
1864,4,<ENDS>,24,24,0
1865,0,<START>,0,0,0
1865,1,home,0,8,8
1865,2,work,8,13,5
1865,3,shop,13,14,1
1865,4,home,14,24,10
1865,5,<ENDS>,24,24,0
1866,0,<START>,0,0,0
1866,1,home,0,6,6
1866,2,work,6,13,7
1866,3,home,13,17,4
1866,4,work,17,19,2
1866,5,home,19,24,5
1866,6,<ENDS>,24,24,0
1867,0,<START>,0,0,0
1867,1,home,0,8,8
1867,2,work,8,14,6
1867,3,shop,14,15,1
1867,4,work,15,19,4
1867,5,home,19,24,5
1867,6,<ENDS>,24,24,0
1868,0,<START>,0,0,0
1868,1,home,0,8,8
1868,2,education,8,11,3
1868,3,home,11,17,6
1868,4,shop,17,19,2
1868,5,home,19,24,5
1868,6,<ENDS>,24,24,0
1869,0,<START>,0,0,0
1869,1,home,0,7,7
1869,2,shop,7,8,1
1869,3,home,8,9,1
1869,4,work,9,16,7
1869,5,home,16,24,8
1869,6,<ENDS>,24,24,0
1870,0,<START>,0,0,0
1870,1,home,0,8,8
1870,2,work,8,14,6
1870,3,home,14,24,10
1870,4,<ENDS>,24,24,0
1871,0,<START>,0,0,0
1871,1,home,0,7,7
1871,2,shop,7,8,1
1871,3,education,8,12,4
1871,4,shop,12,14,2
1871,5,education,14,15,1
1871,6,shop,15,16,1
1871,7,home,16,24,8
1871,8,<ENDS>,24,24,0
1872,0,<START>,0,0,0
1872,1,home,0,8,8
1872,2,education,8,11,3
1872,3,home,11,19,8
1872,4,shop,19,21,2
1872,5,home,21,24,3
1872,6,<ENDS>,24,24,0
1873,0,<START>,0,0,0
1873,1,home,0,7,7
1873,2,work,7,13,6
1873,3,home,13,15,2
1873,4,shop,15,16,1
1873,5,home,16,21,5
1873,6,work,21,22,1
1873,7,home,22,24,2
1873,8,<ENDS>,24,24,0
1874,0,<START>,0,0,0
1874,1,home,0,7,7
1874,2,work,7,13,6
1874,3,shop,13,14,1
1874,4,work,14,20,6
1874,5,home,20,24,4
1874,6,<ENDS>,24,24,0
1875,0,<START>,0,0,0
1875,1,home,0,6,6
1875,2,work,6,13,7
1875,3,shop,13,14,1
1875,4,work,14,19,5
1875,5,home,19,24,5
1875,6,<ENDS>,24,24,0
1876,0,<START>,0,0,0
1876,1,home,0,6,6
1876,2,work,6,7,1
1876,3,home,7,9,2
1876,4,work,9,11,2
1876,5,home,11,17,6
1876,6,work,17,19,2
1876,7,home,19,24,5
1876,8,<ENDS>,24,24,0
1877,0,<START>,0,0,0
1877,1,home,0,7,7
1877,2,shop,7,8,1
1877,3,education,8,11,3
1877,4,home,11,18,7
1877,5,shop,18,19,1
1877,6,home,19,24,5
1877,7,<ENDS>,24,24,0
1878,0,<START>,0,0,0
1878,1,home,0,7,7
1878,2,work,7,13,6
1878,3,home,13,24,11
1878,4,<ENDS>,24,24,0
1879,0,<START>,0,0,0
1879,1,home,0,6,6
1879,2,work,6,13,7
1879,3,shop,13,14,1
1879,4,work,14,18,4
1879,5,home,18,24,6
1879,6,<ENDS>,24,24,0
1880,0,<START>,0,0,0
1880,1,home,0,7,7
1880,2,work,7,13,6
1880,3,shop,13,14,1
1880,4,home,14,24,10
1880,5,<ENDS>,24,24,0
1881,0,<START>,0,0,0
1881,1,home,0,8,8
1881,2,work,8,15,7
1881,3,shop,15,16,1
1881,4,work,16,19,3
1881,5,home,19,24,5
1881,6,<ENDS>,24,24,0
1882,0,<START>,0,0,0
1882,1,home,0,7,7
1882,2,work,7,13,6
1882,3,shop,13,14,1
1882,4,home,14,24,10
1882,5,<ENDS>,24,24,0
1883,0,<START>,0,0,0
1883,1,home,0,7,7
1883,2,work,7,13,6
1883,3,shop,13,14,1
1883,4,home,14,24,10
1883,5,<ENDS>,24,24,0
1884,0,<START>,0,0,0
1884,1,home,0,7,7
1884,2,work,7,13,6
1884,3,home,13,23,10
1884,4,work,23,24,1
1884,5,<ENDS>,24,24,0
1885,0,<START>,0,0,0
1885,1,home,0,7,7
1885,2,work,7,13,6
1885,3,shop,13,14,1
1885,4,education,14,17,3
1885,5,home,17,24,7
1885,6,<ENDS>,24,24,0
1886,0,<START>,0,0,0
1886,1,home,0,7,7
1886,2,shop,7,8,1
1886,3,home,8,10,2
1886,4,work,10,16,6
1886,5,home,16,22,6
1886,6,work,22,23,1
1886,7,home,23,24,1
1886,8,<ENDS>,24,24,0
1887,0,<START>,0,0,0
1887,1,home,0,8,8
1887,2,work,8,15,7
1887,3,home,15,23,8
1887,4,work,23,24,1
1887,5,<ENDS>,24,24,0
1888,0,<START>,0,0,0
1888,1,home,0,8,8
1888,2,work,8,15,7
1888,3,home,15,24,9
1888,4,<ENDS>,24,24,0
1889,0,<START>,0,0,0
1889,1,home,0,6,6
1889,2,work,6,13,7
1889,3,home,13,24,11
1889,4,<ENDS>,24,24,0
1890,0,<START>,0,0,0
1890,1,home,0,8,8
1890,2,work,8,15,7
1890,3,home,15,24,9
1890,4,<ENDS>,24,24,0
1891,0,<START>,0,0,0
1891,1,home,0,7,7
1891,2,work,7,13,6
1891,3,shop,13,14,1
1891,4,home,14,24,10
1891,5,<ENDS>,24,24,0
1892,0,<START>,0,0,0
1892,1,home,0,8,8
1892,2,work,8,14,6
1892,3,home,14,24,10
1892,4,<ENDS>,24,24,0
1893,0,<START>,0,0,0
1893,1,home,0,7,7
1893,2,education,7,11,4
1893,3,home,11,18,7
1893,4,shop,18,19,1
1893,5,home,19,24,5
1893,6,<ENDS>,24,24,0
1894,0,<START>,0,0,0
1894,1,home,0,7,7
1894,2,work,7,13,6
1894,3,shop,13,14,1
1894,4,work,14,19,5
1894,5,home,19,24,5
1894,6,<ENDS>,24,24,0
1895,0,<START>,0,0,0
1895,1,home,0,7,7
1895,2,work,7,14,7
1895,3,home,14,24,10
1895,4,<ENDS>,24,24,0
1896,0,<START>,0,0,0
1896,1,home,0,9,9
1896,2,work,9,15,6
1896,3,home,15,21,6
1896,4,work,21,22,1
1896,5,home,22,24,2
1896,6,<ENDS>,24,24,0
1897,0,<START>,0,0,0
1897,1,home,0,7,7
1897,2,work,7,13,6
1897,3,home,13,24,11
1897,4,<ENDS>,24,24,0
1898,0,<START>,0,0,0
1898,1,home,0,7,7
1898,2,shop,7,8,1
1898,3,education,8,12,4
1898,4,home,12,21,9
1898,5,shop,21,22,1
1898,6,home,22,24,2
1898,7,<ENDS>,24,24,0
1899,0,<START>,0,0,0
1899,1,home,0,6,6
1899,2,work,6,7,1
1899,3,home,7,11,4
1899,4,work,11,13,2
1899,5,home,13,21,8
1899,6,work,21,22,1
1899,7,home,22,24,2
1899,8,<ENDS>,24,24,0
1900,0,<START>,0,0,0
1900,1,home,0,6,6
1900,2,shop,6,7,1
1900,3,home,7,10,3
1900,4,education,10,13,3
1900,5,home,13,19,6
1900,6,shop,19,20,1
1900,7,home,20,24,4
1900,8,<ENDS>,24,24,0
1901,0,<START>,0,0,0
1901,1,home,0,7,7
1901,2,work,7,13,6
1901,3,home,13,17,4
1901,4,work,17,20,3
1901,5,home,20,24,4
1901,6,<ENDS>,24,24,0
1902,0,<START>,0,0,0
1902,1,home,0,7,7
1902,2,work,7,9,2
1902,3,home,9,15,6
1902,4,work,15,18,3
1902,5,home,18,24,6
1902,6,<ENDS>,24,24,0
1903,0,<START>,0,0,0
1903,1,home,0,7,7
1903,2,education,7,12,5
1903,3,home,12,19,7
1903,4,shop,19,20,1
1903,5,home,20,24,4
1903,6,<ENDS>,24,24,0
1904,0,<START>,0,0,0
1904,1,home,0,6,6
1904,2,work,6,13,7
1904,3,shop,13,14,1
1904,4,home,14,23,9
1904,5,work,23,24,1
1904,6,<ENDS>,24,24,0
1905,0,<START>,0,0,0
1905,1,home,0,7,7
1905,2,work,7,13,6
1905,3,home,13,17,4
1905,4,shop,17,19,2
1905,5,home,19,24,5
1905,6,<ENDS>,24,24,0
1906,0,<START>,0,0,0
1906,1,home,0,7,7
1906,2,work,7,13,6
1906,3,home,13,18,5
1906,4,work,18,20,2
1906,5,home,20,24,4
1906,6,<ENDS>,24,24,0
1907,0,<START>,0,0,0
1907,1,home,0,7,7
1907,2,shop,7,8,1
1907,3,education,8,12,4
1907,4,shop,12,14,2
1907,5,home,14,21,7
1907,6,shop,21,22,1
1907,7,home,22,24,2
1907,8,<ENDS>,24,24,0
1908,0,<START>,0,0,0
1908,1,home,0,7,7
1908,2,work,7,13,6
1908,3,shop,13,14,1
1908,4,education,14,16,2
1908,5,home,16,24,8
1908,6,<ENDS>,24,24,0
1909,0,<START>,0,0,0
1909,1,home,0,8,8
1909,2,education,8,11,3
1909,3,home,11,17,6
1909,4,shop,17,19,2
1909,5,home,19,24,5
1909,6,<ENDS>,24,24,0
1910,0,<START>,0,0,0
1910,1,home,0,9,9
1910,2,work,9,16,7
1910,3,home,16,20,4
1910,4,shop,20,21,1
1910,5,home,21,24,3
1910,6,<ENDS>,24,24,0
1911,0,<START>,0,0,0
1911,1,home,0,8,8
1911,2,work,8,15,7
1911,3,shop,15,16,1
1911,4,home,16,24,8
1911,5,<ENDS>,24,24,0
1912,0,<START>,0,0,0
1912,1,home,0,7,7
1912,2,work,7,14,7
1912,3,home,14,18,4
1912,4,work,18,20,2
1912,5,home,20,24,4
1912,6,<ENDS>,24,24,0
1913,0,<START>,0,0,0
1913,1,home,0,7,7
1913,2,education,7,11,4
1913,3,home,11,14,3
1913,4,education,14,16,2
1913,5,home,16,24,8
1913,6,<ENDS>,24,24,0
1914,0,<START>,0,0,0
1914,1,home,0,9,9
1914,2,work,9,15,6
1914,3,shop,15,16,1
1914,4,work,16,20,4
1914,5,home,20,24,4
1914,6,<ENDS>,24,24,0
1915,0,<START>,0,0,0
1915,1,home,0,7,7
1915,2,work,7,13,6
1915,3,home,13,24,11
1915,4,<ENDS>,24,24,0
1916,0,<START>,0,0,0
1916,1,home,0,6,6
1916,2,work,6,13,7
1916,3,home,13,24,11
1916,4,<ENDS>,24,24,0
1917,0,<START>,0,0,0
1917,1,home,0,8,8
1917,2,education,8,11,3
1917,3,home,11,19,8
1917,4,shop,19,21,2
1917,5,home,21,24,3
1917,6,<ENDS>,24,24,0
1918,0,<START>,0,0,0
1918,1,home,0,7,7
1918,2,work,7,9,2
1918,3,home,9,13,4
1918,4,work,13,15,2
1918,5,home,15,23,8
1918,6,work,23,24,1
1918,7,<ENDS>,24,24,0
1919,0,<START>,0,0,0
1919,1,home,0,8,8
1919,2,work,8,15,7
1919,3,home,15,24,9
1919,4,<ENDS>,24,24,0
1920,0,<START>,0,0,0
1920,1,home,0,8,8
1920,2,work,8,15,7
1920,3,home,15,23,8
1920,4,work,23,24,1
1920,5,<ENDS>,24,24,0
1921,0,<START>,0,0,0
1921,1,home,0,7,7
1921,2,work,7,9,2
1921,3,home,9,13,4
1921,4,work,13,15,2
1921,5,home,15,23,8
1921,6,work,23,24,1
1921,7,<ENDS>,24,24,0
1922,0,<START>,0,0,0
1922,1,home,0,8,8
1922,2,education,8,11,3
1922,3,home,11,13,2
1922,4,education,13,15,2
1922,5,shop,15,17,2
1922,6,home,17,24,7
1922,7,<ENDS>,24,24,0
1923,0,<START>,0,0,0
1923,1,home,0,7,7
1923,2,work,7,13,6
1923,3,home,13,20,7
1923,4,shop,20,21,1
1923,5,home,21,24,3
1923,6,<ENDS>,24,24,0
1924,0,<START>,0,0,0
1924,1,home,0,7,7
1924,2,shop,7,9,2
1924,3,education,9,12,3
1924,4,home,12,18,6
1924,5,shop,18,19,1
1924,6,home,19,24,5
1924,7,<ENDS>,24,24,0
1925,0,<START>,0,0,0
1925,1,home,0,8,8
1925,2,work,8,15,7
1925,3,home,15,24,9
1925,4,<ENDS>,24,24,0
1926,0,<START>,0,0,0
1926,1,home,0,7,7
1926,2,shop,7,8,1
1926,3,education,8,11,3
1926,4,home,11,18,7
1926,5,shop,18,19,1
1926,6,home,19,24,5
1926,7,<ENDS>,24,24,0
1927,0,<START>,0,0,0
1927,1,home,0,6,6
1927,2,work,6,7,1
1927,3,shop,7,8,1
1927,4,work,8,10,2
1927,5,home,10,18,8
1927,6,work,18,20,2
1927,7,home,20,24,4
1927,8,<ENDS>,24,24,0
1928,0,<START>,0,0,0
1928,1,home,0,6,6
1928,2,shop,6,7,1
1928,3,home,7,9,2
1928,4,education,9,15,6
1928,5,shop,15,16,1
1928,6,home,16,24,8
1928,7,<ENDS>,24,24,0
1929,0,<START>,0,0,0
1929,1,home,0,7,7
1929,2,education,7,12,5
1929,3,home,12,20,8
1929,4,shop,20,21,1
1929,5,home,21,24,3
1929,6,<ENDS>,24,24,0
1930,0,<START>,0,0,0
1930,1,home,0,6,6
1930,2,work,6,13,7
1930,3,home,13,17,4
1930,4,work,17,20,3
1930,5,home,20,24,4
1930,6,<ENDS>,24,24,0
1931,0,<START>,0,0,0
1931,1,home,0,6,6
1931,2,shop,6,7,1
1931,3,home,7,13,6
1931,4,education,13,16,3
1931,5,home,16,24,8
1931,6,<ENDS>,24,24,0
1932,0,<START>,0,0,0
1932,1,home,0,6,6
1932,2,work,6,13,7
1932,3,home,13,17,4
1932,4,work,17,19,2
1932,5,home,19,24,5
1932,6,<ENDS>,24,24,0
1933,0,<START>,0,0,0
1933,1,home,0,7,7
1933,2,shop,7,8,1
1933,3,education,8,11,3
1933,4,home,11,14,3
1933,5,education,14,16,2
1933,6,shop,16,18,2
1933,7,home,18,24,6
1933,8,<ENDS>,24,24,0
1934,0,<START>,0,0,0
1934,1,home,0,8,8
1934,2,work,8,14,6
1934,3,home,14,22,8
1934,4,work,22,23,1
1934,5,home,23,24,1
1934,6,<ENDS>,24,24,0
1935,0,<START>,0,0,0
1935,1,home,0,7,7
1935,2,work,7,14,7
1935,3,home,14,24,10
1935,4,<ENDS>,24,24,0
1936,0,<START>,0,0,0
1936,1,home,0,6,6
1936,2,work,6,12,6
1936,3,shop,12,13,1
1936,4,work,13,19,6
1936,5,home,19,24,5
1936,6,<ENDS>,24,24,0
1937,0,<START>,0,0,0
1937,1,home,0,8,8
1937,2,work,8,15,7
1937,3,home,15,24,9
1937,4,<ENDS>,24,24,0
1938,0,<START>,0,0,0
1938,1,home,0,7,7
1938,2,education,7,11,4
1938,3,home,11,18,7
1938,4,shop,18,19,1
1938,5,home,19,24,5
1938,6,<ENDS>,24,24,0
1939,0,<START>,0,0,0
1939,1,home,0,7,7
1939,2,work,7,9,2
1939,3,home,9,14,5
1939,4,work,14,16,2
1939,5,home,16,24,8
1939,6,<ENDS>,24,24,0
1940,0,<START>,0,0,0
1940,1,home,0,7,7
1940,2,work,7,14,7
1940,3,shop,14,15,1
1940,4,home,15,22,7
1940,5,work,22,23,1
1940,6,home,23,24,1
1940,7,<ENDS>,24,24,0
1941,0,<START>,0,0,0
1941,1,home,0,7,7
1941,2,work,7,13,6
1941,3,home,13,24,11
1941,4,<ENDS>,24,24,0
1942,0,<START>,0,0,0
1942,1,home,0,7,7
1942,2,education,7,11,4
1942,3,home,11,19,8
1942,4,shop,19,20,1
1942,5,home,20,24,4
1942,6,<ENDS>,24,24,0
1943,0,<START>,0,0,0
1943,1,home,0,7,7
1943,2,work,7,13,6
1943,3,home,13,24,11
1943,4,<ENDS>,24,24,0
1944,0,<START>,0,0,0
1944,1,home,0,6,6
1944,2,work,6,13,7
1944,3,home,13,17,4
1944,4,shop,17,18,1
1944,5,home,18,24,6
1944,6,<ENDS>,24,24,0
1945,0,<START>,0,0,0
1945,1,home,0,7,7
1945,2,work,7,13,6
1945,3,shop,13,14,1
1945,4,home,14,18,4
1945,5,work,18,20,2
1945,6,home,20,24,4
1945,7,<ENDS>,24,24,0
1946,0,<START>,0,0,0
1946,1,home,0,6,6
1946,2,work,6,13,7
1946,3,shop,13,14,1
1946,4,home,14,24,10
1946,5,<ENDS>,24,24,0
1947,0,<START>,0,0,0
1947,1,home,0,9,9
1947,2,work,9,16,7
1947,3,home,16,22,6
1947,4,work,22,23,1
1947,5,home,23,24,1
1947,6,<ENDS>,24,24,0
1948,0,<START>,0,0,0
1948,1,home,0,7,7
1948,2,education,7,11,4
1948,3,home,11,19,8
1948,4,shop,19,20,1
1948,5,home,20,24,4
1948,6,<ENDS>,24,24,0
1949,0,<START>,0,0,0
1949,1,home,0,8,8
1949,2,work,8,14,6
1949,3,home,14,24,10
1949,4,<ENDS>,24,24,0
1950,0,<START>,0,0,0
1950,1,home,0,8,8
1950,2,work,8,16,8
1950,3,shop,16,18,2
1950,4,home,18,24,6
1950,5,<ENDS>,24,24,0
1951,0,<START>,0,0,0
1951,1,home,0,6,6
1951,2,work,6,8,2
1951,3,home,8,14,6
1951,4,work,14,16,2
1951,5,home,16,24,8
1951,6,<ENDS>,24,24,0
1952,0,<START>,0,0,0
1952,1,home,0,6,6
1952,2,work,6,8,2
1952,3,home,8,13,5
1952,4,work,13,15,2
1952,5,home,15,22,7
1952,6,work,22,23,1
1952,7,home,23,24,1
1952,8,<ENDS>,24,24,0
1953,0,<START>,0,0,0
1953,1,home,0,7,7
1953,2,work,7,13,6
1953,3,home,13,24,11
1953,4,<ENDS>,24,24,0
1954,0,<START>,0,0,0
1954,1,home,0,6,6
1954,2,work,6,13,7
1954,3,shop,13,14,1
1954,4,home,14,22,8
1954,5,work,22,23,1
1954,6,home,23,24,1
1954,7,<ENDS>,24,24,0
1955,0,<START>,0,0,0
1955,1,home,0,6,6
1955,2,work,6,13,7
1955,3,home,13,17,4
1955,4,work,17,20,3
1955,5,home,20,24,4
1955,6,<ENDS>,24,24,0
1956,0,<START>,0,0,0
1956,1,home,0,9,9
1956,2,education,9,12,3
1956,3,home,12,24,12
1956,4,<ENDS>,24,24,0
1957,0,<START>,0,0,0
1957,1,home,0,6,6
1957,2,work,6,13,7
1957,3,home,13,24,11
1957,4,<ENDS>,24,24,0
1958,0,<START>,0,0,0
1958,1,home,0,8,8
1958,2,work,8,14,6
1958,3,shop,14,15,1
1958,4,work,15,20,5
1958,5,home,20,24,4
1958,6,<ENDS>,24,24,0
1959,0,<START>,0,0,0
1959,1,home,0,7,7
1959,2,shop,7,8,1
1959,3,education,8,11,3
1959,4,home,11,18,7
1959,5,shop,18,19,1
1959,6,home,19,24,5
1959,7,<ENDS>,24,24,0
1960,0,<START>,0,0,0
1960,1,home,0,8,8
1960,2,work,8,15,7
1960,3,home,15,24,9
1960,4,<ENDS>,24,24,0
1961,0,<START>,0,0,0
1961,1,home,0,7,7
1961,2,shop,7,8,1
1961,3,home,8,10,2
1961,4,work,10,17,7
1961,5,home,17,21,4
1961,6,work,21,22,1
1961,7,home,22,24,2
1961,8,<ENDS>,24,24,0
1962,0,<START>,0,0,0
1962,1,home,0,6,6
1962,2,work,6,8,2
1962,3,home,8,11,3
1962,4,work,11,13,2
1962,5,home,13,21,8
1962,6,work,21,22,1
1962,7,home,22,24,2
1962,8,<ENDS>,24,24,0
1963,0,<START>,0,0,0
1963,1,home,0,7,7
1963,2,work,7,14,7
1963,3,home,14,24,10
1963,4,<ENDS>,24,24,0
1964,0,<START>,0,0,0
1964,1,home,0,7,7
1964,2,work,7,13,6
1964,3,home,13,24,11
1964,4,<ENDS>,24,24,0
1965,0,<START>,0,0,0
1965,1,home,0,7,7
1965,2,work,7,8,1
1965,3,home,8,14,6
1965,4,work,14,16,2
1965,5,home,16,23,7
1965,6,work,23,24,1
1965,7,<ENDS>,24,24,0
1966,0,<START>,0,0,0
1966,1,home,0,6,6
1966,2,work,6,11,5
1966,3,home,11,21,10
1966,4,work,21,22,1
1966,5,home,22,24,2
1966,6,<ENDS>,24,24,0
1967,0,<START>,0,0,0
1967,1,home,0,7,7
1967,2,work,7,13,6
1967,3,home,13,18,5
1967,4,shop,18,19,1
1967,5,home,19,23,4
1967,6,work,23,24,1
1967,7,<ENDS>,24,24,0
1968,0,<START>,0,0,0
1968,1,home,0,7,7
1968,2,education,7,11,4
1968,3,home,11,17,6
1968,4,shop,17,19,2
1968,5,home,19,24,5
1968,6,<ENDS>,24,24,0
1969,0,<START>,0,0,0
1969,1,home,0,6,6
1969,2,work,6,13,7
1969,3,home,13,23,10
1969,4,work,23,24,1
1969,5,<ENDS>,24,24,0
1970,0,<START>,0,0,0
1970,1,home,0,7,7
1970,2,work,7,8,1
1970,3,home,8,13,5
1970,4,work,13,16,3
1970,5,home,16,23,7
1970,6,work,23,24,1
1970,7,<ENDS>,24,24,0
1971,0,<START>,0,0,0
1971,1,home,0,6,6
1971,2,shop,6,7,1
1971,3,home,7,10,3
1971,4,education,10,13,3
1971,5,home,13,19,6
1971,6,shop,19,20,1
1971,7,home,20,24,4
1971,8,<ENDS>,24,24,0
1972,0,<START>,0,0,0
1972,1,home,0,7,7
1972,2,shop,7,8,1
1972,3,education,8,13,5
1972,4,shop,13,15,2
1972,5,home,15,24,9
1972,6,<ENDS>,24,24,0
1973,0,<START>,0,0,0
1973,1,home,0,9,9
1973,2,work,9,16,7
1973,3,shop,16,17,1
1973,4,work,17,20,3
1973,5,home,20,24,4
1973,6,<ENDS>,24,24,0
1974,0,<START>,0,0,0
1974,1,home,0,6,6
1974,2,work,6,13,7
1974,3,shop,13,14,1
1974,4,work,14,20,6
1974,5,home,20,24,4
1974,6,<ENDS>,24,24,0
1975,0,<START>,0,0,0
1975,1,home,0,8,8
1975,2,work,8,14,6
1975,3,shop,14,15,1
1975,4,home,15,24,9
1975,5,<ENDS>,24,24,0
1976,0,<START>,0,0,0
1976,1,home,0,8,8
1976,2,work,8,15,7
1976,3,home,15,24,9
1976,4,<ENDS>,24,24,0
1977,0,<START>,0,0,0
1977,1,home,0,8,8
1977,2,work,8,15,7
1977,3,home,15,21,6
1977,4,work,21,22,1
1977,5,home,22,24,2
1977,6,<ENDS>,24,24,0
1978,0,<START>,0,0,0
1978,1,home,0,8,8
1978,2,education,8,12,4
1978,3,shop,12,14,2
1978,4,home,14,24,10
1978,5,<ENDS>,24,24,0
1979,0,<START>,0,0,0
1979,1,home,0,6,6
1979,2,work,6,8,2
1979,3,home,8,9,1
1979,4,work,9,11,2
1979,5,home,11,17,6
1979,6,work,17,19,2
1979,7,home,19,24,5
1979,8,<ENDS>,24,24,0
1980,0,<START>,0,0,0
1980,1,home,0,7,7
1980,2,work,7,8,1
1980,3,home,8,14,6
1980,4,work,14,15,1
1980,5,home,15,23,8
1980,6,work,23,24,1
1980,7,<ENDS>,24,24,0
1981,0,<START>,0,0,0
1981,1,home,0,6,6
1981,2,work,6,14,8
1981,3,home,14,24,10
1981,4,<ENDS>,24,24,0
1982,0,<START>,0,0,0
1982,1,home,0,7,7
1982,2,work,7,14,7
1982,3,home,14,21,7
1982,4,shop,21,22,1
1982,5,home,22,24,2
1982,6,<ENDS>,24,24,0
1983,0,<START>,0,0,0
1983,1,home,0,6,6
1983,2,work,6,13,7
1983,3,home,13,19,6
1983,4,shop,19,20,1
1983,5,home,20,24,4
1983,6,<ENDS>,24,24,0
1984,0,<START>,0,0,0
1984,1,home,0,6,6
1984,2,shop,6,7,1
1984,3,work,7,14,7
1984,4,home,14,24,10
1984,5,<ENDS>,24,24,0
1985,0,<START>,0,0,0
1985,1,home,0,7,7
1985,2,shop,7,8,1
1985,3,education,8,11,3
1985,4,home,11,14,3
1985,5,education,14,16,2
1985,6,home,16,24,8
1985,7,<ENDS>,24,24,0
1986,0,<START>,0,0,0
1986,1,home,0,8,8
1986,2,work,8,14,6
1986,3,home,14,24,10
1986,4,<ENDS>,24,24,0
1987,0,<START>,0,0,0
1987,1,home,0,7,7
1987,2,work,7,14,7
1987,3,home,14,23,9
1987,4,work,23,24,1
1987,5,<ENDS>,24,24,0
1988,0,<START>,0,0,0
1988,1,home,0,7,7
1988,2,work,7,14,7
1988,3,home,14,16,2
1988,4,work,16,20,4
1988,5,home,20,24,4
1988,6,<ENDS>,24,24,0
1989,0,<START>,0,0,0
1989,1,home,0,7,7
1989,2,education,7,11,4
1989,3,home,11,14,3
1989,4,education,14,16,2
1989,5,home,16,24,8
1989,6,<ENDS>,24,24,0
1990,0,<START>,0,0,0
1990,1,home,0,8,8
1990,2,work,8,15,7
1990,3,shop,15,16,1
1990,4,home,16,24,8
1990,5,<ENDS>,24,24,0
1991,0,<START>,0,0,0
1991,1,home,0,8,8
1991,2,education,8,12,4
1991,3,home,12,19,7
1991,4,shop,19,21,2
1991,5,home,21,24,3
1991,6,<ENDS>,24,24,0
1992,0,<START>,0,0,0
1992,1,home,0,6,6
1992,2,work,6,13,7
1992,3,home,13,24,11
1992,4,<ENDS>,24,24,0
1993,0,<START>,0,0,0
1993,1,home,0,6,6
1993,2,work,6,13,7
1993,3,shop,13,14,1
1993,4,work,14,19,5
1993,5,home,19,24,5
1993,6,<ENDS>,24,24,0
1994,0,<START>,0,0,0
1994,1,home,0,7,7
1994,2,work,7,14,7
1994,3,shop,14,15,1
1994,4,work,15,20,5
1994,5,home,20,24,4
1994,6,<ENDS>,24,24,0
1995,0,<START>,0,0,0
1995,1,home,0,6,6
1995,2,work,6,13,7
1995,3,shop,13,14,1
1995,4,work,14,20,6
1995,5,home,20,24,4
1995,6,<ENDS>,24,24,0
1996,0,<START>,0,0,0
1996,1,home,0,6,6
1996,2,shop,6,7,1
1996,3,home,7,10,3
1996,4,education,10,16,6
1996,5,home,16,24,8
1996,6,<ENDS>,24,24,0
1997,0,<START>,0,0,0
1997,1,home,0,6,6
1997,2,work,6,9,3
1997,3,home,9,13,4
1997,4,work,13,15,2
1997,5,home,15,21,6
1997,6,work,21,22,1
1997,7,home,22,24,2
1997,8,<ENDS>,24,24,0
1998,0,<START>,0,0,0
1998,1,home,0,7,7
1998,2,work,7,13,6
1998,3,home,13,24,11
1998,4,<ENDS>,24,24,0
1999,0,<START>,0,0,0
1999,1,home,0,6,6
1999,2,shop,6,7,1
1999,3,home,7,11,4
1999,4,education,11,14,3
1999,5,shop,14,15,1
1999,6,home,15,24,9
1999,7,<ENDS>,24,24,0
2000,0,<START>,0,0,0
2000,1,home,0,6,6
2000,2,work,6,13,7
2000,3,home,13,24,11
2000,4,<ENDS>,24,24,0
2001,0,<START>,0,0,0
2001,1,home,0,7,7
2001,2,education,7,11,4
2001,3,home,11,19,8
2001,4,shop,19,21,2
2001,5,home,21,24,3
2001,6,<ENDS>,24,24,0
2002,0,<START>,0,0,0
2002,1,home,0,6,6
2002,2,shop,6,7,1
2002,3,home,7,11,4
2002,4,shop,11,12,1
2002,5,work,12,19,7
2002,6,home,19,24,5
2002,7,<ENDS>,24,24,0
2003,0,<START>,0,0,0
2003,1,home,0,6,6
2003,2,work,6,8,2
2003,3,home,8,14,6
2003,4,work,14,16,2
2003,5,home,16,21,5
2003,6,work,21,22,1
2003,7,home,22,24,2
2003,8,<ENDS>,24,24,0
2004,0,<START>,0,0,0
2004,1,home,0,8,8
2004,2,work,8,14,6
2004,3,home,14,17,3
2004,4,shop,17,18,1
2004,5,home,18,24,6
2004,6,<ENDS>,24,24,0
2005,0,<START>,0,0,0
2005,1,home,0,6,6
2005,2,shop,6,7,1
2005,3,home,7,9,2
2005,4,work,9,16,7
2005,5,home,16,24,8
2005,6,<ENDS>,24,24,0
2006,0,<START>,0,0,0
2006,1,home,0,6,6
2006,2,shop,6,7,1
2006,3,home,7,9,2
2006,4,education,9,12,3
2006,5,shop,12,14,2
2006,6,education,14,16,2
2006,7,home,16,24,8
2006,8,<ENDS>,24,24,0
2007,0,<START>,0,0,0
2007,1,home,0,7,7
2007,2,work,7,9,2
2007,3,home,9,14,5
2007,4,work,14,16,2
2007,5,home,16,22,6
2007,6,work,22,23,1
2007,7,home,23,24,1
2007,8,<ENDS>,24,24,0
2008,0,<START>,0,0,0
2008,1,home,0,7,7
2008,2,work,7,14,7
2008,3,home,14,24,10
2008,4,<ENDS>,24,24,0
2009,0,<START>,0,0,0
2009,1,home,0,6,6
2009,2,work,6,13,7
2009,3,shop,13,15,2
2009,4,home,15,24,9
2009,5,<ENDS>,24,24,0
2010,0,<START>,0,0,0
2010,1,home,0,6,6
2010,2,shop,6,7,1
2010,3,home,7,13,6
2010,4,education,13,16,3
2010,5,shop,16,18,2
2010,6,home,18,24,6
2010,7,<ENDS>,24,24,0
2011,0,<START>,0,0,0
2011,1,home,0,7,7
2011,2,shop,7,8,1
2011,3,work,8,16,8
2011,4,home,16,24,8
2011,5,<ENDS>,24,24,0
2012,0,<START>,0,0,0
2012,1,home,0,6,6
2012,2,work,6,13,7
2012,3,home,13,17,4
2012,4,work,17,20,3
2012,5,home,20,24,4
2012,6,<ENDS>,24,24,0
2013,0,<START>,0,0,0
2013,1,home,0,7,7
2013,2,education,7,11,4
2013,3,home,11,18,7
2013,4,shop,18,19,1
2013,5,home,19,24,5
2013,6,<ENDS>,24,24,0
2014,0,<START>,0,0,0
2014,1,home,0,8,8
2014,2,education,8,11,3
2014,3,home,11,13,2
2014,4,education,13,16,3
2014,5,home,16,24,8
2014,6,<ENDS>,24,24,0
2015,0,<START>,0,0,0
2015,1,home,0,6,6
2015,2,work,6,8,2
2015,3,home,8,9,1
2015,4,work,9,11,2
2015,5,home,11,18,7
2015,6,work,18,19,1
2015,7,home,19,24,5
2015,8,<ENDS>,24,24,0
2016,0,<START>,0,0,0
2016,1,home,0,6,6
2016,2,work,6,13,7
2016,3,shop,13,14,1
2016,4,work,14,20,6
2016,5,home,20,24,4
2016,6,<ENDS>,24,24,0
2017,0,<START>,0,0,0
2017,1,home,0,7,7
2017,2,work,7,9,2
2017,3,home,9,13,4
2017,4,work,13,15,2
2017,5,home,15,22,7
2017,6,work,22,23,1
2017,7,home,23,24,1
2017,8,<ENDS>,24,24,0
2018,0,<START>,0,0,0
2018,1,home,0,6,6
2018,2,work,6,13,7
2018,3,shop,13,14,1
2018,4,education,14,18,4
2018,5,work,18,20,2
2018,6,home,20,24,4
2018,7,<ENDS>,24,24,0
2019,0,<START>,0,0,0
2019,1,home,0,6,6
2019,2,work,6,13,7
2019,3,shop,13,14,1
2019,4,education,14,17,3
2019,5,shop,17,18,1
2019,6,home,18,24,6
2019,7,<ENDS>,24,24,0
2020,0,<START>,0,0,0
2020,1,home,0,7,7
2020,2,education,7,11,4
2020,3,home,11,20,9
2020,4,shop,20,21,1
2020,5,home,21,24,3
2020,6,<ENDS>,24,24,0
2021,0,<START>,0,0,0
2021,1,home,0,6,6
2021,2,work,6,13,7
2021,3,home,13,17,4
2021,4,work,17,19,2
2021,5,home,19,24,5
2021,6,<ENDS>,24,24,0
2022,0,<START>,0,0,0
2022,1,home,0,8,8
2022,2,work,8,15,7
2022,3,home,15,23,8
2022,4,work,23,24,1
2022,5,<ENDS>,24,24,0
2023,0,<START>,0,0,0
2023,1,home,0,7,7
2023,2,work,7,14,7
2023,3,shop,14,15,1
2023,4,home,15,24,9
2023,5,<ENDS>,24,24,0
2024,0,<START>,0,0,0
2024,1,home,0,8,8
2024,2,work,8,14,6
2024,3,home,14,18,4
2024,4,shop,18,19,1
2024,5,home,19,23,4
2024,6,work,23,24,1
2024,7,<ENDS>,24,24,0
2025,0,<START>,0,0,0
2025,1,home,0,7,7
2025,2,work,7,13,6
2025,3,home,13,17,4
2025,4,work,17,20,3
2025,5,home,20,24,4
2025,6,<ENDS>,24,24,0
2026,0,<START>,0,0,0
2026,1,home,0,7,7
2026,2,shop,7,8,1
2026,3,education,8,12,4
2026,4,shop,12,13,1
2026,5,education,13,16,3
2026,6,shop,16,17,1
2026,7,home,17,24,7
2026,8,<ENDS>,24,24,0
2027,0,<START>,0,0,0
2027,1,home,0,7,7
2027,2,work,7,14,7
2027,3,home,14,23,9
2027,4,work,23,24,1
2027,5,<ENDS>,24,24,0
2028,0,<START>,0,0,0
2028,1,home,0,7,7
2028,2,work,7,13,6
2028,3,shop,13,14,1
2028,4,education,14,17,3
2028,5,home,17,24,7
2028,6,<ENDS>,24,24,0
2029,0,<START>,0,0,0
2029,1,home,0,7,7
2029,2,work,7,8,1
2029,3,home,8,9,1
2029,4,work,9,10,1
2029,5,home,10,15,5
2029,6,work,15,17,2
2029,7,home,17,23,6
2029,8,work,23,24,1
2029,9,<ENDS>,24,24,0
2030,0,<START>,0,0,0
2030,1,home,0,7,7
2030,2,work,7,14,7
2030,3,shop,14,15,1
2030,4,work,15,20,5
2030,5,home,20,24,4
2030,6,<ENDS>,24,24,0
2031,0,<START>,0,0,0
2031,1,home,0,7,7
2031,2,education,7,12,5
2031,3,home,12,17,5
2031,4,shop,17,18,1
2031,5,home,18,24,6
2031,6,<ENDS>,24,24,0
2032,0,<START>,0,0,0
2032,1,home,0,6,6
2032,2,work,6,13,7
2032,3,shop,13,14,1
2032,4,work,14,19,5
2032,5,home,19,24,5
2032,6,<ENDS>,24,24,0
2033,0,<START>,0,0,0
2033,1,home,0,7,7
2033,2,shop,7,8,1
2033,3,education,8,12,4
2033,4,home,12,18,6
2033,5,shop,18,19,1
2033,6,home,19,24,5
2033,7,<ENDS>,24,24,0
2034,0,<START>,0,0,0
2034,1,home,0,8,8
2034,2,work,8,15,7
2034,3,home,15,24,9
2034,4,<ENDS>,24,24,0
2035,0,<START>,0,0,0
2035,1,home,0,8,8
2035,2,education,8,12,4
2035,3,shop,12,13,1
2035,4,work,13,19,6
2035,5,home,19,24,5
2035,6,<ENDS>,24,24,0
2036,0,<START>,0,0,0
2036,1,home,0,6,6
2036,2,shop,6,7,1
2036,3,work,7,14,7
2036,4,home,14,24,10
2036,5,<ENDS>,24,24,0
2037,0,<START>,0,0,0
2037,1,home,0,8,8
2037,2,work,8,13,5
2037,3,home,13,17,4
2037,4,work,17,20,3
2037,5,home,20,24,4
2037,6,<ENDS>,24,24,0
2038,0,<START>,0,0,0
2038,1,home,0,6,6
2038,2,work,6,8,2
2038,3,home,8,15,7
2038,4,work,15,17,2
2038,5,home,17,24,7
2038,6,<ENDS>,24,24,0
2039,0,<START>,0,0,0
2039,1,home,0,8,8
2039,2,work,8,14,6
2039,3,home,14,24,10
2039,4,<ENDS>,24,24,0
2040,0,<START>,0,0,0
2040,1,home,0,6,6
2040,2,work,6,7,1
2040,3,home,7,12,5
2040,4,work,12,14,2
2040,5,home,14,21,7
2040,6,work,21,22,1
2040,7,home,22,24,2
2040,8,<ENDS>,24,24,0
2041,0,<START>,0,0,0
2041,1,home,0,6,6
2041,2,work,6,8,2
2041,3,home,8,15,7
2041,4,work,15,18,3
2041,5,home,18,22,4
2041,6,work,22,23,1
2041,7,home,23,24,1
2041,8,<ENDS>,24,24,0
2042,0,<START>,0,0,0
2042,1,home,0,7,7
2042,2,education,7,11,4
2042,3,home,11,18,7
2042,4,shop,18,19,1
2042,5,home,19,24,5
2042,6,<ENDS>,24,24,0
2043,0,<START>,0,0,0
2043,1,home,0,6,6
2043,2,shop,6,7,1
2043,3,home,7,10,3
2043,4,education,10,13,3
2043,5,shop,13,15,2
2043,6,home,15,19,4
2043,7,shop,19,20,1
2043,8,home,20,24,4
2043,9,<ENDS>,24,24,0
2044,0,<START>,0,0,0
2044,1,home,0,8,8
2044,2,education,8,12,4
2044,3,work,12,18,6
2044,4,home,18,21,3
2044,5,work,21,22,1
2044,6,home,22,24,2
2044,7,<ENDS>,24,24,0
2045,0,<START>,0,0,0
2045,1,home,0,6,6
2045,2,work,6,7,1
2045,3,home,7,13,6
2045,4,work,13,14,1
2045,5,home,14,18,4
2045,6,work,18,20,2
2045,7,home,20,24,4
2045,8,<ENDS>,24,24,0
2046,0,<START>,0,0,0
2046,1,home,0,7,7
2046,2,work,7,13,6
2046,3,home,13,22,9
2046,4,work,22,23,1
2046,5,home,23,24,1
2046,6,<ENDS>,24,24,0
2047,0,<START>,0,0,0
2047,1,home,0,8,8
2047,2,work,8,15,7
2047,3,shop,15,17,2
2047,4,home,17,24,7
2047,5,<ENDS>,24,24,0
2048,0,<START>,0,0,0
2048,1,home,0,7,7
2048,2,work,7,13,6
2048,3,shop,13,14,1
2048,4,work,14,19,5
2048,5,home,19,24,5
2048,6,<ENDS>,24,24,0
2049,0,<START>,0,0,0
2049,1,home,0,7,7
2049,2,shop,7,8,1
2049,3,education,8,11,3
2049,4,home,11,19,8
2049,5,shop,19,20,1
2049,6,home,20,24,4
2049,7,<ENDS>,24,24,0
2050,0,<START>,0,0,0
2050,1,home,0,9,9
2050,2,work,9,17,8
2050,3,home,17,24,7
2050,4,<ENDS>,24,24,0
2051,0,<START>,0,0,0
2051,1,home,0,7,7
2051,2,work,7,15,8
2051,3,home,15,24,9
2051,4,<ENDS>,24,24,0
2052,0,<START>,0,0,0
2052,1,home,0,7,7
2052,2,work,7,13,6
2052,3,home,13,17,4
2052,4,shop,17,18,1
2052,5,home,18,24,6
2052,6,<ENDS>,24,24,0
2053,0,<START>,0,0,0
2053,1,home,0,7,7
2053,2,shop,7,8,1
2053,3,work,8,16,8
2053,4,home,16,24,8
2053,5,<ENDS>,24,24,0
2054,0,<START>,0,0,0
2054,1,home,0,7,7
2054,2,shop,7,8,1
2054,3,home,8,9,1
2054,4,work,9,16,7
2054,5,shop,16,17,1
2054,6,home,17,24,7
2054,7,<ENDS>,24,24,0
2055,0,<START>,0,0,0
2055,1,home,0,7,7
2055,2,work,7,13,6
2055,3,home,13,17,4
2055,4,work,17,20,3
2055,5,home,20,24,4
2055,6,<ENDS>,24,24,0
2056,0,<START>,0,0,0
2056,1,home,0,7,7
2056,2,education,7,12,5
2056,3,home,12,18,6
2056,4,shop,18,19,1
2056,5,home,19,24,5
2056,6,<ENDS>,24,24,0
2057,0,<START>,0,0,0
2057,1,home,0,7,7
2057,2,work,7,8,1
2057,3,home,8,14,6
2057,4,work,14,16,2
2057,5,home,16,23,7
2057,6,work,23,24,1
2057,7,<ENDS>,24,24,0
2058,0,<START>,0,0,0
2058,1,home,0,6,6
2058,2,work,6,13,7
2058,3,shop,13,14,1
2058,4,home,14,21,7
2058,5,work,21,22,1
2058,6,home,22,24,2
2058,7,<ENDS>,24,24,0
2059,0,<START>,0,0,0
2059,1,home,0,6,6
2059,2,work,6,13,7
2059,3,home,13,24,11
2059,4,<ENDS>,24,24,0
2060,0,<START>,0,0,0
2060,1,home,0,7,7
2060,2,work,7,13,6
2060,3,shop,13,14,1
2060,4,home,14,24,10
2060,5,<ENDS>,24,24,0
2061,0,<START>,0,0,0
2061,1,home,0,6,6
2061,2,shop,6,7,1
2061,3,home,7,13,6
2061,4,education,13,16,3
2061,5,home,16,24,8
2061,6,<ENDS>,24,24,0
2062,0,<START>,0,0,0
2062,1,home,0,9,9
2062,2,work,9,16,7
2062,3,home,16,24,8
2062,4,<ENDS>,24,24,0
2063,0,<START>,0,0,0
2063,1,home,0,8,8
2063,2,work,8,15,7
2063,3,home,15,24,9
2063,4,<ENDS>,24,24,0
2064,0,<START>,0,0,0
2064,1,home,0,7,7
2064,2,work,7,13,6
2064,3,home,13,24,11
2064,4,<ENDS>,24,24,0
2065,0,<START>,0,0,0
2065,1,home,0,7,7
2065,2,work,7,8,1
2065,3,home,8,9,1
2065,4,work,9,10,1
2065,5,home,10,16,6
2065,6,work,16,18,2
2065,7,home,18,24,6
2065,8,<ENDS>,24,24,0
2066,0,<START>,0,0,0
2066,1,home,0,6,6
2066,2,work,6,8,2
2066,3,home,8,13,5
2066,4,work,13,16,3
2066,5,home,16,22,6
2066,6,work,22,23,1
2066,7,home,23,24,1
2066,8,<ENDS>,24,24,0
2067,0,<START>,0,0,0
2067,1,home,0,6,6
2067,2,work,6,13,7
2067,3,shop,13,14,1
2067,4,home,14,16,2
2067,5,shop,16,17,1
2067,6,home,17,24,7
2067,7,<ENDS>,24,24,0
2068,0,<START>,0,0,0
2068,1,home,0,6,6
2068,2,shop,6,7,1
2068,3,home,7,9,2
2068,4,education,9,13,4
2068,5,shop,13,14,1
2068,6,education,14,16,2
2068,7,home,16,24,8
2068,8,<ENDS>,24,24,0
2069,0,<START>,0,0,0
2069,1,home,0,7,7
2069,2,work,7,14,7
2069,3,home,14,17,3
2069,4,work,17,20,3
2069,5,home,20,24,4
2069,6,<ENDS>,24,24,0
2070,0,<START>,0,0,0
2070,1,home,0,7,7
2070,2,education,7,11,4
2070,3,home,11,14,3
2070,4,education,14,16,2
2070,5,home,16,24,8
2070,6,<ENDS>,24,24,0
2071,0,<START>,0,0,0
2071,1,home,0,7,7
2071,2,work,7,13,6
2071,3,shop,13,14,1
2071,4,home,14,24,10
2071,5,<ENDS>,24,24,0
2072,0,<START>,0,0,0
2072,1,home,0,8,8
2072,2,work,8,14,6
2072,3,home,14,24,10
2072,4,<ENDS>,24,24,0
2073,0,<START>,0,0,0
2073,1,home,0,7,7
2073,2,work,7,13,6
2073,3,home,13,24,11
2073,4,<ENDS>,24,24,0
2074,0,<START>,0,0,0
2074,1,home,0,7,7
2074,2,work,7,14,7
2074,3,home,14,24,10
2074,4,<ENDS>,24,24,0
2075,0,<START>,0,0,0
2075,1,home,0,7,7
2075,2,education,7,11,4
2075,3,home,11,13,2
2075,4,education,13,15,2
2075,5,shop,15,16,1
2075,6,home,16,24,8
2075,7,<ENDS>,24,24,0
2076,0,<START>,0,0,0
2076,1,home,0,7,7
2076,2,work,7,16,9
2076,3,shop,16,17,1
2076,4,home,17,21,4
2076,5,work,21,22,1
2076,6,home,22,24,2
2076,7,<ENDS>,24,24,0
2077,0,<START>,0,0,0
2077,1,home,0,6,6
2077,2,work,6,13,7
2077,3,home,13,24,11
2077,4,<ENDS>,24,24,0
2078,0,<START>,0,0,0
2078,1,home,0,7,7
2078,2,education,7,11,4
2078,3,home,11,15,4
2078,4,shop,15,16,1
2078,5,home,16,20,4
2078,6,shop,20,21,1
2078,7,home,21,24,3
2078,8,<ENDS>,24,24,0
2079,0,<START>,0,0,0
2079,1,home,0,8,8
2079,2,work,8,14,6
2079,3,home,14,24,10
2079,4,<ENDS>,24,24,0
2080,0,<START>,0,0,0
2080,1,home,0,6,6
2080,2,work,6,13,7
2080,3,shop,13,14,1
2080,4,work,14,19,5
2080,5,home,19,24,5
2080,6,<ENDS>,24,24,0
2081,0,<START>,0,0,0
2081,1,home,0,7,7
2081,2,work,7,14,7
2081,3,home,14,24,10
2081,4,<ENDS>,24,24,0
2082,0,<START>,0,0,0
2082,1,home,0,7,7
2082,2,work,7,13,6
2082,3,shop,13,14,1
2082,4,work,14,20,6
2082,5,home,20,24,4
2082,6,<ENDS>,24,24,0
2083,0,<START>,0,0,0
2083,1,home,0,6,6
2083,2,work,6,13,7
2083,3,shop,13,14,1
2083,4,home,14,22,8
2083,5,work,22,23,1
2083,6,home,23,24,1
2083,7,<ENDS>,24,24,0
2084,0,<START>,0,0,0
2084,1,home,0,7,7
2084,2,shop,7,8,1
2084,3,home,8,9,1
2084,4,work,9,16,7
2084,5,home,16,24,8
2084,6,<ENDS>,24,24,0
2085,0,<START>,0,0,0
2085,1,home,0,8,8
2085,2,shop,8,9,1
2085,3,work,9,15,6
2085,4,home,15,24,9
2085,5,<ENDS>,24,24,0
2086,0,<START>,0,0,0
2086,1,home,0,6,6
2086,2,work,6,8,2
2086,3,home,8,13,5
2086,4,work,13,15,2
2086,5,home,15,22,7
2086,6,work,22,23,1
2086,7,home,23,24,1
2086,8,<ENDS>,24,24,0
2087,0,<START>,0,0,0
2087,1,home,0,6,6
2087,2,work,6,13,7
2087,3,shop,13,14,1
2087,4,work,14,20,6
2087,5,home,20,24,4
2087,6,<ENDS>,24,24,0
2088,0,<START>,0,0,0
2088,1,home,0,7,7
2088,2,work,7,9,2
2088,3,home,9,13,4
2088,4,work,13,15,2
2088,5,home,15,21,6
2088,6,shop,21,22,1
2088,7,home,22,24,2
2088,8,<ENDS>,24,24,0
2089,0,<START>,0,0,0
2089,1,work,0,7,7
2089,2,shop,7,8,1
2089,3,work,8,15,7
2089,4,home,15,24,9
2089,5,<ENDS>,24,24,0
2090,0,<START>,0,0,0
2090,1,home,0,6,6
2090,2,work,6,7,1
2090,3,home,7,9,2
2090,4,work,9,10,1
2090,5,home,10,13,3
2090,6,work,13,15,2
2090,7,home,15,21,6
2090,8,work,21,22,1
2090,9,home,22,24,2
2090,10,<ENDS>,24,24,0
2091,0,<START>,0,0,0
2091,1,home,0,7,7
2091,2,education,7,12,5
2091,3,shop,12,14,2
2091,4,education,14,16,2
2091,5,home,16,24,8
2091,6,<ENDS>,24,24,0
2092,0,<START>,0,0,0
2092,1,home,0,8,8
2092,2,work,8,15,7
2092,3,shop,15,16,1
2092,4,home,16,20,4
2092,5,shop,20,21,1
2092,6,home,21,24,3
2092,7,<ENDS>,24,24,0
2093,0,<START>,0,0,0
2093,1,home,0,7,7
2093,2,work,7,13,6
2093,3,home,13,18,5
2093,4,work,18,20,2
2093,5,home,20,24,4
2093,6,<ENDS>,24,24,0
2094,0,<START>,0,0,0
2094,1,home,0,7,7
2094,2,education,7,11,4
2094,3,home,11,18,7
2094,4,shop,18,20,2
2094,5,home,20,24,4
2094,6,<ENDS>,24,24,0
2095,0,<START>,0,0,0
2095,1,home,0,8,8
2095,2,shop,8,9,1
2095,3,home,9,17,8
2095,4,work,17,20,3
2095,5,home,20,24,4
2095,6,<ENDS>,24,24,0
2096,0,<START>,0,0,0
2096,1,home,0,7,7
2096,2,work,7,15,8
2096,3,shop,15,16,1
2096,4,work,16,20,4
2096,5,home,20,24,4
2096,6,<ENDS>,24,24,0
2097,0,<START>,0,0,0
2097,1,home,0,8,8
2097,2,education,8,12,4
2097,3,work,12,19,7
2097,4,home,19,24,5
2097,5,<ENDS>,24,24,0
2098,0,<START>,0,0,0
2098,1,home,0,6,6
2098,2,shop,6,7,1
2098,3,work,7,14,7
2098,4,home,14,24,10
2098,5,<ENDS>,24,24,0
2099,0,<START>,0,0,0
2099,1,home,0,6,6
2099,2,work,6,13,7
2099,3,home,13,24,11
2099,4,<ENDS>,24,24,0
2100,0,<START>,0,0,0
2100,1,home,0,7,7
2100,2,shop,7,8,1
2100,3,education,8,12,4
2100,4,home,12,19,7
2100,5,shop,19,20,1
2100,6,home,20,24,4
2100,7,<ENDS>,24,24,0
2101,0,<START>,0,0,0
2101,1,home,0,7,7
2101,2,work,7,13,6
2101,3,shop,13,14,1
2101,4,work,14,18,4
2101,5,home,18,24,6
2101,6,<ENDS>,24,24,0
2102,0,<START>,0,0,0
2102,1,home,0,6,6
2102,2,work,6,7,1
2102,3,home,7,9,2
2102,4,work,9,11,2
2102,5,home,11,16,5
2102,6,shop,16,17,1
2102,7,work,17,19,2
2102,8,home,19,24,5
2102,9,<ENDS>,24,24,0
2103,0,<START>,0,0,0
2103,1,home,0,6,6
2103,2,work,6,13,7
2103,3,shop,13,14,1
2103,4,home,14,24,10
2103,5,<ENDS>,24,24,0
2104,0,<START>,0,0,0
2104,1,home,0,9,9
2104,2,work,9,16,7
2104,3,home,16,20,4
2104,4,shop,20,21,1
2104,5,home,21,24,3
2104,6,<ENDS>,24,24,0
2105,0,<START>,0,0,0
2105,1,home,0,7,7
2105,2,work,7,13,6
2105,3,shop,13,14,1
2105,4,work,14,19,5
2105,5,home,19,24,5
2105,6,<ENDS>,24,24,0
2106,0,<START>,0,0,0
2106,1,home,0,6,6
2106,2,shop,6,7,1
2106,3,home,7,9,2
2106,4,education,9,12,3
2106,5,home,12,21,9
2106,6,shop,21,22,1
2106,7,home,22,24,2
2106,8,<ENDS>,24,24,0
2107,0,<START>,0,0,0
2107,1,home,0,6,6
2107,2,shop,6,7,1
2107,3,home,7,10,3
2107,4,work,10,15,5
2107,5,home,15,24,9
2107,6,<ENDS>,24,24,0
2108,0,<START>,0,0,0
2108,1,home,0,8,8
2108,2,work,8,14,6
2108,3,home,14,22,8
2108,4,work,22,23,1
2108,5,home,23,24,1
2108,6,<ENDS>,24,24,0
2109,0,<START>,0,0,0
2109,1,home,0,8,8
2109,2,work,8,13,5
2109,3,home,13,18,5
2109,4,shop,18,19,1
2109,5,home,19,24,5
2109,6,<ENDS>,24,24,0
2110,0,<START>,0,0,0
2110,1,home,0,7,7
2110,2,shop,7,9,2
2110,3,education,9,12,3
2110,4,home,12,18,6
2110,5,shop,18,19,1
2110,6,home,19,24,5
2110,7,<ENDS>,24,24,0
2111,0,<START>,0,0,0
2111,1,home,0,8,8
2111,2,work,8,15,7
2111,3,home,15,24,9
2111,4,<ENDS>,24,24,0
2112,0,<START>,0,0,0
2112,1,home,0,7,7
2112,2,work,7,13,6
2112,3,shop,13,14,1
2112,4,work,14,19,5
2112,5,home,19,24,5
2112,6,<ENDS>,24,24,0
2113,0,<START>,0,0,0
2113,1,home,0,8,8
2113,2,work,8,15,7
2113,3,home,15,24,9
2113,4,<ENDS>,24,24,0
2114,0,<START>,0,0,0
2114,1,home,0,8,8
2114,2,work,8,14,6
2114,3,home,14,24,10
2114,4,<ENDS>,24,24,0
2115,0,<START>,0,0,0
2115,1,home,0,8,8
2115,2,work,8,15,7
2115,3,home,15,23,8
2115,4,work,23,24,1
2115,5,<ENDS>,24,24,0
2116,0,<START>,0,0,0
2116,1,home,0,8,8
2116,2,work,8,15,7
2116,3,home,15,21,6
2116,4,shop,21,22,1
2116,5,home,22,24,2
2116,6,<ENDS>,24,24,0
2117,0,<START>,0,0,0
2117,1,home,0,8,8
2117,2,work,8,15,7
2117,3,shop,15,16,1
2117,4,home,16,24,8
2117,5,<ENDS>,24,24,0
2118,0,<START>,0,0,0
2118,1,home,0,6,6
2118,2,shop,6,7,1
2118,3,home,7,13,6
2118,4,education,13,16,3
2118,5,home,16,24,8
2118,6,<ENDS>,24,24,0
2119,0,<START>,0,0,0
2119,1,home,0,7,7
2119,2,work,7,13,6
2119,3,home,13,24,11
2119,4,<ENDS>,24,24,0
2120,0,<START>,0,0,0
2120,1,home,0,6,6
2120,2,work,6,13,7
2120,3,home,13,16,3
2120,4,work,16,18,2
2120,5,home,18,24,6
2120,6,<ENDS>,24,24,0
2121,0,<START>,0,0,0
2121,1,home,0,7,7
2121,2,work,7,13,6
2121,3,home,13,24,11
2121,4,<ENDS>,24,24,0
2122,0,<START>,0,0,0
2122,1,home,0,7,7
2122,2,education,7,12,5
2122,3,shop,12,14,2
2122,4,education,14,16,2
2122,5,shop,16,17,1
2122,6,home,17,24,7
2122,7,<ENDS>,24,24,0
2123,0,<START>,0,0,0
2123,1,home,0,8,8
2123,2,work,8,14,6
2123,3,home,14,22,8
2123,4,work,22,23,1
2123,5,home,23,24,1
2123,6,<ENDS>,24,24,0
2124,0,<START>,0,0,0
2124,1,home,0,6,6
2124,2,shop,6,7,1
2124,3,work,7,9,2
2124,4,home,9,15,6
2124,5,work,15,16,1
2124,6,home,16,21,5
2124,7,work,21,22,1
2124,8,home,22,24,2
2124,9,<ENDS>,24,24,0
2125,0,<START>,0,0,0
2125,1,home,0,8,8
2125,2,education,8,12,4
2125,3,work,12,19,7
2125,4,education,19,20,1
2125,5,home,20,24,4
2125,6,<ENDS>,24,24,0
2126,0,<START>,0,0,0
2126,1,home,0,8,8
2126,2,work,8,14,6
2126,3,shop,14,15,1
2126,4,home,15,24,9
2126,5,<ENDS>,24,24,0
2127,0,<START>,0,0,0
2127,1,home,0,6,6
2127,2,work,6,8,2
2127,3,home,8,14,6
2127,4,work,14,17,3
2127,5,home,17,21,4
2127,6,work,21,22,1
2127,7,home,22,24,2
2127,8,<ENDS>,24,24,0
2128,0,<START>,0,0,0
2128,1,home,0,8,8
2128,2,work,8,16,8
2128,3,home,16,24,8
2128,4,<ENDS>,24,24,0
2129,0,<START>,0,0,0
2129,1,home,0,6,6
2129,2,shop,6,7,1
2129,3,work,7,13,6
2129,4,home,13,24,11
2129,5,<ENDS>,24,24,0
2130,0,<START>,0,0,0
2130,1,home,0,7,7
2130,2,shop,7,8,1
2130,3,education,8,14,6
2130,4,shop,14,15,1
2130,5,home,15,21,6
2130,6,shop,21,22,1
2130,7,home,22,24,2
2130,8,<ENDS>,24,24,0
2131,0,<START>,0,0,0
2131,1,home,0,8,8
2131,2,work,8,15,7
2131,3,home,15,24,9
2131,4,<ENDS>,24,24,0
2132,0,<START>,0,0,0
2132,1,home,0,6,6
2132,2,shop,6,7,1
2132,3,home,7,10,3
2132,4,education,10,12,2
2132,5,shop,12,13,1
2132,6,education,13,16,3
2132,7,home,16,24,8
2132,8,<ENDS>,24,24,0
2133,0,<START>,0,0,0
2133,1,home,0,7,7
2133,2,work,7,13,6
2133,3,home,13,17,4
2133,4,work,17,20,3
2133,5,home,20,24,4
2133,6,<ENDS>,24,24,0
2134,0,<START>,0,0,0
2134,1,home,0,6,6
2134,2,work,6,7,1
2134,3,home,7,13,6
2134,4,work,13,15,2
2134,5,shop,15,16,1
2134,6,home,16,23,7
2134,7,work,23,24,1
2134,8,<ENDS>,24,24,0
2135,0,<START>,0,0,0
2135,1,home,0,7,7
2135,2,work,7,14,7
2135,3,shop,14,15,1
2135,4,home,15,24,9
2135,5,<ENDS>,24,24,0
2136,0,<START>,0,0,0
2136,1,home,0,7,7
2136,2,education,7,11,4
2136,3,home,11,18,7
2136,4,shop,18,20,2
2136,5,home,20,24,4
2136,6,<ENDS>,24,24,0
2137,0,<START>,0,0,0
2137,1,home,0,7,7
2137,2,shop,7,8,1
2137,3,work,8,15,7
2137,4,shop,15,16,1
2137,5,home,16,23,7
2137,6,work,23,24,1
2137,7,<ENDS>,24,24,0
2138,0,<START>,0,0,0
2138,1,home,0,8,8
2138,2,work,8,15,7
2138,3,home,15,24,9
2138,4,<ENDS>,24,24,0
2139,0,<START>,0,0,0
2139,1,home,0,7,7
2139,2,shop,7,9,2
2139,3,education,9,12,3
2139,4,shop,12,14,2
2139,5,education,14,16,2
2139,6,home,16,24,8
2139,7,<ENDS>,24,24,0
2140,0,<START>,0,0,0
2140,1,home,0,8,8
2140,2,work,8,15,7
2140,3,home,15,24,9
2140,4,<ENDS>,24,24,0
2141,0,<START>,0,0,0
2141,1,home,0,7,7
2141,2,education,7,12,5
2141,3,home,12,19,7
2141,4,shop,19,20,1
2141,5,home,20,24,4
2141,6,<ENDS>,24,24,0
2142,0,<START>,0,0,0
2142,1,home,0,7,7
2142,2,work,7,13,6
2142,3,shop,13,14,1
2142,4,home,14,24,10
2142,5,<ENDS>,24,24,0
2143,0,<START>,0,0,0
2143,1,home,0,7,7
2143,2,education,7,11,4
2143,3,home,11,18,7
2143,4,shop,18,20,2
2143,5,home,20,24,4
2143,6,<ENDS>,24,24,0
2144,0,<START>,0,0,0
2144,1,home,0,8,8
2144,2,shop,8,9,1
2144,3,work,9,16,7
2144,4,shop,16,17,1
2144,5,home,17,24,7
2144,6,<ENDS>,24,24,0
2145,0,<START>,0,0,0
2145,1,home,0,6,6
2145,2,work,6,7,1
2145,3,home,7,11,4
2145,4,work,11,13,2
2145,5,home,13,17,4
2145,6,work,17,19,2
2145,7,home,19,24,5
2145,8,<ENDS>,24,24,0
2146,0,<START>,0,0,0
2146,1,home,0,6,6
2146,2,work,6,9,3
2146,3,home,9,13,4
2146,4,work,13,15,2
2146,5,home,15,21,6
2146,6,work,21,22,1
2146,7,home,22,24,2
2146,8,<ENDS>,24,24,0
2147,0,<START>,0,0,0
2147,1,home,0,7,7
2147,2,work,7,13,6
2147,3,shop,13,14,1
2147,4,home,14,24,10
2147,5,<ENDS>,24,24,0
2148,0,<START>,0,0,0
2148,1,home,0,6,6
2148,2,work,6,8,2
2148,3,shop,8,9,1
2148,4,work,9,15,6
2148,5,home,15,24,9
2148,6,<ENDS>,24,24,0
2149,0,<START>,0,0,0
2149,1,home,0,7,7
2149,2,work,7,10,3
2149,3,home,10,17,7
2149,4,work,17,19,2
2149,5,home,19,24,5
2149,6,<ENDS>,24,24,0
2150,0,<START>,0,0,0
2150,1,home,0,7,7
2150,2,work,7,13,6
2150,3,home,13,18,5
2150,4,shop,18,19,1
2150,5,home,19,24,5
2150,6,<ENDS>,24,24,0
2151,0,<START>,0,0,0
2151,1,home,0,8,8
2151,2,work,8,14,6
2151,3,home,14,19,5
2151,4,shop,19,20,1
2151,5,home,20,24,4
2151,6,<ENDS>,24,24,0
2152,0,<START>,0,0,0
2152,1,home,0,7,7
2152,2,work,7,14,7
2152,3,home,14,24,10
2152,4,<ENDS>,24,24,0
2153,0,<START>,0,0,0
2153,1,home,0,7,7
2153,2,work,7,14,7
2153,3,shop,14,15,1
2153,4,home,15,24,9
2153,5,<ENDS>,24,24,0
2154,0,<START>,0,0,0
2154,1,home,0,8,8
2154,2,shop,8,9,1
2154,3,work,9,17,8
2154,4,home,17,23,6
2154,5,work,23,24,1
2154,6,<ENDS>,24,24,0
2155,0,<START>,0,0,0
2155,1,home,0,9,9
2155,2,work,9,16,7
2155,3,shop,16,17,1
2155,4,home,17,24,7
2155,5,<ENDS>,24,24,0
2156,0,<START>,0,0,0
2156,1,home,0,7,7
2156,2,work,7,13,6
2156,3,shop,13,14,1
2156,4,work,14,20,6
2156,5,home,20,24,4
2156,6,<ENDS>,24,24,0
2157,0,<START>,0,0,0
2157,1,home,0,7,7
2157,2,work,7,14,7
2157,3,shop,14,15,1
2157,4,work,15,19,4
2157,5,home,19,24,5
2157,6,<ENDS>,24,24,0
2158,0,<START>,0,0,0
2158,1,home,0,7,7
2158,2,work,7,14,7
2158,3,home,14,24,10
2158,4,<ENDS>,24,24,0
2159,0,<START>,0,0,0
2159,1,home,0,8,8
2159,2,work,8,15,7
2159,3,home,15,24,9
2159,4,<ENDS>,24,24,0
2160,0,<START>,0,0,0
2160,1,home,0,8,8
2160,2,work,8,15,7
2160,3,home,15,22,7
2160,4,work,22,23,1
2160,5,home,23,24,1
2160,6,<ENDS>,24,24,0
2161,0,<START>,0,0,0
2161,1,home,0,8,8
2161,2,work,8,14,6
2161,3,shop,14,15,1
2161,4,work,15,19,4
2161,5,home,19,24,5
2161,6,<ENDS>,24,24,0
2162,0,<START>,0,0,0
2162,1,home,0,8,8
2162,2,work,8,15,7
2162,3,home,15,24,9
2162,4,<ENDS>,24,24,0
2163,0,<START>,0,0,0
2163,1,home,0,7,7
2163,2,shop,7,8,1
2163,3,home,8,9,1
2163,4,work,9,16,7
2163,5,home,16,24,8
2163,6,<ENDS>,24,24,0
2164,0,<START>,0,0,0
2164,1,home,0,8,8
2164,2,work,8,15,7
2164,3,home,15,21,6
2164,4,shop,21,22,1
2164,5,home,22,24,2
2164,6,<ENDS>,24,24,0
2165,0,<START>,0,0,0
2165,1,home,0,7,7
2165,2,work,7,13,6
2165,3,home,13,17,4
2165,4,work,17,18,1
2165,5,home,18,24,6
2165,6,<ENDS>,24,24,0
2166,0,<START>,0,0,0
2166,1,home,0,9,9
2166,2,work,9,17,8
2166,3,home,17,24,7
2166,4,<ENDS>,24,24,0
2167,0,<START>,0,0,0
2167,1,home,0,6,6
2167,2,work,6,13,7
2167,3,shop,13,14,1
2167,4,home,14,24,10
2167,5,<ENDS>,24,24,0
2168,0,<START>,0,0,0
2168,1,home,0,6,6
2168,2,work,6,13,7
2168,3,home,13,24,11
2168,4,<ENDS>,24,24,0
2169,0,<START>,0,0,0
2169,1,home,0,7,7
2169,2,work,7,13,6
2169,3,shop,13,14,1
2169,4,education,14,16,2
2169,5,home,16,24,8
2169,6,<ENDS>,24,24,0
2170,0,<START>,0,0,0
2170,1,home,0,6,6
2170,2,work,6,7,1
2170,3,home,7,9,2
2170,4,work,9,11,2
2170,5,home,11,17,6
2170,6,work,17,19,2
2170,7,home,19,23,4
2170,8,work,23,24,1
2170,9,<ENDS>,24,24,0
2171,0,<START>,0,0,0
2171,1,home,0,7,7
2171,2,work,7,9,2
2171,3,home,9,13,4
2171,4,work,13,16,3
2171,5,home,16,23,7
2171,6,work,23,24,1
2171,7,<ENDS>,24,24,0
2172,0,<START>,0,0,0
2172,1,home,0,7,7
2172,2,work,7,13,6
2172,3,shop,13,14,1
2172,4,home,14,23,9
2172,5,work,23,24,1
2172,6,<ENDS>,24,24,0
2173,0,<START>,0,0,0
2173,1,home,0,7,7
2173,2,work,7,14,7
2173,3,home,14,24,10
2173,4,<ENDS>,24,24,0
2174,0,<START>,0,0,0
2174,1,home,0,7,7
2174,2,education,7,11,4
2174,3,home,11,18,7
2174,4,shop,18,19,1
2174,5,home,19,24,5
2174,6,<ENDS>,24,24,0
2175,0,<START>,0,0,0
2175,1,home,0,7,7
2175,2,work,7,14,7
2175,3,shop,14,15,1
2175,4,home,15,24,9
2175,5,<ENDS>,24,24,0
2176,0,<START>,0,0,0
2176,1,home,0,7,7
2176,2,shop,7,8,1
2176,3,work,8,14,6
2176,4,home,14,24,10
2176,5,<ENDS>,24,24,0
2177,0,<START>,0,0,0
2177,1,home,0,7,7
2177,2,work,7,13,6
2177,3,shop,13,14,1
2177,4,work,14,18,4
2177,5,home,18,24,6
2177,6,<ENDS>,24,24,0
2178,0,<START>,0,0,0
2178,1,home,0,8,8
2178,2,work,8,14,6
2178,3,home,14,24,10
2178,4,<ENDS>,24,24,0
2179,0,<START>,0,0,0
2179,1,home,0,8,8
2179,2,education,8,11,3
2179,3,home,11,17,6
2179,4,shop,17,19,2
2179,5,home,19,24,5
2179,6,<ENDS>,24,24,0
2180,0,<START>,0,0,0
2180,1,home,0,7,7
2180,2,shop,7,8,1
2180,3,education,8,11,3
2180,4,home,11,14,3
2180,5,education,14,16,2
2180,6,home,16,24,8
2180,7,<ENDS>,24,24,0
2181,0,<START>,0,0,0
2181,1,home,0,6,6
2181,2,shop,6,7,1
2181,3,home,7,9,2
2181,4,education,9,12,3
2181,5,home,12,20,8
2181,6,shop,20,21,1
2181,7,home,21,24,3
2181,8,<ENDS>,24,24,0
2182,0,<START>,0,0,0
2182,1,home,0,7,7
2182,2,education,7,11,4
2182,3,home,11,19,8
2182,4,shop,19,20,1
2182,5,home,20,24,4
2182,6,<ENDS>,24,24,0
2183,0,<START>,0,0,0
2183,1,home,0,7,7
2183,2,education,7,11,4
2183,3,home,11,18,7
2183,4,shop,18,19,1
2183,5,home,19,24,5
2183,6,<ENDS>,24,24,0
2184,0,<START>,0,0,0
2184,1,home,0,7,7
2184,2,work,7,13,6
2184,3,home,13,18,5
2184,4,work,18,20,2
2184,5,home,20,24,4
2184,6,<ENDS>,24,24,0
2185,0,<START>,0,0,0
2185,1,home,0,6,6
2185,2,work,6,13,7
2185,3,home,13,21,8
2185,4,shop,21,22,1
2185,5,home,22,24,2
2185,6,<ENDS>,24,24,0
2186,0,<START>,0,0,0
2186,1,home,0,6,6
2186,2,work,6,13,7
2186,3,shop,13,14,1
2186,4,home,14,24,10
2186,5,<ENDS>,24,24,0
2187,0,<START>,0,0,0
2187,1,home,0,8,8
2187,2,work,8,15,7
2187,3,home,15,24,9
2187,4,<ENDS>,24,24,0
2188,0,<START>,0,0,0
2188,1,home,0,7,7
2188,2,shop,7,8,1
2188,3,work,8,14,6
2188,4,home,14,21,7
2188,5,shop,21,22,1
2188,6,home,22,24,2
2188,7,<ENDS>,24,24,0
2189,0,<START>,0,0,0
2189,1,home,0,6,6
2189,2,shop,6,7,1
2189,3,home,7,13,6
2189,4,education,13,16,3
2189,5,home,16,24,8
2189,6,<ENDS>,24,24,0
2190,0,<START>,0,0,0
2190,1,home,0,6,6
2190,2,work,6,13,7
2190,3,home,13,24,11
2190,4,<ENDS>,24,24,0
2191,0,<START>,0,0,0
2191,1,home,0,6,6
2191,2,work,6,7,1
2191,3,home,7,12,5
2191,4,work,12,14,2
2191,5,home,14,15,1
2191,6,work,15,17,2
2191,7,home,17,23,6
2191,8,work,23,24,1
2191,9,<ENDS>,24,24,0
2192,0,<START>,0,0,0
2192,1,home,0,7,7
2192,2,education,7,11,4
2192,3,home,11,18,7
2192,4,shop,18,20,2
2192,5,home,20,24,4
2192,6,<ENDS>,24,24,0
2193,0,<START>,0,0,0
2193,1,home,0,7,7
2193,2,work,7,15,8
2193,3,home,15,24,9
2193,4,<ENDS>,24,24,0
2194,0,<START>,0,0,0
2194,1,home,0,6,6
2194,2,work,6,8,2
2194,3,home,8,9,1
2194,4,work,9,11,2
2194,5,home,11,17,6
2194,6,work,17,19,2
2194,7,home,19,24,5
2194,8,<ENDS>,24,24,0
2195,0,<START>,0,0,0
2195,1,home,0,7,7
2195,2,work,7,14,7
2195,3,home,14,22,8
2195,4,work,22,23,1
2195,5,home,23,24,1
2195,6,<ENDS>,24,24,0
2196,0,<START>,0,0,0
2196,1,home,0,6,6
2196,2,work,6,7,1
2196,3,home,7,11,4
2196,4,work,11,12,1
2196,5,home,12,21,9
2196,6,work,21,22,1
2196,7,home,22,24,2
2196,8,<ENDS>,24,24,0
2197,0,<START>,0,0,0
2197,1,home,0,6,6
2197,2,shop,6,7,1
2197,3,work,7,14,7
2197,4,home,14,23,9
2197,5,work,23,24,1
2197,6,<ENDS>,24,24,0
2198,0,<START>,0,0,0
2198,1,home,0,7,7
2198,2,education,7,12,5
2198,3,shop,12,14,2
2198,4,home,14,24,10
2198,5,<ENDS>,24,24,0
2199,0,<START>,0,0,0
2199,1,home,0,6,6
2199,2,work,6,13,7
2199,3,shop,13,14,1
2199,4,home,14,18,4
2199,5,shop,18,19,1
2199,6,home,19,23,4
2199,7,work,23,24,1
2199,8,<ENDS>,24,24,0
2200,0,<START>,0,0,0
2200,1,home,0,8,8
2200,2,work,8,15,7
2200,3,home,15,24,9
2200,4,<ENDS>,24,24,0
2201,0,<START>,0,0,0
2201,1,home,0,6,6
2201,2,shop,6,7,1
2201,3,home,7,13,6
2201,4,education,13,16,3
2201,5,home,16,24,8
2201,6,<ENDS>,24,24,0
2202,0,<START>,0,0,0
2202,1,home,0,7,7
2202,2,work,7,13,6
2202,3,shop,13,14,1
2202,4,work,14,18,4
2202,5,home,18,24,6
2202,6,<ENDS>,24,24,0
2203,0,<START>,0,0,0
2203,1,home,0,7,7
2203,2,work,7,13,6
2203,3,home,13,17,4
2203,4,work,17,20,3
2203,5,home,20,24,4
2203,6,<ENDS>,24,24,0
2204,0,<START>,0,0,0
2204,1,home,0,6,6
2204,2,shop,6,7,1
2204,3,home,7,13,6
2204,4,education,13,16,3
2204,5,home,16,24,8
2204,6,<ENDS>,24,24,0
2205,0,<START>,0,0,0
2205,1,home,0,6,6
2205,2,shop,6,7,1
2205,3,home,7,9,2
2205,4,education,9,12,3
2205,5,shop,12,14,2
2205,6,home,14,20,6
2205,7,shop,20,21,1
2205,8,home,21,24,3
2205,9,<ENDS>,24,24,0
2206,0,<START>,0,0,0
2206,1,home,0,6,6
2206,2,work,6,8,2
2206,3,home,8,13,5
2206,4,work,13,16,3
2206,5,home,16,23,7
2206,6,work,23,24,1
2206,7,<ENDS>,24,24,0
2207,0,<START>,0,0,0
2207,1,home,0,7,7
2207,2,work,7,14,7
2207,3,shop,14,15,1
2207,4,work,15,19,4
2207,5,home,19,24,5
2207,6,<ENDS>,24,24,0
2208,0,<START>,0,0,0
2208,1,home,0,7,7
2208,2,work,7,13,6
2208,3,shop,13,14,1
2208,4,work,14,19,5
2208,5,home,19,21,2
2208,6,work,21,22,1
2208,7,home,22,24,2
2208,8,<ENDS>,24,24,0
2209,0,<START>,0,0,0
2209,1,home,0,8,8
2209,2,work,8,15,7
2209,3,home,15,21,6
2209,4,work,21,22,1
2209,5,home,22,24,2
2209,6,<ENDS>,24,24,0
2210,0,<START>,0,0,0
2210,1,home,0,7,7
2210,2,work,7,13,6
2210,3,shop,13,14,1
2210,4,work,14,19,5
2210,5,home,19,24,5
2210,6,<ENDS>,24,24,0
2211,0,<START>,0,0,0
2211,1,home,0,6,6
2211,2,shop,6,7,1
2211,3,home,7,10,3
2211,4,education,10,12,2
2211,5,shop,12,14,2
2211,6,home,14,24,10
2211,7,<ENDS>,24,24,0
2212,0,<START>,0,0,0
2212,1,home,0,7,7
2212,2,work,7,14,7
2212,3,shop,14,15,1
2212,4,home,15,22,7
2212,5,work,22,23,1
2212,6,home,23,24,1
2212,7,<ENDS>,24,24,0
2213,0,<START>,0,0,0
2213,1,home,0,7,7
2213,2,shop,7,8,1
2213,3,education,8,11,3
2213,4,home,11,18,7
2213,5,shop,18,19,1
2213,6,home,19,24,5
2213,7,<ENDS>,24,24,0
2214,0,<START>,0,0,0
2214,1,home,0,6,6
2214,2,work,6,13,7
2214,3,shop,13,15,2
2214,4,home,15,24,9
2214,5,<ENDS>,24,24,0
2215,0,<START>,0,0,0
2215,1,home,0,7,7
2215,2,work,7,13,6
2215,3,home,13,17,4
2215,4,work,17,18,1
2215,5,home,18,24,6
2215,6,<ENDS>,24,24,0
2216,0,<START>,0,0,0
2216,1,home,0,7,7
2216,2,work,7,15,8
2216,3,home,15,22,7
2216,4,work,22,23,1
2216,5,home,23,24,1
2216,6,<ENDS>,24,24,0
2217,0,<START>,0,0,0
2217,1,home,0,8,8
2217,2,work,8,16,8
2217,3,shop,16,17,1
2217,4,home,17,24,7
2217,5,<ENDS>,24,24,0
2218,0,<START>,0,0,0
2218,1,home,0,7,7
2218,2,shop,7,8,1
2218,3,work,8,16,8
2218,4,home,16,21,5
2218,5,work,21,22,1
2218,6,home,22,24,2
2218,7,<ENDS>,24,24,0
2219,0,<START>,0,0,0
2219,1,home,0,6,6
2219,2,shop,6,7,1
2219,3,home,7,9,2
2219,4,education,9,12,3
2219,5,home,12,20,8
2219,6,shop,20,21,1
2219,7,home,21,24,3
2219,8,<ENDS>,24,24,0
2220,0,<START>,0,0,0
2220,1,home,0,7,7
2220,2,work,7,13,6
2220,3,home,13,24,11
2220,4,<ENDS>,24,24,0
2221,0,<START>,0,0,0
2221,1,home,0,7,7
2221,2,shop,7,8,1
2221,3,education,8,11,3
2221,4,home,11,14,3
2221,5,education,14,16,2
2221,6,home,16,24,8
2221,7,<ENDS>,24,24,0
2222,0,<START>,0,0,0
2222,1,home,0,7,7
2222,2,work,7,13,6
2222,3,home,13,21,8
2222,4,work,21,22,1
2222,5,home,22,24,2
2222,6,<ENDS>,24,24,0
2223,0,<START>,0,0,0
2223,1,home,0,7,7
2223,2,work,7,13,6
2223,3,home,13,23,10
2223,4,work,23,24,1
2223,5,<ENDS>,24,24,0
2224,0,<START>,0,0,0
2224,1,home,0,7,7
2224,2,shop,7,8,1
2224,3,home,8,12,4
2224,4,work,12,14,2
2224,5,home,14,21,7
2224,6,work,21,22,1
2224,7,home,22,24,2
2224,8,<ENDS>,24,24,0
2225,0,<START>,0,0,0
2225,1,home,0,7,7
2225,2,work,7,14,7
2225,3,shop,14,15,1
2225,4,work,15,20,5
2225,5,home,20,24,4
2225,6,<ENDS>,24,24,0
2226,0,<START>,0,0,0
2226,1,home,0,6,6
2226,2,work,6,13,7
2226,3,home,13,16,3
2226,4,shop,16,17,1
2226,5,home,17,24,7
2226,6,<ENDS>,24,24,0
2227,0,<START>,0,0,0
2227,1,home,0,6,6
2227,2,shop,6,7,1
2227,3,home,7,10,3
2227,4,education,10,11,1
2227,5,home,11,19,8
2227,6,shop,19,21,2
2227,7,home,21,24,3
2227,8,<ENDS>,24,24,0
2228,0,<START>,0,0,0
2228,1,home,0,6,6
2228,2,shop,6,7,1
2228,3,home,7,13,6
2228,4,education,13,15,2
2228,5,shop,15,17,2
2228,6,home,17,24,7
2228,7,<ENDS>,24,24,0
2229,0,<START>,0,0,0
2229,1,home,0,8,8
2229,2,education,8,11,3
2229,3,home,11,15,4
2229,4,work,15,20,5
2229,5,home,20,24,4
2229,6,<ENDS>,24,24,0
2230,0,<START>,0,0,0
2230,1,home,0,7,7
2230,2,education,7,11,4
2230,3,home,11,17,6
2230,4,shop,17,18,1
2230,5,home,18,24,6
2230,6,<ENDS>,24,24,0
2231,0,<START>,0,0,0
2231,1,home,0,7,7
2231,2,education,7,12,5
2231,3,shop,12,13,1
2231,4,education,13,16,3
2231,5,home,16,24,8
2231,6,<ENDS>,24,24,0
2232,0,<START>,0,0,0
2232,1,home,0,7,7
2232,2,shop,7,8,1
2232,3,education,8,11,3
2232,4,home,11,20,9
2232,5,shop,20,21,1
2232,6,home,21,24,3
2232,7,<ENDS>,24,24,0
2233,0,<START>,0,0,0
2233,1,home,0,8,8
2233,2,work,8,15,7
2233,3,home,15,21,6
2233,4,shop,21,22,1
2233,5,home,22,24,2
2233,6,<ENDS>,24,24,0
2234,0,<START>,0,0,0
2234,1,home,0,7,7
2234,2,work,7,13,6
2234,3,shop,13,14,1
2234,4,home,14,23,9
2234,5,work,23,24,1
2234,6,<ENDS>,24,24,0
2235,0,<START>,0,0,0
2235,1,home,0,6,6
2235,2,work,6,8,2
2235,3,home,8,14,6
2235,4,work,14,16,2
2235,5,home,16,22,6
2235,6,work,22,23,1
2235,7,home,23,24,1
2235,8,<ENDS>,24,24,0
2236,0,<START>,0,0,0
2236,1,home,0,7,7
2236,2,work,7,14,7
2236,3,home,14,24,10
2236,4,<ENDS>,24,24,0
2237,0,<START>,0,0,0
2237,1,home,0,7,7
2237,2,work,7,15,8
2237,3,home,15,22,7
2237,4,work,22,23,1
2237,5,home,23,24,1
2237,6,<ENDS>,24,24,0
2238,0,<START>,0,0,0
2238,1,home,0,7,7
2238,2,education,7,11,4
2238,3,home,11,14,3
2238,4,education,14,17,3
2238,5,home,17,24,7
2238,6,<ENDS>,24,24,0
2239,0,<START>,0,0,0
2239,1,home,0,7,7
2239,2,work,7,14,7
2239,3,home,14,24,10
2239,4,<ENDS>,24,24,0
2240,0,<START>,0,0,0
2240,1,home,0,8,8
2240,2,work,8,14,6
2240,3,home,14,20,6
2240,4,shop,20,21,1
2240,5,home,21,24,3
2240,6,<ENDS>,24,24,0
2241,0,<START>,0,0,0
2241,1,home,0,6,6
2241,2,work,6,13,7
2241,3,shop,13,14,1
2241,4,home,14,24,10
2241,5,<ENDS>,24,24,0
2242,0,<START>,0,0,0
2242,1,home,0,8,8
2242,2,work,8,14,6
2242,3,home,14,24,10
2242,4,<ENDS>,24,24,0
2243,0,<START>,0,0,0
2243,1,home,0,8,8
2243,2,work,8,16,8
2243,3,home,16,21,5
2243,4,shop,21,22,1
2243,5,home,22,24,2
2243,6,<ENDS>,24,24,0
2244,0,<START>,0,0,0
2244,1,home,0,6,6
2244,2,work,6,13,7
2244,3,home,13,18,5
2244,4,shop,18,19,1
2244,5,home,19,24,5
2244,6,<ENDS>,24,24,0
2245,0,<START>,0,0,0
2245,1,home,0,6,6
2245,2,work,6,8,2
2245,3,home,8,13,5
2245,4,work,13,15,2
2245,5,home,15,21,6
2245,6,work,21,22,1
2245,7,home,22,24,2
2245,8,<ENDS>,24,24,0
2246,0,<START>,0,0,0
2246,1,home,0,6,6
2246,2,work,6,13,7
2246,3,home,13,24,11
2246,4,<ENDS>,24,24,0
2247,0,<START>,0,0,0
2247,1,home,0,6,6
2247,2,work,6,13,7
2247,3,home,13,22,9
2247,4,work,22,23,1
2247,5,home,23,24,1
2247,6,<ENDS>,24,24,0
2248,0,<START>,0,0,0
2248,1,home,0,8,8
2248,2,shop,8,10,2
2248,3,education,10,13,3
2248,4,home,13,19,6
2248,5,shop,19,20,1
2248,6,home,20,24,4
2248,7,<ENDS>,24,24,0
2249,0,<START>,0,0,0
2249,1,home,0,8,8
2249,2,work,8,15,7
2249,3,home,15,24,9
2249,4,<ENDS>,24,24,0
2250,0,<START>,0,0,0
2250,1,home,0,6,6
2250,2,shop,6,7,1
2250,3,home,7,8,1
2250,4,shop,8,9,1
2250,5,education,9,12,3
2250,6,home,12,20,8
2250,7,shop,20,21,1
2250,8,home,21,24,3
2250,9,<ENDS>,24,24,0
2251,0,<START>,0,0,0
2251,1,home,0,7,7
2251,2,work,7,13,6
2251,3,home,13,17,4
2251,4,work,17,20,3
2251,5,home,20,24,4
2251,6,<ENDS>,24,24,0
2252,0,<START>,0,0,0
2252,1,home,0,7,7
2252,2,education,7,11,4
2252,3,home,11,18,7
2252,4,shop,18,19,1
2252,5,home,19,24,5
2252,6,<ENDS>,24,24,0
2253,0,<START>,0,0,0
2253,1,home,0,7,7
2253,2,education,7,12,5
2253,3,home,12,18,6
2253,4,shop,18,19,1
2253,5,home,19,24,5
2253,6,<ENDS>,24,24,0
2254,0,<START>,0,0,0
2254,1,home,0,6,6
2254,2,work,6,13,7
2254,3,home,13,24,11
2254,4,<ENDS>,24,24,0
2255,0,<START>,0,0,0
2255,1,home,0,7,7
2255,2,work,7,13,6
2255,3,home,13,22,9
2255,4,work,22,23,1
2255,5,home,23,24,1
2255,6,<ENDS>,24,24,0
2256,0,<START>,0,0,0
2256,1,home,0,6,6
2256,2,work,6,13,7
2256,3,home,13,17,4
2256,4,work,17,19,2
2256,5,home,19,24,5
2256,6,<ENDS>,24,24,0
2257,0,<START>,0,0,0
2257,1,home,0,6,6
2257,2,work,6,13,7
2257,3,shop,13,14,1
2257,4,home,14,15,1
2257,5,work,15,20,5
2257,6,home,20,24,4
2257,7,<ENDS>,24,24,0
2258,0,<START>,0,0,0
2258,1,home,0,7,7
2258,2,shop,7,8,1
2258,3,work,8,16,8
2258,4,home,16,24,8
2258,5,<ENDS>,24,24,0
2259,0,<START>,0,0,0
2259,1,home,0,10,10
2259,2,work,10,18,8
2259,3,education,18,20,2
2259,4,home,20,24,4
2259,5,<ENDS>,24,24,0
2260,0,<START>,0,0,0
2260,1,home,0,6,6
2260,2,shop,6,7,1
2260,3,home,7,10,3
2260,4,education,10,12,2
2260,5,shop,12,13,1
2260,6,education,13,16,3
2260,7,home,16,24,8
2260,8,<ENDS>,24,24,0
2261,0,<START>,0,0,0
2261,1,home,0,7,7
2261,2,work,7,15,8
2261,3,home,15,24,9
2261,4,<ENDS>,24,24,0
2262,0,<START>,0,0,0
2262,1,home,0,6,6
2262,2,work,6,13,7
2262,3,shop,13,14,1
2262,4,home,14,15,1
2262,5,work,15,20,5
2262,6,home,20,24,4
2262,7,<ENDS>,24,24,0
2263,0,<START>,0,0,0
2263,1,home,0,6,6
2263,2,shop,6,7,1
2263,3,home,7,13,6
2263,4,education,13,17,4
2263,5,home,17,24,7
2263,6,<ENDS>,24,24,0
2264,0,<START>,0,0,0
2264,1,home,0,8,8
2264,2,education,8,12,4
2264,3,shop,12,13,1
2264,4,education,13,16,3
2264,5,shop,16,18,2
2264,6,home,18,24,6
2264,7,<ENDS>,24,24,0
2265,0,<START>,0,0,0
2265,1,home,0,6,6
2265,2,work,6,7,1
2265,3,home,7,9,2
2265,4,work,9,11,2
2265,5,home,11,15,4
2265,6,work,15,17,2
2265,7,home,17,23,6
2265,8,work,23,24,1
2265,9,<ENDS>,24,24,0
2266,0,<START>,0,0,0
2266,1,home,0,6,6
2266,2,work,6,13,7
2266,3,home,13,24,11
2266,4,<ENDS>,24,24,0
2267,0,<START>,0,0,0
2267,1,home,0,6,6
2267,2,work,6,13,7
2267,3,home,13,18,5
2267,4,shop,18,20,2
2267,5,home,20,24,4
2267,6,<ENDS>,24,24,0
2268,0,<START>,0,0,0
2268,1,home,0,7,7
2268,2,work,7,13,6
2268,3,home,13,17,4
2268,4,shop,17,18,1
2268,5,home,18,24,6
2268,6,<ENDS>,24,24,0
2269,0,<START>,0,0,0
2269,1,home,0,7,7
2269,2,work,7,13,6
2269,3,home,13,18,5
2269,4,work,18,19,1
2269,5,home,19,24,5
2269,6,<ENDS>,24,24,0
2270,0,<START>,0,0,0
2270,1,home,0,7,7
2270,2,work,7,13,6
2270,3,home,13,18,5
2270,4,shop,18,19,1
2270,5,home,19,23,4
2270,6,work,23,24,1
2270,7,<ENDS>,24,24,0
2271,0,<START>,0,0,0
2271,1,home,0,6,6
2271,2,shop,6,7,1
2271,3,home,7,11,4
2271,4,work,11,13,2
2271,5,home,13,17,4
2271,6,work,17,20,3
2271,7,home,20,24,4
2271,8,<ENDS>,24,24,0
2272,0,<START>,0,0,0
2272,1,home,0,8,8
2272,2,education,8,11,3
2272,3,home,11,19,8
2272,4,shop,19,20,1
2272,5,home,20,24,4
2272,6,<ENDS>,24,24,0
2273,0,<START>,0,0,0
2273,1,home,0,8,8
2273,2,work,8,15,7
2273,3,home,15,19,4
2273,4,shop,19,20,1
2273,5,home,20,24,4
2273,6,<ENDS>,24,24,0
2274,0,<START>,0,0,0
2274,1,home,0,8,8
2274,2,education,8,12,4
2274,3,shop,12,14,2
2274,4,home,14,20,6
2274,5,shop,20,21,1
2274,6,home,21,24,3
2274,7,<ENDS>,24,24,0
2275,0,<START>,0,0,0
2275,1,home,0,7,7
2275,2,work,7,13,6
2275,3,home,13,20,7
2275,4,shop,20,21,1
2275,5,home,21,24,3
2275,6,<ENDS>,24,24,0
2276,0,<START>,0,0,0
2276,1,home,0,8,8
2276,2,education,8,11,3
2276,3,home,11,21,10
2276,4,shop,21,22,1
2276,5,home,22,24,2
2276,6,<ENDS>,24,24,0
2277,0,<START>,0,0,0
2277,1,home,0,8,8
2277,2,shop,8,9,1
2277,3,education,9,12,3
2277,4,shop,12,13,1
2277,5,education,13,16,3
2277,6,home,16,24,8
2277,7,<ENDS>,24,24,0
2278,0,<START>,0,0,0
2278,1,home,0,7,7
2278,2,work,7,13,6
2278,3,home,13,17,4
2278,4,work,17,20,3
2278,5,home,20,24,4
2278,6,<ENDS>,24,24,0
2279,0,<START>,0,0,0
2279,1,home,0,6,6
2279,2,work,6,7,1
2279,3,home,7,11,4
2279,4,work,11,13,2
2279,5,home,13,16,3
2279,6,work,16,18,2
2279,7,home,18,24,6
2279,8,<ENDS>,24,24,0
2280,0,<START>,0,0,0
2280,1,home,0,7,7
2280,2,shop,7,8,1
2280,3,home,8,9,1
2280,4,education,9,13,4
2280,5,shop,13,14,1
2280,6,home,14,18,4
2280,7,work,18,20,2
2280,8,home,20,24,4
2280,9,<ENDS>,24,24,0
2281,0,<START>,0,0,0
2281,1,home,0,7,7
2281,2,shop,7,8,1
2281,3,education,8,11,3
2281,4,home,11,17,6
2281,5,shop,17,18,1
2281,6,home,18,24,6
2281,7,<ENDS>,24,24,0
2282,0,<START>,0,0,0
2282,1,home,0,7,7
2282,2,work,7,13,6
2282,3,shop,13,14,1
2282,4,home,14,24,10
2282,5,<ENDS>,24,24,0
2283,0,<START>,0,0,0
2283,1,home,0,6,6
2283,2,shop,6,7,1
2283,3,work,7,8,1
2283,4,home,8,9,1
2283,5,work,9,10,1
2283,6,home,10,14,4
2283,7,work,14,16,2
2283,8,home,16,22,6
2283,9,work,22,23,1
2283,10,home,23,24,1
2283,11,<ENDS>,24,24,0
2284,0,<START>,0,0,0
2284,1,home,0,6,6
2284,2,shop,6,7,1
2284,3,work,7,14,7
2284,4,home,14,24,10
2284,5,<ENDS>,24,24,0
2285,0,<START>,0,0,0
2285,1,home,0,8,8
2285,2,work,8,15,7
2285,3,home,15,21,6
2285,4,shop,21,22,1
2285,5,home,22,24,2
2285,6,<ENDS>,24,24,0
2286,0,<START>,0,0,0
2286,1,home,0,9,9
2286,2,work,9,17,8
2286,3,home,17,23,6
2286,4,work,23,24,1
2286,5,<ENDS>,24,24,0
2287,0,<START>,0,0,0
2287,1,home,0,7,7
2287,2,work,7,13,6
2287,3,home,13,17,4
2287,4,work,17,20,3
2287,5,home,20,24,4
2287,6,<ENDS>,24,24,0
2288,0,<START>,0,0,0
2288,1,home,0,8,8
2288,2,work,8,15,7
2288,3,home,15,20,5
2288,4,shop,20,21,1
2288,5,home,21,24,3
2288,6,<ENDS>,24,24,0
2289,0,<START>,0,0,0
2289,1,home,0,6,6
2289,2,shop,6,7,1
2289,3,work,7,13,6
2289,4,home,13,24,11
2289,5,<ENDS>,24,24,0
2290,0,<START>,0,0,0
2290,1,home,0,7,7
2290,2,work,7,13,6
2290,3,shop,13,14,1
2290,4,work,14,19,5
2290,5,home,19,24,5
2290,6,<ENDS>,24,24,0
2291,0,<START>,0,0,0
2291,1,home,0,7,7
2291,2,work,7,9,2
2291,3,home,9,13,4
2291,4,work,13,16,3
2291,5,shop,16,17,1
2291,6,home,17,24,7
2291,7,<ENDS>,24,24,0
2292,0,<START>,0,0,0
2292,1,home,0,8,8
2292,2,work,8,14,6
2292,3,shop,14,15,1
2292,4,home,15,24,9
2292,5,<ENDS>,24,24,0
2293,0,<START>,0,0,0
2293,1,home,0,7,7
2293,2,work,7,15,8
2293,3,home,15,24,9
2293,4,<ENDS>,24,24,0
2294,0,<START>,0,0,0
2294,1,home,0,8,8
2294,2,work,8,13,5
2294,3,home,13,24,11
2294,4,<ENDS>,24,24,0
2295,0,<START>,0,0,0
2295,1,home,0,7,7
2295,2,shop,7,9,2
2295,3,education,9,13,4
2295,4,shop,13,14,1
2295,5,education,14,16,2
2295,6,shop,16,17,1
2295,7,home,17,24,7
2295,8,<ENDS>,24,24,0
2296,0,<START>,0,0,0
2296,1,home,0,7,7
2296,2,education,7,11,4
2296,3,home,11,14,3
2296,4,education,14,16,2
2296,5,home,16,24,8
2296,6,<ENDS>,24,24,0
2297,0,<START>,0,0,0
2297,1,home,0,8,8
2297,2,shop,8,9,1
2297,3,education,9,12,3
2297,4,home,12,20,8
2297,5,shop,20,21,1
2297,6,home,21,24,3
2297,7,<ENDS>,24,24,0
2298,0,<START>,0,0,0
2298,1,home,0,8,8
2298,2,education,8,12,4
2298,3,home,12,15,3
2298,4,shop,15,17,2
2298,5,home,17,24,7
2298,6,<ENDS>,24,24,0
2299,0,<START>,0,0,0
2299,1,home,0,6,6
2299,2,work,6,13,7
2299,3,shop,13,14,1
2299,4,home,14,24,10
2299,5,<ENDS>,24,24,0
2300,0,<START>,0,0,0
2300,1,home,0,7,7
2300,2,work,7,14,7
2300,3,shop,14,15,1
2300,4,home,15,24,9
2300,5,<ENDS>,24,24,0
2301,0,<START>,0,0,0
2301,1,home,0,7,7
2301,2,work,7,13,6
2301,3,shop,13,14,1
2301,4,home,14,18,4
2301,5,shop,18,19,1
2301,6,home,19,21,2
2301,7,work,21,22,1
2301,8,home,22,24,2
2301,9,<ENDS>,24,24,0
2302,0,<START>,0,0,0
2302,1,home,0,6,6
2302,2,work,6,8,2
2302,3,home,8,14,6
2302,4,work,14,17,3
2302,5,home,17,24,7
2302,6,<ENDS>,24,24,0
2303,0,<START>,0,0,0
2303,1,home,0,8,8
2303,2,work,8,14,6
2303,3,home,14,24,10
2303,4,<ENDS>,24,24,0
2304,0,<START>,0,0,0
2304,1,home,0,6,6
2304,2,work,6,13,7
2304,3,shop,13,14,1
2304,4,work,14,20,6
2304,5,home,20,24,4
2304,6,<ENDS>,24,24,0
2305,0,<START>,0,0,0
2305,1,home,0,6,6
2305,2,work,6,8,2
2305,3,home,8,14,6
2305,4,work,14,17,3
2305,5,home,17,24,7
2305,6,<ENDS>,24,24,0
2306,0,<START>,0,0,0
2306,1,home,0,7,7
2306,2,work,7,13,6
2306,3,home,13,24,11
2306,4,<ENDS>,24,24,0
2307,0,<START>,0,0,0
2307,1,home,0,6,6
2307,2,work,6,13,7
2307,3,home,13,17,4
2307,4,shop,17,18,1
2307,5,home,18,24,6
2307,6,<ENDS>,24,24,0
2308,0,<START>,0,0,0
2308,1,home,0,8,8
2308,2,work,8,13,5
2308,3,shop,13,14,1
2308,4,work,14,19,5
2308,5,home,19,24,5
2308,6,<ENDS>,24,24,0
2309,0,<START>,0,0,0
2309,1,home,0,6,6
2309,2,work,6,13,7
2309,3,shop,13,14,1
2309,4,work,14,20,6
2309,5,home,20,24,4
2309,6,<ENDS>,24,24,0
2310,0,<START>,0,0,0
2310,1,home,0,7,7
2310,2,work,7,13,6
2310,3,shop,13,14,1
2310,4,work,14,20,6
2310,5,home,20,24,4
2310,6,<ENDS>,24,24,0
2311,0,<START>,0,0,0
2311,1,home,0,7,7
2311,2,work,7,13,6
2311,3,shop,13,14,1
2311,4,work,14,19,5
2311,5,home,19,24,5
2311,6,<ENDS>,24,24,0
2312,0,<START>,0,0,0
2312,1,home,0,7,7
2312,2,work,7,9,2
2312,3,home,9,15,6
2312,4,work,15,18,3
2312,5,home,18,24,6
2312,6,<ENDS>,24,24,0
2313,0,<START>,0,0,0
2313,1,home,0,8,8
2313,2,work,8,15,7
2313,3,home,15,24,9
2313,4,<ENDS>,24,24,0
2314,0,<START>,0,0,0
2314,1,home,0,6,6
2314,2,work,6,7,1
2314,3,home,7,10,3
2314,4,work,10,11,1
2314,5,home,11,17,6
2314,6,work,17,19,2
2314,7,home,19,24,5
2314,8,<ENDS>,24,24,0
2315,0,<START>,0,0,0
2315,1,home,0,9,9
2315,2,work,9,14,5
2315,3,shop,14,15,1
2315,4,home,15,23,8
2315,5,work,23,24,1
2315,6,<ENDS>,24,24,0
2316,0,<START>,0,0,0
2316,1,home,0,6,6
2316,2,work,6,13,7
2316,3,shop,13,14,1
2316,4,work,14,19,5
2316,5,home,19,24,5
2316,6,<ENDS>,24,24,0
2317,0,<START>,0,0,0
2317,1,home,0,6,6
2317,2,work,6,13,7
2317,3,home,13,17,4
2317,4,work,17,20,3
2317,5,home,20,24,4
2317,6,<ENDS>,24,24,0
2318,0,<START>,0,0,0
2318,1,home,0,7,7
2318,2,work,7,14,7
2318,3,shop,14,15,1
2318,4,work,15,19,4
2318,5,home,19,24,5
2318,6,<ENDS>,24,24,0
2319,0,<START>,0,0,0
2319,1,work,0,1,1
2319,2,home,1,7,6
2319,3,education,7,12,5
2319,4,shop,12,14,2
2319,5,home,14,24,10
2319,6,<ENDS>,24,24,0
2320,0,<START>,0,0,0
2320,1,home,0,7,7
2320,2,work,7,13,6
2320,3,shop,13,14,1
2320,4,work,14,20,6
2320,5,home,20,24,4
2320,6,<ENDS>,24,24,0
2321,0,<START>,0,0,0
2321,1,home,0,7,7
2321,2,work,7,13,6
2321,3,shop,13,14,1
2321,4,home,14,24,10
2321,5,<ENDS>,24,24,0
2322,0,<START>,0,0,0
2322,1,home,0,6,6
2322,2,work,6,13,7
2322,3,shop,13,15,2
2322,4,home,15,21,6
2322,5,work,21,22,1
2322,6,home,22,24,2
2322,7,<ENDS>,24,24,0
2323,0,<START>,0,0,0
2323,1,home,0,6,6
2323,2,work,6,8,2
2323,3,home,8,14,6
2323,4,work,14,17,3
2323,5,home,17,24,7
2323,6,<ENDS>,24,24,0
2324,0,<START>,0,0,0
2324,1,home,0,7,7
2324,2,work,7,9,2
2324,3,home,9,14,5
2324,4,work,14,16,2
2324,5,home,16,21,5
2324,6,shop,21,22,1
2324,7,home,22,24,2
2324,8,<ENDS>,24,24,0
2325,0,<START>,0,0,0
2325,1,home,0,6,6
2325,2,shop,6,7,1
2325,3,work,7,14,7
2325,4,home,14,24,10
2325,5,<ENDS>,24,24,0
2326,0,<START>,0,0,0
2326,1,home,0,7,7
2326,2,education,7,11,4
2326,3,home,11,18,7
2326,4,shop,18,19,1
2326,5,home,19,21,2
2326,6,shop,21,22,1
2326,7,home,22,24,2
2326,8,<ENDS>,24,24,0
2327,0,<START>,0,0,0
2327,1,home,0,9,9
2327,2,work,9,14,5
2327,3,home,14,21,7
2327,4,work,21,22,1
2327,5,home,22,24,2
2327,6,<ENDS>,24,24,0
2328,0,<START>,0,0,0
2328,1,home,0,8,8
2328,2,education,8,11,3
2328,3,home,11,18,7
2328,4,shop,18,20,2
2328,5,home,20,24,4
2328,6,<ENDS>,24,24,0
2329,0,<START>,0,0,0
2329,1,home,0,7,7
2329,2,work,7,13,6
2329,3,shop,13,14,1
2329,4,work,14,19,5
2329,5,home,19,24,5
2329,6,<ENDS>,24,24,0
2330,0,<START>,0,0,0
2330,1,home,0,7,7
2330,2,work,7,14,7
2330,3,home,14,21,7
2330,4,work,21,22,1
2330,5,home,22,24,2
2330,6,<ENDS>,24,24,0
2331,0,<START>,0,0,0
2331,1,home,0,7,7
2331,2,education,7,11,4
2331,3,home,11,18,7
2331,4,shop,18,19,1
2331,5,home,19,24,5
2331,6,<ENDS>,24,24,0
2332,0,<START>,0,0,0
2332,1,home,0,7,7
2332,2,education,7,11,4
2332,3,home,11,18,7
2332,4,shop,18,19,1
2332,5,home,19,24,5
2332,6,<ENDS>,24,24,0
2333,0,<START>,0,0,0
2333,1,home,0,6,6
2333,2,shop,6,7,1
2333,3,home,7,9,2
2333,4,education,9,12,3
2333,5,home,12,18,6
2333,6,shop,18,20,2
2333,7,home,20,24,4
2333,8,<ENDS>,24,24,0
2334,0,<START>,0,0,0
2334,1,home,0,6,6
2334,2,work,6,12,6
2334,3,shop,12,13,1
2334,4,work,13,20,7
2334,5,home,20,24,4
2334,6,<ENDS>,24,24,0
2335,0,<START>,0,0,0
2335,1,home,0,7,7
2335,2,shop,7,8,1
2335,3,home,8,22,14
2335,4,work,22,23,1
2335,5,home,23,24,1
2335,6,<ENDS>,24,24,0
2336,0,<START>,0,0,0
2336,1,home,0,6,6
2336,2,work,6,13,7
2336,3,home,13,24,11
2336,4,<ENDS>,24,24,0
2337,0,<START>,0,0,0
2337,1,home,0,6,6
2337,2,shop,6,7,1
2337,3,work,7,13,6
2337,4,home,13,23,10
2337,5,work,23,24,1
2337,6,<ENDS>,24,24,0
2338,0,<START>,0,0,0
2338,1,home,0,6,6
2338,2,work,6,8,2
2338,3,home,8,12,4
2338,4,work,12,15,3
2338,5,home,15,23,8
2338,6,work,23,24,1
2338,7,<ENDS>,24,24,0
2339,0,<START>,0,0,0
2339,1,home,0,6,6
2339,2,work,6,8,2
2339,3,home,8,14,6
2339,4,work,14,16,2
2339,5,home,16,23,7
2339,6,work,23,24,1
2339,7,<ENDS>,24,24,0
2340,0,<START>,0,0,0
2340,1,home,0,8,8
2340,2,education,8,12,4
2340,3,shop,12,14,2
2340,4,home,14,20,6
2340,5,shop,20,21,1
2340,6,home,21,24,3
2340,7,<ENDS>,24,24,0
2341,0,<START>,0,0,0
2341,1,home,0,7,7
2341,2,shop,7,8,1
2341,3,home,8,11,3
2341,4,work,11,18,7
2341,5,home,18,24,6
2341,6,<ENDS>,24,24,0
2342,0,<START>,0,0,0
2342,1,home,0,6,6
2342,2,work,6,13,7
2342,3,home,13,24,11
2342,4,<ENDS>,24,24,0
2343,0,<START>,0,0,0
2343,1,home,0,7,7
2343,2,work,7,14,7
2343,3,shop,14,15,1
2343,4,work,15,20,5
2343,5,home,20,24,4
2343,6,<ENDS>,24,24,0
2344,0,<START>,0,0,0
2344,1,home,0,6,6
2344,2,shop,6,7,1
2344,3,work,7,13,6
2344,4,shop,13,14,1
2344,5,work,14,20,6
2344,6,home,20,24,4
2344,7,<ENDS>,24,24,0
2345,0,<START>,0,0,0
2345,1,home,0,7,7
2345,2,work,7,13,6
2345,3,shop,13,14,1
2345,4,work,14,20,6
2345,5,home,20,24,4
2345,6,<ENDS>,24,24,0
2346,0,<START>,0,0,0
2346,1,home,0,6,6
2346,2,work,6,13,7
2346,3,home,13,24,11
2346,4,<ENDS>,24,24,0
2347,0,<START>,0,0,0
2347,1,home,0,8,8
2347,2,work,8,15,7
2347,3,home,15,24,9
2347,4,<ENDS>,24,24,0
2348,0,<START>,0,0,0
2348,1,home,0,9,9
2348,2,work,9,16,7
2348,3,home,16,23,7
2348,4,work,23,24,1
2348,5,<ENDS>,24,24,0
2349,0,<START>,0,0,0
2349,1,home,0,7,7
2349,2,education,7,11,4
2349,3,home,11,17,6
2349,4,shop,17,18,1
2349,5,home,18,24,6
2349,6,<ENDS>,24,24,0
2350,0,<START>,0,0,0
2350,1,home,0,6,6
2350,2,shop,6,7,1
2350,3,home,7,13,6
2350,4,education,13,16,3
2350,5,home,16,24,8
2350,6,<ENDS>,24,24,0
2351,0,<START>,0,0,0
2351,1,home,0,7,7
2351,2,education,7,11,4
2351,3,home,11,14,3
2351,4,education,14,16,2
2351,5,shop,16,18,2
2351,6,home,18,24,6
2351,7,<ENDS>,24,24,0
2352,0,<START>,0,0,0
2352,1,home,0,7,7
2352,2,work,7,14,7
2352,3,shop,14,16,2
2352,4,work,16,20,4
2352,5,home,20,24,4
2352,6,<ENDS>,24,24,0
2353,0,<START>,0,0,0
2353,1,home,0,6,6
2353,2,work,6,12,6
2353,3,shop,12,13,1
2353,4,work,13,19,6
2353,5,home,19,24,5
2353,6,<ENDS>,24,24,0
2354,0,<START>,0,0,0
2354,1,home,0,8,8
2354,2,work,8,17,9
2354,3,home,17,24,7
2354,4,<ENDS>,24,24,0
2355,0,<START>,0,0,0
2355,1,home,0,7,7
2355,2,shop,7,8,1
2355,3,education,8,11,3
2355,4,home,11,18,7
2355,5,shop,18,19,1
2355,6,home,19,24,5
2355,7,<ENDS>,24,24,0
2356,0,<START>,0,0,0
2356,1,home,0,8,8
2356,2,work,8,15,7
2356,3,home,15,24,9
2356,4,<ENDS>,24,24,0
2357,0,<START>,0,0,0
2357,1,home,0,7,7
2357,2,education,7,11,4
2357,3,home,11,18,7
2357,4,shop,18,19,1
2357,5,home,19,24,5
2357,6,<ENDS>,24,24,0
2358,0,<START>,0,0,0
2358,1,home,0,7,7
2358,2,education,7,11,4
2358,3,home,11,17,6
2358,4,shop,17,18,1
2358,5,home,18,24,6
2358,6,<ENDS>,24,24,0
2359,0,<START>,0,0,0
2359,1,home,0,8,8
2359,2,work,8,15,7
2359,3,shop,15,16,1
2359,4,home,16,24,8
2359,5,<ENDS>,24,24,0
2360,0,<START>,0,0,0
2360,1,home,0,6,6
2360,2,shop,6,7,1
2360,3,home,7,9,2
2360,4,work,9,17,8
2360,5,home,17,24,7
2360,6,<ENDS>,24,24,0
2361,0,<START>,0,0,0
2361,1,home,0,7,7
2361,2,shop,7,9,2
2361,3,education,9,11,2
2361,4,home,11,19,8
2361,5,shop,19,20,1
2361,6,home,20,24,4
2361,7,<ENDS>,24,24,0
2362,0,<START>,0,0,0
2362,1,home,0,8,8
2362,2,work,8,15,7
2362,3,home,15,24,9
2362,4,<ENDS>,24,24,0
2363,0,<START>,0,0,0
2363,1,home,0,8,8
2363,2,work,8,13,5
2363,3,shop,13,14,1
2363,4,home,14,21,7
2363,5,shop,21,22,1
2363,6,home,22,24,2
2363,7,<ENDS>,24,24,0
2364,0,<START>,0,0,0
2364,1,home,0,7,7
2364,2,shop,7,8,1
2364,3,education,8,11,3
2364,4,home,11,21,10
2364,5,shop,21,22,1
2364,6,home,22,24,2
2364,7,<ENDS>,24,24,0
2365,0,<START>,0,0,0
2365,1,home,0,6,6
2365,2,work,6,8,2
2365,3,home,8,12,4
2365,4,work,12,14,2
2365,5,home,14,21,7
2365,6,work,21,22,1
2365,7,home,22,24,2
2365,8,<ENDS>,24,24,0
2366,0,<START>,0,0,0
2366,1,home,0,9,9
2366,2,work,9,17,8
2366,3,home,17,24,7
2366,4,<ENDS>,24,24,0
2367,0,<START>,0,0,0
2367,1,home,0,6,6
2367,2,shop,6,7,1
2367,3,home,7,17,10
2367,4,work,17,19,2
2367,5,education,19,20,1
2367,6,home,20,24,4
2367,7,<ENDS>,24,24,0
2368,0,<START>,0,0,0
2368,1,home,0,6,6
2368,2,work,6,13,7
2368,3,home,13,17,4
2368,4,work,17,20,3
2368,5,home,20,24,4
2368,6,<ENDS>,24,24,0
2369,0,<START>,0,0,0
2369,1,home,0,7,7
2369,2,education,7,13,6
2369,3,home,13,21,8
2369,4,shop,21,22,1
2369,5,home,22,24,2
2369,6,<ENDS>,24,24,0
2370,0,<START>,0,0,0
2370,1,home,0,6,6
2370,2,work,6,13,7
2370,3,home,13,17,4
2370,4,work,17,20,3
2370,5,home,20,24,4
2370,6,<ENDS>,24,24,0
2371,0,<START>,0,0,0
2371,1,home,0,7,7
2371,2,education,7,11,4
2371,3,home,11,19,8
2371,4,shop,19,21,2
2371,5,home,21,24,3
2371,6,<ENDS>,24,24,0
2372,0,<START>,0,0,0
2372,1,home,0,6,6
2372,2,work,6,13,7
2372,3,shop,13,14,1
2372,4,work,14,17,3
2372,5,home,17,24,7
2372,6,<ENDS>,24,24,0
2373,0,<START>,0,0,0
2373,1,home,0,7,7
2373,2,education,7,11,4
2373,3,home,11,17,6
2373,4,shop,17,18,1
2373,5,home,18,24,6
2373,6,<ENDS>,24,24,0
2374,0,<START>,0,0,0
2374,1,home,0,8,8
2374,2,work,8,14,6
2374,3,home,14,24,10
2374,4,<ENDS>,24,24,0
2375,0,<START>,0,0,0
2375,1,home,0,7,7
2375,2,work,7,13,6
2375,3,shop,13,14,1
2375,4,home,14,24,10
2375,5,<ENDS>,24,24,0
2376,0,<START>,0,0,0
2376,1,home,0,8,8
2376,2,work,8,15,7
2376,3,home,15,24,9
2376,4,<ENDS>,24,24,0
2377,0,<START>,0,0,0
2377,1,home,0,7,7
2377,2,work,7,14,7
2377,3,shop,14,15,1
2377,4,work,15,20,5
2377,5,home,20,24,4
2377,6,<ENDS>,24,24,0
2378,0,<START>,0,0,0
2378,1,home,0,6,6
2378,2,work,6,13,7
2378,3,shop,13,14,1
2378,4,home,14,24,10
2378,5,<ENDS>,24,24,0
2379,0,<START>,0,0,0
2379,1,home,0,7,7
2379,2,work,7,14,7
2379,3,home,14,23,9
2379,4,work,23,24,1
2379,5,<ENDS>,24,24,0
2380,0,<START>,0,0,0
2380,1,home,0,9,9
2380,2,education,9,12,3
2380,3,work,12,19,7
2380,4,home,19,24,5
2380,5,<ENDS>,24,24,0
2381,0,<START>,0,0,0
2381,1,home,0,8,8
2381,2,work,8,15,7
2381,3,home,15,21,6
2381,4,work,21,22,1
2381,5,home,22,24,2
2381,6,<ENDS>,24,24,0
2382,0,<START>,0,0,0
2382,1,home,0,7,7
2382,2,work,7,13,6
2382,3,home,13,24,11
2382,4,<ENDS>,24,24,0
2383,0,<START>,0,0,0
2383,1,home,0,7,7
2383,2,work,7,13,6
2383,3,home,13,24,11
2383,4,<ENDS>,24,24,0
2384,0,<START>,0,0,0
2384,1,home,0,7,7
2384,2,education,7,11,4
2384,3,home,11,17,6
2384,4,shop,17,18,1
2384,5,home,18,24,6
2384,6,<ENDS>,24,24,0
2385,0,<START>,0,0,0
2385,1,home,0,6,6
2385,2,work,6,8,2
2385,3,home,8,10,2
2385,4,work,10,12,2
2385,5,shop,12,13,1
2385,6,work,13,15,2
2385,7,home,15,22,7
2385,8,work,22,23,1
2385,9,home,23,24,1
2385,10,<ENDS>,24,24,0
2386,0,<START>,0,0,0
2386,1,home,0,7,7
2386,2,work,7,13,6
2386,3,home,13,24,11
2386,4,<ENDS>,24,24,0
2387,0,<START>,0,0,0
2387,1,home,0,8,8
2387,2,work,8,15,7
2387,3,shop,15,16,1
2387,4,home,16,24,8
2387,5,<ENDS>,24,24,0
2388,0,<START>,0,0,0
2388,1,home,0,7,7
2388,2,work,7,15,8
2388,3,home,15,23,8
2388,4,work,23,24,1
2388,5,<ENDS>,24,24,0
2389,0,<START>,0,0,0
2389,1,home,0,7,7
2389,2,education,7,11,4
2389,3,home,11,17,6
2389,4,shop,17,18,1
2389,5,home,18,24,6
2389,6,<ENDS>,24,24,0
2390,0,<START>,0,0,0
2390,1,home,0,7,7
2390,2,work,7,13,6
2390,3,shop,13,14,1
2390,4,home,14,24,10
2390,5,<ENDS>,24,24,0
2391,0,<START>,0,0,0
2391,1,home,0,8,8
2391,2,education,8,12,4
2391,3,home,12,16,4
2391,4,shop,16,17,1
2391,5,home,17,21,4
2391,6,work,21,22,1
2391,7,home,22,24,2
2391,8,<ENDS>,24,24,0
2392,0,<START>,0,0,0
2392,1,home,0,8,8
2392,2,work,8,14,6
2392,3,shop,14,15,1
2392,4,home,15,24,9
2392,5,<ENDS>,24,24,0
2393,0,<START>,0,0,0
2393,1,home,0,8,8
2393,2,education,8,11,3
2393,3,home,11,14,3
2393,4,work,14,20,6
2393,5,home,20,24,4
2393,6,<ENDS>,24,24,0
2394,0,<START>,0,0,0
2394,1,home,0,7,7
2394,2,work,7,14,7
2394,3,home,14,24,10
2394,4,<ENDS>,24,24,0
2395,0,<START>,0,0,0
2395,1,home,0,7,7
2395,2,work,7,13,6
2395,3,shop,13,14,1
2395,4,education,14,16,2
2395,5,home,16,21,5
2395,6,work,21,22,1
2395,7,home,22,24,2
2395,8,<ENDS>,24,24,0
2396,0,<START>,0,0,0
2396,1,home,0,7,7
2396,2,work,7,14,7
2396,3,shop,14,15,1
2396,4,home,15,24,9
2396,5,<ENDS>,24,24,0
2397,0,<START>,0,0,0
2397,1,home,0,7,7
2397,2,shop,7,8,1
2397,3,home,8,9,1
2397,4,work,9,16,7
2397,5,home,16,22,6
2397,6,work,22,23,1
2397,7,home,23,24,1
2397,8,<ENDS>,24,24,0
2398,0,<START>,0,0,0
2398,1,home,0,7,7
2398,2,work,7,13,6
2398,3,home,13,18,5
2398,4,work,18,20,2
2398,5,home,20,24,4
2398,6,<ENDS>,24,24,0
2399,0,<START>,0,0,0
2399,1,home,0,7,7
2399,2,work,7,13,6
2399,3,home,13,17,4
2399,4,work,17,20,3
2399,5,home,20,24,4
2399,6,<ENDS>,24,24,0
2400,0,<START>,0,0,0
2400,1,home,0,7,7
2400,2,work,7,14,7
2400,3,shop,14,15,1
2400,4,home,15,24,9
2400,5,<ENDS>,24,24,0
2401,0,<START>,0,0,0
2401,1,home,0,7,7
2401,2,shop,7,8,1
2401,3,education,8,11,3
2401,4,home,11,17,6
2401,5,shop,17,18,1
2401,6,home,18,24,6
2401,7,<ENDS>,24,24,0
2402,0,<START>,0,0,0
2402,1,home,0,8,8
2402,2,education,8,11,3
2402,3,home,11,15,4
2402,4,work,15,20,5
2402,5,home,20,24,4
2402,6,<ENDS>,24,24,0
2403,0,<START>,0,0,0
2403,1,home,0,9,9
2403,2,education,9,12,3
2403,3,work,12,19,7
2403,4,home,19,24,5
2403,5,<ENDS>,24,24,0
2404,0,<START>,0,0,0
2404,1,home,0,6,6
2404,2,shop,6,7,1
2404,3,home,7,13,6
2404,4,education,13,16,3
2404,5,home,16,24,8
2404,6,<ENDS>,24,24,0
2405,0,<START>,0,0,0
2405,1,home,0,7,7
2405,2,work,7,14,7
2405,3,home,14,19,5
2405,4,shop,19,20,1
2405,5,home,20,24,4
2405,6,<ENDS>,24,24,0
2406,0,<START>,0,0,0
2406,1,home,0,6,6
2406,2,work,6,13,7
2406,3,shop,13,14,1
2406,4,work,14,20,6
2406,5,home,20,24,4
2406,6,<ENDS>,24,24,0
2407,0,<START>,0,0,0
2407,1,home,0,6,6
2407,2,shop,6,7,1
2407,3,work,7,13,6
2407,4,home,13,21,8
2407,5,work,21,22,1
2407,6,home,22,24,2
2407,7,<ENDS>,24,24,0
2408,0,<START>,0,0,0
2408,1,home,0,7,7
2408,2,work,7,13,6
2408,3,home,13,24,11
2408,4,<ENDS>,24,24,0
2409,0,<START>,0,0,0
2409,1,home,0,7,7
2409,2,education,7,12,5
2409,3,shop,12,13,1
2409,4,home,13,21,8
2409,5,shop,21,22,1
2409,6,home,22,24,2
2409,7,<ENDS>,24,24,0
2410,0,<START>,0,0,0
2410,1,home,0,6,6
2410,2,shop,6,7,1
2410,3,work,7,8,1
2410,4,home,8,14,6
2410,5,work,14,17,3
2410,6,home,17,21,4
2410,7,work,21,22,1
2410,8,home,22,24,2
2410,9,<ENDS>,24,24,0
2411,0,<START>,0,0,0
2411,1,home,0,7,7
2411,2,work,7,14,7
2411,3,shop,14,15,1
2411,4,work,15,20,5
2411,5,home,20,24,4
2411,6,<ENDS>,24,24,0
2412,0,<START>,0,0,0
2412,1,home,0,6,6
2412,2,work,6,13,7
2412,3,shop,13,14,1
2412,4,work,14,20,6
2412,5,home,20,24,4
2412,6,<ENDS>,24,24,0
2413,0,<START>,0,0,0
2413,1,home,0,9,9
2413,2,work,9,17,8
2413,3,home,17,22,5
2413,4,work,22,23,1
2413,5,home,23,24,1
2413,6,<ENDS>,24,24,0
2414,0,<START>,0,0,0
2414,1,home,0,6,6
2414,2,shop,6,7,1
2414,3,work,7,14,7
2414,4,home,14,24,10
2414,5,<ENDS>,24,24,0
2415,0,<START>,0,0,0
2415,1,home,0,11,11
2415,2,work,11,18,7
2415,3,home,18,24,6
2415,4,<ENDS>,24,24,0
2416,0,<START>,0,0,0
2416,1,home,0,7,7
2416,2,shop,7,8,1
2416,3,work,8,15,7
2416,4,home,15,23,8
2416,5,work,23,24,1
2416,6,<ENDS>,24,24,0
2417,0,<START>,0,0,0
2417,1,home,0,7,7
2417,2,shop,7,8,1
2417,3,home,8,14,6
2417,4,work,14,20,6
2417,5,home,20,24,4
2417,6,<ENDS>,24,24,0
2418,0,<START>,0,0,0
2418,1,home,0,8,8
2418,2,education,8,14,6
2418,3,shop,14,15,1
2418,4,home,15,24,9
2418,5,<ENDS>,24,24,0
2419,0,<START>,0,0,0
2419,1,home,0,6,6
2419,2,work,6,7,1
2419,3,home,7,9,2
2419,4,work,9,11,2
2419,5,home,11,18,7
2419,6,work,18,20,2
2419,7,home,20,24,4
2419,8,<ENDS>,24,24,0
2420,0,<START>,0,0,0
2420,1,home,0,6,6
2420,2,work,6,14,8
2420,3,home,14,24,10
2420,4,<ENDS>,24,24,0
2421,0,<START>,0,0,0
2421,1,home,0,6,6
2421,2,work,6,13,7
2421,3,home,13,24,11
2421,4,<ENDS>,24,24,0
2422,0,<START>,0,0,0
2422,1,home,0,7,7
2422,2,education,7,12,5
2422,3,shop,12,14,2
2422,4,education,14,16,2
2422,5,home,16,24,8
2422,6,<ENDS>,24,24,0
2423,0,<START>,0,0,0
2423,1,home,0,7,7
2423,2,education,7,11,4
2423,3,home,11,14,3
2423,4,education,14,16,2
2423,5,home,16,24,8
2423,6,<ENDS>,24,24,0
2424,0,<START>,0,0,0
2424,1,home,0,8,8
2424,2,work,8,15,7
2424,3,home,15,24,9
2424,4,<ENDS>,24,24,0
2425,0,<START>,0,0,0
2425,1,home,0,6,6
2425,2,work,6,13,7
2425,3,shop,13,14,1
2425,4,home,14,24,10
2425,5,<ENDS>,24,24,0
2426,0,<START>,0,0,0
2426,1,home,0,7,7
2426,2,shop,7,8,1
2426,3,work,8,15,7
2426,4,home,15,17,2
2426,5,work,17,20,3
2426,6,home,20,24,4
2426,7,<ENDS>,24,24,0
2427,0,<START>,0,0,0
2427,1,home,0,7,7
2427,2,work,7,14,7
2427,3,home,14,21,7
2427,4,shop,21,22,1
2427,5,home,22,24,2
2427,6,<ENDS>,24,24,0
2428,0,<START>,0,0,0
2428,1,home,0,7,7
2428,2,education,7,11,4
2428,3,home,11,17,6
2428,4,shop,17,18,1
2428,5,home,18,24,6
2428,6,<ENDS>,24,24,0
2429,0,<START>,0,0,0
2429,1,home,0,6,6
2429,2,work,6,13,7
2429,3,home,13,17,4
2429,4,work,17,20,3
2429,5,home,20,24,4
2429,6,<ENDS>,24,24,0
2430,0,<START>,0,0,0
2430,1,home,0,8,8
2430,2,work,8,14,6
2430,3,shop,14,15,1
2430,4,home,15,24,9
2430,5,<ENDS>,24,24,0
2431,0,<START>,0,0,0
2431,1,home,0,6,6
2431,2,work,6,7,1
2431,3,home,7,11,4
2431,4,work,11,13,2
2431,5,home,13,15,2
2431,6,work,15,17,2
2431,7,home,17,23,6
2431,8,work,23,24,1
2431,9,<ENDS>,24,24,0
2432,0,<START>,0,0,0
2432,1,home,0,7,7
2432,2,education,7,11,4
2432,3,home,11,15,4
2432,4,shop,15,16,1
2432,5,home,16,24,8
2432,6,<ENDS>,24,24,0
2433,0,<START>,0,0,0
2433,1,home,0,7,7
2433,2,work,7,14,7
2433,3,shop,14,15,1
2433,4,home,15,24,9
2433,5,<ENDS>,24,24,0
2434,0,<START>,0,0,0
2434,1,home,0,7,7
2434,2,work,7,9,2
2434,3,home,9,12,3
2434,4,work,12,14,2
2434,5,home,14,19,5
2434,6,shop,19,20,1
2434,7,home,20,24,4
2434,8,<ENDS>,24,24,0
2435,0,<START>,0,0,0
2435,1,home,0,7,7
2435,2,education,7,11,4
2435,3,home,11,15,4
2435,4,shop,15,16,1
2435,5,home,16,24,8
2435,6,<ENDS>,24,24,0
2436,0,<START>,0,0,0
2436,1,home,0,8,8
2436,2,education,8,11,3
2436,3,home,11,18,7
2436,4,shop,18,19,1
2436,5,home,19,24,5
2436,6,<ENDS>,24,24,0
2437,0,<START>,0,0,0
2437,1,home,0,7,7
2437,2,work,7,9,2
2437,3,home,9,13,4
2437,4,work,13,15,2
2437,5,home,15,21,6
2437,6,work,21,22,1
2437,7,home,22,24,2
2437,8,<ENDS>,24,24,0
2438,0,<START>,0,0,0
2438,1,home,0,7,7
2438,2,work,7,14,7
2438,3,shop,14,15,1
2438,4,work,15,17,2
2438,5,home,17,24,7
2438,6,<ENDS>,24,24,0
2439,0,<START>,0,0,0
2439,1,home,0,6,6
2439,2,work,6,8,2
2439,3,home,8,12,4
2439,4,work,12,13,1
2439,5,home,13,17,4
2439,6,work,17,19,2
2439,7,home,19,24,5
2439,8,<ENDS>,24,24,0
2440,0,<START>,0,0,0
2440,1,home,0,8,8
2440,2,work,8,15,7
2440,3,home,15,23,8
2440,4,work,23,24,1
2440,5,<ENDS>,24,24,0
2441,0,<START>,0,0,0
2441,1,home,0,6,6
2441,2,shop,6,7,1
2441,3,work,7,14,7
2441,4,home,14,21,7
2441,5,work,21,22,1
2441,6,home,22,24,2
2441,7,<ENDS>,24,24,0
2442,0,<START>,0,0,0
2442,1,home,0,6,6
2442,2,work,6,13,7
2442,3,shop,13,14,1
2442,4,work,14,19,5
2442,5,home,19,24,5
2442,6,<ENDS>,24,24,0
2443,0,<START>,0,0,0
2443,1,home,0,6,6
2443,2,work,6,13,7
2443,3,home,13,16,3
2443,4,work,16,20,4
2443,5,home,20,24,4
2443,6,<ENDS>,24,24,0
2444,0,<START>,0,0,0
2444,1,home,0,7,7
2444,2,education,7,11,4
2444,3,home,11,17,6
2444,4,shop,17,19,2
2444,5,home,19,24,5
2444,6,<ENDS>,24,24,0
2445,0,<START>,0,0,0
2445,1,home,0,8,8
2445,2,work,8,13,5
2445,3,shop,13,15,2
2445,4,home,15,24,9
2445,5,<ENDS>,24,24,0
2446,0,<START>,0,0,0
2446,1,home,0,6,6
2446,2,work,6,13,7
2446,3,home,13,21,8
2446,4,work,21,22,1
2446,5,home,22,24,2
2446,6,<ENDS>,24,24,0
2447,0,<START>,0,0,0
2447,1,home,0,7,7
2447,2,work,7,13,6
2447,3,home,13,24,11
2447,4,<ENDS>,24,24,0
2448,0,<START>,0,0,0
2448,1,home,0,7,7
2448,2,work,7,9,2
2448,3,home,9,13,4
2448,4,work,13,15,2
2448,5,home,15,21,6
2448,6,work,21,22,1
2448,7,home,22,24,2
2448,8,<ENDS>,24,24,0
2449,0,<START>,0,0,0
2449,1,home,0,7,7
2449,2,education,7,13,6
2449,3,shop,13,14,1
2449,4,education,14,15,1
2449,5,shop,15,16,1
2449,6,home,16,24,8
2449,7,<ENDS>,24,24,0
2450,0,<START>,0,0,0
2450,1,home,0,7,7
2450,2,work,7,9,2
2450,3,home,9,11,2
2450,4,work,11,13,2
2450,5,home,13,21,8
2450,6,work,21,22,1
2450,7,home,22,24,2
2450,8,<ENDS>,24,24,0
2451,0,<START>,0,0,0
2451,1,home,0,8,8
2451,2,work,8,13,5
2451,3,home,13,19,6
2451,4,shop,19,20,1
2451,5,home,20,24,4
2451,6,<ENDS>,24,24,0
2452,0,<START>,0,0,0
2452,1,home,0,6,6
2452,2,work,6,13,7
2452,3,home,13,17,4
2452,4,work,17,20,3
2452,5,home,20,24,4
2452,6,<ENDS>,24,24,0
2453,0,<START>,0,0,0
2453,1,home,0,6,6
2453,2,shop,6,7,1
2453,3,work,7,8,1
2453,4,home,8,13,5
2453,5,work,13,15,2
2453,6,home,15,23,8
2453,7,work,23,24,1
2453,8,<ENDS>,24,24,0
2454,0,<START>,0,0,0
2454,1,home,0,6,6
2454,2,work,6,13,7
2454,3,shop,13,14,1
2454,4,home,14,21,7
2454,5,work,21,22,1
2454,6,home,22,24,2
2454,7,<ENDS>,24,24,0
2455,0,<START>,0,0,0
2455,1,home,0,7,7
2455,2,work,7,13,6
2455,3,shop,13,14,1
2455,4,home,14,18,4
2455,5,work,18,20,2
2455,6,home,20,24,4
2455,7,<ENDS>,24,24,0
2456,0,<START>,0,0,0
2456,1,home,0,6,6
2456,2,shop,6,7,1
2456,3,home,7,9,2
2456,4,education,9,11,2
2456,5,home,11,18,7
2456,6,shop,18,19,1
2456,7,home,19,24,5
2456,8,<ENDS>,24,24,0
2457,0,<START>,0,0,0
2457,1,home,0,7,7
2457,2,work,7,13,6
2457,3,home,13,17,4
2457,4,work,17,20,3
2457,5,home,20,24,4
2457,6,<ENDS>,24,24,0
2458,0,<START>,0,0,0
2458,1,home,0,7,7
2458,2,work,7,14,7
2458,3,home,14,24,10
2458,4,<ENDS>,24,24,0
2459,0,<START>,0,0,0
2459,1,home,0,8,8
2459,2,work,8,15,7
2459,3,home,15,24,9
2459,4,<ENDS>,24,24,0
2460,0,<START>,0,0,0
2460,1,home,0,8,8
2460,2,work,8,15,7
2460,3,home,15,24,9
2460,4,<ENDS>,24,24,0
2461,0,<START>,0,0,0
2461,1,home,0,8,8
2461,2,work,8,10,2
2461,3,home,10,15,5
2461,4,work,15,17,2
2461,5,home,17,22,5
2461,6,work,22,23,1
2461,7,home,23,24,1
2461,8,<ENDS>,24,24,0
2462,0,<START>,0,0,0
2462,1,home,0,6,6
2462,2,work,6,13,7
2462,3,shop,13,14,1
2462,4,home,14,21,7
2462,5,work,21,22,1
2462,6,home,22,24,2
2462,7,<ENDS>,24,24,0
2463,0,<START>,0,0,0
2463,1,home,0,6,6
2463,2,work,6,13,7
2463,3,home,13,17,4
2463,4,work,17,20,3
2463,5,home,20,24,4
2463,6,<ENDS>,24,24,0
2464,0,<START>,0,0,0
2464,1,home,0,7,7
2464,2,shop,7,8,1
2464,3,education,8,11,3
2464,4,home,11,18,7
2464,5,shop,18,19,1
2464,6,home,19,24,5
2464,7,<ENDS>,24,24,0
2465,0,<START>,0,0,0
2465,1,home,0,6,6
2465,2,shop,6,7,1
2465,3,home,7,13,6
2465,4,education,13,17,4
2465,5,home,17,21,4
2465,6,shop,21,22,1
2465,7,home,22,24,2
2465,8,<ENDS>,24,24,0
2466,0,<START>,0,0,0
2466,1,home,0,7,7
2466,2,work,7,15,8
2466,3,home,15,19,4
2466,4,shop,19,20,1
2466,5,home,20,24,4
2466,6,<ENDS>,24,24,0
2467,0,<START>,0,0,0
2467,1,home,0,7,7
2467,2,work,7,13,6
2467,3,shop,13,14,1
2467,4,work,14,19,5
2467,5,home,19,24,5
2467,6,<ENDS>,24,24,0
2468,0,<START>,0,0,0
2468,1,home,0,7,7
2468,2,education,7,12,5
2468,3,home,12,17,5
2468,4,shop,17,19,2
2468,5,home,19,24,5
2468,6,<ENDS>,24,24,0
2469,0,<START>,0,0,0
2469,1,home,0,6,6
2469,2,work,6,7,1
2469,3,home,7,11,4
2469,4,work,11,13,2
2469,5,home,13,21,8
2469,6,work,21,22,1
2469,7,home,22,24,2
2469,8,<ENDS>,24,24,0
2470,0,<START>,0,0,0
2470,1,home,0,6,6
2470,2,shop,6,7,1
2470,3,home,7,10,3
2470,4,education,10,16,6
2470,5,shop,16,17,1
2470,6,home,17,24,7
2470,7,<ENDS>,24,24,0
2471,0,<START>,0,0,0
2471,1,home,0,7,7
2471,2,work,7,13,6
2471,3,home,13,17,4
2471,4,work,17,20,3
2471,5,home,20,24,4
2471,6,<ENDS>,24,24,0
2472,0,<START>,0,0,0
2472,1,home,0,6,6
2472,2,work,6,13,7
2472,3,home,13,17,4
2472,4,work,17,19,2
2472,5,home,19,24,5
2472,6,<ENDS>,24,24,0
2473,0,<START>,0,0,0
2473,1,home,0,8,8
2473,2,work,8,15,7
2473,3,home,15,22,7
2473,4,work,22,23,1
2473,5,home,23,24,1
2473,6,<ENDS>,24,24,0
2474,0,<START>,0,0,0
2474,1,home,0,7,7
2474,2,education,7,12,5
2474,3,shop,12,14,2
2474,4,home,14,21,7
2474,5,shop,21,22,1
2474,6,home,22,24,2
2474,7,<ENDS>,24,24,0
2475,0,<START>,0,0,0
2475,1,home,0,6,6
2475,2,work,6,8,2
2475,3,home,8,11,3
2475,4,work,11,12,1
2475,5,home,12,20,8
2475,6,shop,20,21,1
2475,7,home,21,24,3
2475,8,<ENDS>,24,24,0
2476,0,<START>,0,0,0
2476,1,home,0,6,6
2476,2,work,6,13,7
2476,3,home,13,17,4
2476,4,shop,17,18,1
2476,5,home,18,24,6
2476,6,<ENDS>,24,24,0
2477,0,<START>,0,0,0
2477,1,home,0,9,9
2477,2,work,9,15,6
2477,3,shop,15,16,1
2477,4,work,16,20,4
2477,5,home,20,24,4
2477,6,<ENDS>,24,24,0
2478,0,<START>,0,0,0
2478,1,home,0,6,6
2478,2,work,6,13,7
2478,3,home,13,24,11
2478,4,<ENDS>,24,24,0
2479,0,<START>,0,0,0
2479,1,home,0,9,9
2479,2,work,9,15,6
2479,3,home,15,24,9
2479,4,<ENDS>,24,24,0
2480,0,<START>,0,0,0
2480,1,home,0,6,6
2480,2,shop,6,7,1
2480,3,home,7,11,4
2480,4,work,11,18,7
2480,5,home,18,24,6
2480,6,<ENDS>,24,24,0
2481,0,<START>,0,0,0
2481,1,home,0,8,8
2481,2,work,8,15,7
2481,3,home,15,24,9
2481,4,<ENDS>,24,24,0
2482,0,<START>,0,0,0
2482,1,home,0,8,8
2482,2,work,8,15,7
2482,3,home,15,24,9
2482,4,<ENDS>,24,24,0
2483,0,<START>,0,0,0
2483,1,home,0,7,7
2483,2,work,7,13,6
2483,3,home,13,24,11
2483,4,<ENDS>,24,24,0
2484,0,<START>,0,0,0
2484,1,home,0,7,7
2484,2,work,7,13,6
2484,3,home,13,15,2
2484,4,work,15,20,5
2484,5,home,20,24,4
2484,6,<ENDS>,24,24,0
2485,0,<START>,0,0,0
2485,1,home,0,6,6
2485,2,work,6,13,7
2485,3,home,13,15,2
2485,4,work,15,20,5
2485,5,home,20,24,4
2485,6,<ENDS>,24,24,0
2486,0,<START>,0,0,0
2486,1,home,0,7,7
2486,2,work,7,14,7
2486,3,home,14,23,9
2486,4,work,23,24,1
2486,5,<ENDS>,24,24,0
2487,0,<START>,0,0,0
2487,1,home,0,6,6
2487,2,work,6,8,2
2487,3,home,8,9,1
2487,4,work,9,11,2
2487,5,home,11,17,6
2487,6,work,17,19,2
2487,7,home,19,24,5
2487,8,<ENDS>,24,24,0
2488,0,<START>,0,0,0
2488,1,home,0,6,6
2488,2,work,6,13,7
2488,3,home,13,24,11
2488,4,<ENDS>,24,24,0
2489,0,<START>,0,0,0
2489,1,home,0,7,7
2489,2,education,7,11,4
2489,3,home,11,18,7
2489,4,shop,18,20,2
2489,5,home,20,24,4
2489,6,<ENDS>,24,24,0
2490,0,<START>,0,0,0
2490,1,home,0,8,8
2490,2,work,8,15,7
2490,3,shop,15,17,2
2490,4,home,17,24,7
2490,5,<ENDS>,24,24,0
2491,0,<START>,0,0,0
2491,1,home,0,7,7
2491,2,education,7,12,5
2491,3,home,12,14,2
2491,4,education,14,16,2
2491,5,shop,16,17,1
2491,6,home,17,24,7
2491,7,<ENDS>,24,24,0
2492,0,<START>,0,0,0
2492,1,home,0,6,6
2492,2,work,6,13,7
2492,3,shop,13,14,1
2492,4,work,14,19,5
2492,5,home,19,24,5
2492,6,<ENDS>,24,24,0
2493,0,<START>,0,0,0
2493,1,home,0,6,6
2493,2,work,6,13,7
2493,3,home,13,24,11
2493,4,<ENDS>,24,24,0
2494,0,<START>,0,0,0
2494,1,home,0,6,6
2494,2,shop,6,7,1
2494,3,home,7,9,2
2494,4,education,9,10,1
2494,5,home,10,14,4
2494,6,education,14,17,3
2494,7,home,17,24,7
2494,8,<ENDS>,24,24,0
2495,0,<START>,0,0,0
2495,1,home,0,8,8
2495,2,work,8,14,6
2495,3,home,14,21,7
2495,4,work,21,22,1
2495,5,home,22,24,2
2495,6,<ENDS>,24,24,0
2496,0,<START>,0,0,0
2496,1,home,0,7,7
2496,2,work,7,13,6
2496,3,home,13,24,11
2496,4,<ENDS>,24,24,0
2497,0,<START>,0,0,0
2497,1,home,0,7,7
2497,2,education,7,11,4
2497,3,home,11,13,2
2497,4,education,13,16,3
2497,5,home,16,24,8
2497,6,<ENDS>,24,24,0
2498,0,<START>,0,0,0
2498,1,home,0,8,8
2498,2,education,8,12,4
2498,3,home,12,18,6
2498,4,shop,18,20,2
2498,5,home,20,24,4
2498,6,<ENDS>,24,24,0
2499,0,<START>,0,0,0
2499,1,home,0,6,6
2499,2,work,6,13,7
2499,3,shop,13,14,1
2499,4,home,14,24,10
2499,5,<ENDS>,24,24,0
2500,0,<START>,0,0,0
2500,1,home,0,6,6
2500,2,work,6,13,7
2500,3,home,13,17,4
2500,4,shop,17,18,1
2500,5,work,18,20,2
2500,6,home,20,24,4
2500,7,<ENDS>,24,24,0
2501,0,<START>,0,0,0
2501,1,home,0,8,8
2501,2,work,8,15,7
2501,3,home,15,21,6
2501,4,shop,21,22,1
2501,5,home,22,24,2
2501,6,<ENDS>,24,24,0
2502,0,<START>,0,0,0
2502,1,home,0,7,7
2502,2,work,7,14,7
2502,3,home,14,18,4
2502,4,shop,18,19,1
2502,5,home,19,24,5
2502,6,<ENDS>,24,24,0
2503,0,<START>,0,0,0
2503,1,home,0,7,7
2503,2,shop,7,8,1
2503,3,home,8,9,1
2503,4,work,9,15,6
2503,5,home,15,22,7
2503,6,work,22,23,1
2503,7,home,23,24,1
2503,8,<ENDS>,24,24,0
2504,0,<START>,0,0,0
2504,1,home,0,6,6
2504,2,work,6,13,7
2504,3,shop,13,14,1
2504,4,home,14,22,8
2504,5,work,22,23,1
2504,6,home,23,24,1
2504,7,<ENDS>,24,24,0
2505,0,<START>,0,0,0
2505,1,home,0,6,6
2505,2,work,6,13,7
2505,3,shop,13,15,2
2505,4,home,15,24,9
2505,5,<ENDS>,24,24,0
2506,0,<START>,0,0,0
2506,1,home,0,6,6
2506,2,work,6,13,7
2506,3,shop,13,15,2
2506,4,work,15,20,5
2506,5,home,20,24,4
2506,6,<ENDS>,24,24,0
2507,0,<START>,0,0,0
2507,1,home,0,7,7
2507,2,work,7,14,7
2507,3,home,14,24,10
2507,4,<ENDS>,24,24,0
2508,0,<START>,0,0,0
2508,1,home,0,7,7
2508,2,work,7,13,6
2508,3,shop,13,14,1
2508,4,work,14,19,5
2508,5,home,19,24,5
2508,6,<ENDS>,24,24,0
2509,0,<START>,0,0,0
2509,1,home,0,7,7
2509,2,work,7,13,6
2509,3,home,13,21,8
2509,4,shop,21,22,1
2509,5,home,22,24,2
2509,6,<ENDS>,24,24,0
2510,0,<START>,0,0,0
2510,1,home,0,7,7
2510,2,work,7,9,2
2510,3,home,9,13,4
2510,4,work,13,15,2
2510,5,home,15,21,6
2510,6,work,21,22,1
2510,7,home,22,24,2
2510,8,<ENDS>,24,24,0
2511,0,<START>,0,0,0
2511,1,home,0,7,7
2511,2,work,7,9,2
2511,3,home,9,15,6
2511,4,work,15,17,2
2511,5,home,17,23,6
2511,6,work,23,24,1
2511,7,<ENDS>,24,24,0
2512,0,<START>,0,0,0
2512,1,home,0,7,7
2512,2,work,7,8,1
2512,3,home,8,13,5
2512,4,work,13,15,2
2512,5,home,15,21,6
2512,6,work,21,22,1
2512,7,home,22,24,2
2512,8,<ENDS>,24,24,0
2513,0,<START>,0,0,0
2513,1,home,0,7,7
2513,2,work,7,13,6
2513,3,home,13,17,4
2513,4,work,17,20,3
2513,5,home,20,24,4
2513,6,<ENDS>,24,24,0
2514,0,<START>,0,0,0
2514,1,home,0,7,7
2514,2,shop,7,8,1
2514,3,home,8,12,4
2514,4,education,12,17,5
2514,5,home,17,24,7
2514,6,<ENDS>,24,24,0
2515,0,<START>,0,0,0
2515,1,home,0,7,7
2515,2,work,7,14,7
2515,3,home,14,24,10
2515,4,<ENDS>,24,24,0
2516,0,<START>,0,0,0
2516,1,home,0,6,6
2516,2,shop,6,7,1
2516,3,work,7,13,6
2516,4,home,13,24,11
2516,5,<ENDS>,24,24,0
2517,0,<START>,0,0,0
2517,1,home,0,8,8
2517,2,work,8,13,5
2517,3,home,13,21,8
2517,4,shop,21,22,1
2517,5,home,22,24,2
2517,6,<ENDS>,24,24,0
2518,0,<START>,0,0,0
2518,1,home,0,7,7
2518,2,work,7,14,7
2518,3,home,14,21,7
2518,4,work,21,22,1
2518,5,home,22,24,2
2518,6,<ENDS>,24,24,0
2519,0,<START>,0,0,0
2519,1,home,0,7,7
2519,2,education,7,11,4
2519,3,home,11,17,6
2519,4,shop,17,18,1
2519,5,home,18,24,6
2519,6,<ENDS>,24,24,0
2520,0,<START>,0,0,0
2520,1,home,0,7,7
2520,2,education,7,11,4
2520,3,home,11,19,8
2520,4,shop,19,21,2
2520,5,home,21,24,3
2520,6,<ENDS>,24,24,0
2521,0,<START>,0,0,0
2521,1,home,0,7,7
2521,2,work,7,14,7
2521,3,home,14,24,10
2521,4,<ENDS>,24,24,0
2522,0,<START>,0,0,0
2522,1,home,0,7,7
2522,2,shop,7,8,1
2522,3,education,8,11,3
2522,4,home,11,14,3
2522,5,education,14,16,2
2522,6,home,16,24,8
2522,7,<ENDS>,24,24,0
2523,0,<START>,0,0,0
2523,1,home,0,6,6
2523,2,shop,6,7,1
2523,3,work,7,14,7
2523,4,shop,14,15,1
2523,5,home,15,16,1
2523,6,work,16,20,4
2523,7,home,20,24,4
2523,8,<ENDS>,24,24,0
2524,0,<START>,0,0,0
2524,1,home,0,7,7
2524,2,education,7,12,5
2524,3,home,12,16,4
2524,4,shop,16,17,1
2524,5,home,17,24,7
2524,6,<ENDS>,24,24,0
2525,0,<START>,0,0,0
2525,1,home,0,6,6
2525,2,work,6,13,7
2525,3,shop,13,14,1
2525,4,work,14,20,6
2525,5,home,20,24,4
2525,6,<ENDS>,24,24,0
2526,0,<START>,0,0,0
2526,1,home,0,6,6
2526,2,shop,6,7,1
2526,3,work,7,14,7
2526,4,home,14,22,8
2526,5,work,22,23,1
2526,6,home,23,24,1
2526,7,<ENDS>,24,24,0
2527,0,<START>,0,0,0
2527,1,home,0,7,7
2527,2,shop,7,8,1
2527,3,work,8,14,6
2527,4,home,14,24,10
2527,5,<ENDS>,24,24,0
2528,0,<START>,0,0,0
2528,1,home,0,7,7
2528,2,work,7,14,7
2528,3,shop,14,15,1
2528,4,work,15,20,5
2528,5,home,20,24,4
2528,6,<ENDS>,24,24,0
2529,0,<START>,0,0,0
2529,1,home,0,7,7
2529,2,education,7,11,4
2529,3,home,11,18,7
2529,4,shop,18,20,2
2529,5,home,20,24,4
2529,6,<ENDS>,24,24,0
2530,0,<START>,0,0,0
2530,1,home,0,6,6
2530,2,work,6,8,2
2530,3,home,8,10,2
2530,4,work,10,12,2
2530,5,home,12,16,4
2530,6,work,16,18,2
2530,7,home,18,24,6
2530,8,<ENDS>,24,24,0
2531,0,<START>,0,0,0
2531,1,home,0,6,6
2531,2,work,6,13,7
2531,3,home,13,17,4
2531,4,work,17,20,3
2531,5,home,20,24,4
2531,6,<ENDS>,24,24,0
2532,0,<START>,0,0,0
2532,1,home,0,8,8
2532,2,education,8,11,3
2532,3,home,11,15,4
2532,4,work,15,20,5
2532,5,home,20,24,4
2532,6,<ENDS>,24,24,0
2533,0,<START>,0,0,0
2533,1,home,0,7,7
2533,2,work,7,13,6
2533,3,shop,13,15,2
2533,4,work,15,19,4
2533,5,home,19,24,5
2533,6,<ENDS>,24,24,0
2534,0,<START>,0,0,0
2534,1,home,0,8,8
2534,2,education,8,11,3
2534,3,home,11,14,3
2534,4,education,14,16,2
2534,5,home,16,24,8
2534,6,<ENDS>,24,24,0
2535,0,<START>,0,0,0
2535,1,home,0,9,9
2535,2,work,9,15,6
2535,3,home,15,16,1
2535,4,work,16,20,4
2535,5,home,20,24,4
2535,6,<ENDS>,24,24,0
2536,0,<START>,0,0,0
2536,1,home,0,8,8
2536,2,work,8,16,8
2536,3,home,16,23,7
2536,4,work,23,24,1
2536,5,<ENDS>,24,24,0
2537,0,<START>,0,0,0
2537,1,home,0,6,6
2537,2,work,6,8,2
2537,3,home,8,14,6
2537,4,work,14,16,2
2537,5,home,16,22,6
2537,6,work,22,23,1
2537,7,home,23,24,1
2537,8,<ENDS>,24,24,0
2538,0,<START>,0,0,0
2538,1,home,0,6,6
2538,2,shop,6,7,1
2538,3,home,7,12,5
2538,4,work,12,19,7
2538,5,home,19,24,5
2538,6,<ENDS>,24,24,0
2539,0,<START>,0,0,0
2539,1,home,0,7,7
2539,2,education,7,12,5
2539,3,home,12,20,8
2539,4,shop,20,21,1
2539,5,home,21,24,3
2539,6,<ENDS>,24,24,0
2540,0,<START>,0,0,0
2540,1,home,0,7,7
2540,2,education,7,11,4
2540,3,home,11,14,3
2540,4,education,14,16,2
2540,5,home,16,24,8
2540,6,<ENDS>,24,24,0
2541,0,<START>,0,0,0
2541,1,home,0,8,8
2541,2,work,8,15,7
2541,3,home,15,21,6
2541,4,work,21,22,1
2541,5,home,22,24,2
2541,6,<ENDS>,24,24,0
2542,0,<START>,0,0,0
2542,1,home,0,7,7
2542,2,shop,7,8,1
2542,3,education,8,11,3
2542,4,home,11,17,6
2542,5,shop,17,19,2
2542,6,home,19,24,5
2542,7,<ENDS>,24,24,0
2543,0,<START>,0,0,0
2543,1,home,0,11,11
2543,2,education,11,16,5
2543,3,home,16,24,8
2543,4,<ENDS>,24,24,0
2544,0,<START>,0,0,0
2544,1,home,0,7,7
2544,2,work,7,13,6
2544,3,home,13,20,7
2544,4,shop,20,21,1
2544,5,home,21,24,3
2544,6,<ENDS>,24,24,0
2545,0,<START>,0,0,0
2545,1,home,0,6,6
2545,2,shop,6,7,1
2545,3,home,7,14,7
2545,4,education,14,16,2
2545,5,home,16,24,8
2545,6,<ENDS>,24,24,0
2546,0,<START>,0,0,0
2546,1,home,0,6,6
2546,2,work,6,13,7
2546,3,shop,13,14,1
2546,4,work,14,19,5
2546,5,home,19,24,5
2546,6,<ENDS>,24,24,0
2547,0,<START>,0,0,0
2547,1,home,0,6,6
2547,2,work,6,13,7
2547,3,shop,13,14,1
2547,4,home,14,23,9
2547,5,work,23,24,1
2547,6,<ENDS>,24,24,0
2548,0,<START>,0,0,0
2548,1,home,0,8,8
2548,2,work,8,15,7
2548,3,shop,15,16,1
2548,4,work,16,19,3
2548,5,home,19,24,5
2548,6,<ENDS>,24,24,0
2549,0,<START>,0,0,0
2549,1,home,0,8,8
2549,2,work,8,15,7
2549,3,shop,15,16,1
2549,4,home,16,23,7
2549,5,work,23,24,1
2549,6,<ENDS>,24,24,0
2550,0,<START>,0,0,0
2550,1,home,0,8,8
2550,2,shop,8,9,1
2550,3,work,9,16,7
2550,4,home,16,21,5
2550,5,work,21,22,1
2550,6,home,22,24,2
2550,7,<ENDS>,24,24,0
2551,0,<START>,0,0,0
2551,1,home,0,8,8
2551,2,education,8,12,4
2551,3,work,12,19,7
2551,4,home,19,24,5
2551,5,<ENDS>,24,24,0
2552,0,<START>,0,0,0
2552,1,home,0,7,7
2552,2,work,7,13,6
2552,3,home,13,17,4
2552,4,work,17,20,3
2552,5,home,20,24,4
2552,6,<ENDS>,24,24,0
2553,0,<START>,0,0,0
2553,1,home,0,8,8
2553,2,work,8,16,8
2553,3,shop,16,17,1
2553,4,home,17,21,4
2553,5,work,21,22,1
2553,6,home,22,24,2
2553,7,<ENDS>,24,24,0
2554,0,<START>,0,0,0
2554,1,home,0,7,7
2554,2,work,7,9,2
2554,3,home,9,15,6
2554,4,work,15,18,3
2554,5,home,18,24,6
2554,6,<ENDS>,24,24,0
2555,0,<START>,0,0,0
2555,1,home,0,6,6
2555,2,shop,6,7,1
2555,3,home,7,12,5
2555,4,education,12,14,2
2555,5,shop,14,15,1
2555,6,home,15,19,4
2555,7,shop,19,20,1
2555,8,home,20,24,4
2555,9,<ENDS>,24,24,0
2556,0,<START>,0,0,0
2556,1,home,0,6,6
2556,2,shop,6,7,1
2556,3,home,7,13,6
2556,4,education,13,16,3
2556,5,home,16,24,8
2556,6,<ENDS>,24,24,0
2557,0,<START>,0,0,0
2557,1,home,0,8,8
2557,2,education,8,11,3
2557,3,home,11,15,4
2557,4,work,15,20,5
2557,5,home,20,24,4
2557,6,<ENDS>,24,24,0
2558,0,<START>,0,0,0
2558,1,home,0,9,9
2558,2,work,9,16,7
2558,3,shop,16,17,1
2558,4,work,17,20,3
2558,5,home,20,24,4
2558,6,<ENDS>,24,24,0
2559,0,<START>,0,0,0
2559,1,home,0,6,6
2559,2,shop,6,7,1
2559,3,home,7,10,3
2559,4,education,10,13,3
2559,5,shop,13,15,2
2559,6,home,15,24,9
2559,7,<ENDS>,24,24,0
2560,0,<START>,0,0,0
2560,1,home,0,6,6
2560,2,work,6,12,6
2560,3,shop,12,13,1
2560,4,work,13,18,5
2560,5,home,18,24,6
2560,6,<ENDS>,24,24,0
2561,0,<START>,0,0,0
2561,1,home,0,8,8
2561,2,education,8,12,4
2561,3,shop,12,14,2
2561,4,home,14,20,6
2561,5,shop,20,21,1
2561,6,home,21,24,3
2561,7,<ENDS>,24,24,0
2562,0,<START>,0,0,0
2562,1,home,0,6,6
2562,2,work,6,13,7
2562,3,shop,13,15,2
2562,4,work,15,19,4
2562,5,home,19,24,5
2562,6,<ENDS>,24,24,0
2563,0,<START>,0,0,0
2563,1,home,0,6,6
2563,2,shop,6,7,1
2563,3,home,7,13,6
2563,4,education,13,16,3
2563,5,home,16,24,8
2563,6,<ENDS>,24,24,0
2564,0,<START>,0,0,0
2564,1,home,0,8,8
2564,2,work,8,15,7
2564,3,home,15,24,9
2564,4,<ENDS>,24,24,0
2565,0,<START>,0,0,0
2565,1,home,0,7,7
2565,2,work,7,13,6
2565,3,home,13,17,4
2565,4,shop,17,18,1
2565,5,home,18,23,5
2565,6,work,23,24,1
2565,7,<ENDS>,24,24,0
2566,0,<START>,0,0,0
2566,1,home,0,7,7
2566,2,work,7,13,6
2566,3,shop,13,14,1
2566,4,work,14,19,5
2566,5,home,19,24,5
2566,6,<ENDS>,24,24,0
2567,0,<START>,0,0,0
2567,1,home,0,6,6
2567,2,work,6,7,1
2567,3,home,7,9,2
2567,4,work,9,11,2
2567,5,home,11,15,4
2567,6,work,15,18,3
2567,7,home,18,24,6
2567,8,<ENDS>,24,24,0
2568,0,<START>,0,0,0
2568,1,home,0,6,6
2568,2,work,6,13,7
2568,3,shop,13,14,1
2568,4,work,14,19,5
2568,5,home,19,24,5
2568,6,<ENDS>,24,24,0
2569,0,<START>,0,0,0
2569,1,home,0,7,7
2569,2,work,7,13,6
2569,3,home,13,17,4
2569,4,work,17,20,3
2569,5,home,20,24,4
2569,6,<ENDS>,24,24,0
2570,0,<START>,0,0,0
2570,1,home,0,7,7
2570,2,education,7,12,5
2570,3,home,12,19,7
2570,4,shop,19,20,1
2570,5,home,20,24,4
2570,6,<ENDS>,24,24,0
2571,0,<START>,0,0,0
2571,1,home,0,7,7
2571,2,work,7,9,2
2571,3,home,9,14,5
2571,4,work,14,17,3
2571,5,home,17,24,7
2571,6,<ENDS>,24,24,0
2572,0,<START>,0,0,0
2572,1,home,0,7,7
2572,2,work,7,14,7
2572,3,home,14,24,10
2572,4,<ENDS>,24,24,0
2573,0,<START>,0,0,0
2573,1,home,0,7,7
2573,2,education,7,14,7
2573,3,shop,14,16,2
2573,4,home,16,24,8
2573,5,<ENDS>,24,24,0
2574,0,<START>,0,0,0
2574,1,home,0,7,7
2574,2,education,7,12,5
2574,3,home,12,17,5
2574,4,shop,17,18,1
2574,5,home,18,24,6
2574,6,<ENDS>,24,24,0
2575,0,<START>,0,0,0
2575,1,home,0,8,8
2575,2,education,8,12,4
2575,3,shop,12,13,1
2575,4,work,13,20,7
2575,5,home,20,24,4
2575,6,<ENDS>,24,24,0
2576,0,<START>,0,0,0
2576,1,home,0,6,6
2576,2,work,6,14,8
2576,3,shop,14,15,1
2576,4,home,15,24,9
2576,5,<ENDS>,24,24,0
2577,0,<START>,0,0,0
2577,1,home,0,7,7
2577,2,education,7,11,4
2577,3,home,11,13,2
2577,4,education,13,16,3
2577,5,home,16,24,8
2577,6,<ENDS>,24,24,0
2578,0,<START>,0,0,0
2578,1,home,0,8,8
2578,2,work,8,16,8
2578,3,home,16,23,7
2578,4,work,23,24,1
2578,5,<ENDS>,24,24,0
2579,0,<START>,0,0,0
2579,1,home,0,7,7
2579,2,shop,7,8,1
2579,3,work,8,16,8
2579,4,home,16,24,8
2579,5,<ENDS>,24,24,0
2580,0,<START>,0,0,0
2580,1,home,0,7,7
2580,2,work,7,8,1
2580,3,home,8,9,1
2580,4,work,9,10,1
2580,5,home,10,17,7
2580,6,work,17,19,2
2580,7,home,19,24,5
2580,8,<ENDS>,24,24,0
2581,0,<START>,0,0,0
2581,1,home,0,7,7
2581,2,work,7,13,6
2581,3,shop,13,14,1
2581,4,home,14,24,10
2581,5,<ENDS>,24,24,0
2582,0,<START>,0,0,0
2582,1,home,0,8,8
2582,2,work,8,15,7
2582,3,shop,15,16,1
2582,4,work,16,20,4
2582,5,home,20,24,4
2582,6,<ENDS>,24,24,0
2583,0,<START>,0,0,0
2583,1,home,0,7,7
2583,2,work,7,13,6
2583,3,home,13,17,4
2583,4,work,17,20,3
2583,5,home,20,24,4
2583,6,<ENDS>,24,24,0
2584,0,<START>,0,0,0
2584,1,home,0,6,6
2584,2,shop,6,7,1
2584,3,home,7,13,6
2584,4,education,13,16,3
2584,5,shop,16,17,1
2584,6,home,17,24,7
2584,7,<ENDS>,24,24,0
2585,0,<START>,0,0,0
2585,1,home,0,7,7
2585,2,work,7,9,2
2585,3,home,9,15,6
2585,4,work,15,17,2
2585,5,home,17,23,6
2585,6,work,23,24,1
2585,7,<ENDS>,24,24,0
2586,0,<START>,0,0,0
2586,1,home,0,7,7
2586,2,work,7,13,6
2586,3,shop,13,14,1
2586,4,home,14,24,10
2586,5,<ENDS>,24,24,0
2587,0,<START>,0,0,0
2587,1,home,0,6,6
2587,2,work,6,13,7
2587,3,home,13,24,11
2587,4,<ENDS>,24,24,0
2588,0,<START>,0,0,0
2588,1,home,0,7,7
2588,2,work,7,9,2
2588,3,home,9,12,3
2588,4,work,12,14,2
2588,5,home,14,18,4
2588,6,work,18,20,2
2588,7,home,20,24,4
2588,8,<ENDS>,24,24,0
2589,0,<START>,0,0,0
2589,1,home,0,7,7
2589,2,work,7,14,7
2589,3,home,14,23,9
2589,4,work,23,24,1
2589,5,<ENDS>,24,24,0
2590,0,<START>,0,0,0
2590,1,home,0,6,6
2590,2,work,6,13,7
2590,3,home,13,24,11
2590,4,<ENDS>,24,24,0
2591,0,<START>,0,0,0
2591,1,home,0,7,7
2591,2,work,7,13,6
2591,3,shop,13,15,2
2591,4,work,15,20,5
2591,5,home,20,24,4
2591,6,<ENDS>,24,24,0
2592,0,<START>,0,0,0
2592,1,home,0,6,6
2592,2,work,6,13,7
2592,3,shop,13,14,1
2592,4,home,14,24,10
2592,5,<ENDS>,24,24,0
2593,0,<START>,0,0,0
2593,1,home,0,7,7
2593,2,work,7,13,6
2593,3,shop,13,14,1
2593,4,home,14,24,10
2593,5,<ENDS>,24,24,0
2594,0,<START>,0,0,0
2594,1,home,0,6,6
2594,2,shop,6,7,1
2594,3,work,7,13,6
2594,4,home,13,17,4
2594,5,work,17,20,3
2594,6,home,20,24,4
2594,7,<ENDS>,24,24,0
2595,0,<START>,0,0,0
2595,1,home,0,6,6
2595,2,work,6,13,7
2595,3,shop,13,14,1
2595,4,work,14,19,5
2595,5,home,19,24,5
2595,6,<ENDS>,24,24,0
2596,0,<START>,0,0,0
2596,1,home,0,6,6
2596,2,shop,6,7,1
2596,3,home,7,10,3
2596,4,education,10,12,2
2596,5,home,12,18,6
2596,6,shop,18,20,2
2596,7,home,20,24,4
2596,8,<ENDS>,24,24,0
2597,0,<START>,0,0,0
2597,1,home,0,6,6
2597,2,work,6,13,7
2597,3,home,13,24,11
2597,4,<ENDS>,24,24,0
2598,0,<START>,0,0,0
2598,1,home,0,7,7
2598,2,work,7,14,7
2598,3,home,14,24,10
2598,4,<ENDS>,24,24,0
2599,0,<START>,0,0,0
2599,1,home,0,6,6
2599,2,work,6,13,7
2599,3,home,13,21,8
2599,4,shop,21,22,1
2599,5,home,22,24,2
2599,6,<ENDS>,24,24,0
2600,0,<START>,0,0,0
2600,1,home,0,7,7
2600,2,work,7,14,7
2600,3,shop,14,15,1
2600,4,work,15,20,5
2600,5,home,20,24,4
2600,6,<ENDS>,24,24,0
2601,0,<START>,0,0,0
2601,1,home,0,8,8
2601,2,work,8,15,7
2601,3,home,15,17,2
2601,4,work,17,20,3
2601,5,home,20,24,4
2601,6,<ENDS>,24,24,0
2602,0,<START>,0,0,0
2602,1,home,0,7,7
2602,2,shop,7,8,1
2602,3,education,8,12,4
2602,4,shop,12,13,1
2602,5,home,13,19,6
2602,6,shop,19,21,2
2602,7,home,21,24,3
2602,8,<ENDS>,24,24,0
2603,0,<START>,0,0,0
2603,1,home,0,7,7
2603,2,work,7,13,6
2603,3,shop,13,14,1
2603,4,work,14,20,6
2603,5,home,20,24,4
2603,6,<ENDS>,24,24,0
2604,0,<START>,0,0,0
2604,1,home,0,8,8
2604,2,work,8,13,5
2604,3,shop,13,14,1
2604,4,home,14,21,7
2604,5,work,21,22,1
2604,6,home,22,24,2
2604,7,<ENDS>,24,24,0
2605,0,<START>,0,0,0
2605,1,home,0,6,6
2605,2,work,6,13,7
2605,3,home,13,21,8
2605,4,work,21,22,1
2605,5,home,22,24,2
2605,6,<ENDS>,24,24,0
2606,0,<START>,0,0,0
2606,1,home,0,7,7
2606,2,work,7,13,6
2606,3,shop,13,14,1
2606,4,education,14,16,2
2606,5,home,16,24,8
2606,6,<ENDS>,24,24,0
2607,0,<START>,0,0,0
2607,1,home,0,7,7
2607,2,work,7,13,6
2607,3,shop,13,14,1
2607,4,work,14,20,6
2607,5,home,20,24,4
2607,6,<ENDS>,24,24,0
2608,0,<START>,0,0,0
2608,1,home,0,8,8
2608,2,work,8,15,7
2608,3,home,15,19,4
2608,4,shop,19,20,1
2608,5,home,20,24,4
2608,6,<ENDS>,24,24,0
2609,0,<START>,0,0,0
2609,1,home,0,8,8
2609,2,work,8,15,7
2609,3,home,15,24,9
2609,4,<ENDS>,24,24,0
2610,0,<START>,0,0,0
2610,1,home,0,6,6
2610,2,work,6,13,7
2610,3,home,13,20,7
2610,4,shop,20,21,1
2610,5,home,21,24,3
2610,6,<ENDS>,24,24,0
2611,0,<START>,0,0,0
2611,1,home,0,7,7
2611,2,work,7,13,6
2611,3,shop,13,14,1
2611,4,work,14,20,6
2611,5,home,20,24,4
2611,6,<ENDS>,24,24,0
2612,0,<START>,0,0,0
2612,1,home,0,6,6
2612,2,work,6,8,2
2612,3,home,8,12,4
2612,4,work,12,14,2
2612,5,home,14,21,7
2612,6,work,21,22,1
2612,7,home,22,24,2
2612,8,<ENDS>,24,24,0
2613,0,<START>,0,0,0
2613,1,home,0,7,7
2613,2,work,7,13,6
2613,3,shop,13,14,1
2613,4,home,14,24,10
2613,5,<ENDS>,24,24,0
2614,0,<START>,0,0,0
2614,1,home,0,6,6
2614,2,work,6,8,2
2614,3,home,8,9,1
2614,4,work,9,11,2
2614,5,home,11,18,7
2614,6,work,18,19,1
2614,7,home,19,24,5
2614,8,<ENDS>,24,24,0
2615,0,<START>,0,0,0
2615,1,home,0,7,7
2615,2,education,7,11,4
2615,3,home,11,18,7
2615,4,shop,18,19,1
2615,5,home,19,24,5
2615,6,<ENDS>,24,24,0
2616,0,<START>,0,0,0
2616,1,home,0,7,7
2616,2,work,7,14,7
2616,3,home,14,21,7
2616,4,shop,21,22,1
2616,5,home,22,24,2
2616,6,<ENDS>,24,24,0
2617,0,<START>,0,0,0
2617,1,home,0,6,6
2617,2,shop,6,7,1
2617,3,home,7,10,3
2617,4,education,10,12,2
2617,5,home,12,19,7
2617,6,shop,19,20,1
2617,7,home,20,24,4
2617,8,<ENDS>,24,24,0
2618,0,<START>,0,0,0
2618,1,home,0,7,7
2618,2,education,7,11,4
2618,3,home,11,17,6
2618,4,shop,17,18,1
2618,5,home,18,24,6
2618,6,<ENDS>,24,24,0
2619,0,<START>,0,0,0
2619,1,home,0,8,8
2619,2,education,8,11,3
2619,3,home,11,18,7
2619,4,shop,18,20,2
2619,5,home,20,24,4
2619,6,<ENDS>,24,24,0
2620,0,<START>,0,0,0
2620,1,home,0,6,6
2620,2,work,6,8,2
2620,3,home,8,9,1
2620,4,work,9,11,2
2620,5,home,11,16,5
2620,6,work,16,18,2
2620,7,home,18,24,6
2620,8,<ENDS>,24,24,0
2621,0,<START>,0,0,0
2621,1,home,0,7,7
2621,2,work,7,13,6
2621,3,home,13,18,5
2621,4,work,18,20,2
2621,5,home,20,24,4
2621,6,<ENDS>,24,24,0
2622,0,<START>,0,0,0
2622,1,home,0,7,7
2622,2,shop,7,8,1
2622,3,work,8,15,7
2622,4,home,15,24,9
2622,5,<ENDS>,24,24,0
2623,0,<START>,0,0,0
2623,1,home,0,8,8
2623,2,work,8,14,6
2623,3,home,14,24,10
2623,4,<ENDS>,24,24,0
2624,0,<START>,0,0,0
2624,1,home,0,7,7
2624,2,work,7,14,7
2624,3,shop,14,15,1
2624,4,home,15,22,7
2624,5,work,22,23,1
2624,6,home,23,24,1
2624,7,<ENDS>,24,24,0
2625,0,<START>,0,0,0
2625,1,home,0,6,6
2625,2,shop,6,7,1
2625,3,home,7,9,2
2625,4,education,9,12,3
2625,5,home,12,20,8
2625,6,shop,20,21,1
2625,7,home,21,24,3
2625,8,<ENDS>,24,24,0
2626,0,<START>,0,0,0
2626,1,home,0,6,6
2626,2,shop,6,7,1
2626,3,home,7,9,2
2626,4,education,9,11,2
2626,5,home,11,17,6
2626,6,shop,17,18,1
2626,7,home,18,24,6
2626,8,<ENDS>,24,24,0
2627,0,<START>,0,0,0
2627,1,home,0,7,7
2627,2,work,7,14,7
2627,3,home,14,21,7
2627,4,work,21,22,1
2627,5,home,22,24,2
2627,6,<ENDS>,24,24,0
2628,0,<START>,0,0,0
2628,1,home,0,7,7
2628,2,work,7,13,6
2628,3,home,13,18,5
2628,4,work,18,20,2
2628,5,home,20,24,4
2628,6,<ENDS>,24,24,0
2629,0,<START>,0,0,0
2629,1,home,0,8,8
2629,2,work,8,15,7
2629,3,home,15,21,6
2629,4,work,21,22,1
2629,5,home,22,24,2
2629,6,<ENDS>,24,24,0
2630,0,<START>,0,0,0
2630,1,home,0,8,8
2630,2,education,8,12,4
2630,3,work,12,19,7
2630,4,home,19,24,5
2630,5,<ENDS>,24,24,0
2631,0,<START>,0,0,0
2631,1,home,0,6,6
2631,2,work,6,13,7
2631,3,home,13,17,4
2631,4,work,17,20,3
2631,5,home,20,24,4
2631,6,<ENDS>,24,24,0
2632,0,<START>,0,0,0
2632,1,home,0,6,6
2632,2,work,6,13,7
2632,3,shop,13,14,1
2632,4,home,14,16,2
2632,5,work,16,20,4
2632,6,home,20,24,4
2632,7,<ENDS>,24,24,0
2633,0,<START>,0,0,0
2633,1,home,0,7,7
2633,2,education,7,12,5
2633,3,home,12,19,7
2633,4,shop,19,21,2
2633,5,home,21,24,3
2633,6,<ENDS>,24,24,0
2634,0,<START>,0,0,0
2634,1,home,0,6,6
2634,2,shop,6,7,1
2634,3,work,7,13,6
2634,4,home,13,17,4
2634,5,work,17,20,3
2634,6,home,20,24,4
2634,7,<ENDS>,24,24,0
2635,0,<START>,0,0,0
2635,1,home,0,9,9
2635,2,work,9,14,5
2635,3,home,14,19,5
2635,4,shop,19,20,1
2635,5,home,20,24,4
2635,6,<ENDS>,24,24,0
2636,0,<START>,0,0,0
2636,1,home,0,6,6
2636,2,shop,6,7,1
2636,3,work,7,13,6
2636,4,shop,13,14,1
2636,5,work,14,19,5
2636,6,home,19,24,5
2636,7,<ENDS>,24,24,0
2637,0,<START>,0,0,0
2637,1,home,0,9,9
2637,2,education,9,11,2
2637,3,shop,11,12,1
2637,4,work,12,19,7
2637,5,home,19,24,5
2637,6,<ENDS>,24,24,0
2638,0,<START>,0,0,0
2638,1,home,0,7,7
2638,2,work,7,13,6
2638,3,home,13,21,8
2638,4,shop,21,22,1
2638,5,home,22,24,2
2638,6,<ENDS>,24,24,0
2639,0,<START>,0,0,0
2639,1,home,0,8,8
2639,2,education,8,11,3
2639,3,home,11,15,4
2639,4,work,15,20,5
2639,5,home,20,23,3
2639,6,work,23,24,1
2639,7,<ENDS>,24,24,0
2640,0,<START>,0,0,0
2640,1,home,0,7,7
2640,2,education,7,12,5
2640,3,home,12,18,6
2640,4,shop,18,19,1
2640,5,home,19,24,5
2640,6,<ENDS>,24,24,0
2641,0,<START>,0,0,0
2641,1,home,0,7,7
2641,2,education,7,11,4
2641,3,home,11,19,8
2641,4,shop,19,20,1
2641,5,home,20,24,4
2641,6,<ENDS>,24,24,0
2642,0,<START>,0,0,0
2642,1,home,0,8,8
2642,2,work,8,14,6
2642,3,home,14,21,7
2642,4,shop,21,22,1
2642,5,home,22,24,2
2642,6,<ENDS>,24,24,0
2643,0,<START>,0,0,0
2643,1,home,0,7,7
2643,2,work,7,13,6
2643,3,home,13,24,11
2643,4,<ENDS>,24,24,0
2644,0,<START>,0,0,0
2644,1,home,0,7,7
2644,2,shop,7,9,2
2644,3,education,9,11,2
2644,4,home,11,19,8
2644,5,shop,19,20,1
2644,6,home,20,24,4
2644,7,<ENDS>,24,24,0
2645,0,<START>,0,0,0
2645,1,home,0,7,7
2645,2,work,7,14,7
2645,3,home,14,24,10
2645,4,<ENDS>,24,24,0
2646,0,<START>,0,0,0
2646,1,home,0,7,7
2646,2,work,7,14,7
2646,3,shop,14,15,1
2646,4,work,15,19,4
2646,5,home,19,24,5
2646,6,<ENDS>,24,24,0
2647,0,<START>,0,0,0
2647,1,home,0,6,6
2647,2,shop,6,7,1
2647,3,home,7,10,3
2647,4,work,10,17,7
2647,5,home,17,24,7
2647,6,<ENDS>,24,24,0
2648,0,<START>,0,0,0
2648,1,home,0,7,7
2648,2,work,7,13,6
2648,3,home,13,21,8
2648,4,shop,21,22,1
2648,5,home,22,24,2
2648,6,<ENDS>,24,24,0
2649,0,<START>,0,0,0
2649,1,home,0,6,6
2649,2,work,6,13,7
2649,3,shop,13,14,1
2649,4,work,14,20,6
2649,5,home,20,24,4
2649,6,<ENDS>,24,24,0
2650,0,<START>,0,0,0
2650,1,home,0,8,8
2650,2,work,8,13,5
2650,3,home,13,24,11
2650,4,<ENDS>,24,24,0
2651,0,<START>,0,0,0
2651,1,home,0,7,7
2651,2,work,7,13,6
2651,3,shop,13,14,1
2651,4,home,14,24,10
2651,5,<ENDS>,24,24,0
2652,0,<START>,0,0,0
2652,1,home,0,8,8
2652,2,work,8,16,8
2652,3,shop,16,17,1
2652,4,work,17,20,3
2652,5,home,20,24,4
2652,6,<ENDS>,24,24,0
2653,0,<START>,0,0,0
2653,1,home,0,8,8
2653,2,work,8,14,6
2653,3,home,14,24,10
2653,4,<ENDS>,24,24,0
2654,0,<START>,0,0,0
2654,1,home,0,8,8
2654,2,work,8,15,7
2654,3,shop,15,16,1
2654,4,home,16,23,7
2654,5,work,23,24,1
2654,6,<ENDS>,24,24,0
2655,0,<START>,0,0,0
2655,1,home,0,6,6
2655,2,shop,6,7,1
2655,3,home,7,10,3
2655,4,education,10,12,2
2655,5,shop,12,14,2
2655,6,education,14,16,2
2655,7,home,16,20,4
2655,8,shop,20,21,1
2655,9,home,21,24,3
2655,10,<ENDS>,24,24,0
2656,0,<START>,0,0,0
2656,1,home,0,7,7
2656,2,work,7,9,2
2656,3,home,9,13,4
2656,4,work,13,15,2
2656,5,home,15,22,7
2656,6,work,22,23,1
2656,7,home,23,24,1
2656,8,<ENDS>,24,24,0
2657,0,<START>,0,0,0
2657,1,home,0,7,7
2657,2,education,7,11,4
2657,3,home,11,17,6
2657,4,shop,17,18,1
2657,5,home,18,24,6
2657,6,<ENDS>,24,24,0
2658,0,<START>,0,0,0
2658,1,home,0,7,7
2658,2,work,7,14,7
2658,3,home,14,18,4
2658,4,work,18,20,2
2658,5,home,20,24,4
2658,6,<ENDS>,24,24,0
2659,0,<START>,0,0,0
2659,1,home,0,6,6
2659,2,shop,6,7,1
2659,3,home,7,13,6
2659,4,education,13,16,3
2659,5,home,16,24,8
2659,6,<ENDS>,24,24,0
2660,0,<START>,0,0,0
2660,1,home,0,7,7
2660,2,education,7,11,4
2660,3,home,11,14,3
2660,4,education,14,16,2
2660,5,home,16,24,8
2660,6,<ENDS>,24,24,0
2661,0,<START>,0,0,0
2661,1,home,0,6,6
2661,2,work,6,13,7
2661,3,home,13,18,5
2661,4,work,18,20,2
2661,5,home,20,24,4
2661,6,<ENDS>,24,24,0
2662,0,<START>,0,0,0
2662,1,home,0,7,7
2662,2,work,7,13,6
2662,3,home,13,17,4
2662,4,work,17,20,3
2662,5,home,20,24,4
2662,6,<ENDS>,24,24,0
2663,0,<START>,0,0,0
2663,1,home,0,6,6
2663,2,work,6,13,7
2663,3,shop,13,14,1
2663,4,home,14,24,10
2663,5,<ENDS>,24,24,0
2664,0,<START>,0,0,0
2664,1,home,0,6,6
2664,2,work,6,13,7
2664,3,home,13,18,5
2664,4,work,18,19,1
2664,5,home,19,24,5
2664,6,<ENDS>,24,24,0
2665,0,<START>,0,0,0
2665,1,work,0,9,9
2665,2,shop,9,10,1
2665,3,work,10,17,7
2665,4,home,17,23,6
2665,5,work,23,24,1
2665,6,<ENDS>,24,24,0
2666,0,<START>,0,0,0
2666,1,home,0,8,8
2666,2,work,8,14,6
2666,3,home,14,18,4
2666,4,shop,18,19,1
2666,5,home,19,24,5
2666,6,<ENDS>,24,24,0
2667,0,<START>,0,0,0
2667,1,home,0,7,7
2667,2,work,7,13,6
2667,3,home,13,19,6
2667,4,shop,19,20,1
2667,5,home,20,24,4
2667,6,<ENDS>,24,24,0
2668,0,<START>,0,0,0
2668,1,home,0,7,7
2668,2,work,7,13,6
2668,3,shop,13,14,1
2668,4,home,14,22,8
2668,5,work,22,23,1
2668,6,home,23,24,1
2668,7,<ENDS>,24,24,0
2669,0,<START>,0,0,0
2669,1,home,0,8,8
2669,2,work,8,15,7
2669,3,home,15,24,9
2669,4,<ENDS>,24,24,0
2670,0,<START>,0,0,0
2670,1,home,0,6,6
2670,2,shop,6,7,1
2670,3,home,7,13,6
2670,4,education,13,17,4
2670,5,home,17,24,7
2670,6,<ENDS>,24,24,0
2671,0,<START>,0,0,0
2671,1,home,0,7,7
2671,2,shop,7,8,1
2671,3,work,8,15,7
2671,4,home,15,22,7
2671,5,work,22,23,1
2671,6,home,23,24,1
2671,7,<ENDS>,24,24,0
2672,0,<START>,0,0,0
2672,1,home,0,8,8
2672,2,education,8,11,3
2672,3,shop,11,12,1
2672,4,work,12,19,7
2672,5,home,19,24,5
2672,6,<ENDS>,24,24,0
2673,0,<START>,0,0,0
2673,1,home,0,8,8
2673,2,work,8,14,6
2673,3,home,14,21,7
2673,4,shop,21,22,1
2673,5,home,22,24,2
2673,6,<ENDS>,24,24,0
2674,0,<START>,0,0,0
2674,1,home,0,7,7
2674,2,work,7,8,1
2674,3,home,8,9,1
2674,4,work,9,10,1
2674,5,home,10,14,4
2674,6,work,14,16,2
2674,7,home,16,22,6
2674,8,work,22,23,1
2674,9,home,23,24,1
2674,10,<ENDS>,24,24,0
2675,0,<START>,0,0,0
2675,1,home,0,6,6
2675,2,shop,6,7,1
2675,3,home,7,10,3
2675,4,education,10,12,2
2675,5,shop,12,15,3
2675,6,home,15,24,9
2675,7,<ENDS>,24,24,0
2676,0,<START>,0,0,0
2676,1,home,0,7,7
2676,2,work,7,17,10
2676,3,home,17,24,7
2676,4,<ENDS>,24,24,0
2677,0,<START>,0,0,0
2677,1,home,0,6,6
2677,2,work,6,14,8
2677,3,shop,14,15,1
2677,4,home,15,21,6
2677,5,work,21,22,1
2677,6,home,22,24,2
2677,7,<ENDS>,24,24,0
2678,0,<START>,0,0,0
2678,1,home,0,6,6
2678,2,shop,6,7,1
2678,3,home,7,9,2
2678,4,education,9,12,3
2678,5,home,12,15,3
2678,6,work,15,20,5
2678,7,home,20,24,4
2678,8,<ENDS>,24,24,0
2679,0,<START>,0,0,0
2679,1,home,0,7,7
2679,2,work,7,13,6
2679,3,shop,13,14,1
2679,4,home,14,22,8
2679,5,work,22,23,1
2679,6,home,23,24,1
2679,7,<ENDS>,24,24,0
2680,0,<START>,0,0,0
2680,1,home,0,6,6
2680,2,work,6,8,2
2680,3,home,8,14,6
2680,4,work,14,15,1
2680,5,home,15,21,6
2680,6,work,21,22,1
2680,7,home,22,24,2
2680,8,<ENDS>,24,24,0
2681,0,<START>,0,0,0
2681,1,home,0,8,8
2681,2,work,8,16,8
2681,3,home,16,24,8
2681,4,<ENDS>,24,24,0
2682,0,<START>,0,0,0
2682,1,home,0,6,6
2682,2,shop,6,7,1
2682,3,home,7,13,6
2682,4,education,13,16,3
2682,5,home,16,24,8
2682,6,<ENDS>,24,24,0
2683,0,<START>,0,0,0
2683,1,home,0,8,8
2683,2,work,8,15,7
2683,3,home,15,24,9
2683,4,<ENDS>,24,24,0
2684,0,<START>,0,0,0
2684,1,home,0,6,6
2684,2,work,6,13,7
2684,3,shop,13,14,1
2684,4,education,14,17,3
2684,5,home,17,24,7
2684,6,<ENDS>,24,24,0
2685,0,<START>,0,0,0
2685,1,home,0,7,7
2685,2,work,7,14,7
2685,3,shop,14,15,1
2685,4,home,15,24,9
2685,5,<ENDS>,24,24,0
2686,0,<START>,0,0,0
2686,1,home,0,7,7
2686,2,shop,7,10,3
2686,3,education,10,16,6
2686,4,home,16,24,8
2686,5,<ENDS>,24,24,0
2687,0,<START>,0,0,0
2687,1,home,0,6,6
2687,2,shop,6,7,1
2687,3,home,7,12,5
2687,4,education,12,16,4
2687,5,home,16,24,8
2687,6,<ENDS>,24,24,0
2688,0,<START>,0,0,0
2688,1,home,0,7,7
2688,2,work,7,13,6
2688,3,home,13,24,11
2688,4,<ENDS>,24,24,0
2689,0,<START>,0,0,0
2689,1,home,0,6,6
2689,2,work,6,13,7
2689,3,shop,13,14,1
2689,4,home,14,23,9
2689,5,work,23,24,1
2689,6,<ENDS>,24,24,0
2690,0,<START>,0,0,0
2690,1,home,0,6,6
2690,2,work,6,13,7
2690,3,shop,13,14,1
2690,4,education,14,17,3
2690,5,home,17,24,7
2690,6,<ENDS>,24,24,0
2691,0,<START>,0,0,0
2691,1,home,0,7,7
2691,2,work,7,14,7
2691,3,shop,14,15,1
2691,4,work,15,20,5
2691,5,home,20,24,4
2691,6,<ENDS>,24,24,0
2692,0,<START>,0,0,0
2692,1,home,0,7,7
2692,2,work,7,13,6
2692,3,home,13,24,11
2692,4,<ENDS>,24,24,0
2693,0,<START>,0,0,0
2693,1,home,0,7,7
2693,2,shop,7,8,1
2693,3,education,8,11,3
2693,4,home,11,14,3
2693,5,education,14,16,2
2693,6,shop,16,17,1
2693,7,home,17,24,7
2693,8,<ENDS>,24,24,0
2694,0,<START>,0,0,0
2694,1,home,0,7,7
2694,2,work,7,13,6
2694,3,shop,13,14,1
2694,4,education,14,16,2
2694,5,home,16,24,8
2694,6,<ENDS>,24,24,0
2695,0,<START>,0,0,0
2695,1,home,0,7,7
2695,2,education,7,11,4
2695,3,home,11,17,6
2695,4,shop,17,18,1
2695,5,home,18,24,6
2695,6,<ENDS>,24,24,0
2696,0,<START>,0,0,0
2696,1,home,0,6,6
2696,2,shop,6,9,3
2696,3,work,9,15,6
2696,4,home,15,24,9
2696,5,<ENDS>,24,24,0
2697,0,<START>,0,0,0
2697,1,home,0,7,7
2697,2,education,7,12,5
2697,3,home,12,13,1
2697,4,education,13,16,3
2697,5,home,16,24,8
2697,6,<ENDS>,24,24,0
2698,0,<START>,0,0,0
2698,1,home,0,8,8
2698,2,education,8,12,4
2698,3,work,12,18,6
2698,4,home,18,24,6
2698,5,<ENDS>,24,24,0
2699,0,<START>,0,0,0
2699,1,home,0,7,7
2699,2,work,7,9,2
2699,3,home,9,13,4
2699,4,work,13,15,2
2699,5,home,15,22,7
2699,6,work,22,23,1
2699,7,home,23,24,1
2699,8,<ENDS>,24,24,0
2700,0,<START>,0,0,0
2700,1,home,0,7,7
2700,2,work,7,13,6
2700,3,home,13,17,4
2700,4,work,17,20,3
2700,5,home,20,24,4
2700,6,<ENDS>,24,24,0
2701,0,<START>,0,0,0
2701,1,home,0,8,8
2701,2,work,8,16,8
2701,3,home,16,20,4
2701,4,shop,20,21,1
2701,5,home,21,24,3
2701,6,<ENDS>,24,24,0
2702,0,<START>,0,0,0
2702,1,home,0,7,7
2702,2,work,7,14,7
2702,3,home,14,18,4
2702,4,work,18,20,2
2702,5,home,20,24,4
2702,6,<ENDS>,24,24,0
2703,0,<START>,0,0,0
2703,1,home,0,7,7
2703,2,education,7,13,6
2703,3,home,13,17,4
2703,4,shop,17,19,2
2703,5,home,19,24,5
2703,6,<ENDS>,24,24,0
2704,0,<START>,0,0,0
2704,1,home,0,8,8
2704,2,education,8,12,4
2704,3,home,12,19,7
2704,4,shop,19,21,2
2704,5,home,21,24,3
2704,6,<ENDS>,24,24,0
2705,0,<START>,0,0,0
2705,1,home,0,8,8
2705,2,shop,8,9,1
2705,3,work,9,17,8
2705,4,home,17,23,6
2705,5,work,23,24,1
2705,6,<ENDS>,24,24,0
2706,0,<START>,0,0,0
2706,1,home,0,6,6
2706,2,work,6,13,7
2706,3,home,13,24,11
2706,4,<ENDS>,24,24,0
2707,0,<START>,0,0,0
2707,1,home,0,6,6
2707,2,shop,6,7,1
2707,3,home,7,10,3
2707,4,education,10,12,2
2707,5,home,12,18,6
2707,6,shop,18,19,1
2707,7,home,19,24,5
2707,8,<ENDS>,24,24,0
2708,0,<START>,0,0,0
2708,1,home,0,7,7
2708,2,work,7,14,7
2708,3,home,14,24,10
2708,4,<ENDS>,24,24,0
2709,0,<START>,0,0,0
2709,1,home,0,8,8
2709,2,shop,8,9,1
2709,3,work,9,15,6
2709,4,home,15,24,9
2709,5,<ENDS>,24,24,0
2710,0,<START>,0,0,0
2710,1,home,0,7,7
2710,2,work,7,13,6
2710,3,shop,13,14,1
2710,4,home,14,18,4
2710,5,work,18,20,2
2710,6,home,20,24,4
2710,7,<ENDS>,24,24,0
2711,0,<START>,0,0,0
2711,1,home,0,8,8
2711,2,education,8,11,3
2711,3,shop,11,12,1
2711,4,home,12,16,4
2711,5,work,16,20,4
2711,6,home,20,24,4
2711,7,<ENDS>,24,24,0
2712,0,<START>,0,0,0
2712,1,home,0,7,7
2712,2,shop,7,8,1
2712,3,education,8,12,4
2712,4,home,12,20,8
2712,5,shop,20,21,1
2712,6,home,21,24,3
2712,7,<ENDS>,24,24,0
2713,0,<START>,0,0,0
2713,1,home,0,6,6
2713,2,shop,6,7,1
2713,3,home,7,10,3
2713,4,education,10,13,3
2713,5,shop,13,15,2
2713,6,home,15,21,6
2713,7,shop,21,22,1
2713,8,home,22,24,2
2713,9,<ENDS>,24,24,0
2714,0,<START>,0,0,0
2714,1,home,0,8,8
2714,2,education,8,11,3
2714,3,home,11,15,4
2714,4,work,15,20,5
2714,5,home,20,23,3
2714,6,work,23,24,1
2714,7,<ENDS>,24,24,0
2715,0,<START>,0,0,0
2715,1,home,0,7,7
2715,2,work,7,14,7
2715,3,home,14,24,10
2715,4,<ENDS>,24,24,0
2716,0,<START>,0,0,0
2716,1,home,0,7,7
2716,2,work,7,13,6
2716,3,home,13,24,11
2716,4,<ENDS>,24,24,0
2717,0,<START>,0,0,0
2717,1,home,0,6,6
2717,2,shop,6,7,1
2717,3,work,7,9,2
2717,4,home,9,14,5
2717,5,work,14,17,3
2717,6,home,17,23,6
2717,7,work,23,24,1
2717,8,<ENDS>,24,24,0
2718,0,<START>,0,0,0
2718,1,home,0,7,7
2718,2,work,7,9,2
2718,3,home,9,13,4
2718,4,work,13,15,2
2718,5,home,15,21,6
2718,6,work,21,22,1
2718,7,home,22,24,2
2718,8,<ENDS>,24,24,0
2719,0,<START>,0,0,0
2719,1,home,0,8,8
2719,2,work,8,14,6
2719,3,shop,14,15,1
2719,4,home,15,21,6
2719,5,work,21,22,1
2719,6,home,22,24,2
2719,7,<ENDS>,24,24,0
2720,0,<START>,0,0,0
2720,1,home,0,6,6
2720,2,shop,6,7,1
2720,3,work,7,10,3
2720,4,home,10,16,6
2720,5,work,16,18,2
2720,6,home,18,24,6
2720,7,<ENDS>,24,24,0
2721,0,<START>,0,0,0
2721,1,home,0,6,6
2721,2,shop,6,7,1
2721,3,home,7,11,4
2721,4,work,11,18,7
2721,5,home,18,22,4
2721,6,work,22,23,1
2721,7,home,23,24,1
2721,8,<ENDS>,24,24,0
2722,0,<START>,0,0,0
2722,1,home,0,7,7
2722,2,work,7,13,6
2722,3,home,13,18,5
2722,4,work,18,19,1
2722,5,home,19,23,4
2722,6,work,23,24,1
2722,7,<ENDS>,24,24,0
2723,0,<START>,0,0,0
2723,1,home,0,7,7
2723,2,work,7,14,7
2723,3,home,14,17,3
2723,4,work,17,19,2
2723,5,home,19,24,5
2723,6,<ENDS>,24,24,0
2724,0,<START>,0,0,0
2724,1,home,0,7,7
2724,2,work,7,9,2
2724,3,home,9,15,6
2724,4,work,15,17,2
2724,5,home,17,24,7
2724,6,<ENDS>,24,24,0
2725,0,<START>,0,0,0
2725,1,home,0,8,8
2725,2,work,8,15,7
2725,3,home,15,17,2
2725,4,work,17,19,2
2725,5,education,19,20,1
2725,6,home,20,24,4
2725,7,<ENDS>,24,24,0
2726,0,<START>,0,0,0
2726,1,home,0,7,7
2726,2,work,7,14,7
2726,3,shop,14,15,1
2726,4,home,15,24,9
2726,5,<ENDS>,24,24,0
2727,0,<START>,0,0,0
2727,1,home,0,8,8
2727,2,work,8,15,7
2727,3,shop,15,16,1
2727,4,home,16,23,7
2727,5,work,23,24,1
2727,6,<ENDS>,24,24,0
2728,0,<START>,0,0,0
2728,1,home,0,6,6
2728,2,shop,6,7,1
2728,3,home,7,13,6
2728,4,education,13,16,3
2728,5,home,16,24,8
2728,6,<ENDS>,24,24,0
2729,0,<START>,0,0,0
2729,1,home,0,7,7
2729,2,work,7,14,7
2729,3,shop,14,15,1
2729,4,work,15,20,5
2729,5,home,20,24,4
2729,6,<ENDS>,24,24,0
2730,0,<START>,0,0,0
2730,1,home,0,7,7
2730,2,work,7,13,6
2730,3,home,13,17,4
2730,4,shop,17,18,1
2730,5,home,18,22,4
2730,6,work,22,23,1
2730,7,home,23,24,1
2730,8,<ENDS>,24,24,0
2731,0,<START>,0,0,0
2731,1,home,0,7,7
2731,2,shop,7,8,1
2731,3,home,8,15,7
2731,4,work,15,20,5
2731,5,home,20,24,4
2731,6,<ENDS>,24,24,0
2732,0,<START>,0,0,0
2732,1,home,0,7,7
2732,2,work,7,13,6
2732,3,home,13,24,11
2732,4,<ENDS>,24,24,0
2733,0,<START>,0,0,0
2733,1,home,0,7,7
2733,2,work,7,15,8
2733,3,home,15,24,9
2733,4,<ENDS>,24,24,0
2734,0,<START>,0,0,0
2734,1,home,0,7,7
2734,2,work,7,13,6
2734,3,shop,13,14,1
2734,4,home,14,21,7
2734,5,work,21,22,1
2734,6,home,22,24,2
2734,7,<ENDS>,24,24,0
2735,0,<START>,0,0,0
2735,1,home,0,6,6
2735,2,work,6,13,7
2735,3,home,13,18,5
2735,4,work,18,20,2
2735,5,home,20,24,4
2735,6,<ENDS>,24,24,0
2736,0,<START>,0,0,0
2736,1,home,0,7,7
2736,2,work,7,9,2
2736,3,home,9,14,5
2736,4,work,14,17,3
2736,5,home,17,24,7
2736,6,<ENDS>,24,24,0
2737,0,<START>,0,0,0
2737,1,home,0,8,8
2737,2,work,8,15,7
2737,3,home,15,24,9
2737,4,<ENDS>,24,24,0
2738,0,<START>,0,0,0
2738,1,home,0,7,7
2738,2,work,7,13,6
2738,3,shop,13,14,1
2738,4,home,14,18,4
2738,5,work,18,20,2
2738,6,home,20,24,4
2738,7,<ENDS>,24,24,0
2739,0,<START>,0,0,0
2739,1,home,0,8,8
2739,2,work,8,14,6
2739,3,shop,14,15,1
2739,4,work,15,18,3
2739,5,home,18,24,6
2739,6,<ENDS>,24,24,0
2740,0,<START>,0,0,0
2740,1,home,0,6,6
2740,2,work,6,14,8
2740,3,shop,14,15,1
2740,4,work,15,20,5
2740,5,home,20,24,4
2740,6,<ENDS>,24,24,0
2741,0,<START>,0,0,0
2741,1,home,0,6,6
2741,2,work,6,13,7
2741,3,home,13,17,4
2741,4,work,17,20,3
2741,5,home,20,24,4
2741,6,<ENDS>,24,24,0
2742,0,<START>,0,0,0
2742,1,home,0,7,7
2742,2,work,7,14,7
2742,3,home,14,23,9
2742,4,work,23,24,1
2742,5,<ENDS>,24,24,0
2743,0,<START>,0,0,0
2743,1,home,0,6,6
2743,2,shop,6,7,1
2743,3,home,7,9,2
2743,4,education,9,15,6
2743,5,shop,15,17,2
2743,6,home,17,24,7
2743,7,<ENDS>,24,24,0
2744,0,<START>,0,0,0
2744,1,home,0,8,8
2744,2,work,8,15,7
2744,3,home,15,24,9
2744,4,<ENDS>,24,24,0
2745,0,<START>,0,0,0
2745,1,home,0,9,9
2745,2,work,9,17,8
2745,3,home,17,24,7
2745,4,<ENDS>,24,24,0
2746,0,<START>,0,0,0
2746,1,home,0,7,7
2746,2,work,7,14,7
2746,3,home,14,24,10
2746,4,<ENDS>,24,24,0
2747,0,<START>,0,0,0
2747,1,home,0,7,7
2747,2,education,7,11,4
2747,3,home,11,18,7
2747,4,shop,18,19,1
2747,5,home,19,24,5
2747,6,<ENDS>,24,24,0
2748,0,<START>,0,0,0
2748,1,home,0,8,8
2748,2,shop,8,9,1
2748,3,home,9,13,4
2748,4,work,13,20,7
2748,5,home,20,24,4
2748,6,<ENDS>,24,24,0
2749,0,<START>,0,0,0
2749,1,home,0,7,7
2749,2,work,7,14,7
2749,3,shop,14,15,1
2749,4,home,15,24,9
2749,5,<ENDS>,24,24,0
2750,0,<START>,0,0,0
2750,1,home,0,6,6
2750,2,work,6,13,7
2750,3,shop,13,14,1
2750,4,work,14,20,6
2750,5,home,20,24,4
2750,6,<ENDS>,24,24,0
2751,0,<START>,0,0,0
2751,1,home,0,9,9
2751,2,work,9,16,7
2751,3,home,16,24,8
2751,4,<ENDS>,24,24,0
2752,0,<START>,0,0,0
2752,1,home,0,6,6
2752,2,work,6,8,2
2752,3,home,8,9,1
2752,4,work,9,11,2
2752,5,home,11,17,6
2752,6,work,17,19,2
2752,7,home,19,24,5
2752,8,<ENDS>,24,24,0
2753,0,<START>,0,0,0
2753,1,home,0,6,6
2753,2,work,6,13,7
2753,3,shop,13,14,1
2753,4,education,14,15,1
2753,5,home,15,24,9
2753,6,<ENDS>,24,24,0
2754,0,<START>,0,0,0
2754,1,home,0,6,6
2754,2,shop,6,7,1
2754,3,home,7,11,4
2754,4,work,11,17,6
2754,5,home,17,24,7
2754,6,<ENDS>,24,24,0
2755,0,<START>,0,0,0
2755,1,home,0,8,8
2755,2,work,8,15,7
2755,3,home,15,19,4
2755,4,shop,19,20,1
2755,5,home,20,24,4
2755,6,<ENDS>,24,24,0
2756,0,<START>,0,0,0
2756,1,home,0,6,6
2756,2,work,6,14,8
2756,3,shop,14,15,1
2756,4,home,15,22,7
2756,5,work,22,23,1
2756,6,home,23,24,1
2756,7,<ENDS>,24,24,0
2757,0,<START>,0,0,0
2757,1,home,0,8,8
2757,2,work,8,16,8
2757,3,home,16,24,8
2757,4,<ENDS>,24,24,0
2758,0,<START>,0,0,0
2758,1,home,0,7,7
2758,2,work,7,14,7
2758,3,home,14,24,10
2758,4,<ENDS>,24,24,0
2759,0,<START>,0,0,0
2759,1,home,0,6,6
2759,2,work,6,8,2
2759,3,home,8,12,4
2759,4,work,12,14,2
2759,5,home,14,21,7
2759,6,work,21,22,1
2759,7,home,22,24,2
2759,8,<ENDS>,24,24,0
2760,0,<START>,0,0,0
2760,1,home,0,6,6
2760,2,work,6,13,7
2760,3,home,13,18,5
2760,4,work,18,20,2
2760,5,home,20,24,4
2760,6,<ENDS>,24,24,0
2761,0,<START>,0,0,0
2761,1,home,0,7,7
2761,2,work,7,14,7
2761,3,home,14,22,8
2761,4,work,22,23,1
2761,5,home,23,24,1
2761,6,<ENDS>,24,24,0
2762,0,<START>,0,0,0
2762,1,home,0,7,7
2762,2,work,7,13,6
2762,3,shop,13,14,1
2762,4,home,14,15,1
2762,5,work,15,20,5
2762,6,home,20,24,4
2762,7,<ENDS>,24,24,0
2763,0,<START>,0,0,0
2763,1,home,0,7,7
2763,2,education,7,10,3
2763,3,home,10,14,4
2763,4,education,14,16,2
2763,5,shop,16,17,1
2763,6,home,17,24,7
2763,7,<ENDS>,24,24,0
2764,0,<START>,0,0,0
2764,1,home,0,7,7
2764,2,education,7,12,5
2764,3,shop,12,13,1
2764,4,home,13,21,8
2764,5,shop,21,22,1
2764,6,home,22,24,2
2764,7,<ENDS>,24,24,0
2765,0,<START>,0,0,0
2765,1,home,0,6,6
2765,2,shop,6,7,1
2765,3,home,7,17,10
2765,4,work,17,20,3
2765,5,home,20,24,4
2765,6,<ENDS>,24,24,0
2766,0,<START>,0,0,0
2766,1,home,0,7,7
2766,2,work,7,13,6
2766,3,home,13,17,4
2766,4,shop,17,18,1
2766,5,home,18,24,6
2766,6,<ENDS>,24,24,0
2767,0,<START>,0,0,0
2767,1,home,0,7,7
2767,2,work,7,13,6
2767,3,shop,13,14,1
2767,4,work,14,19,5
2767,5,home,19,24,5
2767,6,<ENDS>,24,24,0
2768,0,<START>,0,0,0
2768,1,home,0,8,8
2768,2,work,8,15,7
2768,3,shop,15,16,1
2768,4,home,16,24,8
2768,5,<ENDS>,24,24,0
2769,0,<START>,0,0,0
2769,1,home,0,8,8
2769,2,shop,8,9,1
2769,3,home,9,13,4
2769,4,work,13,19,6
2769,5,home,19,24,5
2769,6,<ENDS>,24,24,0
2770,0,<START>,0,0,0
2770,1,home,0,6,6
2770,2,shop,6,7,1
2770,3,home,7,12,5
2770,4,education,12,16,4
2770,5,shop,16,17,1
2770,6,home,17,24,7
2770,7,<ENDS>,24,24,0
2771,0,<START>,0,0,0
2771,1,home,0,6,6
2771,2,shop,6,7,1
2771,3,work,7,14,7
2771,4,shop,14,15,1
2771,5,home,15,24,9
2771,6,<ENDS>,24,24,0
2772,0,<START>,0,0,0
2772,1,home,0,6,6
2772,2,work,6,8,2
2772,3,home,8,14,6
2772,4,work,14,16,2
2772,5,home,16,22,6
2772,6,work,22,23,1
2772,7,home,23,24,1
2772,8,<ENDS>,24,24,0
2773,0,<START>,0,0,0
2773,1,home,0,8,8
2773,2,work,8,13,5
2773,3,home,13,17,4
2773,4,work,17,20,3
2773,5,home,20,24,4
2773,6,<ENDS>,24,24,0
2774,0,<START>,0,0,0
2774,1,home,0,8,8
2774,2,work,8,14,6
2774,3,home,14,22,8
2774,4,work,22,23,1
2774,5,home,23,24,1
2774,6,<ENDS>,24,24,0
2775,0,<START>,0,0,0
2775,1,home,0,8,8
2775,2,work,8,15,7
2775,3,home,15,21,6
2775,4,shop,21,22,1
2775,5,home,22,24,2
2775,6,<ENDS>,24,24,0
2776,0,<START>,0,0,0
2776,1,home,0,7,7
2776,2,work,7,13,6
2776,3,shop,13,14,1
2776,4,home,14,23,9
2776,5,work,23,24,1
2776,6,<ENDS>,24,24,0
2777,0,<START>,0,0,0
2777,1,home,0,8,8
2777,2,work,8,16,8
2777,3,shop,16,17,1
2777,4,home,17,24,7
2777,5,<ENDS>,24,24,0
2778,0,<START>,0,0,0
2778,1,home,0,6,6
2778,2,shop,6,7,1
2778,3,home,7,10,3
2778,4,education,10,13,3
2778,5,home,13,20,7
2778,6,shop,20,21,1
2778,7,home,21,24,3
2778,8,<ENDS>,24,24,0
2779,0,<START>,0,0,0
2779,1,home,0,6,6
2779,2,shop,6,7,1
2779,3,home,7,13,6
2779,4,education,13,17,4
2779,5,home,17,24,7
2779,6,<ENDS>,24,24,0
2780,0,<START>,0,0,0
2780,1,home,0,6,6
2780,2,work,6,13,7
2780,3,home,13,20,7
2780,4,shop,20,21,1
2780,5,home,21,24,3
2780,6,<ENDS>,24,24,0
2781,0,<START>,0,0,0
2781,1,home,0,7,7
2781,2,work,7,14,7
2781,3,home,14,15,1
2781,4,work,15,19,4
2781,5,home,19,24,5
2781,6,<ENDS>,24,24,0
2782,0,<START>,0,0,0
2782,1,home,0,8,8
2782,2,education,8,11,3
2782,3,home,11,21,10
2782,4,shop,21,22,1
2782,5,home,22,24,2
2782,6,<ENDS>,24,24,0
2783,0,<START>,0,0,0
2783,1,home,0,7,7
2783,2,work,7,8,1
2783,3,home,8,13,5
2783,4,work,13,15,2
2783,5,home,15,22,7
2783,6,work,22,23,1
2783,7,home,23,24,1
2783,8,<ENDS>,24,24,0
2784,0,<START>,0,0,0
2784,1,home,0,6,6
2784,2,work,6,13,7
2784,3,shop,13,14,1
2784,4,work,14,20,6
2784,5,home,20,24,4
2784,6,<ENDS>,24,24,0
2785,0,<START>,0,0,0
2785,1,home,0,8,8
2785,2,shop,8,9,1
2785,3,home,9,14,5
2785,4,work,14,20,6
2785,5,home,20,24,4
2785,6,<ENDS>,24,24,0
2786,0,<START>,0,0,0
2786,1,home,0,7,7
2786,2,work,7,13,6
2786,3,home,13,16,3
2786,4,work,16,19,3
2786,5,home,19,24,5
2786,6,<ENDS>,24,24,0
2787,0,<START>,0,0,0
2787,1,home,0,6,6
2787,2,work,6,13,7
2787,3,shop,13,14,1
2787,4,home,14,24,10
2787,5,<ENDS>,24,24,0
2788,0,<START>,0,0,0
2788,1,home,0,6,6
2788,2,work,6,8,2
2788,3,home,8,14,6
2788,4,work,14,16,2
2788,5,home,16,23,7
2788,6,work,23,24,1
2788,7,<ENDS>,24,24,0
2789,0,<START>,0,0,0
2789,1,home,0,7,7
2789,2,work,7,13,6
2789,3,home,13,21,8
2789,4,work,21,22,1
2789,5,home,22,24,2
2789,6,<ENDS>,24,24,0
2790,0,<START>,0,0,0
2790,1,home,0,8,8
2790,2,work,8,14,6
2790,3,home,14,21,7
2790,4,work,21,22,1
2790,5,home,22,24,2
2790,6,<ENDS>,24,24,0
2791,0,<START>,0,0,0
2791,1,home,0,6,6
2791,2,shop,6,7,1
2791,3,home,7,9,2
2791,4,work,9,16,7
2791,5,home,16,24,8
2791,6,<ENDS>,24,24,0
2792,0,<START>,0,0,0
2792,1,home,0,7,7
2792,2,work,7,14,7
2792,3,shop,14,15,1
2792,4,work,15,20,5
2792,5,home,20,24,4
2792,6,<ENDS>,24,24,0
2793,0,<START>,0,0,0
2793,1,home,0,8,8
2793,2,work,8,15,7
2793,3,home,15,23,8
2793,4,work,23,24,1
2793,5,<ENDS>,24,24,0
2794,0,<START>,0,0,0
2794,1,home,0,6,6
2794,2,work,6,13,7
2794,3,home,13,18,5
2794,4,shop,18,19,1
2794,5,home,19,23,4
2794,6,work,23,24,1
2794,7,<ENDS>,24,24,0
2795,0,<START>,0,0,0
2795,1,home,0,7,7
2795,2,work,7,14,7
2795,3,home,14,24,10
2795,4,<ENDS>,24,24,0
2796,0,<START>,0,0,0
2796,1,home,0,7,7
2796,2,shop,7,8,1
2796,3,home,8,9,1
2796,4,education,9,12,3
2796,5,home,12,24,12
2796,6,<ENDS>,24,24,0
2797,0,<START>,0,0,0
2797,1,home,0,6,6
2797,2,work,6,7,1
2797,3,home,7,12,5
2797,4,work,12,14,2
2797,5,home,14,20,6
2797,6,shop,20,21,1
2797,7,home,21,24,3
2797,8,<ENDS>,24,24,0
2798,0,<START>,0,0,0
2798,1,home,0,8,8
2798,2,work,8,14,6
2798,3,shop,14,15,1
2798,4,work,15,19,4
2798,5,home,19,24,5
2798,6,<ENDS>,24,24,0
2799,0,<START>,0,0,0
2799,1,home,0,8,8
2799,2,work,8,14,6
2799,3,home,14,24,10
2799,4,<ENDS>,24,24,0
2800,0,<START>,0,0,0
2800,1,home,0,6,6
2800,2,work,6,8,2
2800,3,home,8,14,6
2800,4,work,14,17,3
2800,5,home,17,24,7
2800,6,<ENDS>,24,24,0
2801,0,<START>,0,0,0
2801,1,home,0,7,7
2801,2,education,7,12,5
2801,3,shop,12,13,1
2801,4,education,13,15,2
2801,5,shop,15,16,1
2801,6,home,16,24,8
2801,7,<ENDS>,24,24,0
2802,0,<START>,0,0,0
2802,1,home,0,7,7
2802,2,work,7,13,6
2802,3,shop,13,14,1
2802,4,work,14,19,5
2802,5,home,19,24,5
2802,6,<ENDS>,24,24,0
2803,0,<START>,0,0,0
2803,1,home,0,7,7
2803,2,work,7,13,6
2803,3,shop,13,14,1
2803,4,work,14,19,5
2803,5,home,19,24,5
2803,6,<ENDS>,24,24,0
2804,0,<START>,0,0,0
2804,1,home,0,6,6
2804,2,shop,6,7,1
2804,3,work,7,14,7
2804,4,home,14,24,10
2804,5,<ENDS>,24,24,0
2805,0,<START>,0,0,0
2805,1,home,0,7,7
2805,2,work,7,8,1
2805,3,home,8,12,4
2805,4,work,12,14,2
2805,5,home,14,21,7
2805,6,work,21,22,1
2805,7,home,22,24,2
2805,8,<ENDS>,24,24,0
2806,0,<START>,0,0,0
2806,1,home,0,8,8
2806,2,work,8,15,7
2806,3,shop,15,16,1
2806,4,work,16,19,3
2806,5,home,19,24,5
2806,6,<ENDS>,24,24,0
2807,0,<START>,0,0,0
2807,1,home,0,8,8
2807,2,shop,8,9,1
2807,3,work,9,16,7
2807,4,home,16,24,8
2807,5,<ENDS>,24,24,0
2808,0,<START>,0,0,0
2808,1,home,0,9,9
2808,2,work,9,15,6
2808,3,home,15,24,9
2808,4,<ENDS>,24,24,0
2809,0,<START>,0,0,0
2809,1,home,0,7,7
2809,2,work,7,13,6
2809,3,shop,13,15,2
2809,4,work,15,19,4
2809,5,home,19,24,5
2809,6,<ENDS>,24,24,0
2810,0,<START>,0,0,0
2810,1,home,0,8,8
2810,2,education,8,15,7
2810,3,work,15,20,5
2810,4,home,20,24,4
2810,5,<ENDS>,24,24,0
2811,0,<START>,0,0,0
2811,1,home,0,9,9
2811,2,education,9,12,3
2811,3,work,12,19,7
2811,4,home,19,21,2
2811,5,work,21,22,1
2811,6,home,22,24,2
2811,7,<ENDS>,24,24,0
2812,0,<START>,0,0,0
2812,1,home,0,7,7
2812,2,work,7,9,2
2812,3,home,9,13,4
2812,4,work,13,16,3
2812,5,home,16,22,6
2812,6,work,22,23,1
2812,7,home,23,24,1
2812,8,<ENDS>,24,24,0
2813,0,<START>,0,0,0
2813,1,home,0,7,7
2813,2,education,7,11,4
2813,3,home,11,14,3
2813,4,education,14,16,2
2813,5,home,16,24,8
2813,6,<ENDS>,24,24,0
2814,0,<START>,0,0,0
2814,1,home,0,8,8
2814,2,work,8,14,6
2814,3,home,14,17,3
2814,4,work,17,20,3
2814,5,home,20,24,4
2814,6,<ENDS>,24,24,0
2815,0,<START>,0,0,0
2815,1,home,0,8,8
2815,2,work,8,15,7
2815,3,home,15,24,9
2815,4,<ENDS>,24,24,0
2816,0,<START>,0,0,0
2816,1,home,0,7,7
2816,2,education,7,11,4
2816,3,home,11,18,7
2816,4,shop,18,19,1
2816,5,home,19,24,5
2816,6,<ENDS>,24,24,0
2817,0,<START>,0,0,0
2817,1,home,0,7,7
2817,2,work,7,14,7
2817,3,shop,14,16,2
2817,4,work,16,19,3
2817,5,home,19,24,5
2817,6,<ENDS>,24,24,0
2818,0,<START>,0,0,0
2818,1,home,0,9,9
2818,2,education,9,11,2
2818,3,home,11,15,4
2818,4,work,15,20,5
2818,5,home,20,24,4
2818,6,<ENDS>,24,24,0
2819,0,<START>,0,0,0
2819,1,home,0,7,7
2819,2,shop,7,9,2
2819,3,education,9,12,3
2819,4,home,12,20,8
2819,5,shop,20,21,1
2819,6,home,21,24,3
2819,7,<ENDS>,24,24,0
2820,0,<START>,0,0,0
2820,1,home,0,9,9
2820,2,work,9,16,7
2820,3,shop,16,17,1
2820,4,home,17,24,7
2820,5,<ENDS>,24,24,0
2821,0,<START>,0,0,0
2821,1,home,0,8,8
2821,2,work,8,14,6
2821,3,shop,14,15,1
2821,4,home,15,24,9
2821,5,<ENDS>,24,24,0
2822,0,<START>,0,0,0
2822,1,home,0,7,7
2822,2,work,7,13,6
2822,3,shop,13,14,1
2822,4,home,14,18,4
2822,5,work,18,20,2
2822,6,home,20,24,4
2822,7,<ENDS>,24,24,0
2823,0,<START>,0,0,0
2823,1,home,0,7,7
2823,2,work,7,8,1
2823,3,home,8,12,4
2823,4,work,12,14,2
2823,5,home,14,21,7
2823,6,work,21,22,1
2823,7,home,22,24,2
2823,8,<ENDS>,24,24,0
2824,0,<START>,0,0,0
2824,1,home,0,7,7
2824,2,education,7,11,4
2824,3,home,11,17,6
2824,4,shop,17,19,2
2824,5,home,19,24,5
2824,6,<ENDS>,24,24,0
2825,0,<START>,0,0,0
2825,1,home,0,7,7
2825,2,work,7,14,7
2825,3,home,14,24,10
2825,4,<ENDS>,24,24,0
2826,0,<START>,0,0,0
2826,1,home,0,6,6
2826,2,work,6,8,2
2826,3,home,8,13,5
2826,4,work,13,15,2
2826,5,home,15,22,7
2826,6,work,22,23,1
2826,7,home,23,24,1
2826,8,<ENDS>,24,24,0
2827,0,<START>,0,0,0
2827,1,home,0,6,6
2827,2,shop,6,7,1
2827,3,work,7,13,6
2827,4,home,13,17,4
2827,5,work,17,19,2
2827,6,education,19,20,1
2827,7,home,20,22,2
2827,8,work,22,23,1
2827,9,home,23,24,1
2827,10,<ENDS>,24,24,0
2828,0,<START>,0,0,0
2828,1,home,0,6,6
2828,2,work,6,13,7
2828,3,home,13,21,8
2828,4,work,21,22,1
2828,5,home,22,24,2
2828,6,<ENDS>,24,24,0
2829,0,<START>,0,0,0
2829,1,home,0,7,7
2829,2,work,7,9,2
2829,3,home,9,13,4
2829,4,work,13,15,2
2829,5,home,15,21,6
2829,6,work,21,22,1
2829,7,home,22,24,2
2829,8,<ENDS>,24,24,0
2830,0,<START>,0,0,0
2830,1,home,0,6,6
2830,2,work,6,8,2
2830,3,home,8,14,6
2830,4,work,14,16,2
2830,5,home,16,22,6
2830,6,work,22,23,1
2830,7,home,23,24,1
2830,8,<ENDS>,24,24,0
2831,0,<START>,0,0,0
2831,1,home,0,7,7
2831,2,education,7,11,4
2831,3,home,11,14,3
2831,4,education,14,16,2
2831,5,home,16,24,8
2831,6,<ENDS>,24,24,0
2832,0,<START>,0,0,0
2832,1,home,0,9,9
2832,2,work,9,15,6
2832,3,home,15,21,6
2832,4,work,21,22,1
2832,5,home,22,24,2
2832,6,<ENDS>,24,24,0
2833,0,<START>,0,0,0
2833,1,home,0,7,7
2833,2,work,7,13,6
2833,3,home,13,20,7
2833,4,shop,20,21,1
2833,5,home,21,24,3
2833,6,<ENDS>,24,24,0
2834,0,<START>,0,0,0
2834,1,home,0,8,8
2834,2,work,8,15,7
2834,3,shop,15,16,1
2834,4,home,16,24,8
2834,5,<ENDS>,24,24,0
2835,0,<START>,0,0,0
2835,1,home,0,8,8
2835,2,work,8,15,7
2835,3,shop,15,16,1
2835,4,work,16,20,4
2835,5,home,20,24,4
2835,6,<ENDS>,24,24,0
2836,0,<START>,0,0,0
2836,1,home,0,7,7
2836,2,work,7,13,6
2836,3,home,13,17,4
2836,4,work,17,20,3
2836,5,home,20,24,4
2836,6,<ENDS>,24,24,0
2837,0,<START>,0,0,0
2837,1,home,0,6,6
2837,2,shop,6,7,1
2837,3,home,7,10,3
2837,4,education,10,12,2
2837,5,shop,12,13,1
2837,6,home,13,19,6
2837,7,shop,19,21,2
2837,8,home,21,24,3
2837,9,<ENDS>,24,24,0
2838,0,<START>,0,0,0
2838,1,home,0,7,7
2838,2,shop,7,8,1
2838,3,education,8,11,3
2838,4,home,11,18,7
2838,5,shop,18,19,1
2838,6,home,19,24,5
2838,7,<ENDS>,24,24,0
2839,0,<START>,0,0,0
2839,1,home,0,7,7
2839,2,work,7,14,7
2839,3,shop,14,15,1
2839,4,work,15,20,5
2839,5,home,20,24,4
2839,6,<ENDS>,24,24,0
2840,0,<START>,0,0,0
2840,1,home,0,7,7
2840,2,work,7,13,6
2840,3,home,13,24,11
2840,4,<ENDS>,24,24,0
2841,0,<START>,0,0,0
2841,1,home,0,7,7
2841,2,work,7,13,6
2841,3,home,13,24,11
2841,4,<ENDS>,24,24,0
2842,0,<START>,0,0,0
2842,1,home,0,9,9
2842,2,education,9,12,3
2842,3,shop,12,13,1
2842,4,work,13,19,6
2842,5,home,19,24,5
2842,6,<ENDS>,24,24,0
2843,0,<START>,0,0,0
2843,1,home,0,8,8
2843,2,work,8,15,7
2843,3,home,15,24,9
2843,4,<ENDS>,24,24,0
2844,0,<START>,0,0,0
2844,1,home,0,8,8
2844,2,work,8,14,6
2844,3,home,14,24,10
2844,4,<ENDS>,24,24,0
2845,0,<START>,0,0,0
2845,1,home,0,7,7
2845,2,work,7,14,7
2845,3,shop,14,15,1
2845,4,work,15,19,4
2845,5,home,19,24,5
2845,6,<ENDS>,24,24,0
2846,0,<START>,0,0,0
2846,1,home,0,7,7
2846,2,work,7,13,6
2846,3,home,13,24,11
2846,4,<ENDS>,24,24,0
2847,0,<START>,0,0,0
2847,1,home,0,7,7
2847,2,education,7,11,4
2847,3,home,11,19,8
2847,4,shop,19,20,1
2847,5,home,20,24,4
2847,6,<ENDS>,24,24,0
2848,0,<START>,0,0,0
2848,1,home,0,7,7
2848,2,education,7,11,4
2848,3,home,11,14,3
2848,4,education,14,16,2
2848,5,home,16,24,8
2848,6,<ENDS>,24,24,0
2849,0,<START>,0,0,0
2849,1,home,0,6,6
2849,2,work,6,13,7
2849,3,home,13,24,11
2849,4,<ENDS>,24,24,0
2850,0,<START>,0,0,0
2850,1,home,0,8,8
2850,2,work,8,14,6
2850,3,shop,14,15,1
2850,4,work,15,20,5
2850,5,home,20,24,4
2850,6,<ENDS>,24,24,0
2851,0,<START>,0,0,0
2851,1,home,0,8,8
2851,2,work,8,15,7
2851,3,shop,15,16,1
2851,4,home,16,21,5
2851,5,shop,21,22,1
2851,6,home,22,24,2
2851,7,<ENDS>,24,24,0
2852,0,<START>,0,0,0
2852,1,home,0,8,8
2852,2,education,8,12,4
2852,3,home,12,22,10
2852,4,work,22,23,1
2852,5,home,23,24,1
2852,6,<ENDS>,24,24,0
2853,0,<START>,0,0,0
2853,1,home,0,8,8
2853,2,work,8,15,7
2853,3,home,15,21,6
2853,4,shop,21,22,1
2853,5,home,22,24,2
2853,6,<ENDS>,24,24,0
2854,0,<START>,0,0,0
2854,1,home,0,7,7
2854,2,work,7,13,6
2854,3,home,13,16,3
2854,4,work,16,20,4
2854,5,home,20,24,4
2854,6,<ENDS>,24,24,0
2855,0,<START>,0,0,0
2855,1,home,0,7,7
2855,2,work,7,13,6
2855,3,shop,13,14,1
2855,4,home,14,24,10
2855,5,<ENDS>,24,24,0
2856,0,<START>,0,0,0
2856,1,home,0,7,7
2856,2,work,7,13,6
2856,3,home,13,23,10
2856,4,work,23,24,1
2856,5,<ENDS>,24,24,0
2857,0,<START>,0,0,0
2857,1,home,0,8,8
2857,2,work,8,15,7
2857,3,home,15,24,9
2857,4,<ENDS>,24,24,0
2858,0,<START>,0,0,0
2858,1,home,0,6,6
2858,2,work,6,13,7
2858,3,shop,13,14,1
2858,4,work,14,19,5
2858,5,home,19,24,5
2858,6,<ENDS>,24,24,0
2859,0,<START>,0,0,0
2859,1,home,0,6,6
2859,2,work,6,13,7
2859,3,home,13,19,6
2859,4,shop,19,20,1
2859,5,home,20,24,4
2859,6,<ENDS>,24,24,0
2860,0,<START>,0,0,0
2860,1,home,0,9,9
2860,2,work,9,15,6
2860,3,home,15,24,9
2860,4,<ENDS>,24,24,0
2861,0,<START>,0,0,0
2861,1,home,0,6,6
2861,2,work,6,7,1
2861,3,home,7,9,2
2861,4,work,9,11,2
2861,5,home,11,15,4
2861,6,work,15,17,2
2861,7,home,17,23,6
2861,8,work,23,24,1
2861,9,<ENDS>,24,24,0
2862,0,<START>,0,0,0
2862,1,home,0,8,8
2862,2,work,8,14,6
2862,3,home,14,20,6
2862,4,shop,20,21,1
2862,5,home,21,24,3
2862,6,<ENDS>,24,24,0
2863,0,<START>,0,0,0
2863,1,home,0,7,7
2863,2,work,7,15,8
2863,3,shop,15,16,1
2863,4,home,16,21,5
2863,5,work,21,22,1
2863,6,home,22,24,2
2863,7,<ENDS>,24,24,0
2864,0,<START>,0,0,0
2864,1,home,0,8,8
2864,2,work,8,15,7
2864,3,home,15,24,9
2864,4,<ENDS>,24,24,0
2865,0,<START>,0,0,0
2865,1,home,0,8,8
2865,2,work,8,16,8
2865,3,home,16,20,4
2865,4,shop,20,21,1
2865,5,home,21,24,3
2865,6,<ENDS>,24,24,0
2866,0,<START>,0,0,0
2866,1,home,0,6,6
2866,2,shop,6,7,1
2866,3,home,7,9,2
2866,4,education,9,11,2
2866,5,home,11,20,9
2866,6,shop,20,21,1
2866,7,home,21,24,3
2866,8,<ENDS>,24,24,0
2867,0,<START>,0,0,0
2867,1,home,0,8,8
2867,2,work,8,16,8
2867,3,home,16,21,5
2867,4,shop,21,22,1
2867,5,home,22,24,2
2867,6,<ENDS>,24,24,0
2868,0,<START>,0,0,0
2868,1,home,0,6,6
2868,2,shop,6,7,1
2868,3,home,7,10,3
2868,4,education,10,13,3
2868,5,home,13,20,7
2868,6,shop,20,21,1
2868,7,home,21,24,3
2868,8,<ENDS>,24,24,0
2869,0,<START>,0,0,0
2869,1,home,0,6,6
2869,2,work,6,13,7
2869,3,home,13,22,9
2869,4,work,22,23,1
2869,5,home,23,24,1
2869,6,<ENDS>,24,24,0
2870,0,<START>,0,0,0
2870,1,home,0,6,6
2870,2,shop,6,7,1
2870,3,home,7,10,3
2870,4,education,10,11,1
2870,5,home,11,18,7
2870,6,shop,18,19,1
2870,7,home,19,24,5
2870,8,<ENDS>,24,24,0
2871,0,<START>,0,0,0
2871,1,home,0,8,8
2871,2,work,8,17,9
2871,3,home,17,22,5
2871,4,work,22,23,1
2871,5,home,23,24,1
2871,6,<ENDS>,24,24,0
2872,0,<START>,0,0,0
2872,1,home,0,7,7
2872,2,work,7,13,6
2872,3,home,13,24,11
2872,4,<ENDS>,24,24,0
2873,0,<START>,0,0,0
2873,1,home,0,8,8
2873,2,work,8,15,7
2873,3,home,15,24,9
2873,4,<ENDS>,24,24,0
2874,0,<START>,0,0,0
2874,1,home,0,6,6
2874,2,shop,6,7,1
2874,3,home,7,10,3
2874,4,education,10,12,2
2874,5,home,12,18,6
2874,6,shop,18,20,2
2874,7,home,20,24,4
2874,8,<ENDS>,24,24,0
2875,0,<START>,0,0,0
2875,1,home,0,6,6
2875,2,work,6,13,7
2875,3,home,13,18,5
2875,4,work,18,20,2
2875,5,home,20,24,4
2875,6,<ENDS>,24,24,0
2876,0,<START>,0,0,0
2876,1,home,0,8,8
2876,2,work,8,15,7
2876,3,home,15,22,7
2876,4,work,22,23,1
2876,5,home,23,24,1
2876,6,<ENDS>,24,24,0
2877,0,<START>,0,0,0
2877,1,home,0,7,7
2877,2,work,7,8,1
2877,3,home,8,12,4
2877,4,work,12,13,1
2877,5,home,13,21,8
2877,6,work,21,22,1
2877,7,home,22,24,2
2877,8,<ENDS>,24,24,0
2878,0,<START>,0,0,0
2878,1,home,0,9,9
2878,2,work,9,15,6
2878,3,home,15,24,9
2878,4,<ENDS>,24,24,0
2879,0,<START>,0,0,0
2879,1,home,0,7,7
2879,2,work,7,14,7
2879,3,home,14,24,10
2879,4,<ENDS>,24,24,0
2880,0,<START>,0,0,0
2880,1,home,0,6,6
2880,2,work,6,8,2
2880,3,home,8,14,6
2880,4,work,14,16,2
2880,5,home,16,22,6
2880,6,work,22,23,1
2880,7,home,23,24,1
2880,8,<ENDS>,24,24,0
2881,0,<START>,0,0,0
2881,1,home,0,6,6
2881,2,work,6,13,7
2881,3,home,13,22,9
2881,4,work,22,23,1
2881,5,home,23,24,1
2881,6,<ENDS>,24,24,0
2882,0,<START>,0,0,0
2882,1,home,0,6,6
2882,2,shop,6,7,1
2882,3,home,7,9,2
2882,4,education,9,12,3
2882,5,home,12,18,6
2882,6,shop,18,19,1
2882,7,home,19,24,5
2882,8,<ENDS>,24,24,0
2883,0,<START>,0,0,0
2883,1,home,0,6,6
2883,2,work,6,13,7
2883,3,home,13,17,4
2883,4,work,17,20,3
2883,5,home,20,24,4
2883,6,<ENDS>,24,24,0
2884,0,<START>,0,0,0
2884,1,home,0,8,8
2884,2,work,8,14,6
2884,3,home,14,24,10
2884,4,<ENDS>,24,24,0
2885,0,<START>,0,0,0
2885,1,home,0,6,6
2885,2,shop,6,7,1
2885,3,home,7,9,2
2885,4,education,9,12,3
2885,5,home,12,20,8
2885,6,shop,20,21,1
2885,7,home,21,24,3
2885,8,<ENDS>,24,24,0
2886,0,<START>,0,0,0
2886,1,home,0,6,6
2886,2,work,6,13,7
2886,3,home,13,23,10
2886,4,work,23,24,1
2886,5,<ENDS>,24,24,0
2887,0,<START>,0,0,0
2887,1,home,0,8,8
2887,2,education,8,11,3
2887,3,home,11,16,5
2887,4,shop,16,17,1
2887,5,home,17,24,7
2887,6,<ENDS>,24,24,0
2888,0,<START>,0,0,0
2888,1,home,0,7,7
2888,2,shop,7,8,1
2888,3,education,8,12,4
2888,4,shop,12,13,1
2888,5,home,13,20,7
2888,6,shop,20,21,1
2888,7,home,21,24,3
2888,8,<ENDS>,24,24,0
2889,0,<START>,0,0,0
2889,1,home,0,8,8
2889,2,work,8,15,7
2889,3,home,15,21,6
2889,4,work,21,22,1
2889,5,home,22,24,2
2889,6,<ENDS>,24,24,0
2890,0,<START>,0,0,0
2890,1,home,0,6,6
2890,2,shop,6,7,1
2890,3,home,7,10,3
2890,4,education,10,11,1
2890,5,home,11,18,7
2890,6,shop,18,19,1
2890,7,home,19,24,5
2890,8,<ENDS>,24,24,0
2891,0,<START>,0,0,0
2891,1,home,0,8,8
2891,2,work,8,15,7
2891,3,home,15,23,8
2891,4,work,23,24,1
2891,5,<ENDS>,24,24,0
2892,0,<START>,0,0,0
2892,1,home,0,7,7
2892,2,work,7,13,6
2892,3,shop,13,14,1
2892,4,work,14,19,5
2892,5,home,19,24,5
2892,6,<ENDS>,24,24,0
2893,0,<START>,0,0,0
2893,1,home,0,7,7
2893,2,shop,7,8,1
2893,3,education,8,12,4
2893,4,shop,12,14,2
2893,5,education,14,16,2
2893,6,home,16,24,8
2893,7,<ENDS>,24,24,0
2894,0,<START>,0,0,0
2894,1,home,0,8,8
2894,2,education,8,11,3
2894,3,home,11,18,7
2894,4,shop,18,20,2
2894,5,home,20,24,4
2894,6,<ENDS>,24,24,0
2895,0,<START>,0,0,0
2895,1,home,0,7,7
2895,2,work,7,13,6
2895,3,home,13,17,4
2895,4,work,17,20,3
2895,5,home,20,24,4
2895,6,<ENDS>,24,24,0
2896,0,<START>,0,0,0
2896,1,home,0,7,7
2896,2,work,7,14,7
2896,3,home,14,18,4
2896,4,work,18,20,2
2896,5,home,20,24,4
2896,6,<ENDS>,24,24,0
2897,0,<START>,0,0,0
2897,1,home,0,7,7
2897,2,work,7,14,7
2897,3,shop,14,15,1
2897,4,home,15,24,9
2897,5,<ENDS>,24,24,0
2898,0,<START>,0,0,0
2898,1,home,0,6,6
2898,2,shop,6,7,1
2898,3,home,7,9,2
2898,4,education,9,12,3
2898,5,home,12,19,7
2898,6,shop,19,21,2
2898,7,home,21,24,3
2898,8,<ENDS>,24,24,0
2899,0,<START>,0,0,0
2899,1,home,0,9,9
2899,2,work,9,16,7
2899,3,home,16,22,6
2899,4,work,22,23,1
2899,5,home,23,24,1
2899,6,<ENDS>,24,24,0
2900,0,<START>,0,0,0
2900,1,home,0,6,6
2900,2,work,6,13,7
2900,3,home,13,18,5
2900,4,work,18,20,2
2900,5,home,20,24,4
2900,6,<ENDS>,24,24,0
2901,0,<START>,0,0,0
2901,1,home,0,6,6
2901,2,work,6,13,7
2901,3,home,13,24,11
2901,4,<ENDS>,24,24,0
2902,0,<START>,0,0,0
2902,1,home,0,9,9
2902,2,work,9,16,7
2902,3,shop,16,17,1
2902,4,home,17,24,7
2902,5,<ENDS>,24,24,0
2903,0,<START>,0,0,0
2903,1,home,0,8,8
2903,2,shop,8,9,1
2903,3,work,9,16,7
2903,4,home,16,24,8
2903,5,<ENDS>,24,24,0
2904,0,<START>,0,0,0
2904,1,home,0,8,8
2904,2,work,8,14,6
2904,3,home,14,24,10
2904,4,<ENDS>,24,24,0
2905,0,<START>,0,0,0
2905,1,home,0,6,6
2905,2,work,6,13,7
2905,3,shop,13,14,1
2905,4,work,14,19,5
2905,5,home,19,24,5
2905,6,<ENDS>,24,24,0
2906,0,<START>,0,0,0
2906,1,home,0,8,8
2906,2,education,8,12,4
2906,3,home,12,18,6
2906,4,shop,18,19,1
2906,5,home,19,24,5
2906,6,<ENDS>,24,24,0
2907,0,<START>,0,0,0
2907,1,home,0,6,6
2907,2,shop,6,7,1
2907,3,home,7,12,5
2907,4,education,12,16,4
2907,5,home,16,24,8
2907,6,<ENDS>,24,24,0
2908,0,<START>,0,0,0
2908,1,home,0,8,8
2908,2,work,8,15,7
2908,3,home,15,23,8
2908,4,work,23,24,1
2908,5,<ENDS>,24,24,0
2909,0,<START>,0,0,0
2909,1,home,0,8,8
2909,2,education,8,11,3
2909,3,home,11,18,7
2909,4,shop,18,19,1
2909,5,home,19,24,5
2909,6,<ENDS>,24,24,0
2910,0,<START>,0,0,0
2910,1,home,0,7,7
2910,2,work,7,13,6
2910,3,home,13,24,11
2910,4,<ENDS>,24,24,0
2911,0,<START>,0,0,0
2911,1,home,0,6,6
2911,2,work,6,13,7
2911,3,home,13,17,4
2911,4,work,17,19,2
2911,5,home,19,24,5
2911,6,<ENDS>,24,24,0
2912,0,<START>,0,0,0
2912,1,home,0,8,8
2912,2,work,8,15,7
2912,3,shop,15,16,1
2912,4,home,16,22,6
2912,5,work,22,23,1
2912,6,home,23,24,1
2912,7,<ENDS>,24,24,0
2913,0,<START>,0,0,0
2913,1,home,0,6,6
2913,2,shop,6,7,1
2913,3,home,7,9,2
2913,4,education,9,12,3
2913,5,home,12,20,8
2913,6,shop,20,21,1
2913,7,home,21,24,3
2913,8,<ENDS>,24,24,0
2914,0,<START>,0,0,0
2914,1,home,0,8,8
2914,2,work,8,14,6
2914,3,shop,14,15,1
2914,4,home,15,24,9
2914,5,<ENDS>,24,24,0
2915,0,<START>,0,0,0
2915,1,home,0,7,7
2915,2,education,7,11,4
2915,3,home,11,18,7
2915,4,shop,18,20,2
2915,5,home,20,24,4
2915,6,<ENDS>,24,24,0
2916,0,<START>,0,0,0
2916,1,home,0,6,6
2916,2,work,6,8,2
2916,3,home,8,14,6
2916,4,work,14,17,3
2916,5,home,17,24,7
2916,6,<ENDS>,24,24,0
2917,0,<START>,0,0,0
2917,1,home,0,8,8
2917,2,shop,8,9,1
2917,3,work,9,15,6
2917,4,home,15,24,9
2917,5,<ENDS>,24,24,0
2918,0,<START>,0,0,0
2918,1,home,0,6,6
2918,2,shop,6,7,1
2918,3,home,7,13,6
2918,4,education,13,16,3
2918,5,home,16,24,8
2918,6,<ENDS>,24,24,0
2919,0,<START>,0,0,0
2919,1,home,0,7,7
2919,2,work,7,13,6
2919,3,home,13,17,4
2919,4,work,17,20,3
2919,5,home,20,24,4
2919,6,<ENDS>,24,24,0
2920,0,<START>,0,0,0
2920,1,home,0,7,7
2920,2,work,7,13,6
2920,3,home,13,17,4
2920,4,work,17,20,3
2920,5,home,20,24,4
2920,6,<ENDS>,24,24,0
2921,0,<START>,0,0,0
2921,1,home,0,7,7
2921,2,shop,7,8,1
2921,3,home,8,16,8
2921,4,work,16,20,4
2921,5,home,20,24,4
2921,6,<ENDS>,24,24,0
2922,0,<START>,0,0,0
2922,1,home,0,6,6
2922,2,work,6,13,7
2922,3,shop,13,14,1
2922,4,home,14,24,10
2922,5,<ENDS>,24,24,0
2923,0,<START>,0,0,0
2923,1,home,0,8,8
2923,2,work,8,15,7
2923,3,home,15,24,9
2923,4,<ENDS>,24,24,0
2924,0,<START>,0,0,0
2924,1,home,0,7,7
2924,2,education,7,11,4
2924,3,home,11,17,6
2924,4,shop,17,19,2
2924,5,home,19,24,5
2924,6,<ENDS>,24,24,0
2925,0,<START>,0,0,0
2925,1,home,0,7,7
2925,2,work,7,14,7
2925,3,home,14,17,3
2925,4,work,17,19,2
2925,5,home,19,24,5
2925,6,<ENDS>,24,24,0
2926,0,<START>,0,0,0
2926,1,home,0,7,7
2926,2,work,7,13,6
2926,3,shop,13,14,1
2926,4,work,14,19,5
2926,5,home,19,24,5
2926,6,<ENDS>,24,24,0
2927,0,<START>,0,0,0
2927,1,home,0,7,7
2927,2,shop,7,8,1
2927,3,home,8,12,4
2927,4,education,12,16,4
2927,5,home,16,23,7
2927,6,work,23,24,1
2927,7,<ENDS>,24,24,0
2928,0,<START>,0,0,0
2928,1,home,0,7,7
2928,2,education,7,11,4
2928,3,home,11,14,3
2928,4,education,14,16,2
2928,5,shop,16,17,1
2928,6,home,17,24,7
2928,7,<ENDS>,24,24,0
2929,0,<START>,0,0,0
2929,1,home,0,7,7
2929,2,work,7,13,6
2929,3,home,13,20,7
2929,4,shop,20,21,1
2929,5,home,21,24,3
2929,6,<ENDS>,24,24,0
2930,0,<START>,0,0,0
2930,1,home,0,7,7
2930,2,work,7,13,6
2930,3,home,13,24,11
2930,4,<ENDS>,24,24,0
2931,0,<START>,0,0,0
2931,1,home,0,6,6
2931,2,work,6,13,7
2931,3,shop,13,14,1
2931,4,home,14,24,10
2931,5,<ENDS>,24,24,0
2932,0,<START>,0,0,0
2932,1,home,0,6,6
2932,2,work,6,13,7
2932,3,shop,13,14,1
2932,4,home,14,24,10
2932,5,<ENDS>,24,24,0
2933,0,<START>,0,0,0
2933,1,home,0,8,8
2933,2,education,8,12,4
2933,3,shop,12,13,1
2933,4,work,13,19,6
2933,5,home,19,24,5
2933,6,<ENDS>,24,24,0
2934,0,<START>,0,0,0
2934,1,home,0,6,6
2934,2,work,6,13,7
2934,3,home,13,19,6
2934,4,shop,19,20,1
2934,5,home,20,24,4
2934,6,<ENDS>,24,24,0
2935,0,<START>,0,0,0
2935,1,home,0,8,8
2935,2,education,8,12,4
2935,3,home,12,16,4
2935,4,work,16,20,4
2935,5,home,20,23,3
2935,6,work,23,24,1
2935,7,<ENDS>,24,24,0
2936,0,<START>,0,0,0
2936,1,home,0,7,7
2936,2,work,7,13,6
2936,3,shop,13,14,1
2936,4,home,14,18,4
2936,5,work,18,20,2
2936,6,home,20,24,4
2936,7,<ENDS>,24,24,0
2937,0,<START>,0,0,0
2937,1,home,0,8,8
2937,2,work,8,15,7
2937,3,home,15,24,9
2937,4,<ENDS>,24,24,0
2938,0,<START>,0,0,0
2938,1,home,0,7,7
2938,2,work,7,13,6
2938,3,shop,13,14,1
2938,4,work,14,19,5
2938,5,home,19,24,5
2938,6,<ENDS>,24,24,0
2939,0,<START>,0,0,0
2939,1,home,0,6,6
2939,2,work,6,13,7
2939,3,home,13,24,11
2939,4,<ENDS>,24,24,0
2940,0,<START>,0,0,0
2940,1,home,0,6,6
2940,2,work,6,13,7
2940,3,shop,13,14,1
2940,4,work,14,19,5
2940,5,home,19,24,5
2940,6,<ENDS>,24,24,0
2941,0,<START>,0,0,0
2941,1,home,0,7,7
2941,2,education,7,11,4
2941,3,home,11,17,6
2941,4,shop,17,18,1
2941,5,home,18,24,6
2941,6,<ENDS>,24,24,0
2942,0,<START>,0,0,0
2942,1,home,0,8,8
2942,2,education,8,12,4
2942,3,home,12,21,9
2942,4,work,21,22,1
2942,5,home,22,24,2
2942,6,<ENDS>,24,24,0
2943,0,<START>,0,0,0
2943,1,home,0,7,7
2943,2,work,7,9,2
2943,3,home,9,16,7
2943,4,work,16,18,2
2943,5,home,18,24,6
2943,6,<ENDS>,24,24,0
2944,0,<START>,0,0,0
2944,1,home,0,9,9
2944,2,work,9,16,7
2944,3,home,16,21,5
2944,4,shop,21,22,1
2944,5,home,22,24,2
2944,6,<ENDS>,24,24,0
2945,0,<START>,0,0,0
2945,1,home,0,7,7
2945,2,work,7,13,6
2945,3,home,13,17,4
2945,4,work,17,20,3
2945,5,home,20,24,4
2945,6,<ENDS>,24,24,0
2946,0,<START>,0,0,0
2946,1,home,0,7,7
2946,2,work,7,14,7
2946,3,home,14,21,7
2946,4,work,21,22,1
2946,5,home,22,24,2
2946,6,<ENDS>,24,24,0
2947,0,<START>,0,0,0
2947,1,home,0,6,6
2947,2,shop,6,7,1
2947,3,home,7,13,6
2947,4,education,13,17,4
2947,5,shop,17,18,1
2947,6,home,18,24,6
2947,7,<ENDS>,24,24,0
2948,0,<START>,0,0,0
2948,1,home,0,7,7
2948,2,work,7,14,7
2948,3,shop,14,15,1
2948,4,work,15,19,4
2948,5,home,19,24,5
2948,6,<ENDS>,24,24,0
2949,0,<START>,0,0,0
2949,1,home,0,9,9
2949,2,work,9,16,7
2949,3,shop,16,17,1
2949,4,home,17,24,7
2949,5,<ENDS>,24,24,0
2950,0,<START>,0,0,0
2950,1,home,0,8,8
2950,2,work,8,14,6
2950,3,home,14,24,10
2950,4,<ENDS>,24,24,0
2951,0,<START>,0,0,0
2951,1,home,0,7,7
2951,2,work,7,14,7
2951,3,home,14,18,4
2951,4,shop,18,19,1
2951,5,home,19,24,5
2951,6,<ENDS>,24,24,0
2952,0,<START>,0,0,0
2952,1,home,0,8,8
2952,2,work,8,15,7
2952,3,shop,15,16,1
2952,4,home,16,24,8
2952,5,<ENDS>,24,24,0
2953,0,<START>,0,0,0
2953,1,home,0,8,8
2953,2,work,8,15,7
2953,3,home,15,22,7
2953,4,work,22,23,1
2953,5,home,23,24,1
2953,6,<ENDS>,24,24,0
2954,0,<START>,0,0,0
2954,1,home,0,7,7
2954,2,work,7,14,7
2954,3,home,14,24,10
2954,4,<ENDS>,24,24,0
2955,0,<START>,0,0,0
2955,1,home,0,6,6
2955,2,work,6,8,2
2955,3,home,8,14,6
2955,4,work,14,16,2
2955,5,home,16,24,8
2955,6,<ENDS>,24,24,0
2956,0,<START>,0,0,0
2956,1,home,0,7,7
2956,2,work,7,14,7
2956,3,home,14,24,10
2956,4,<ENDS>,24,24,0
2957,0,<START>,0,0,0
2957,1,home,0,7,7
2957,2,work,7,13,6
2957,3,home,13,17,4
2957,4,work,17,20,3
2957,5,home,20,24,4
2957,6,<ENDS>,24,24,0
2958,0,<START>,0,0,0
2958,1,home,0,8,8
2958,2,education,8,11,3
2958,3,home,11,14,3
2958,4,education,14,16,2
2958,5,shop,16,17,1
2958,6,home,17,24,7
2958,7,<ENDS>,24,24,0
2959,0,<START>,0,0,0
2959,1,home,0,6,6
2959,2,work,6,8,2
2959,3,home,8,12,4
2959,4,work,12,14,2
2959,5,home,14,21,7
2959,6,shop,21,22,1
2959,7,home,22,24,2
2959,8,<ENDS>,24,24,0
2960,0,<START>,0,0,0
2960,1,home,0,6,6
2960,2,shop,6,7,1
2960,3,home,7,13,6
2960,4,education,13,16,3
2960,5,home,16,24,8
2960,6,<ENDS>,24,24,0
2961,0,<START>,0,0,0
2961,1,work,0,8,8
2961,2,shop,8,9,1
2961,3,work,9,15,6
2961,4,home,15,24,9
2961,5,<ENDS>,24,24,0
2962,0,<START>,0,0,0
2962,1,home,0,6,6
2962,2,shop,6,7,1
2962,3,home,7,11,4
2962,4,education,11,12,1
2962,5,home,12,20,8
2962,6,shop,20,21,1
2962,7,home,21,24,3
2962,8,<ENDS>,24,24,0
2963,0,<START>,0,0,0
2963,1,home,0,6,6
2963,2,shop,6,7,1
2963,3,home,7,11,4
2963,4,work,11,19,8
2963,5,home,19,24,5
2963,6,<ENDS>,24,24,0
2964,0,<START>,0,0,0
2964,1,home,0,7,7
2964,2,education,7,11,4
2964,3,home,11,18,7
2964,4,shop,18,20,2
2964,5,home,20,24,4
2964,6,<ENDS>,24,24,0
2965,0,<START>,0,0,0
2965,1,home,0,7,7
2965,2,work,7,14,7
2965,3,home,14,18,4
2965,4,shop,18,19,1
2965,5,home,19,24,5
2965,6,<ENDS>,24,24,0
2966,0,<START>,0,0,0
2966,1,home,0,6,6
2966,2,shop,6,7,1
2966,3,work,7,13,6
2966,4,home,13,20,7
2966,5,shop,20,21,1
2966,6,home,21,24,3
2966,7,<ENDS>,24,24,0
2967,0,<START>,0,0,0
2967,1,home,0,7,7
2967,2,work,7,13,6
2967,3,shop,13,14,1
2967,4,home,14,22,8
2967,5,work,22,23,1
2967,6,home,23,24,1
2967,7,<ENDS>,24,24,0
2968,0,<START>,0,0,0
2968,1,home,0,7,7
2968,2,shop,7,8,1
2968,3,work,8,15,7
2968,4,home,15,21,6
2968,5,work,21,22,1
2968,6,home,22,24,2
2968,7,<ENDS>,24,24,0
2969,0,<START>,0,0,0
2969,1,home,0,7,7
2969,2,education,7,13,6
2969,3,shop,13,15,2
2969,4,home,15,24,9
2969,5,<ENDS>,24,24,0
2970,0,<START>,0,0,0
2970,1,home,0,9,9
2970,2,education,9,11,2
2970,3,home,11,24,13
2970,4,<ENDS>,24,24,0
2971,0,<START>,0,0,0
2971,1,home,0,6,6
2971,2,work,6,13,7
2971,3,home,13,17,4
2971,4,work,17,20,3
2971,5,home,20,24,4
2971,6,<ENDS>,24,24,0
2972,0,<START>,0,0,0
2972,1,home,0,8,8
2972,2,education,8,11,3
2972,3,home,11,24,13
2972,4,<ENDS>,24,24,0
2973,0,<START>,0,0,0
2973,1,home,0,7,7
2973,2,work,7,14,7
2973,3,home,14,18,4
2973,4,work,18,20,2
2973,5,home,20,24,4
2973,6,<ENDS>,24,24,0
2974,0,<START>,0,0,0
2974,1,home,0,6,6
2974,2,work,6,8,2
2974,3,home,8,9,1
2974,4,work,9,11,2
2974,5,home,11,15,4
2974,6,work,15,18,3
2974,7,home,18,24,6
2974,8,<ENDS>,24,24,0
2975,0,<START>,0,0,0
2975,1,home,0,7,7
2975,2,work,7,9,2
2975,3,home,9,15,6
2975,4,work,15,18,3
2975,5,home,18,24,6
2975,6,<ENDS>,24,24,0
2976,0,<START>,0,0,0
2976,1,home,0,7,7
2976,2,work,7,14,7
2976,3,shop,14,15,1
2976,4,work,15,19,4
2976,5,home,19,24,5
2976,6,<ENDS>,24,24,0
2977,0,<START>,0,0,0
2977,1,home,0,8,8
2977,2,work,8,15,7
2977,3,home,15,20,5
2977,4,shop,20,21,1
2977,5,home,21,24,3
2977,6,<ENDS>,24,24,0
2978,0,<START>,0,0,0
2978,1,home,0,6,6
2978,2,work,6,13,7
2978,3,home,13,24,11
2978,4,<ENDS>,24,24,0
2979,0,<START>,0,0,0
2979,1,home,0,8,8
2979,2,work,8,15,7
2979,3,home,15,23,8
2979,4,work,23,24,1
2979,5,<ENDS>,24,24,0
2980,0,<START>,0,0,0
2980,1,home,0,7,7
2980,2,work,7,14,7
2980,3,shop,14,15,1
2980,4,home,15,24,9
2980,5,<ENDS>,24,24,0
2981,0,<START>,0,0,0
2981,1,home,0,7,7
2981,2,work,7,9,2
2981,3,home,9,15,6
2981,4,work,15,17,2
2981,5,home,17,24,7
2981,6,<ENDS>,24,24,0
2982,0,<START>,0,0,0
2982,1,home,0,7,7
2982,2,work,7,13,6
2982,3,home,13,24,11
2982,4,<ENDS>,24,24,0
2983,0,<START>,0,0,0
2983,1,home,0,8,8
2983,2,work,8,14,6
2983,3,home,14,24,10
2983,4,<ENDS>,24,24,0
2984,0,<START>,0,0,0
2984,1,home,0,7,7
2984,2,work,7,13,6
2984,3,shop,13,14,1
2984,4,work,14,20,6
2984,5,home,20,24,4
2984,6,<ENDS>,24,24,0
2985,0,<START>,0,0,0
2985,1,home,0,7,7
2985,2,work,7,14,7
2985,3,shop,14,15,1
2985,4,home,15,24,9
2985,5,<ENDS>,24,24,0
2986,0,<START>,0,0,0
2986,1,home,0,7,7
2986,2,work,7,15,8
2986,3,home,15,21,6
2986,4,work,21,22,1
2986,5,home,22,24,2
2986,6,<ENDS>,24,24,0
2987,0,<START>,0,0,0
2987,1,home,0,8,8
2987,2,work,8,15,7
2987,3,shop,15,16,1
2987,4,work,16,20,4
2987,5,home,20,24,4
2987,6,<ENDS>,24,24,0
2988,0,<START>,0,0,0
2988,1,home,0,8,8
2988,2,work,8,14,6
2988,3,shop,14,15,1
2988,4,home,15,24,9
2988,5,<ENDS>,24,24,0
2989,0,<START>,0,0,0
2989,1,home,0,6,6
2989,2,shop,6,7,1
2989,3,home,7,9,2
2989,4,education,9,11,2
2989,5,home,11,18,7
2989,6,shop,18,20,2
2989,7,home,20,24,4
2989,8,<ENDS>,24,24,0
2990,0,<START>,0,0,0
2990,1,home,0,8,8
2990,2,work,8,13,5
2990,3,home,13,16,3
2990,4,work,16,20,4
2990,5,home,20,24,4
2990,6,<ENDS>,24,24,0
2991,0,<START>,0,0,0
2991,1,home,0,7,7
2991,2,work,7,14,7
2991,3,home,14,24,10
2991,4,<ENDS>,24,24,0
2992,0,<START>,0,0,0
2992,1,home,0,7,7
2992,2,work,7,13,6
2992,3,home,13,24,11
2992,4,<ENDS>,24,24,0
2993,0,<START>,0,0,0
2993,1,home,0,8,8
2993,2,work,8,15,7
2993,3,home,15,24,9
2993,4,<ENDS>,24,24,0
2994,0,<START>,0,0,0
2994,1,home,0,7,7
2994,2,shop,7,9,2
2994,3,education,9,13,4
2994,4,home,13,20,7
2994,5,shop,20,21,1
2994,6,home,21,24,3
2994,7,<ENDS>,24,24,0
2995,0,<START>,0,0,0
2995,1,home,0,6,6
2995,2,work,6,7,1
2995,3,home,7,13,6
2995,4,work,13,16,3
2995,5,home,16,22,6
2995,6,work,22,23,1
2995,7,home,23,24,1
2995,8,<ENDS>,24,24,0
2996,0,<START>,0,0,0
2996,1,home,0,7,7
2996,2,education,7,11,4
2996,3,home,11,17,6
2996,4,shop,17,18,1
2996,5,home,18,24,6
2996,6,<ENDS>,24,24,0
2997,0,<START>,0,0,0
2997,1,home,0,6,6
2997,2,shop,6,7,1
2997,3,home,7,9,2
2997,4,education,9,13,4
2997,5,shop,13,15,2
2997,6,home,15,19,4
2997,7,shop,19,21,2
2997,8,home,21,24,3
2997,9,<ENDS>,24,24,0
2998,0,<START>,0,0,0
2998,1,home,0,7,7
2998,2,work,7,13,6
2998,3,home,13,17,4
2998,4,work,17,20,3
2998,5,home,20,24,4
2998,6,<ENDS>,24,24,0
2999,0,<START>,0,0,0
2999,1,home,0,8,8
2999,2,shop,8,9,1
2999,3,home,9,11,2
2999,4,work,11,14,3
2999,5,shop,14,15,1
2999,6,home,15,23,8
2999,7,work,23,24,1
2999,8,<ENDS>,24,24,0
3000,0,<START>,0,0,0
3000,1,home,0,7,7
3000,2,work,7,9,2
3000,3,home,9,14,5
3000,4,work,14,17,3
3000,5,home,17,24,7
3000,6,<ENDS>,24,24,0
3001,0,<START>,0,0,0
3001,1,home,0,6,6
3001,2,work,6,13,7
3001,3,home,13,18,5
3001,4,work,18,20,2
3001,5,home,20,24,4
3001,6,<ENDS>,24,24,0
3002,0,<START>,0,0,0
3002,1,home,0,7,7
3002,2,work,7,13,6
3002,3,home,13,17,4
3002,4,work,17,20,3
3002,5,home,20,24,4
3002,6,<ENDS>,24,24,0
3003,0,<START>,0,0,0
3003,1,home,0,8,8
3003,2,shop,8,9,1
3003,3,home,9,13,4
3003,4,education,13,16,3
3003,5,home,16,24,8
3003,6,<ENDS>,24,24,0
3004,0,<START>,0,0,0
3004,1,home,0,8,8
3004,2,work,8,18,10
3004,3,home,18,24,6
3004,4,<ENDS>,24,24,0
3005,0,<START>,0,0,0
3005,1,home,0,7,7
3005,2,work,7,13,6
3005,3,shop,13,14,1
3005,4,home,14,24,10
3005,5,<ENDS>,24,24,0
3006,0,<START>,0,0,0
3006,1,home,0,8,8
3006,2,work,8,15,7
3006,3,shop,15,16,1
3006,4,home,16,24,8
3006,5,<ENDS>,24,24,0
3007,0,<START>,0,0,0
3007,1,home,0,7,7
3007,2,shop,7,8,1
3007,3,education,8,12,4
3007,4,shop,12,14,2
3007,5,home,14,24,10
3007,6,<ENDS>,24,24,0
3008,0,<START>,0,0,0
3008,1,home,0,6,6
3008,2,work,6,12,6
3008,3,shop,12,13,1
3008,4,work,13,19,6
3008,5,home,19,24,5
3008,6,<ENDS>,24,24,0
3009,0,<START>,0,0,0
3009,1,home,0,6,6
3009,2,work,6,13,7
3009,3,home,13,18,5
3009,4,work,18,20,2
3009,5,home,20,24,4
3009,6,<ENDS>,24,24,0
3010,0,<START>,0,0,0
3010,1,home,0,6,6
3010,2,work,6,8,2
3010,3,home,8,13,5
3010,4,work,13,15,2
3010,5,home,15,22,7
3010,6,work,22,23,1
3010,7,home,23,24,1
3010,8,<ENDS>,24,24,0
3011,0,<START>,0,0,0
3011,1,home,0,6,6
3011,2,work,6,13,7
3011,3,home,13,18,5
3011,4,work,18,20,2
3011,5,home,20,24,4
3011,6,<ENDS>,24,24,0
3012,0,<START>,0,0,0
3012,1,home,0,6,6
3012,2,work,6,8,2
3012,3,home,8,14,6
3012,4,work,14,17,3
3012,5,home,17,23,6
3012,6,work,23,24,1
3012,7,<ENDS>,24,24,0
3013,0,<START>,0,0,0
3013,1,home,0,6,6
3013,2,shop,6,7,1
3013,3,home,7,12,5
3013,4,education,12,15,3
3013,5,home,15,21,6
3013,6,work,21,22,1
3013,7,home,22,24,2
3013,8,<ENDS>,24,24,0
3014,0,<START>,0,0,0
3014,1,home,0,8,8
3014,2,work,8,15,7
3014,3,home,15,21,6
3014,4,work,21,22,1
3014,5,home,22,24,2
3014,6,<ENDS>,24,24,0
3015,0,<START>,0,0,0
3015,1,home,0,7,7
3015,2,shop,7,8,1
3015,3,education,8,11,3
3015,4,home,11,15,4
3015,5,shop,15,17,2
3015,6,home,17,24,7
3015,7,<ENDS>,24,24,0
3016,0,<START>,0,0,0
3016,1,home,0,6,6
3016,2,work,6,8,2
3016,3,home,8,14,6
3016,4,work,14,16,2
3016,5,home,16,21,5
3016,6,work,21,22,1
3016,7,home,22,24,2
3016,8,<ENDS>,24,24,0
3017,0,<START>,0,0,0
3017,1,home,0,7,7
3017,2,work,7,14,7
3017,3,home,14,24,10
3017,4,<ENDS>,24,24,0
3018,0,<START>,0,0,0
3018,1,home,0,9,9
3018,2,education,9,11,2
3018,3,home,11,19,8
3018,4,shop,19,20,1
3018,5,home,20,24,4
3018,6,<ENDS>,24,24,0
3019,0,<START>,0,0,0
3019,1,home,0,8,8
3019,2,education,8,11,3
3019,3,shop,11,12,1
3019,4,work,12,19,7
3019,5,home,19,24,5
3019,6,<ENDS>,24,24,0
3020,0,<START>,0,0,0
3020,1,home,0,7,7
3020,2,shop,7,8,1
3020,3,education,8,11,3
3020,4,home,11,20,9
3020,5,shop,20,21,1
3020,6,home,21,24,3
3020,7,<ENDS>,24,24,0
3021,0,<START>,0,0,0
3021,1,home,0,7,7
3021,2,shop,7,8,1
3021,3,education,8,12,4
3021,4,home,12,20,8
3021,5,shop,20,21,1
3021,6,home,21,24,3
3021,7,<ENDS>,24,24,0
3022,0,<START>,0,0,0
3022,1,home,0,8,8
3022,2,work,8,14,6
3022,3,home,14,18,4
3022,4,work,18,20,2
3022,5,home,20,24,4
3022,6,<ENDS>,24,24,0
3023,0,<START>,0,0,0
3023,1,home,0,6,6
3023,2,work,6,13,7
3023,3,shop,13,14,1
3023,4,home,14,24,10
3023,5,<ENDS>,24,24,0
3024,0,<START>,0,0,0
3024,1,home,0,7,7
3024,2,shop,7,9,2
3024,3,education,9,12,3
3024,4,home,12,18,6
3024,5,shop,18,19,1
3024,6,home,19,24,5
3024,7,<ENDS>,24,24,0
3025,0,<START>,0,0,0
3025,1,home,0,7,7
3025,2,education,7,11,4
3025,3,home,11,18,7
3025,4,shop,18,19,1
3025,5,home,19,24,5
3025,6,<ENDS>,24,24,0
3026,0,<START>,0,0,0
3026,1,home,0,8,8
3026,2,work,8,15,7
3026,3,home,15,22,7
3026,4,work,22,23,1
3026,5,home,23,24,1
3026,6,<ENDS>,24,24,0
3027,0,<START>,0,0,0
3027,1,home,0,7,7
3027,2,work,7,13,6
3027,3,shop,13,14,1
3027,4,education,14,17,3
3027,5,home,17,23,6
3027,6,work,23,24,1
3027,7,<ENDS>,24,24,0
3028,0,<START>,0,0,0
3028,1,home,0,8,8
3028,2,work,8,16,8
3028,3,home,16,24,8
3028,4,<ENDS>,24,24,0
3029,0,<START>,0,0,0
3029,1,home,0,6,6
3029,2,work,6,13,7
3029,3,home,13,17,4
3029,4,work,17,20,3
3029,5,home,20,24,4
3029,6,<ENDS>,24,24,0
3030,0,<START>,0,0,0
3030,1,home,0,8,8
3030,2,work,8,14,6
3030,3,shop,14,15,1
3030,4,home,15,24,9
3030,5,<ENDS>,24,24,0
3031,0,<START>,0,0,0
3031,1,home,0,6,6
3031,2,work,6,13,7
3031,3,home,13,18,5
3031,4,shop,18,19,1
3031,5,home,19,24,5
3031,6,<ENDS>,24,24,0
3032,0,<START>,0,0,0
3032,1,home,0,6,6
3032,2,work,6,13,7
3032,3,shop,13,14,1
3032,4,work,14,19,5
3032,5,home,19,24,5
3032,6,<ENDS>,24,24,0
3033,0,<START>,0,0,0
3033,1,home,0,6,6
3033,2,work,6,9,3
3033,3,home,9,15,6
3033,4,work,15,16,1
3033,5,home,16,22,6
3033,6,work,22,23,1
3033,7,home,23,24,1
3033,8,<ENDS>,24,24,0
3034,0,<START>,0,0,0
3034,1,home,0,7,7
3034,2,shop,7,8,1
3034,3,work,8,17,9
3034,4,home,17,24,7
3034,5,<ENDS>,24,24,0
3035,0,<START>,0,0,0
3035,1,home,0,7,7
3035,2,work,7,13,6
3035,3,shop,13,14,1
3035,4,work,14,19,5
3035,5,home,19,24,5
3035,6,<ENDS>,24,24,0
3036,0,<START>,0,0,0
3036,1,home,0,8,8
3036,2,work,8,15,7
3036,3,home,15,24,9
3036,4,<ENDS>,24,24,0
3037,0,<START>,0,0,0
3037,1,home,0,6,6
3037,2,work,6,14,8
3037,3,home,14,22,8
3037,4,work,22,23,1
3037,5,home,23,24,1
3037,6,<ENDS>,24,24,0
3038,0,<START>,0,0,0
3038,1,home,0,6,6
3038,2,work,6,13,7
3038,3,shop,13,15,2
3038,4,home,15,24,9
3038,5,<ENDS>,24,24,0
3039,0,<START>,0,0,0
3039,1,home,0,7,7
3039,2,work,7,14,7
3039,3,shop,14,15,1
3039,4,home,15,24,9
3039,5,<ENDS>,24,24,0
3040,0,<START>,0,0,0
3040,1,home,0,6,6
3040,2,work,6,13,7
3040,3,home,13,24,11
3040,4,<ENDS>,24,24,0
3041,0,<START>,0,0,0
3041,1,home,0,7,7
3041,2,work,7,14,7
3041,3,shop,14,15,1
3041,4,home,15,24,9
3041,5,<ENDS>,24,24,0
3042,0,<START>,0,0,0
3042,1,home,0,6,6
3042,2,work,6,13,7
3042,3,shop,13,14,1
3042,4,home,14,24,10
3042,5,<ENDS>,24,24,0
3043,0,<START>,0,0,0
3043,1,home,0,6,6
3043,2,shop,6,7,1
3043,3,home,7,9,2
3043,4,education,9,12,3
3043,5,home,12,21,9
3043,6,shop,21,22,1
3043,7,home,22,24,2
3043,8,<ENDS>,24,24,0
3044,0,<START>,0,0,0
3044,1,home,0,8,8
3044,2,work,8,15,7
3044,3,shop,15,16,1
3044,4,home,16,21,5
3044,5,shop,21,22,1
3044,6,home,22,24,2
3044,7,<ENDS>,24,24,0
3045,0,<START>,0,0,0
3045,1,home,0,8,8
3045,2,work,8,15,7
3045,3,home,15,21,6
3045,4,work,21,22,1
3045,5,home,22,24,2
3045,6,<ENDS>,24,24,0
3046,0,<START>,0,0,0
3046,1,home,0,7,7
3046,2,work,7,13,6
3046,3,shop,13,15,2
3046,4,home,15,23,8
3046,5,work,23,24,1
3046,6,<ENDS>,24,24,0
3047,0,<START>,0,0,0
3047,1,home,0,6,6
3047,2,work,6,13,7
3047,3,shop,13,14,1
3047,4,work,14,19,5
3047,5,home,19,24,5
3047,6,<ENDS>,24,24,0
3048,0,<START>,0,0,0
3048,1,home,0,6,6
3048,2,shop,6,7,1
3048,3,home,7,13,6
3048,4,education,13,16,3
3048,5,home,16,24,8
3048,6,<ENDS>,24,24,0
3049,0,<START>,0,0,0
3049,1,home,0,7,7
3049,2,work,7,13,6
3049,3,home,13,17,4
3049,4,work,17,20,3
3049,5,home,20,24,4
3049,6,<ENDS>,24,24,0
3050,0,<START>,0,0,0
3050,1,home,0,7,7
3050,2,education,7,12,5
3050,3,home,12,20,8
3050,4,shop,20,21,1
3050,5,home,21,24,3
3050,6,<ENDS>,24,24,0
3051,0,<START>,0,0,0
3051,1,home,0,7,7
3051,2,work,7,14,7
3051,3,shop,14,15,1
3051,4,home,15,24,9
3051,5,<ENDS>,24,24,0
3052,0,<START>,0,0,0
3052,1,home,0,5,5
3052,2,work,5,12,7
3052,3,shop,12,13,1
3052,4,work,13,19,6
3052,5,home,19,24,5
3052,6,<ENDS>,24,24,0
3053,0,<START>,0,0,0
3053,1,home,0,7,7
3053,2,education,7,12,5
3053,3,home,12,20,8
3053,4,shop,20,21,1
3053,5,home,21,24,3
3053,6,<ENDS>,24,24,0
3054,0,<START>,0,0,0
3054,1,home,0,7,7
3054,2,education,7,11,4
3054,3,home,11,18,7
3054,4,shop,18,20,2
3054,5,home,20,24,4
3054,6,<ENDS>,24,24,0
3055,0,<START>,0,0,0
3055,1,home,0,6,6
3055,2,work,6,13,7
3055,3,home,13,23,10
3055,4,work,23,24,1
3055,5,<ENDS>,24,24,0
3056,0,<START>,0,0,0
3056,1,home,0,7,7
3056,2,education,7,11,4
3056,3,home,11,20,9
3056,4,shop,20,21,1
3056,5,home,21,24,3
3056,6,<ENDS>,24,24,0
3057,0,<START>,0,0,0
3057,1,home,0,6,6
3057,2,work,6,13,7
3057,3,home,13,20,7
3057,4,shop,20,21,1
3057,5,home,21,24,3
3057,6,<ENDS>,24,24,0
3058,0,<START>,0,0,0
3058,1,home,0,7,7
3058,2,shop,7,8,1
3058,3,home,8,9,1
3058,4,education,9,15,6
3058,5,home,15,23,8
3058,6,work,23,24,1
3058,7,<ENDS>,24,24,0
3059,0,<START>,0,0,0
3059,1,home,0,7,7
3059,2,shop,7,8,1
3059,3,work,8,15,7
3059,4,home,15,18,3
3059,5,work,18,20,2
3059,6,home,20,24,4
3059,7,<ENDS>,24,24,0
3060,0,<START>,0,0,0
3060,1,home,0,6,6
3060,2,work,6,13,7
3060,3,home,13,17,4
3060,4,work,17,20,3
3060,5,home,20,24,4
3060,6,<ENDS>,24,24,0
3061,0,<START>,0,0,0
3061,1,home,0,7,7
3061,2,work,7,14,7
3061,3,home,14,20,6
3061,4,shop,20,21,1
3061,5,home,21,24,3
3061,6,<ENDS>,24,24,0
3062,0,<START>,0,0,0
3062,1,home,0,7,7
3062,2,work,7,13,6
3062,3,shop,13,14,1
3062,4,work,14,19,5
3062,5,home,19,24,5
3062,6,<ENDS>,24,24,0
3063,0,<START>,0,0,0
3063,1,home,0,7,7
3063,2,work,7,13,6
3063,3,home,13,17,4
3063,4,work,17,20,3
3063,5,home,20,24,4
3063,6,<ENDS>,24,24,0
3064,0,<START>,0,0,0
3064,1,home,0,7,7
3064,2,work,7,14,7
3064,3,shop,14,15,1
3064,4,home,15,24,9
3064,5,<ENDS>,24,24,0
3065,0,<START>,0,0,0
3065,1,home,0,8,8
3065,2,work,8,14,6
3065,3,home,14,24,10
3065,4,<ENDS>,24,24,0
3066,0,<START>,0,0,0
3066,1,home,0,7,7
3066,2,work,7,14,7
3066,3,shop,14,15,1
3066,4,work,15,20,5
3066,5,home,20,24,4
3066,6,<ENDS>,24,24,0
3067,0,<START>,0,0,0
3067,1,home,0,8,8
3067,2,work,8,15,7
3067,3,home,15,21,6
3067,4,work,21,22,1
3067,5,home,22,23,1
3067,6,work,23,24,1
3067,7,<ENDS>,24,24,0
3068,0,<START>,0,0,0
3068,1,home,0,7,7
3068,2,education,7,12,5
3068,3,home,12,21,9
3068,4,shop,21,22,1
3068,5,home,22,24,2
3068,6,<ENDS>,24,24,0
3069,0,<START>,0,0,0
3069,1,home,0,7,7
3069,2,work,7,13,6
3069,3,shop,13,14,1
3069,4,work,14,19,5
3069,5,home,19,24,5
3069,6,<ENDS>,24,24,0
3070,0,<START>,0,0,0
3070,1,home,0,7,7
3070,2,shop,7,8,1
3070,3,work,8,14,6
3070,4,home,14,24,10
3070,5,<ENDS>,24,24,0
3071,0,<START>,0,0,0
3071,1,home,0,6,6
3071,2,work,6,13,7
3071,3,shop,13,14,1
3071,4,home,14,18,4
3071,5,work,18,20,2
3071,6,home,20,24,4
3071,7,<ENDS>,24,24,0
3072,0,<START>,0,0,0
3072,1,home,0,6,6
3072,2,work,6,8,2
3072,3,home,8,14,6
3072,4,work,14,17,3
3072,5,home,17,24,7
3072,6,<ENDS>,24,24,0
3073,0,<START>,0,0,0
3073,1,home,0,7,7
3073,2,work,7,14,7
3073,3,home,14,21,7
3073,4,work,21,22,1
3073,5,home,22,24,2
3073,6,<ENDS>,24,24,0
3074,0,<START>,0,0,0
3074,1,home,0,6,6
3074,2,work,6,8,2
3074,3,home,8,12,4
3074,4,work,12,14,2
3074,5,home,14,21,7
3074,6,work,21,22,1
3074,7,home,22,24,2
3074,8,<ENDS>,24,24,0
3075,0,<START>,0,0,0
3075,1,home,0,6,6
3075,2,shop,6,7,1
3075,3,work,7,14,7
3075,4,home,14,22,8
3075,5,work,22,23,1
3075,6,home,23,24,1
3075,7,<ENDS>,24,24,0
3076,0,<START>,0,0,0
3076,1,home,0,7,7
3076,2,work,7,14,7
3076,3,shop,14,15,1
3076,4,home,15,24,9
3076,5,<ENDS>,24,24,0
3077,0,<START>,0,0,0
3077,1,home,0,8,8
3077,2,work,8,15,7
3077,3,shop,15,16,1
3077,4,work,16,19,3
3077,5,home,19,24,5
3077,6,<ENDS>,24,24,0
3078,0,<START>,0,0,0
3078,1,home,0,7,7
3078,2,work,7,14,7
3078,3,home,14,24,10
3078,4,<ENDS>,24,24,0
3079,0,<START>,0,0,0
3079,1,home,0,8,8
3079,2,education,8,12,4
3079,3,home,12,20,8
3079,4,shop,20,21,1
3079,5,home,21,24,3
3079,6,<ENDS>,24,24,0
3080,0,<START>,0,0,0
3080,1,home,0,8,8
3080,2,work,8,14,6
3080,3,shop,14,15,1
3080,4,home,15,24,9
3080,5,<ENDS>,24,24,0
3081,0,<START>,0,0,0
3081,1,home,0,6,6
3081,2,work,6,13,7
3081,3,shop,13,14,1
3081,4,work,14,20,6
3081,5,home,20,24,4
3081,6,<ENDS>,24,24,0
3082,0,<START>,0,0,0
3082,1,home,0,6,6
3082,2,work,6,7,1
3082,3,home,7,11,4
3082,4,work,11,12,1
3082,5,home,12,19,7
3082,6,shop,19,20,1
3082,7,home,20,24,4
3082,8,<ENDS>,24,24,0
3083,0,<START>,0,0,0
3083,1,home,0,8,8
3083,2,work,8,15,7
3083,3,home,15,24,9
3083,4,<ENDS>,24,24,0
3084,0,<START>,0,0,0
3084,1,home,0,7,7
3084,2,work,7,14,7
3084,3,home,14,24,10
3084,4,<ENDS>,24,24,0
3085,0,<START>,0,0,0
3085,1,home,0,7,7
3085,2,shop,7,8,1
3085,3,home,8,12,4
3085,4,education,12,16,4
3085,5,home,16,24,8
3085,6,<ENDS>,24,24,0
3086,0,<START>,0,0,0
3086,1,home,0,6,6
3086,2,work,6,13,7
3086,3,home,13,18,5
3086,4,shop,18,19,1
3086,5,home,19,24,5
3086,6,<ENDS>,24,24,0
3087,0,<START>,0,0,0
3087,1,home,0,7,7
3087,2,education,7,11,4
3087,3,home,11,17,6
3087,4,shop,17,18,1
3087,5,home,18,24,6
3087,6,<ENDS>,24,24,0
3088,0,<START>,0,0,0
3088,1,home,0,7,7
3088,2,shop,7,8,1
3088,3,work,8,15,7
3088,4,home,15,24,9
3088,5,<ENDS>,24,24,0
3089,0,<START>,0,0,0
3089,1,home,0,7,7
3089,2,work,7,14,7
3089,3,home,14,18,4
3089,4,work,18,20,2
3089,5,home,20,24,4
3089,6,<ENDS>,24,24,0
3090,0,<START>,0,0,0
3090,1,home,0,7,7
3090,2,education,7,10,3
3090,3,home,10,18,8
3090,4,shop,18,20,2
3090,5,home,20,24,4
3090,6,<ENDS>,24,24,0
3091,0,<START>,0,0,0
3091,1,home,0,8,8
3091,2,work,8,15,7
3091,3,shop,15,16,1
3091,4,home,16,21,5
3091,5,shop,21,22,1
3091,6,home,22,24,2
3091,7,<ENDS>,24,24,0
3092,0,<START>,0,0,0
3092,1,home,0,6,6
3092,2,work,6,13,7
3092,3,home,13,16,3
3092,4,work,16,20,4
3092,5,home,20,24,4
3092,6,<ENDS>,24,24,0
3093,0,<START>,0,0,0
3093,1,home,0,7,7
3093,2,work,7,13,6
3093,3,home,13,24,11
3093,4,<ENDS>,24,24,0
3094,0,<START>,0,0,0
3094,1,home,0,7,7
3094,2,education,7,11,4
3094,3,home,11,18,7
3094,4,shop,18,19,1
3094,5,home,19,24,5
3094,6,<ENDS>,24,24,0
3095,0,<START>,0,0,0
3095,1,home,0,6,6
3095,2,work,6,13,7
3095,3,shop,13,14,1
3095,4,work,14,20,6
3095,5,home,20,24,4
3095,6,<ENDS>,24,24,0
3096,0,<START>,0,0,0
3096,1,home,0,8,8
3096,2,work,8,17,9
3096,3,home,17,21,4
3096,4,work,21,22,1
3096,5,home,22,24,2
3096,6,<ENDS>,24,24,0
3097,0,<START>,0,0,0
3097,1,home,0,9,9
3097,2,work,9,16,7
3097,3,home,16,24,8
3097,4,<ENDS>,24,24,0
3098,0,<START>,0,0,0
3098,1,home,0,8,8
3098,2,work,8,15,7
3098,3,home,15,22,7
3098,4,work,22,23,1
3098,5,home,23,24,1
3098,6,<ENDS>,24,24,0
3099,0,<START>,0,0,0
3099,1,home,0,7,7
3099,2,work,7,13,6
3099,3,home,13,17,4
3099,4,shop,17,18,1
3099,5,home,18,24,6
3099,6,<ENDS>,24,24,0
3100,0,<START>,0,0,0
3100,1,home,0,7,7
3100,2,shop,7,8,1
3100,3,home,8,12,4
3100,4,work,12,19,7
3100,5,home,19,24,5
3100,6,<ENDS>,24,24,0
3101,0,<START>,0,0,0
3101,1,home,0,7,7
3101,2,work,7,13,6
3101,3,home,13,24,11
3101,4,<ENDS>,24,24,0
3102,0,<START>,0,0,0
3102,1,home,0,7,7
3102,2,shop,7,8,1
3102,3,home,8,12,4
3102,4,work,12,18,6
3102,5,home,18,24,6
3102,6,<ENDS>,24,24,0
3103,0,<START>,0,0,0
3103,1,home,0,6,6
3103,2,work,6,12,6
3103,3,shop,12,13,1
3103,4,work,13,19,6
3103,5,home,19,24,5
3103,6,<ENDS>,24,24,0
3104,0,<START>,0,0,0
3104,1,home,0,6,6
3104,2,work,6,13,7
3104,3,shop,13,14,1
3104,4,home,14,24,10
3104,5,<ENDS>,24,24,0
3105,0,<START>,0,0,0
3105,1,home,0,7,7
3105,2,work,7,14,7
3105,3,shop,14,15,1
3105,4,home,15,21,6
3105,5,work,21,22,1
3105,6,home,22,24,2
3105,7,<ENDS>,24,24,0
3106,0,<START>,0,0,0
3106,1,home,0,6,6
3106,2,shop,6,7,1
3106,3,home,7,9,2
3106,4,education,9,12,3
3106,5,home,12,19,7
3106,6,shop,19,21,2
3106,7,home,21,24,3
3106,8,<ENDS>,24,24,0
3107,0,<START>,0,0,0
3107,1,home,0,8,8
3107,2,education,8,12,4
3107,3,home,12,17,5
3107,4,work,17,20,3
3107,5,home,20,24,4
3107,6,<ENDS>,24,24,0
3108,0,<START>,0,0,0
3108,1,home,0,7,7
3108,2,work,7,14,7
3108,3,home,14,22,8
3108,4,work,22,23,1
3108,5,home,23,24,1
3108,6,<ENDS>,24,24,0
3109,0,<START>,0,0,0
3109,1,home,0,7,7
3109,2,work,7,14,7
3109,3,home,14,23,9
3109,4,work,23,24,1
3109,5,<ENDS>,24,24,0
3110,0,<START>,0,0,0
3110,1,home,0,7,7
3110,2,work,7,13,6
3110,3,shop,13,14,1
3110,4,work,14,19,5
3110,5,home,19,24,5
3110,6,<ENDS>,24,24,0
3111,0,<START>,0,0,0
3111,1,home,0,7,7
3111,2,work,7,9,2
3111,3,home,9,15,6
3111,4,work,15,17,2
3111,5,home,17,24,7
3111,6,<ENDS>,24,24,0
3112,0,<START>,0,0,0
3112,1,work,0,9,9
3112,2,shop,9,10,1
3112,3,work,10,16,6
3112,4,home,16,24,8
3112,5,<ENDS>,24,24,0
3113,0,<START>,0,0,0
3113,1,home,0,8,8
3113,2,work,8,15,7
3113,3,home,15,24,9
3113,4,<ENDS>,24,24,0
3114,0,<START>,0,0,0
3114,1,home,0,6,6
3114,2,work,6,13,7
3114,3,home,13,24,11
3114,4,<ENDS>,24,24,0
3115,0,<START>,0,0,0
3115,1,home,0,7,7
3115,2,shop,7,8,1
3115,3,work,8,15,7
3115,4,home,15,24,9
3115,5,<ENDS>,24,24,0
3116,0,<START>,0,0,0
3116,1,home,0,7,7
3116,2,shop,7,9,2
3116,3,education,9,11,2
3116,4,home,11,17,6
3116,5,shop,17,18,1
3116,6,home,18,24,6
3116,7,<ENDS>,24,24,0
3117,0,<START>,0,0,0
3117,1,home,0,7,7
3117,2,education,7,10,3
3117,3,home,10,14,4
3117,4,education,14,16,2
3117,5,home,16,24,8
3117,6,<ENDS>,24,24,0
3118,0,<START>,0,0,0
3118,1,home,0,7,7
3118,2,work,7,14,7
3118,3,shop,14,15,1
3118,4,home,15,24,9
3118,5,<ENDS>,24,24,0
3119,0,<START>,0,0,0
3119,1,home,0,9,9
3119,2,work,9,14,5
3119,3,shop,14,15,1
3119,4,home,15,21,6
3119,5,work,21,22,1
3119,6,home,22,24,2
3119,7,<ENDS>,24,24,0
3120,0,<START>,0,0,0
3120,1,home,0,7,7
3120,2,shop,7,8,1
3120,3,home,8,9,1
3120,4,education,9,12,3
3120,5,shop,12,13,1
3120,6,work,13,19,6
3120,7,home,19,24,5
3120,8,<ENDS>,24,24,0
3121,0,<START>,0,0,0
3121,1,home,0,8,8
3121,2,education,8,12,4
3121,3,home,12,14,2
3121,4,work,14,20,6
3121,5,home,20,24,4
3121,6,<ENDS>,24,24,0
3122,0,<START>,0,0,0
3122,1,home,0,7,7
3122,2,shop,7,8,1
3122,3,education,8,11,3
3122,4,home,11,14,3
3122,5,education,14,16,2
3122,6,home,16,24,8
3122,7,<ENDS>,24,24,0
3123,0,<START>,0,0,0
3123,1,home,0,7,7
3123,2,education,7,11,4
3123,3,home,11,13,2
3123,4,education,13,16,3
3123,5,home,16,24,8
3123,6,<ENDS>,24,24,0
3124,0,<START>,0,0,0
3124,1,home,0,7,7
3124,2,work,7,14,7
3124,3,shop,14,15,1
3124,4,home,15,24,9
3124,5,<ENDS>,24,24,0
3125,0,<START>,0,0,0
3125,1,home,0,8,8
3125,2,work,8,14,6
3125,3,home,14,19,5
3125,4,shop,19,20,1
3125,5,home,20,24,4
3125,6,<ENDS>,24,24,0
3126,0,<START>,0,0,0
3126,1,home,0,8,8
3126,2,shop,8,10,2
3126,3,education,10,12,2
3126,4,shop,12,13,1
3126,5,home,13,20,7
3126,6,shop,20,21,1
3126,7,home,21,24,3
3126,8,<ENDS>,24,24,0
3127,0,<START>,0,0,0
3127,1,home,0,8,8
3127,2,work,8,13,5
3127,3,home,13,21,8
3127,4,work,21,22,1
3127,5,home,22,24,2
3127,6,<ENDS>,24,24,0
3128,0,<START>,0,0,0
3128,1,home,0,6,6
3128,2,work,6,8,2
3128,3,home,8,13,5
3128,4,work,13,15,2
3128,5,home,15,21,6
3128,6,work,21,22,1
3128,7,home,22,24,2
3128,8,<ENDS>,24,24,0
3129,0,<START>,0,0,0
3129,1,home,0,7,7
3129,2,shop,7,8,1
3129,3,work,8,15,7
3129,4,home,15,24,9
3129,5,<ENDS>,24,24,0
3130,0,<START>,0,0,0
3130,1,home,0,7,7
3130,2,education,7,11,4
3130,3,home,11,18,7
3130,4,shop,18,19,1
3130,5,home,19,24,5
3130,6,<ENDS>,24,24,0
3131,0,<START>,0,0,0
3131,1,home,0,6,6
3131,2,work,6,13,7
3131,3,home,13,22,9
3131,4,work,22,23,1
3131,5,home,23,24,1
3131,6,<ENDS>,24,24,0
3132,0,<START>,0,0,0
3132,1,home,0,6,6
3132,2,shop,6,7,1
3132,3,home,7,9,2
3132,4,work,9,16,7
3132,5,home,16,24,8
3132,6,<ENDS>,24,24,0
3133,0,<START>,0,0,0
3133,1,home,0,6,6
3133,2,shop,6,7,1
3133,3,work,7,13,6
3133,4,shop,13,14,1
3133,5,work,14,19,5
3133,6,home,19,24,5
3133,7,<ENDS>,24,24,0
3134,0,<START>,0,0,0
3134,1,home,0,8,8
3134,2,work,8,15,7
3134,3,home,15,24,9
3134,4,<ENDS>,24,24,0
3135,0,<START>,0,0,0
3135,1,home,0,8,8
3135,2,work,8,16,8
3135,3,home,16,24,8
3135,4,<ENDS>,24,24,0
3136,0,<START>,0,0,0
3136,1,home,0,7,7
3136,2,education,7,11,4
3136,3,home,11,14,3
3136,4,education,14,15,1
3136,5,shop,15,16,1
3136,6,home,16,20,4
3136,7,shop,20,21,1
3136,8,home,21,24,3
3136,9,<ENDS>,24,24,0
3137,0,<START>,0,0,0
3137,1,home,0,7,7
3137,2,work,7,13,6
3137,3,home,13,24,11
3137,4,<ENDS>,24,24,0
3138,0,<START>,0,0,0
3138,1,home,0,7,7
3138,2,work,7,13,6
3138,3,shop,13,14,1
3138,4,home,14,24,10
3138,5,<ENDS>,24,24,0
3139,0,<START>,0,0,0
3139,1,home,0,8,8
3139,2,work,8,14,6
3139,3,home,14,16,2
3139,4,work,16,20,4
3139,5,home,20,24,4
3139,6,<ENDS>,24,24,0
3140,0,<START>,0,0,0
3140,1,home,0,7,7
3140,2,education,7,11,4
3140,3,home,11,13,2
3140,4,education,13,16,3
3140,5,home,16,24,8
3140,6,<ENDS>,24,24,0
3141,0,<START>,0,0,0
3141,1,home,0,6,6
3141,2,work,6,8,2
3141,3,home,8,14,6
3141,4,work,14,16,2
3141,5,home,16,22,6
3141,6,work,22,23,1
3141,7,home,23,24,1
3141,8,<ENDS>,24,24,0
3142,0,<START>,0,0,0
3142,1,home,0,7,7
3142,2,work,7,13,6
3142,3,home,13,18,5
3142,4,work,18,20,2
3142,5,home,20,24,4
3142,6,<ENDS>,24,24,0
3143,0,<START>,0,0,0
3143,1,home,0,6,6
3143,2,shop,6,7,1
3143,3,home,7,10,3
3143,4,education,10,13,3
3143,5,shop,13,15,2
3143,6,home,15,21,6
3143,7,shop,21,22,1
3143,8,home,22,24,2
3143,9,<ENDS>,24,24,0
3144,0,<START>,0,0,0
3144,1,home,0,6,6
3144,2,work,6,8,2
3144,3,home,8,13,5
3144,4,work,13,15,2
3144,5,home,15,22,7
3144,6,work,22,23,1
3144,7,home,23,24,1
3144,8,<ENDS>,24,24,0
3145,0,<START>,0,0,0
3145,1,home,0,7,7
3145,2,work,7,14,7
3145,3,home,14,18,4
3145,4,work,18,20,2
3145,5,home,20,24,4
3145,6,<ENDS>,24,24,0
3146,0,<START>,0,0,0
3146,1,home,0,6,6
3146,2,shop,6,7,1
3146,3,work,7,13,6
3146,4,home,13,17,4
3146,5,work,17,20,3
3146,6,home,20,24,4
3146,7,<ENDS>,24,24,0
3147,0,<START>,0,0,0
3147,1,home,0,6,6
3147,2,work,6,13,7
3147,3,shop,13,14,1
3147,4,work,14,20,6
3147,5,home,20,24,4
3147,6,<ENDS>,24,24,0
3148,0,<START>,0,0,0
3148,1,home,0,6,6
3148,2,work,6,8,2
3148,3,home,8,12,4
3148,4,work,12,14,2
3148,5,home,14,21,7
3148,6,work,21,22,1
3148,7,home,22,24,2
3148,8,<ENDS>,24,24,0
3149,0,<START>,0,0,0
3149,1,home,0,8,8
3149,2,work,8,14,6
3149,3,home,14,22,8
3149,4,work,22,23,1
3149,5,home,23,24,1
3149,6,<ENDS>,24,24,0
3150,0,<START>,0,0,0
3150,1,home,0,7,7
3150,2,work,7,13,6
3150,3,shop,13,14,1
3150,4,work,14,20,6
3150,5,home,20,24,4
3150,6,<ENDS>,24,24,0
3151,0,<START>,0,0,0
3151,1,home,0,8,8
3151,2,education,8,11,3
3151,3,home,11,18,7
3151,4,shop,18,19,1
3151,5,home,19,24,5
3151,6,<ENDS>,24,24,0
3152,0,<START>,0,0,0
3152,1,home,0,7,7
3152,2,shop,7,8,1
3152,3,education,8,11,3
3152,4,home,11,18,7
3152,5,shop,18,19,1
3152,6,home,19,24,5
3152,7,<ENDS>,24,24,0
3153,0,<START>,0,0,0
3153,1,home,0,7,7
3153,2,education,7,12,5
3153,3,home,12,19,7
3153,4,shop,19,21,2
3153,5,home,21,24,3
3153,6,<ENDS>,24,24,0
3154,0,<START>,0,0,0
3154,1,home,0,7,7
3154,2,work,7,14,7
3154,3,shop,14,15,1
3154,4,home,15,17,2
3154,5,work,17,20,3
3154,6,home,20,24,4
3154,7,<ENDS>,24,24,0
3155,0,<START>,0,0,0
3155,1,home,0,7,7
3155,2,work,7,14,7
3155,3,home,14,24,10
3155,4,<ENDS>,24,24,0
3156,0,<START>,0,0,0
3156,1,home,0,7,7
3156,2,work,7,15,8
3156,3,home,15,23,8
3156,4,work,23,24,1
3156,5,<ENDS>,24,24,0
3157,0,<START>,0,0,0
3157,1,home,0,6,6
3157,2,work,6,8,2
3157,3,home,8,13,5
3157,4,work,13,15,2
3157,5,home,15,21,6
3157,6,work,21,22,1
3157,7,home,22,24,2
3157,8,<ENDS>,24,24,0
3158,0,<START>,0,0,0
3158,1,home,0,7,7
3158,2,work,7,9,2
3158,3,home,9,15,6
3158,4,work,15,17,2
3158,5,home,17,24,7
3158,6,<ENDS>,24,24,0
3159,0,<START>,0,0,0
3159,1,home,0,7,7
3159,2,work,7,13,6
3159,3,home,13,22,9
3159,4,work,22,23,1
3159,5,home,23,24,1
3159,6,<ENDS>,24,24,0
3160,0,<START>,0,0,0
3160,1,home,0,6,6
3160,2,shop,6,7,1
3160,3,home,7,10,3
3160,4,work,10,17,7
3160,5,home,17,24,7
3160,6,<ENDS>,24,24,0
3161,0,<START>,0,0,0
3161,1,home,0,9,9
3161,2,work,9,14,5
3161,3,home,14,24,10
3161,4,<ENDS>,24,24,0
3162,0,<START>,0,0,0
3162,1,home,0,7,7
3162,2,work,7,14,7
3162,3,home,14,17,3
3162,4,work,17,20,3
3162,5,home,20,24,4
3162,6,<ENDS>,24,24,0
3163,0,<START>,0,0,0
3163,1,home,0,6,6
3163,2,work,6,13,7
3163,3,home,13,15,2
3163,4,work,15,20,5
3163,5,home,20,24,4
3163,6,<ENDS>,24,24,0
3164,0,<START>,0,0,0
3164,1,home,0,6,6
3164,2,work,6,13,7
3164,3,shop,13,14,1
3164,4,home,14,24,10
3164,5,<ENDS>,24,24,0
3165,0,<START>,0,0,0
3165,1,home,0,7,7
3165,2,work,7,13,6
3165,3,home,13,18,5
3165,4,work,18,20,2
3165,5,home,20,24,4
3165,6,<ENDS>,24,24,0
3166,0,<START>,0,0,0
3166,1,home,0,8,8
3166,2,work,8,14,6
3166,3,shop,14,15,1
3166,4,work,15,19,4
3166,5,home,19,24,5
3166,6,<ENDS>,24,24,0
3167,0,<START>,0,0,0
3167,1,home,0,8,8
3167,2,work,8,14,6
3167,3,shop,14,15,1
3167,4,home,15,22,7
3167,5,work,22,23,1
3167,6,home,23,24,1
3167,7,<ENDS>,24,24,0
3168,0,<START>,0,0,0
3168,1,home,0,7,7
3168,2,education,7,10,3
3168,3,home,10,14,4
3168,4,education,14,16,2
3168,5,home,16,24,8
3168,6,<ENDS>,24,24,0
3169,0,<START>,0,0,0
3169,1,home,0,7,7
3169,2,work,7,14,7
3169,3,home,14,19,5
3169,4,shop,19,20,1
3169,5,home,20,24,4
3169,6,<ENDS>,24,24,0
3170,0,<START>,0,0,0
3170,1,home,0,6,6
3170,2,work,6,13,7
3170,3,home,13,16,3
3170,4,work,16,20,4
3170,5,home,20,24,4
3170,6,<ENDS>,24,24,0
3171,0,<START>,0,0,0
3171,1,home,0,8,8
3171,2,work,8,15,7
3171,3,home,15,21,6
3171,4,work,21,22,1
3171,5,home,22,24,2
3171,6,<ENDS>,24,24,0
3172,0,<START>,0,0,0
3172,1,home,0,7,7
3172,2,work,7,14,7
3172,3,shop,14,15,1
3172,4,home,15,24,9
3172,5,<ENDS>,24,24,0
3173,0,<START>,0,0,0
3173,1,home,0,6,6
3173,2,shop,6,7,1
3173,3,home,7,10,3
3173,4,education,10,13,3
3173,5,home,13,20,7
3173,6,shop,20,21,1
3173,7,home,21,24,3
3173,8,<ENDS>,24,24,0
3174,0,<START>,0,0,0
3174,1,home,0,6,6
3174,2,work,6,13,7
3174,3,shop,13,14,1
3174,4,work,14,19,5
3174,5,home,19,24,5
3174,6,<ENDS>,24,24,0
3175,0,<START>,0,0,0
3175,1,home,0,8,8
3175,2,work,8,16,8
3175,3,home,16,22,6
3175,4,work,22,23,1
3175,5,home,23,24,1
3175,6,<ENDS>,24,24,0
3176,0,<START>,0,0,0
3176,1,home,0,7,7
3176,2,work,7,14,7
3176,3,shop,14,15,1
3176,4,home,15,18,3
3176,5,work,18,20,2
3176,6,home,20,24,4
3176,7,<ENDS>,24,24,0
3177,0,<START>,0,0,0
3177,1,home,0,7,7
3177,2,work,7,14,7
3177,3,shop,14,15,1
3177,4,work,15,20,5
3177,5,home,20,24,4
3177,6,<ENDS>,24,24,0
3178,0,<START>,0,0,0
3178,1,home,0,8,8
3178,2,work,8,15,7
3178,3,home,15,24,9
3178,4,<ENDS>,24,24,0
3179,0,<START>,0,0,0
3179,1,home,0,6,6
3179,2,work,6,13,7
3179,3,home,13,24,11
3179,4,<ENDS>,24,24,0
3180,0,<START>,0,0,0
3180,1,home,0,6,6
3180,2,work,6,8,2
3180,3,home,8,13,5
3180,4,work,13,14,1
3180,5,home,14,22,8
3180,6,work,22,23,1
3180,7,home,23,24,1
3180,8,<ENDS>,24,24,0
3181,0,<START>,0,0,0
3181,1,home,0,7,7
3181,2,education,7,12,5
3181,3,home,12,15,3
3181,4,shop,15,16,1
3181,5,home,16,24,8
3181,6,<ENDS>,24,24,0
3182,0,<START>,0,0,0
3182,1,home,0,7,7
3182,2,education,7,11,4
3182,3,home,11,19,8
3182,4,shop,19,21,2
3182,5,home,21,24,3
3182,6,<ENDS>,24,24,0
3183,0,<START>,0,0,0
3183,1,home,0,7,7
3183,2,work,7,9,2
3183,3,home,9,11,2
3183,4,work,11,12,1
3183,5,home,12,15,3
3183,6,work,15,17,2
3183,7,home,17,21,4
3183,8,work,21,22,1
3183,9,home,22,24,2
3183,10,<ENDS>,24,24,0
3184,0,<START>,0,0,0
3184,1,home,0,7,7
3184,2,education,7,12,5
3184,3,home,12,19,7
3184,4,shop,19,21,2
3184,5,home,21,24,3
3184,6,<ENDS>,24,24,0
3185,0,<START>,0,0,0
3185,1,home,0,8,8
3185,2,work,8,15,7
3185,3,home,15,24,9
3185,4,<ENDS>,24,24,0
3186,0,<START>,0,0,0
3186,1,home,0,7,7
3186,2,shop,7,9,2
3186,3,education,9,12,3
3186,4,home,12,18,6
3186,5,shop,18,19,1
3186,6,home,19,24,5
3186,7,<ENDS>,24,24,0
3187,0,<START>,0,0,0
3187,1,home,0,6,6
3187,2,work,6,8,2
3187,3,home,8,12,4
3187,4,work,12,14,2
3187,5,shop,14,15,1
3187,6,home,15,21,6
3187,7,work,21,22,1
3187,8,home,22,24,2
3187,9,<ENDS>,24,24,0
3188,0,<START>,0,0,0
3188,1,home,0,6,6
3188,2,work,6,13,7
3188,3,home,13,24,11
3188,4,<ENDS>,24,24,0
3189,0,<START>,0,0,0
3189,1,home,0,8,8
3189,2,work,8,15,7
3189,3,shop,15,16,1
3189,4,home,16,24,8
3189,5,<ENDS>,24,24,0
3190,0,<START>,0,0,0
3190,1,home,0,7,7
3190,2,work,7,13,6
3190,3,shop,13,14,1
3190,4,work,14,19,5
3190,5,education,19,20,1
3190,6,home,20,24,4
3190,7,<ENDS>,24,24,0
3191,0,<START>,0,0,0
3191,1,home,0,6,6
3191,2,work,6,13,7
3191,3,home,13,24,11
3191,4,<ENDS>,24,24,0
3192,0,<START>,0,0,0
3192,1,home,0,8,8
3192,2,work,8,15,7
3192,3,home,15,24,9
3192,4,<ENDS>,24,24,0
3193,0,<START>,0,0,0
3193,1,home,0,8,8
3193,2,work,8,14,6
3193,3,home,14,17,3
3193,4,work,17,20,3
3193,5,home,20,24,4
3193,6,<ENDS>,24,24,0
3194,0,<START>,0,0,0
3194,1,home,0,8,8
3194,2,work,8,14,6
3194,3,home,14,16,2
3194,4,work,16,19,3
3194,5,home,19,24,5
3194,6,<ENDS>,24,24,0
3195,0,<START>,0,0,0
3195,1,home,0,7,7
3195,2,shop,7,10,3
3195,3,education,10,16,6
3195,4,home,16,24,8
3195,5,<ENDS>,24,24,0
3196,0,<START>,0,0,0
3196,1,home,0,8,8
3196,2,work,8,15,7
3196,3,home,15,24,9
3196,4,<ENDS>,24,24,0
3197,0,<START>,0,0,0
3197,1,home,0,7,7
3197,2,work,7,14,7
3197,3,home,14,22,8
3197,4,work,22,23,1
3197,5,home,23,24,1
3197,6,<ENDS>,24,24,0
3198,0,<START>,0,0,0
3198,1,home,0,8,8
3198,2,shop,8,9,1
3198,3,home,9,13,4
3198,4,work,13,19,6
3198,5,home,19,23,4
3198,6,work,23,24,1
3198,7,<ENDS>,24,24,0
3199,0,<START>,0,0,0
3199,1,home,0,8,8
3199,2,work,8,15,7
3199,3,home,15,24,9
3199,4,<ENDS>,24,24,0
3200,0,<START>,0,0,0
3200,1,home,0,7,7
3200,2,work,7,15,8
3200,3,home,15,24,9
3200,4,<ENDS>,24,24,0
3201,0,<START>,0,0,0
3201,1,home,0,8,8
3201,2,education,8,12,4
3201,3,shop,12,13,1
3201,4,work,13,19,6
3201,5,home,19,24,5
3201,6,<ENDS>,24,24,0
3202,0,<START>,0,0,0
3202,1,home,0,7,7
3202,2,work,7,13,6
3202,3,home,13,24,11
3202,4,<ENDS>,24,24,0
3203,0,<START>,0,0,0
3203,1,home,0,7,7
3203,2,work,7,14,7
3203,3,home,14,21,7
3203,4,work,21,22,1
3203,5,home,22,24,2
3203,6,<ENDS>,24,24,0
3204,0,<START>,0,0,0
3204,1,home,0,7,7
3204,2,shop,7,8,1
3204,3,education,8,12,4
3204,4,home,12,16,4
3204,5,shop,16,17,1
3204,6,home,17,24,7
3204,7,<ENDS>,24,24,0
3205,0,<START>,0,0,0
3205,1,home,0,8,8
3205,2,work,8,15,7
3205,3,home,15,24,9
3205,4,<ENDS>,24,24,0
3206,0,<START>,0,0,0
3206,1,home,0,6,6
3206,2,work,6,8,2
3206,3,home,8,14,6
3206,4,work,14,16,2
3206,5,home,16,22,6
3206,6,work,22,23,1
3206,7,home,23,24,1
3206,8,<ENDS>,24,24,0
3207,0,<START>,0,0,0
3207,1,home,0,7,7
3207,2,work,7,13,6
3207,3,home,13,24,11
3207,4,<ENDS>,24,24,0
3208,0,<START>,0,0,0
3208,1,home,0,6,6
3208,2,work,6,8,2
3208,3,home,8,15,7
3208,4,work,15,17,2
3208,5,home,17,24,7
3208,6,<ENDS>,24,24,0
3209,0,<START>,0,0,0
3209,1,home,0,6,6
3209,2,work,6,8,2
3209,3,home,8,15,7
3209,4,work,15,18,3
3209,5,home,18,24,6
3209,6,<ENDS>,24,24,0
3210,0,<START>,0,0,0
3210,1,home,0,6,6
3210,2,work,6,7,1
3210,3,home,7,9,2
3210,4,work,9,11,2
3210,5,home,11,16,5
3210,6,work,16,18,2
3210,7,home,18,23,5
3210,8,work,23,24,1
3210,9,<ENDS>,24,24,0
3211,0,<START>,0,0,0
3211,1,work,0,9,9
3211,2,shop,9,10,1
3211,3,work,10,16,6
3211,4,home,16,20,4
3211,5,shop,20,21,1
3211,6,home,21,24,3
3211,7,<ENDS>,24,24,0
3212,0,<START>,0,0,0
3212,1,home,0,7,7
3212,2,work,7,15,8
3212,3,home,15,24,9
3212,4,<ENDS>,24,24,0
3213,0,<START>,0,0,0
3213,1,home,0,6,6
3213,2,work,6,13,7
3213,3,home,13,14,1
3213,4,work,14,20,6
3213,5,home,20,24,4
3213,6,<ENDS>,24,24,0
3214,0,<START>,0,0,0
3214,1,home,0,7,7
3214,2,work,7,13,6
3214,3,home,13,16,3
3214,4,work,16,19,3
3214,5,home,19,24,5
3214,6,<ENDS>,24,24,0
3215,0,<START>,0,0,0
3215,1,home,0,6,6
3215,2,work,6,13,7
3215,3,home,13,22,9
3215,4,work,22,23,1
3215,5,home,23,24,1
3215,6,<ENDS>,24,24,0
3216,0,<START>,0,0,0
3216,1,home,0,7,7
3216,2,work,7,14,7
3216,3,home,14,24,10
3216,4,<ENDS>,24,24,0
3217,0,<START>,0,0,0
3217,1,home,0,7,7
3217,2,work,7,13,6
3217,3,shop,13,14,1
3217,4,home,14,24,10
3217,5,<ENDS>,24,24,0
3218,0,<START>,0,0,0
3218,1,home,0,7,7
3218,2,work,7,13,6
3218,3,home,13,24,11
3218,4,<ENDS>,24,24,0
3219,0,<START>,0,0,0
3219,1,home,0,7,7
3219,2,work,7,13,6
3219,3,home,13,23,10
3219,4,work,23,24,1
3219,5,<ENDS>,24,24,0
3220,0,<START>,0,0,0
3220,1,home,0,9,9
3220,2,work,9,16,7
3220,3,shop,16,17,1
3220,4,home,17,24,7
3220,5,<ENDS>,24,24,0
3221,0,<START>,0,0,0
3221,1,home,0,8,8
3221,2,education,8,12,4
3221,3,work,12,19,7
3221,4,home,19,24,5
3221,5,<ENDS>,24,24,0
3222,0,<START>,0,0,0
3222,1,home,0,6,6
3222,2,shop,6,7,1
3222,3,home,7,10,3
3222,4,education,10,16,6
3222,5,home,16,24,8
3222,6,<ENDS>,24,24,0
3223,0,<START>,0,0,0
3223,1,home,0,7,7
3223,2,education,7,11,4
3223,3,home,11,14,3
3223,4,education,14,16,2
3223,5,shop,16,17,1
3223,6,home,17,24,7
3223,7,<ENDS>,24,24,0
3224,0,<START>,0,0,0
3224,1,home,0,7,7
3224,2,work,7,14,7
3224,3,shop,14,15,1
3224,4,home,15,24,9
3224,5,<ENDS>,24,24,0
3225,0,<START>,0,0,0
3225,1,home,0,7,7
3225,2,work,7,9,2
3225,3,home,9,16,7
3225,4,work,16,18,2
3225,5,home,18,24,6
3225,6,<ENDS>,24,24,0
3226,0,<START>,0,0,0
3226,1,home,0,7,7
3226,2,work,7,14,7
3226,3,home,14,21,7
3226,4,shop,21,22,1
3226,5,home,22,24,2
3226,6,<ENDS>,24,24,0
3227,0,<START>,0,0,0
3227,1,home,0,8,8
3227,2,work,8,15,7
3227,3,shop,15,16,1
3227,4,home,16,21,5
3227,5,work,21,22,1
3227,6,home,22,24,2
3227,7,<ENDS>,24,24,0
3228,0,<START>,0,0,0
3228,1,home,0,7,7
3228,2,work,7,14,7
3228,3,shop,14,15,1
3228,4,work,15,19,4
3228,5,home,19,24,5
3228,6,<ENDS>,24,24,0
3229,0,<START>,0,0,0
3229,1,home,0,8,8
3229,2,work,8,16,8
3229,3,home,16,24,8
3229,4,<ENDS>,24,24,0
3230,0,<START>,0,0,0
3230,1,home,0,6,6
3230,2,work,6,8,2
3230,3,home,8,14,6
3230,4,work,14,16,2
3230,5,home,16,23,7
3230,6,work,23,24,1
3230,7,<ENDS>,24,24,0
3231,0,<START>,0,0,0
3231,1,home,0,7,7
3231,2,education,7,12,5
3231,3,shop,12,14,2
3231,4,home,14,20,6
3231,5,shop,20,21,1
3231,6,home,21,24,3
3231,7,<ENDS>,24,24,0
3232,0,<START>,0,0,0
3232,1,home,0,7,7
3232,2,work,7,13,6
3232,3,shop,13,14,1
3232,4,work,14,20,6
3232,5,home,20,24,4
3232,6,<ENDS>,24,24,0
3233,0,<START>,0,0,0
3233,1,home,0,6,6
3233,2,work,6,13,7
3233,3,home,13,16,3
3233,4,work,16,19,3
3233,5,home,19,24,5
3233,6,<ENDS>,24,24,0
3234,0,<START>,0,0,0
3234,1,home,0,8,8
3234,2,education,8,11,3
3234,3,home,11,18,7
3234,4,shop,18,19,1
3234,5,home,19,24,5
3234,6,<ENDS>,24,24,0
3235,0,<START>,0,0,0
3235,1,home,0,7,7
3235,2,work,7,14,7
3235,3,shop,14,15,1
3235,4,home,15,17,2
3235,5,work,17,20,3
3235,6,home,20,24,4
3235,7,<ENDS>,24,24,0
3236,0,<START>,0,0,0
3236,1,home,0,7,7
3236,2,shop,7,8,1
3236,3,home,8,14,6
3236,4,work,14,20,6
3236,5,home,20,24,4
3236,6,<ENDS>,24,24,0
3237,0,<START>,0,0,0
3237,1,home,0,7,7
3237,2,work,7,13,6
3237,3,shop,13,14,1
3237,4,home,14,15,1
3237,5,work,15,20,5
3237,6,home,20,24,4
3237,7,<ENDS>,24,24,0
3238,0,<START>,0,0,0
3238,1,home,0,7,7
3238,2,education,7,12,5
3238,3,shop,12,14,2
3238,4,home,14,19,5
3238,5,shop,19,20,1
3238,6,home,20,24,4
3238,7,<ENDS>,24,24,0
3239,0,<START>,0,0,0
3239,1,home,0,6,6
3239,2,shop,6,7,1
3239,3,home,7,13,6
3239,4,education,13,16,3
3239,5,home,16,24,8
3239,6,<ENDS>,24,24,0
3240,0,<START>,0,0,0
3240,1,home,0,7,7
3240,2,shop,7,8,1
3240,3,work,8,14,6
3240,4,home,14,24,10
3240,5,<ENDS>,24,24,0
3241,0,<START>,0,0,0
3241,1,home,0,7,7
3241,2,education,7,12,5
3241,3,shop,12,14,2
3241,4,home,14,20,6
3241,5,shop,20,21,1
3241,6,home,21,24,3
3241,7,<ENDS>,24,24,0
3242,0,<START>,0,0,0
3242,1,home,0,7,7
3242,2,work,7,13,6
3242,3,shop,13,14,1
3242,4,education,14,17,3
3242,5,home,17,24,7
3242,6,<ENDS>,24,24,0
3243,0,<START>,0,0,0
3243,1,home,0,8,8
3243,2,education,8,11,3
3243,3,home,11,14,3
3243,4,education,14,16,2
3243,5,home,16,24,8
3243,6,<ENDS>,24,24,0
3244,0,<START>,0,0,0
3244,1,home,0,7,7
3244,2,shop,7,9,2
3244,3,education,9,12,3
3244,4,shop,12,14,2
3244,5,education,14,16,2
3244,6,shop,16,17,1
3244,7,home,17,24,7
3244,8,<ENDS>,24,24,0
3245,0,<START>,0,0,0
3245,1,home,0,8,8
3245,2,work,8,15,7
3245,3,shop,15,16,1
3245,4,work,16,20,4
3245,5,home,20,24,4
3245,6,<ENDS>,24,24,0
3246,0,<START>,0,0,0
3246,1,home,0,6,6
3246,2,work,6,9,3
3246,3,home,9,16,7
3246,4,work,16,18,2
3246,5,home,18,24,6
3246,6,<ENDS>,24,24,0
3247,0,<START>,0,0,0
3247,1,home,0,6,6
3247,2,shop,6,7,1
3247,3,home,7,10,3
3247,4,education,10,13,3
3247,5,home,13,19,6
3247,6,shop,19,20,1
3247,7,home,20,24,4
3247,8,<ENDS>,24,24,0
3248,0,<START>,0,0,0
3248,1,home,0,6,6
3248,2,work,6,13,7
3248,3,shop,13,14,1
3248,4,education,14,16,2
3248,5,home,16,24,8
3248,6,<ENDS>,24,24,0
3249,0,<START>,0,0,0
3249,1,home,0,6,6
3249,2,work,6,8,2
3249,3,home,8,12,4
3249,4,work,12,13,1
3249,5,home,13,22,9
3249,6,work,22,23,1
3249,7,home,23,24,1
3249,8,<ENDS>,24,24,0
3250,0,<START>,0,0,0
3250,1,home,0,7,7
3250,2,work,7,13,6
3250,3,shop,13,14,1
3250,4,work,14,18,4
3250,5,education,18,19,1
3250,6,home,19,24,5
3250,7,<ENDS>,24,24,0
3251,0,<START>,0,0,0
3251,1,home,0,7,7
3251,2,education,7,11,4
3251,3,home,11,19,8
3251,4,shop,19,20,1
3251,5,home,20,24,4
3251,6,<ENDS>,24,24,0
3252,0,<START>,0,0,0
3252,1,home,0,7,7
3252,2,shop,7,8,1
3252,3,work,8,15,7
3252,4,home,15,24,9
3252,5,<ENDS>,24,24,0
3253,0,<START>,0,0,0
3253,1,home,0,6,6
3253,2,work,6,13,7
3253,3,home,13,24,11
3253,4,<ENDS>,24,24,0
3254,0,<START>,0,0,0
3254,1,home,0,8,8
3254,2,work,8,15,7
3254,3,home,15,24,9
3254,4,<ENDS>,24,24,0
3255,0,<START>,0,0,0
3255,1,home,0,9,9
3255,2,work,9,16,7
3255,3,home,16,24,8
3255,4,<ENDS>,24,24,0
3256,0,<START>,0,0,0
3256,1,home,0,8,8
3256,2,work,8,15,7
3256,3,home,15,21,6
3256,4,work,21,22,1
3256,5,home,22,24,2
3256,6,<ENDS>,24,24,0
3257,0,<START>,0,0,0
3257,1,home,0,9,9
3257,2,work,9,16,7
3257,3,home,16,21,5
3257,4,work,21,22,1
3257,5,home,22,24,2
3257,6,<ENDS>,24,24,0
3258,0,<START>,0,0,0
3258,1,home,0,7,7
3258,2,shop,7,8,1
3258,3,education,8,12,4
3258,4,home,12,18,6
3258,5,shop,18,19,1
3258,6,home,19,24,5
3258,7,<ENDS>,24,24,0
3259,0,<START>,0,0,0
3259,1,home,0,7,7
3259,2,work,7,14,7
3259,3,home,14,24,10
3259,4,<ENDS>,24,24,0
3260,0,<START>,0,0,0
3260,1,home,0,6,6
3260,2,shop,6,7,1
3260,3,home,7,11,4
3260,4,work,11,17,6
3260,5,home,17,22,5
3260,6,work,22,23,1
3260,7,home,23,24,1
3260,8,<ENDS>,24,24,0
3261,0,<START>,0,0,0
3261,1,home,0,7,7
3261,2,work,7,9,2
3261,3,home,9,13,4
3261,4,work,13,15,2
3261,5,home,15,21,6
3261,6,work,21,22,1
3261,7,home,22,24,2
3261,8,<ENDS>,24,24,0
3262,0,<START>,0,0,0
3262,1,home,0,6,6
3262,2,shop,6,7,1
3262,3,home,7,10,3
3262,4,education,10,12,2
3262,5,home,12,19,7
3262,6,shop,19,20,1
3262,7,home,20,24,4
3262,8,<ENDS>,24,24,0
3263,0,<START>,0,0,0
3263,1,home,0,6,6
3263,2,work,6,13,7
3263,3,shop,13,14,1
3263,4,work,14,18,4
3263,5,home,18,24,6
3263,6,<ENDS>,24,24,0
3264,0,<START>,0,0,0
3264,1,home,0,8,8
3264,2,work,8,15,7
3264,3,home,15,24,9
3264,4,<ENDS>,24,24,0
3265,0,<START>,0,0,0
3265,1,home,0,7,7
3265,2,work,7,9,2
3265,3,home,9,16,7
3265,4,work,16,18,2
3265,5,home,18,22,4
3265,6,work,22,23,1
3265,7,home,23,24,1
3265,8,<ENDS>,24,24,0
3266,0,<START>,0,0,0
3266,1,home,0,9,9
3266,2,work,9,16,7
3266,3,home,16,24,8
3266,4,<ENDS>,24,24,0
3267,0,<START>,0,0,0
3267,1,home,0,7,7
3267,2,work,7,15,8
3267,3,shop,15,16,1
3267,4,work,16,20,4
3267,5,home,20,24,4
3267,6,<ENDS>,24,24,0
3268,0,<START>,0,0,0
3268,1,home,0,6,6
3268,2,work,6,13,7
3268,3,shop,13,14,1
3268,4,work,14,20,6
3268,5,home,20,24,4
3268,6,<ENDS>,24,24,0
3269,0,<START>,0,0,0
3269,1,home,0,6,6
3269,2,work,6,13,7
3269,3,home,13,18,5
3269,4,shop,18,19,1
3269,5,home,19,24,5
3269,6,<ENDS>,24,24,0
3270,0,<START>,0,0,0
3270,1,home,0,7,7
3270,2,shop,7,8,1
3270,3,work,8,15,7
3270,4,home,15,23,8
3270,5,work,23,24,1
3270,6,<ENDS>,24,24,0
3271,0,<START>,0,0,0
3271,1,home,0,8,8
3271,2,work,8,15,7
3271,3,shop,15,16,1
3271,4,home,16,24,8
3271,5,<ENDS>,24,24,0
3272,0,<START>,0,0,0
3272,1,work,0,1,1
3272,2,home,1,7,6
3272,3,education,7,11,4
3272,4,home,11,18,7
3272,5,shop,18,19,1
3272,6,home,19,24,5
3272,7,<ENDS>,24,24,0
3273,0,<START>,0,0,0
3273,1,home,0,7,7
3273,2,work,7,14,7
3273,3,shop,14,15,1
3273,4,home,15,22,7
3273,5,work,22,23,1
3273,6,home,23,24,1
3273,7,<ENDS>,24,24,0
3274,0,<START>,0,0,0
3274,1,home,0,7,7
3274,2,education,7,11,4
3274,3,home,11,14,3
3274,4,education,14,16,2
3274,5,shop,16,18,2
3274,6,home,18,24,6
3274,7,<ENDS>,24,24,0
3275,0,<START>,0,0,0
3275,1,home,0,7,7
3275,2,shop,7,8,1
3275,3,education,8,11,3
3275,4,home,11,17,6
3275,5,shop,17,18,1
3275,6,home,18,24,6
3275,7,<ENDS>,24,24,0
3276,0,<START>,0,0,0
3276,1,home,0,8,8
3276,2,work,8,15,7
3276,3,shop,15,16,1
3276,4,work,16,20,4
3276,5,home,20,24,4
3276,6,<ENDS>,24,24,0
3277,0,<START>,0,0,0
3277,1,home,0,6,6
3277,2,work,6,8,2
3277,3,home,8,12,4
3277,4,work,12,14,2
3277,5,home,14,21,7
3277,6,work,21,22,1
3277,7,home,22,24,2
3277,8,<ENDS>,24,24,0
3278,0,<START>,0,0,0
3278,1,home,0,7,7
3278,2,education,7,11,4
3278,3,home,11,13,2
3278,4,education,13,16,3
3278,5,home,16,24,8
3278,6,<ENDS>,24,24,0
3279,0,<START>,0,0,0
3279,1,home,0,7,7
3279,2,work,7,13,6
3279,3,shop,13,14,1
3279,4,work,14,19,5
3279,5,home,19,24,5
3279,6,<ENDS>,24,24,0
3280,0,<START>,0,0,0
3280,1,home,0,8,8
3280,2,work,8,15,7
3280,3,home,15,19,4
3280,4,shop,19,20,1
3280,5,home,20,24,4
3280,6,<ENDS>,24,24,0
3281,0,<START>,0,0,0
3281,1,home,0,7,7
3281,2,work,7,14,7
3281,3,shop,14,15,1
3281,4,work,15,20,5
3281,5,home,20,24,4
3281,6,<ENDS>,24,24,0
3282,0,<START>,0,0,0
3282,1,home,0,7,7
3282,2,work,7,14,7
3282,3,home,14,18,4
3282,4,work,18,20,2
3282,5,home,20,24,4
3282,6,<ENDS>,24,24,0
3283,0,<START>,0,0,0
3283,1,home,0,8,8
3283,2,work,8,15,7
3283,3,home,15,24,9
3283,4,<ENDS>,24,24,0
3284,0,<START>,0,0,0
3284,1,home,0,6,6
3284,2,work,6,8,2
3284,3,home,8,13,5
3284,4,work,13,15,2
3284,5,home,15,22,7
3284,6,work,22,23,1
3284,7,home,23,24,1
3284,8,<ENDS>,24,24,0
3285,0,<START>,0,0,0
3285,1,home,0,8,8
3285,2,education,8,11,3
3285,3,home,11,17,6
3285,4,shop,17,19,2
3285,5,home,19,24,5
3285,6,<ENDS>,24,24,0
3286,0,<START>,0,0,0
3286,1,home,0,6,6
3286,2,work,6,13,7
3286,3,home,13,17,4
3286,4,work,17,20,3
3286,5,home,20,24,4
3286,6,<ENDS>,24,24,0
3287,0,<START>,0,0,0
3287,1,home,0,9,9
3287,2,education,9,12,3
3287,3,home,12,18,6
3287,4,shop,18,20,2
3287,5,home,20,24,4
3287,6,<ENDS>,24,24,0
3288,0,<START>,0,0,0
3288,1,home,0,7,7
3288,2,work,7,15,8
3288,3,home,15,24,9
3288,4,<ENDS>,24,24,0
3289,0,<START>,0,0,0
3289,1,home,0,7,7
3289,2,education,7,11,4
3289,3,home,11,19,8
3289,4,shop,19,20,1
3289,5,home,20,24,4
3289,6,<ENDS>,24,24,0
3290,0,<START>,0,0,0
3290,1,home,0,7,7
3290,2,shop,7,8,1
3290,3,education,8,11,3
3290,4,home,11,20,9
3290,5,shop,20,21,1
3290,6,home,21,24,3
3290,7,<ENDS>,24,24,0
3291,0,<START>,0,0,0
3291,1,home,0,7,7
3291,2,work,7,13,6
3291,3,home,13,24,11
3291,4,<ENDS>,24,24,0
3292,0,<START>,0,0,0
3292,1,home,0,9,9
3292,2,work,9,16,7
3292,3,home,16,21,5
3292,4,shop,21,22,1
3292,5,home,22,24,2
3292,6,<ENDS>,24,24,0
3293,0,<START>,0,0,0
3293,1,home,0,7,7
3293,2,work,7,14,7
3293,3,home,14,24,10
3293,4,<ENDS>,24,24,0
3294,0,<START>,0,0,0
3294,1,home,0,6,6
3294,2,shop,6,7,1
3294,3,home,7,10,3
3294,4,education,10,12,2
3294,5,home,12,19,7
3294,6,shop,19,20,1
3294,7,home,20,24,4
3294,8,<ENDS>,24,24,0
3295,0,<START>,0,0,0
3295,1,home,0,9,9
3295,2,work,9,16,7
3295,3,home,16,24,8
3295,4,<ENDS>,24,24,0
3296,0,<START>,0,0,0
3296,1,home,0,7,7
3296,2,work,7,14,7
3296,3,home,14,20,6
3296,4,shop,20,21,1
3296,5,home,21,24,3
3296,6,<ENDS>,24,24,0
3297,0,<START>,0,0,0
3297,1,home,0,7,7
3297,2,work,7,13,6
3297,3,home,13,24,11
3297,4,<ENDS>,24,24,0
3298,0,<START>,0,0,0
3298,1,home,0,8,8
3298,2,work,8,15,7
3298,3,home,15,21,6
3298,4,shop,21,22,1
3298,5,home,22,24,2
3298,6,<ENDS>,24,24,0
3299,0,<START>,0,0,0
3299,1,home,0,8,8
3299,2,education,8,11,3
3299,3,home,11,17,6
3299,4,shop,17,18,1
3299,5,home,18,24,6
3299,6,<ENDS>,24,24,0
3300,0,<START>,0,0,0
3300,1,home,0,7,7
3300,2,work,7,9,2
3300,3,home,9,13,4
3300,4,work,13,15,2
3300,5,home,15,22,7
3300,6,work,22,23,1
3300,7,home,23,24,1
3300,8,<ENDS>,24,24,0
3301,0,<START>,0,0,0
3301,1,home,0,6,6
3301,2,shop,6,7,1
3301,3,home,7,10,3
3301,4,education,10,13,3
3301,5,home,13,20,7
3301,6,shop,20,21,1
3301,7,home,21,24,3
3301,8,<ENDS>,24,24,0
3302,0,<START>,0,0,0
3302,1,home,0,6,6
3302,2,work,6,13,7
3302,3,home,13,24,11
3302,4,<ENDS>,24,24,0
3303,0,<START>,0,0,0
3303,1,home,0,7,7
3303,2,work,7,14,7
3303,3,home,14,24,10
3303,4,<ENDS>,24,24,0
3304,0,<START>,0,0,0
3304,1,home,0,8,8
3304,2,work,8,15,7
3304,3,home,15,23,8
3304,4,work,23,24,1
3304,5,<ENDS>,24,24,0
3305,0,<START>,0,0,0
3305,1,home,0,6,6
3305,2,shop,6,7,1
3305,3,home,7,13,6
3305,4,education,13,16,3
3305,5,home,16,24,8
3305,6,<ENDS>,24,24,0
3306,0,<START>,0,0,0
3306,1,home,0,7,7
3306,2,work,7,13,6
3306,3,home,13,24,11
3306,4,<ENDS>,24,24,0
3307,0,<START>,0,0,0
3307,1,home,0,8,8
3307,2,work,8,15,7
3307,3,home,15,24,9
3307,4,<ENDS>,24,24,0
3308,0,<START>,0,0,0
3308,1,home,0,7,7
3308,2,education,7,12,5
3308,3,home,12,21,9
3308,4,shop,21,22,1
3308,5,home,22,24,2
3308,6,<ENDS>,24,24,0
3309,0,<START>,0,0,0
3309,1,home,0,9,9
3309,2,work,9,16,7
3309,3,home,16,24,8
3309,4,<ENDS>,24,24,0
3310,0,<START>,0,0,0
3310,1,home,0,7,7
3310,2,work,7,9,2
3310,3,home,9,13,4
3310,4,work,13,15,2
3310,5,home,15,21,6
3310,6,work,21,22,1
3310,7,home,22,24,2
3310,8,<ENDS>,24,24,0
3311,0,<START>,0,0,0
3311,1,home,0,8,8
3311,2,work,8,15,7
3311,3,home,15,24,9
3311,4,<ENDS>,24,24,0
3312,0,<START>,0,0,0
3312,1,home,0,6,6
3312,2,shop,6,7,1
3312,3,home,7,9,2
3312,4,education,9,15,6
3312,5,shop,15,16,1
3312,6,home,16,24,8
3312,7,<ENDS>,24,24,0
3313,0,<START>,0,0,0
3313,1,home,0,6,6
3313,2,shop,6,7,1
3313,3,work,7,13,6
3313,4,home,13,22,9
3313,5,work,22,23,1
3313,6,home,23,24,1
3313,7,<ENDS>,24,24,0
3314,0,<START>,0,0,0
3314,1,home,0,8,8
3314,2,work,8,15,7
3314,3,home,15,24,9
3314,4,<ENDS>,24,24,0
3315,0,<START>,0,0,0
3315,1,home,0,5,5
3315,2,work,5,13,8
3315,3,shop,13,14,1
3315,4,work,14,19,5
3315,5,education,19,20,1
3315,6,home,20,24,4
3315,7,<ENDS>,24,24,0
3316,0,<START>,0,0,0
3316,1,home,0,6,6
3316,2,shop,6,7,1
3316,3,home,7,13,6
3316,4,education,13,16,3
3316,5,home,16,24,8
3316,6,<ENDS>,24,24,0
3317,0,<START>,0,0,0
3317,1,home,0,9,9
3317,2,education,9,12,3
3317,3,shop,12,13,1
3317,4,work,13,19,6
3317,5,home,19,24,5
3317,6,<ENDS>,24,24,0
3318,0,<START>,0,0,0
3318,1,home,0,8,8
3318,2,work,8,15,7
3318,3,home,15,24,9
3318,4,<ENDS>,24,24,0
3319,0,<START>,0,0,0
3319,1,home,0,7,7
3319,2,education,7,11,4
3319,3,home,11,17,6
3319,4,shop,17,19,2
3319,5,home,19,24,5
3319,6,<ENDS>,24,24,0
3320,0,<START>,0,0,0
3320,1,home,0,6,6
3320,2,shop,6,7,1
3320,3,work,7,13,6
3320,4,shop,13,14,1
3320,5,work,14,19,5
3320,6,home,19,24,5
3320,7,<ENDS>,24,24,0
3321,0,<START>,0,0,0
3321,1,home,0,7,7
3321,2,education,7,13,6
3321,3,shop,13,15,2
3321,4,home,15,24,9
3321,5,<ENDS>,24,24,0
3322,0,<START>,0,0,0
3322,1,home,0,8,8
3322,2,work,8,15,7
3322,3,home,15,19,4
3322,4,shop,19,20,1
3322,5,home,20,24,4
3322,6,<ENDS>,24,24,0
3323,0,<START>,0,0,0
3323,1,home,0,6,6
3323,2,shop,6,7,1
3323,3,home,7,10,3
3323,4,education,10,12,2
3323,5,shop,12,14,2
3323,6,home,14,21,7
3323,7,shop,21,22,1
3323,8,home,22,24,2
3323,9,<ENDS>,24,24,0
3324,0,<START>,0,0,0
3324,1,home,0,8,8
3324,2,work,8,15,7
3324,3,home,15,21,6
3324,4,work,21,22,1
3324,5,home,22,24,2
3324,6,<ENDS>,24,24,0
3325,0,<START>,0,0,0
3325,1,home,0,7,7
3325,2,work,7,14,7
3325,3,home,14,24,10
3325,4,<ENDS>,24,24,0
3326,0,<START>,0,0,0
3326,1,home,0,8,8
3326,2,work,8,13,5
3326,3,home,13,17,4
3326,4,work,17,20,3
3326,5,home,20,24,4
3326,6,<ENDS>,24,24,0
3327,0,<START>,0,0,0
3327,1,home,0,7,7
3327,2,work,7,8,1
3327,3,home,8,13,5
3327,4,work,13,15,2
3327,5,home,15,23,8
3327,6,work,23,24,1
3327,7,<ENDS>,24,24,0
3328,0,<START>,0,0,0
3328,1,home,0,8,8
3328,2,work,8,15,7
3328,3,home,15,24,9
3328,4,<ENDS>,24,24,0
3329,0,<START>,0,0,0
3329,1,home,0,7,7
3329,2,shop,7,8,1
3329,3,education,8,12,4
3329,4,home,12,21,9
3329,5,shop,21,22,1
3329,6,home,22,24,2
3329,7,<ENDS>,24,24,0
3330,0,<START>,0,0,0
3330,1,home,0,7,7
3330,2,work,7,13,6
3330,3,home,13,24,11
3330,4,<ENDS>,24,24,0
3331,0,<START>,0,0,0
3331,1,home,0,9,9
3331,2,education,9,12,3
3331,3,home,12,17,5
3331,4,work,17,20,3
3331,5,home,20,24,4
3331,6,<ENDS>,24,24,0
3332,0,<START>,0,0,0
3332,1,work,0,7,7
3332,2,shop,7,8,1
3332,3,home,8,9,1
3332,4,work,9,15,6
3332,5,home,15,24,9
3332,6,<ENDS>,24,24,0
3333,0,<START>,0,0,0
3333,1,home,0,6,6
3333,2,work,6,7,1
3333,3,home,7,11,4
3333,4,work,11,13,2
3333,5,home,13,15,2
3333,6,work,15,17,2
3333,7,home,17,24,7
3333,8,<ENDS>,24,24,0
3334,0,<START>,0,0,0
3334,1,home,0,7,7
3334,2,education,7,11,4
3334,3,home,11,20,9
3334,4,shop,20,21,1
3334,5,home,21,24,3
3334,6,<ENDS>,24,24,0
3335,0,<START>,0,0,0
3335,1,home,0,6,6
3335,2,shop,6,7,1
3335,3,home,7,10,3
3335,4,education,10,12,2
3335,5,shop,12,14,2
3335,6,home,14,21,7
3335,7,shop,21,22,1
3335,8,home,22,24,2
3335,9,<ENDS>,24,24,0
3336,0,<START>,0,0,0
3336,1,home,0,6,6
3336,2,shop,6,7,1
3336,3,home,7,13,6
3336,4,education,13,16,3
3336,5,home,16,24,8
3336,6,<ENDS>,24,24,0
3337,0,<START>,0,0,0
3337,1,home,0,7,7
3337,2,work,7,13,6
3337,3,home,13,24,11
3337,4,<ENDS>,24,24,0
3338,0,<START>,0,0,0
3338,1,work,0,9,9
3338,2,shop,9,10,1
3338,3,work,10,17,7
3338,4,home,17,24,7
3338,5,<ENDS>,24,24,0
3339,0,<START>,0,0,0
3339,1,home,0,6,6
3339,2,work,6,13,7
3339,3,shop,13,14,1
3339,4,home,14,24,10
3339,5,<ENDS>,24,24,0
3340,0,<START>,0,0,0
3340,1,home,0,9,9
3340,2,work,9,16,7
3340,3,home,16,24,8
3340,4,<ENDS>,24,24,0
3341,0,<START>,0,0,0
3341,1,home,0,7,7
3341,2,work,7,13,6
3341,3,home,13,17,4
3341,4,work,17,20,3
3341,5,home,20,24,4
3341,6,<ENDS>,24,24,0
3342,0,<START>,0,0,0
3342,1,home,0,7,7
3342,2,work,7,13,6
3342,3,home,13,17,4
3342,4,work,17,20,3
3342,5,home,20,24,4
3342,6,<ENDS>,24,24,0
3343,0,<START>,0,0,0
3343,1,home,0,7,7
3343,2,work,7,14,7
3343,3,home,14,23,9
3343,4,work,23,24,1
3343,5,<ENDS>,24,24,0
3344,0,<START>,0,0,0
3344,1,home,0,7,7
3344,2,education,7,12,5
3344,3,shop,12,13,1
3344,4,education,13,16,3
3344,5,home,16,24,8
3344,6,<ENDS>,24,24,0
3345,0,<START>,0,0,0
3345,1,home,0,8,8
3345,2,work,8,15,7
3345,3,home,15,24,9
3345,4,<ENDS>,24,24,0
3346,0,<START>,0,0,0
3346,1,home,0,8,8
3346,2,work,8,14,6
3346,3,shop,14,15,1
3346,4,work,15,20,5
3346,5,home,20,24,4
3346,6,<ENDS>,24,24,0
3347,0,<START>,0,0,0
3347,1,home,0,7,7
3347,2,work,7,15,8
3347,3,home,15,24,9
3347,4,<ENDS>,24,24,0
3348,0,<START>,0,0,0
3348,1,home,0,8,8
3348,2,work,8,14,6
3348,3,home,14,24,10
3348,4,<ENDS>,24,24,0
3349,0,<START>,0,0,0
3349,1,home,0,8,8
3349,2,work,8,15,7
3349,3,shop,15,16,1
3349,4,home,16,21,5
3349,5,work,21,22,1
3349,6,home,22,24,2
3349,7,<ENDS>,24,24,0
3350,0,<START>,0,0,0
3350,1,home,0,7,7
3350,2,work,7,13,6
3350,3,home,13,24,11
3350,4,<ENDS>,24,24,0
3351,0,<START>,0,0,0
3351,1,home,0,7,7
3351,2,work,7,13,6
3351,3,home,13,17,4
3351,4,work,17,20,3
3351,5,home,20,24,4
3351,6,<ENDS>,24,24,0
3352,0,<START>,0,0,0
3352,1,home,0,8,8
3352,2,work,8,18,10
3352,3,home,18,24,6
3352,4,<ENDS>,24,24,0
3353,0,<START>,0,0,0
3353,1,home,0,6,6
3353,2,work,6,7,1
3353,3,home,7,12,5
3353,4,work,12,14,2
3353,5,home,14,22,8
3353,6,work,22,23,1
3353,7,home,23,24,1
3353,8,<ENDS>,24,24,0
3354,0,<START>,0,0,0
3354,1,home,0,6,6
3354,2,work,6,13,7
3354,3,shop,13,14,1
3354,4,home,14,24,10
3354,5,<ENDS>,24,24,0
3355,0,<START>,0,0,0
3355,1,home,0,7,7
3355,2,work,7,13,6
3355,3,home,13,24,11
3355,4,<ENDS>,24,24,0
3356,0,<START>,0,0,0
3356,1,home,0,7,7
3356,2,shop,7,8,1
3356,3,work,8,13,5
3356,4,home,13,24,11
3356,5,<ENDS>,24,24,0
3357,0,<START>,0,0,0
3357,1,home,0,7,7
3357,2,work,7,13,6
3357,3,shop,13,14,1
3357,4,home,14,24,10
3357,5,<ENDS>,24,24,0
3358,0,<START>,0,0,0
3358,1,home,0,7,7
3358,2,shop,7,8,1
3358,3,home,8,12,4
3358,4,work,12,18,6
3358,5,home,18,24,6
3358,6,<ENDS>,24,24,0
3359,0,<START>,0,0,0
3359,1,home,0,7,7
3359,2,work,7,14,7
3359,3,home,14,24,10
3359,4,<ENDS>,24,24,0
3360,0,<START>,0,0,0
3360,1,home,0,6,6
3360,2,work,6,13,7
3360,3,home,13,22,9
3360,4,work,22,23,1
3360,5,home,23,24,1
3360,6,<ENDS>,24,24,0
3361,0,<START>,0,0,0
3361,1,home,0,7,7
3361,2,shop,7,8,1
3361,3,work,8,15,7
3361,4,home,15,24,9
3361,5,<ENDS>,24,24,0
3362,0,<START>,0,0,0
3362,1,home,0,8,8
3362,2,work,8,14,6
3362,3,home,14,21,7
3362,4,shop,21,22,1
3362,5,home,22,24,2
3362,6,<ENDS>,24,24,0
3363,0,<START>,0,0,0
3363,1,home,0,6,6
3363,2,work,6,8,2
3363,3,home,8,10,2
3363,4,work,10,12,2
3363,5,home,12,18,6
3363,6,work,18,19,1
3363,7,home,19,24,5
3363,8,<ENDS>,24,24,0
3364,0,<START>,0,0,0
3364,1,home,0,7,7
3364,2,work,7,15,8
3364,3,home,15,24,9
3364,4,<ENDS>,24,24,0
3365,0,<START>,0,0,0
3365,1,home,0,6,6
3365,2,work,6,8,2
3365,3,home,8,14,6
3365,4,work,14,16,2
3365,5,home,16,23,7
3365,6,work,23,24,1
3365,7,<ENDS>,24,24,0
3366,0,<START>,0,0,0
3366,1,home,0,7,7
3366,2,work,7,14,7
3366,3,shop,14,15,1
3366,4,home,15,23,8
3366,5,work,23,24,1
3366,6,<ENDS>,24,24,0
3367,0,<START>,0,0,0
3367,1,home,0,7,7
3367,2,work,7,13,6
3367,3,shop,13,14,1
3367,4,home,14,24,10
3367,5,<ENDS>,24,24,0
3368,0,<START>,0,0,0
3368,1,home,0,7,7
3368,2,work,7,13,6
3368,3,home,13,17,4
3368,4,work,17,20,3
3368,5,home,20,24,4
3368,6,<ENDS>,24,24,0
3369,0,<START>,0,0,0
3369,1,home,0,6,6
3369,2,work,6,8,2
3369,3,home,8,9,1
3369,4,work,9,11,2
3369,5,home,11,15,4
3369,6,work,15,17,2
3369,7,home,17,21,4
3369,8,work,21,22,1
3369,9,home,22,24,2
3369,10,<ENDS>,24,24,0
3370,0,<START>,0,0,0
3370,1,home,0,7,7
3370,2,education,7,11,4
3370,3,home,11,18,7
3370,4,shop,18,20,2
3370,5,home,20,24,4
3370,6,<ENDS>,24,24,0
3371,0,<START>,0,0,0
3371,1,home,0,7,7
3371,2,work,7,14,7
3371,3,shop,14,15,1
3371,4,home,15,24,9
3371,5,<ENDS>,24,24,0
3372,0,<START>,0,0,0
3372,1,home,0,8,8
3372,2,education,8,11,3
3372,3,home,11,23,12
3372,4,work,23,24,1
3372,5,<ENDS>,24,24,0
3373,0,<START>,0,0,0
3373,1,home,0,6,6
3373,2,work,6,13,7
3373,3,home,13,24,11
3373,4,<ENDS>,24,24,0
3374,0,<START>,0,0,0
3374,1,home,0,7,7
3374,2,work,7,14,7
3374,3,home,14,24,10
3374,4,<ENDS>,24,24,0
3375,0,<START>,0,0,0
3375,1,home,0,7,7
3375,2,work,7,13,6
3375,3,home,13,16,3
3375,4,work,16,20,4
3375,5,home,20,24,4
3375,6,<ENDS>,24,24,0
3376,0,<START>,0,0,0
3376,1,home,0,8,8
3376,2,work,8,14,6
3376,3,home,14,18,4
3376,4,work,18,19,1
3376,5,home,19,24,5
3376,6,<ENDS>,24,24,0
3377,0,<START>,0,0,0
3377,1,home,0,7,7
3377,2,education,7,11,4
3377,3,home,11,19,8
3377,4,shop,19,21,2
3377,5,home,21,24,3
3377,6,<ENDS>,24,24,0
3378,0,<START>,0,0,0
3378,1,home,0,6,6
3378,2,shop,6,7,1
3378,3,work,7,14,7
3378,4,home,14,22,8
3378,5,work,22,23,1
3378,6,home,23,24,1
3378,7,<ENDS>,24,24,0
3379,0,<START>,0,0,0
3379,1,home,0,6,6
3379,2,work,6,13,7
3379,3,shop,13,14,1
3379,4,home,14,24,10
3379,5,<ENDS>,24,24,0
3380,0,<START>,0,0,0
3380,1,home,0,6,6
3380,2,work,6,8,2
3380,3,home,8,13,5
3380,4,work,13,16,3
3380,5,home,16,23,7
3380,6,work,23,24,1
3380,7,<ENDS>,24,24,0
3381,0,<START>,0,0,0
3381,1,home,0,7,7
3381,2,work,7,13,6
3381,3,shop,13,14,1
3381,4,work,14,19,5
3381,5,home,19,24,5
3381,6,<ENDS>,24,24,0
3382,0,<START>,0,0,0
3382,1,home,0,8,8
3382,2,work,8,14,6
3382,3,shop,14,15,1
3382,4,home,15,24,9
3382,5,<ENDS>,24,24,0
3383,0,<START>,0,0,0
3383,1,home,0,6,6
3383,2,work,6,8,2
3383,3,home,8,9,1
3383,4,work,9,11,2
3383,5,home,11,15,4
3383,6,work,15,18,3
3383,7,home,18,24,6
3383,8,<ENDS>,24,24,0
3384,0,<START>,0,0,0
3384,1,home,0,7,7
3384,2,work,7,14,7
3384,3,shop,14,15,1
3384,4,home,15,24,9
3384,5,<ENDS>,24,24,0
3385,0,<START>,0,0,0
3385,1,home,0,7,7
3385,2,shop,7,8,1
3385,3,education,8,11,3
3385,4,home,11,17,6
3385,5,shop,17,18,1
3385,6,home,18,24,6
3385,7,<ENDS>,24,24,0
3386,0,<START>,0,0,0
3386,1,home,0,6,6
3386,2,work,6,8,2
3386,3,home,8,9,1
3386,4,work,9,11,2
3386,5,home,11,17,6
3386,6,work,17,19,2
3386,7,home,19,23,4
3386,8,work,23,24,1
3386,9,<ENDS>,24,24,0
3387,0,<START>,0,0,0
3387,1,home,0,7,7
3387,2,work,7,13,6
3387,3,shop,13,14,1
3387,4,education,14,17,3
3387,5,home,17,24,7
3387,6,<ENDS>,24,24,0
3388,0,<START>,0,0,0
3388,1,home,0,7,7
3388,2,education,7,12,5
3388,3,home,12,16,4
3388,4,shop,16,18,2
3388,5,home,18,24,6
3388,6,<ENDS>,24,24,0
3389,0,<START>,0,0,0
3389,1,home,0,7,7
3389,2,work,7,14,7
3389,3,shop,14,15,1
3389,4,work,15,20,5
3389,5,home,20,24,4
3389,6,<ENDS>,24,24,0
3390,0,<START>,0,0,0
3390,1,home,0,6,6
3390,2,work,6,8,2
3390,3,home,8,13,5
3390,4,work,13,16,3
3390,5,home,16,23,7
3390,6,work,23,24,1
3390,7,<ENDS>,24,24,0
3391,0,<START>,0,0,0
3391,1,home,0,6,6
3391,2,shop,6,7,1
3391,3,home,7,10,3
3391,4,education,10,13,3
3391,5,shop,13,15,2
3391,6,home,15,24,9
3391,7,<ENDS>,24,24,0
3392,0,<START>,0,0,0
3392,1,home,0,7,7
3392,2,work,7,14,7
3392,3,home,14,24,10
3392,4,<ENDS>,24,24,0
3393,0,<START>,0,0,0
3393,1,home,0,7,7
3393,2,shop,7,8,1
3393,3,work,8,17,9
3393,4,home,17,24,7
3393,5,<ENDS>,24,24,0
3394,0,<START>,0,0,0
3394,1,home,0,7,7
3394,2,work,7,15,8
3394,3,home,15,24,9
3394,4,<ENDS>,24,24,0
3395,0,<START>,0,0,0
3395,1,home,0,6,6
3395,2,work,6,8,2
3395,3,home,8,12,4
3395,4,work,12,15,3
3395,5,home,15,22,7
3395,6,work,22,23,1
3395,7,home,23,24,1
3395,8,<ENDS>,24,24,0
3396,0,<START>,0,0,0
3396,1,home,0,6,6
3396,2,work,6,13,7
3396,3,home,13,16,3
3396,4,work,16,20,4
3396,5,home,20,24,4
3396,6,<ENDS>,24,24,0
3397,0,<START>,0,0,0
3397,1,home,0,7,7
3397,2,work,7,14,7
3397,3,home,14,23,9
3397,4,work,23,24,1
3397,5,<ENDS>,24,24,0
3398,0,<START>,0,0,0
3398,1,home,0,8,8
3398,2,education,8,11,3
3398,3,home,11,15,4
3398,4,shop,15,17,2
3398,5,home,17,24,7
3398,6,<ENDS>,24,24,0
3399,0,<START>,0,0,0
3399,1,home,0,7,7
3399,2,education,7,11,4
3399,3,home,11,14,3
3399,4,education,14,16,2
3399,5,home,16,24,8
3399,6,<ENDS>,24,24,0
3400,0,<START>,0,0,0
3400,1,home,0,7,7
3400,2,work,7,13,6
3400,3,shop,13,14,1
3400,4,home,14,24,10
3400,5,<ENDS>,24,24,0
3401,0,<START>,0,0,0
3401,1,home,0,8,8
3401,2,work,8,14,6
3401,3,shop,14,16,2
3401,4,home,16,24,8
3401,5,<ENDS>,24,24,0
3402,0,<START>,0,0,0
3402,1,home,0,8,8
3402,2,education,8,11,3
3402,3,home,11,18,7
3402,4,shop,18,19,1
3402,5,home,19,24,5
3402,6,<ENDS>,24,24,0
3403,0,<START>,0,0,0
3403,1,home,0,9,9
3403,2,education,9,13,4
3403,3,home,13,24,11
3403,4,<ENDS>,24,24,0
3404,0,<START>,0,0,0
3404,1,home,0,7,7
3404,2,work,7,13,6
3404,3,shop,13,14,1
3404,4,work,14,19,5
3404,5,home,19,24,5
3404,6,<ENDS>,24,24,0
3405,0,<START>,0,0,0
3405,1,home,0,6,6
3405,2,work,6,13,7
3405,3,shop,13,14,1
3405,4,home,14,24,10
3405,5,<ENDS>,24,24,0
3406,0,<START>,0,0,0
3406,1,home,0,7,7
3406,2,work,7,14,7
3406,3,home,14,16,2
3406,4,work,16,19,3
3406,5,home,19,24,5
3406,6,<ENDS>,24,24,0
3407,0,<START>,0,0,0
3407,1,home,0,6,6
3407,2,work,6,7,1
3407,3,home,7,14,7
3407,4,work,14,16,2
3407,5,home,16,21,5
3407,6,work,21,22,1
3407,7,home,22,24,2
3407,8,<ENDS>,24,24,0
3408,0,<START>,0,0,0
3408,1,home,0,6,6
3408,2,work,6,8,2
3408,3,home,8,11,3
3408,4,work,11,13,2
3408,5,home,13,18,5
3408,6,work,18,20,2
3408,7,home,20,24,4
3408,8,<ENDS>,24,24,0
3409,0,<START>,0,0,0
3409,1,home,0,8,8
3409,2,work,8,15,7
3409,3,home,15,21,6
3409,4,shop,21,22,1
3409,5,home,22,24,2
3409,6,<ENDS>,24,24,0
3410,0,<START>,0,0,0
3410,1,home,0,7,7
3410,2,work,7,13,6
3410,3,home,13,24,11
3410,4,<ENDS>,24,24,0
3411,0,<START>,0,0,0
3411,1,home,0,7,7
3411,2,work,7,14,7
3411,3,shop,14,15,1
3411,4,work,15,19,4
3411,5,home,19,24,5
3411,6,<ENDS>,24,24,0
3412,0,<START>,0,0,0
3412,1,home,0,6,6
3412,2,work,6,13,7
3412,3,shop,13,14,1
3412,4,education,14,18,4
3412,5,home,18,24,6
3412,6,<ENDS>,24,24,0
3413,0,<START>,0,0,0
3413,1,home,0,7,7
3413,2,education,7,12,5
3413,3,home,12,19,7
3413,4,shop,19,20,1
3413,5,home,20,24,4
3413,6,<ENDS>,24,24,0
3414,0,<START>,0,0,0
3414,1,home,0,7,7
3414,2,shop,7,9,2
3414,3,education,9,12,3
3414,4,shop,12,14,2
3414,5,home,14,21,7
3414,6,shop,21,22,1
3414,7,home,22,24,2
3414,8,<ENDS>,24,24,0
3415,0,<START>,0,0,0
3415,1,home,0,8,8
3415,2,work,8,14,6
3415,3,shop,14,15,1
3415,4,home,15,23,8
3415,5,work,23,24,1
3415,6,<ENDS>,24,24,0
3416,0,<START>,0,0,0
3416,1,home,0,8,8
3416,2,work,8,15,7
3416,3,home,15,23,8
3416,4,work,23,24,1
3416,5,<ENDS>,24,24,0
3417,0,<START>,0,0,0
3417,1,home,0,7,7
3417,2,work,7,14,7
3417,3,home,14,24,10
3417,4,<ENDS>,24,24,0
3418,0,<START>,0,0,0
3418,1,home,0,7,7
3418,2,work,7,14,7
3418,3,shop,14,15,1
3418,4,home,15,24,9
3418,5,<ENDS>,24,24,0
3419,0,<START>,0,0,0
3419,1,home,0,7,7
3419,2,work,7,13,6
3419,3,home,13,24,11
3419,4,<ENDS>,24,24,0
3420,0,<START>,0,0,0
3420,1,home,0,7,7
3420,2,work,7,14,7
3420,3,home,14,24,10
3420,4,<ENDS>,24,24,0
3421,0,<START>,0,0,0
3421,1,home,0,8,8
3421,2,work,8,15,7
3421,3,home,15,24,9
3421,4,<ENDS>,24,24,0
3422,0,<START>,0,0,0
3422,1,home,0,8,8
3422,2,work,8,14,6
3422,3,home,14,21,7
3422,4,shop,21,22,1
3422,5,home,22,24,2
3422,6,<ENDS>,24,24,0
3423,0,<START>,0,0,0
3423,1,home,0,7,7
3423,2,work,7,13,6
3423,3,home,13,24,11
3423,4,<ENDS>,24,24,0
3424,0,<START>,0,0,0
3424,1,home,0,7,7
3424,2,work,7,14,7
3424,3,home,14,24,10
3424,4,<ENDS>,24,24,0
3425,0,<START>,0,0,0
3425,1,home,0,8,8
3425,2,work,8,15,7
3425,3,home,15,24,9
3425,4,<ENDS>,24,24,0
3426,0,<START>,0,0,0
3426,1,home,0,8,8
3426,2,work,8,14,6
3426,3,shop,14,15,1
3426,4,home,15,24,9
3426,5,<ENDS>,24,24,0
3427,0,<START>,0,0,0
3427,1,home,0,6,6
3427,2,shop,6,7,1
3427,3,home,7,12,5
3427,4,education,12,16,4
3427,5,home,16,24,8
3427,6,<ENDS>,24,24,0
3428,0,<START>,0,0,0
3428,1,home,0,6,6
3428,2,work,6,8,2
3428,3,home,8,14,6
3428,4,work,14,16,2
3428,5,home,16,21,5
3428,6,work,21,22,1
3428,7,home,22,24,2
3428,8,<ENDS>,24,24,0
3429,0,<START>,0,0,0
3429,1,home,0,7,7
3429,2,shop,7,8,1
3429,3,work,8,15,7
3429,4,home,15,24,9
3429,5,<ENDS>,24,24,0
3430,0,<START>,0,0,0
3430,1,home,0,8,8
3430,2,work,8,15,7
3430,3,home,15,21,6
3430,4,shop,21,22,1
3430,5,home,22,24,2
3430,6,<ENDS>,24,24,0
3431,0,<START>,0,0,0
3431,1,home,0,7,7
3431,2,work,7,13,6
3431,3,shop,13,14,1
3431,4,work,14,19,5
3431,5,home,19,24,5
3431,6,<ENDS>,24,24,0
3432,0,<START>,0,0,0
3432,1,home,0,7,7
3432,2,work,7,13,6
3432,3,home,13,17,4
3432,4,shop,17,18,1
3432,5,home,18,24,6
3432,6,<ENDS>,24,24,0
3433,0,<START>,0,0,0
3433,1,home,0,6,6
3433,2,work,6,13,7
3433,3,shop,13,14,1
3433,4,work,14,20,6
3433,5,home,20,24,4
3433,6,<ENDS>,24,24,0
3434,0,<START>,0,0,0
3434,1,home,0,7,7
3434,2,work,7,8,1
3434,3,home,8,14,6
3434,4,work,14,16,2
3434,5,home,16,22,6
3434,6,work,22,23,1
3434,7,home,23,24,1
3434,8,<ENDS>,24,24,0
3435,0,<START>,0,0,0
3435,1,home,0,8,8
3435,2,education,8,11,3
3435,3,home,11,16,5
3435,4,work,16,20,4
3435,5,home,20,24,4
3435,6,<ENDS>,24,24,0
3436,0,<START>,0,0,0
3436,1,home,0,6,6
3436,2,work,6,13,7
3436,3,shop,13,14,1
3436,4,work,14,20,6
3436,5,home,20,24,4
3436,6,<ENDS>,24,24,0
3437,0,<START>,0,0,0
3437,1,home,0,7,7
3437,2,work,7,13,6
3437,3,home,13,16,3
3437,4,work,16,19,3
3437,5,home,19,24,5
3437,6,<ENDS>,24,24,0
3438,0,<START>,0,0,0
3438,1,home,0,7,7
3438,2,shop,7,8,1
3438,3,home,8,13,5
3438,4,work,13,19,6
3438,5,home,19,24,5
3438,6,<ENDS>,24,24,0
3439,0,<START>,0,0,0
3439,1,home,0,7,7
3439,2,work,7,14,7
3439,3,home,14,24,10
3439,4,<ENDS>,24,24,0
3440,0,<START>,0,0,0
3440,1,home,0,6,6
3440,2,work,6,13,7
3440,3,shop,13,14,1
3440,4,home,14,24,10
3440,5,<ENDS>,24,24,0
3441,0,<START>,0,0,0
3441,1,home,0,7,7
3441,2,shop,7,9,2
3441,3,education,9,11,2
3441,4,home,11,17,6
3441,5,shop,17,18,1
3441,6,home,18,24,6
3441,7,<ENDS>,24,24,0
3442,0,<START>,0,0,0
3442,1,home,0,7,7
3442,2,education,7,13,6
3442,3,shop,13,14,1
3442,4,education,14,16,2
3442,5,home,16,24,8
3442,6,<ENDS>,24,24,0
3443,0,<START>,0,0,0
3443,1,home,0,6,6
3443,2,shop,6,7,1
3443,3,home,7,10,3
3443,4,education,10,12,2
3443,5,home,12,19,7
3443,6,shop,19,20,1
3443,7,home,20,24,4
3443,8,<ENDS>,24,24,0
3444,0,<START>,0,0,0
3444,1,home,0,7,7
3444,2,work,7,13,6
3444,3,home,13,24,11
3444,4,<ENDS>,24,24,0
3445,0,<START>,0,0,0
3445,1,home,0,6,6
3445,2,work,6,8,2
3445,3,home,8,14,6
3445,4,work,14,17,3
3445,5,home,17,24,7
3445,6,<ENDS>,24,24,0
3446,0,<START>,0,0,0
3446,1,home,0,7,7
3446,2,work,7,13,6
3446,3,home,13,16,3
3446,4,work,16,19,3
3446,5,home,19,24,5
3446,6,<ENDS>,24,24,0
3447,0,<START>,0,0,0
3447,1,home,0,7,7
3447,2,work,7,14,7
3447,3,home,14,24,10
3447,4,<ENDS>,24,24,0
3448,0,<START>,0,0,0
3448,1,home,0,6,6
3448,2,work,6,8,2
3448,3,home,8,13,5
3448,4,work,13,15,2
3448,5,home,15,22,7
3448,6,work,22,23,1
3448,7,home,23,24,1
3448,8,<ENDS>,24,24,0
3449,0,<START>,0,0,0
3449,1,home,0,6,6
3449,2,work,6,13,7
3449,3,home,13,21,8
3449,4,work,21,22,1
3449,5,home,22,24,2
3449,6,<ENDS>,24,24,0
3450,0,<START>,0,0,0
3450,1,home,0,8,8
3450,2,education,8,11,3
3450,3,home,11,18,7
3450,4,shop,18,19,1
3450,5,home,19,24,5
3450,6,<ENDS>,24,24,0
3451,0,<START>,0,0,0
3451,1,home,0,8,8
3451,2,work,8,15,7
3451,3,home,15,24,9
3451,4,<ENDS>,24,24,0
3452,0,<START>,0,0,0
3452,1,home,0,7,7
3452,2,education,7,11,4
3452,3,home,11,19,8
3452,4,shop,19,20,1
3452,5,home,20,24,4
3452,6,<ENDS>,24,24,0
3453,0,<START>,0,0,0
3453,1,home,0,7,7
3453,2,work,7,13,6
3453,3,home,13,17,4
3453,4,work,17,20,3
3453,5,home,20,24,4
3453,6,<ENDS>,24,24,0
3454,0,<START>,0,0,0
3454,1,home,0,9,9
3454,2,education,9,12,3
3454,3,home,12,15,3
3454,4,work,15,20,5
3454,5,home,20,24,4
3454,6,<ENDS>,24,24,0
3455,0,<START>,0,0,0
3455,1,home,0,6,6
3455,2,shop,6,7,1
3455,3,home,7,13,6
3455,4,education,13,16,3
3455,5,home,16,24,8
3455,6,<ENDS>,24,24,0
3456,0,<START>,0,0,0
3456,1,home,0,6,6
3456,2,work,6,14,8
3456,3,home,14,24,10
3456,4,<ENDS>,24,24,0
3457,0,<START>,0,0,0
3457,1,home,0,7,7
3457,2,work,7,9,2
3457,3,home,9,13,4
3457,4,work,13,15,2
3457,5,home,15,22,7
3457,6,work,22,23,1
3457,7,home,23,24,1
3457,8,<ENDS>,24,24,0
3458,0,<START>,0,0,0
3458,1,home,0,7,7
3458,2,work,7,13,6
3458,3,shop,13,14,1
3458,4,work,14,20,6
3458,5,home,20,24,4
3458,6,<ENDS>,24,24,0
3459,0,<START>,0,0,0
3459,1,home,0,6,6
3459,2,shop,6,7,1
3459,3,work,7,15,8
3459,4,home,15,24,9
3459,5,<ENDS>,24,24,0
3460,0,<START>,0,0,0
3460,1,home,0,7,7
3460,2,shop,7,8,1
3460,3,work,8,15,7
3460,4,home,15,24,9
3460,5,<ENDS>,24,24,0
3461,0,<START>,0,0,0
3461,1,home,0,6,6
3461,2,shop,6,7,1
3461,3,work,7,17,10
3461,4,home,17,24,7
3461,5,<ENDS>,24,24,0
3462,0,<START>,0,0,0
3462,1,home,0,7,7
3462,2,work,7,14,7
3462,3,shop,14,15,1
3462,4,work,15,20,5
3462,5,home,20,24,4
3462,6,<ENDS>,24,24,0
3463,0,<START>,0,0,0
3463,1,home,0,7,7
3463,2,work,7,14,7
3463,3,home,14,24,10
3463,4,<ENDS>,24,24,0
3464,0,<START>,0,0,0
3464,1,home,0,7,7
3464,2,work,7,13,6
3464,3,shop,13,14,1
3464,4,work,14,19,5
3464,5,home,19,24,5
3464,6,<ENDS>,24,24,0
3465,0,<START>,0,0,0
3465,1,home,0,6,6
3465,2,work,6,7,1
3465,3,home,7,11,4
3465,4,work,11,13,2
3465,5,home,13,17,4
3465,6,work,17,19,2
3465,7,home,19,23,4
3465,8,work,23,24,1
3465,9,<ENDS>,24,24,0
3466,0,<START>,0,0,0
3466,1,home,0,8,8
3466,2,work,8,15,7
3466,3,home,15,24,9
3466,4,<ENDS>,24,24,0
3467,0,<START>,0,0,0
3467,1,home,0,8,8
3467,2,work,8,14,6
3467,3,home,14,19,5
3467,4,shop,19,20,1
3467,5,home,20,24,4
3467,6,<ENDS>,24,24,0
3468,0,<START>,0,0,0
3468,1,home,0,7,7
3468,2,work,7,13,6
3468,3,home,13,24,11
3468,4,<ENDS>,24,24,0
3469,0,<START>,0,0,0
3469,1,home,0,8,8
3469,2,education,8,12,4
3469,3,home,12,17,5
3469,4,shop,17,18,1
3469,5,home,18,24,6
3469,6,<ENDS>,24,24,0
3470,0,<START>,0,0,0
3470,1,home,0,7,7
3470,2,work,7,13,6
3470,3,shop,13,14,1
3470,4,work,14,20,6
3470,5,home,20,24,4
3470,6,<ENDS>,24,24,0
3471,0,<START>,0,0,0
3471,1,home,0,6,6
3471,2,work,6,12,6
3471,3,shop,12,13,1
3471,4,work,13,17,4
3471,5,home,17,24,7
3471,6,<ENDS>,24,24,0
3472,0,<START>,0,0,0
3472,1,home,0,4,4
3472,2,work,4,13,9
3472,3,home,13,21,8
3472,4,work,21,22,1
3472,5,home,22,24,2
3472,6,<ENDS>,24,24,0
3473,0,<START>,0,0,0
3473,1,home,0,8,8
3473,2,work,8,15,7
3473,3,home,15,24,9
3473,4,<ENDS>,24,24,0
3474,0,<START>,0,0,0
3474,1,home,0,7,7
3474,2,work,7,14,7
3474,3,home,14,24,10
3474,4,<ENDS>,24,24,0
3475,0,<START>,0,0,0
3475,1,home,0,7,7
3475,2,work,7,13,6
3475,3,home,13,17,4
3475,4,shop,17,18,1
3475,5,home,18,24,6
3475,6,<ENDS>,24,24,0
3476,0,<START>,0,0,0
3476,1,home,0,8,8
3476,2,work,8,16,8
3476,3,home,16,24,8
3476,4,<ENDS>,24,24,0
3477,0,<START>,0,0,0
3477,1,home,0,6,6
3477,2,shop,6,7,1
3477,3,home,7,10,3
3477,4,education,10,16,6
3477,5,home,16,24,8
3477,6,<ENDS>,24,24,0
3478,0,<START>,0,0,0
3478,1,home,0,6,6
3478,2,shop,6,7,1
3478,3,home,7,10,3
3478,4,education,10,12,2
3478,5,home,12,16,4
3478,6,shop,16,17,1
3478,7,home,17,24,7
3478,8,<ENDS>,24,24,0
3479,0,<START>,0,0,0
3479,1,home,0,7,7
3479,2,work,7,13,6
3479,3,shop,13,14,1
3479,4,home,14,24,10
3479,5,<ENDS>,24,24,0
3480,0,<START>,0,0,0
3480,1,home,0,6,6
3480,2,work,6,13,7
3480,3,home,13,18,5
3480,4,shop,18,19,1
3480,5,home,19,24,5
3480,6,<ENDS>,24,24,0
3481,0,<START>,0,0,0
3481,1,home,0,8,8
3481,2,education,8,14,6
3481,3,home,14,24,10
3481,4,<ENDS>,24,24,0
3482,0,<START>,0,0,0
3482,1,home,0,6,6
3482,2,shop,6,7,1
3482,3,home,7,10,3
3482,4,education,10,15,5
3482,5,shop,15,17,2
3482,6,home,17,24,7
3482,7,<ENDS>,24,24,0
3483,0,<START>,0,0,0
3483,1,home,0,6,6
3483,2,work,6,13,7
3483,3,home,13,16,3
3483,4,work,16,20,4
3483,5,home,20,24,4
3483,6,<ENDS>,24,24,0
3484,0,<START>,0,0,0
3484,1,home,0,7,7
3484,2,shop,7,9,2
3484,3,education,9,13,4
3484,4,shop,13,14,1
3484,5,education,14,17,3
3484,6,home,17,24,7
3484,7,<ENDS>,24,24,0
3485,0,<START>,0,0,0
3485,1,home,0,9,9
3485,2,work,9,16,7
3485,3,home,16,24,8
3485,4,<ENDS>,24,24,0
3486,0,<START>,0,0,0
3486,1,home,0,7,7
3486,2,work,7,9,2
3486,3,home,9,15,6
3486,4,work,15,17,2
3486,5,home,17,24,7
3486,6,<ENDS>,24,24,0
3487,0,<START>,0,0,0
3487,1,home,0,8,8
3487,2,work,8,15,7
3487,3,shop,15,16,1
3487,4,home,16,24,8
3487,5,<ENDS>,24,24,0
3488,0,<START>,0,0,0
3488,1,home,0,8,8
3488,2,work,8,15,7
3488,3,home,15,22,7
3488,4,work,22,23,1
3488,5,home,23,24,1
3488,6,<ENDS>,24,24,0
3489,0,<START>,0,0,0
3489,1,home,0,7,7
3489,2,work,7,14,7
3489,3,home,14,23,9
3489,4,work,23,24,1
3489,5,<ENDS>,24,24,0
3490,0,<START>,0,0,0
3490,1,home,0,6,6
3490,2,work,6,13,7
3490,3,shop,13,14,1
3490,4,work,14,19,5
3490,5,home,19,24,5
3490,6,<ENDS>,24,24,0
3491,0,<START>,0,0,0
3491,1,home,0,8,8
3491,2,work,8,15,7
3491,3,home,15,24,9
3491,4,<ENDS>,24,24,0
3492,0,<START>,0,0,0
3492,1,home,0,8,8
3492,2,work,8,16,8
3492,3,home,16,24,8
3492,4,<ENDS>,24,24,0
3493,0,<START>,0,0,0
3493,1,home,0,7,7
3493,2,work,7,13,6
3493,3,shop,13,14,1
3493,4,work,14,19,5
3493,5,home,19,24,5
3493,6,<ENDS>,24,24,0
3494,0,<START>,0,0,0
3494,1,home,0,8,8
3494,2,work,8,15,7
3494,3,home,15,24,9
3494,4,<ENDS>,24,24,0
3495,0,<START>,0,0,0
3495,1,home,0,6,6
3495,2,work,6,13,7
3495,3,home,13,24,11
3495,4,<ENDS>,24,24,0
3496,0,<START>,0,0,0
3496,1,home,0,7,7
3496,2,education,7,10,3
3496,3,home,10,14,4
3496,4,education,14,16,2
3496,5,home,16,21,5
3496,6,shop,21,22,1
3496,7,home,22,24,2
3496,8,<ENDS>,24,24,0
3497,0,<START>,0,0,0
3497,1,home,0,6,6
3497,2,work,6,13,7
3497,3,shop,13,14,1
3497,4,home,14,24,10
3497,5,<ENDS>,24,24,0
3498,0,<START>,0,0,0
3498,1,home,0,7,7
3498,2,education,7,12,5
3498,3,shop,12,13,1
3498,4,education,13,15,2
3498,5,shop,15,17,2
3498,6,home,17,24,7
3498,7,<ENDS>,24,24,0
3499,0,<START>,0,0,0
3499,1,home,0,7,7
3499,2,work,7,14,7
3499,3,home,14,24,10
3499,4,<ENDS>,24,24,0
3500,0,<START>,0,0,0
3500,1,home,0,7,7
3500,2,shop,7,8,1
3500,3,education,8,12,4
3500,4,home,12,21,9
3500,5,shop,21,22,1
3500,6,home,22,24,2
3500,7,<ENDS>,24,24,0
3501,0,<START>,0,0,0
3501,1,home,0,8,8
3501,2,work,8,14,6
3501,3,home,14,24,10
3501,4,<ENDS>,24,24,0
3502,0,<START>,0,0,0
3502,1,home,0,8,8
3502,2,education,8,11,3
3502,3,home,11,17,6
3502,4,shop,17,18,1
3502,5,home,18,24,6
3502,6,<ENDS>,24,24,0
3503,0,<START>,0,0,0
3503,1,home,0,6,6
3503,2,shop,6,7,1
3503,3,home,7,13,6
3503,4,education,13,16,3
3503,5,home,16,24,8
3503,6,<ENDS>,24,24,0
3504,0,<START>,0,0,0
3504,1,home,0,7,7
3504,2,work,7,14,7
3504,3,home,14,24,10
3504,4,<ENDS>,24,24,0
3505,0,<START>,0,0,0
3505,1,home,0,8,8
3505,2,work,8,15,7
3505,3,home,15,24,9
3505,4,<ENDS>,24,24,0
3506,0,<START>,0,0,0
3506,1,home,0,7,7
3506,2,education,7,12,5
3506,3,home,12,17,5
3506,4,shop,17,18,1
3506,5,home,18,24,6
3506,6,<ENDS>,24,24,0
3507,0,<START>,0,0,0
3507,1,home,0,7,7
3507,2,work,7,13,6
3507,3,home,13,24,11
3507,4,<ENDS>,24,24,0
3508,0,<START>,0,0,0
3508,1,home,0,9,9
3508,2,work,9,16,7
3508,3,shop,16,17,1
3508,4,home,17,24,7
3508,5,<ENDS>,24,24,0
3509,0,<START>,0,0,0
3509,1,home,0,7,7
3509,2,work,7,14,7
3509,3,home,14,18,4
3509,4,work,18,20,2
3509,5,home,20,24,4
3509,6,<ENDS>,24,24,0
3510,0,<START>,0,0,0
3510,1,home,0,7,7
3510,2,work,7,14,7
3510,3,home,14,24,10
3510,4,<ENDS>,24,24,0
3511,0,<START>,0,0,0
3511,1,home,0,6,6
3511,2,shop,6,7,1
3511,3,home,7,13,6
3511,4,education,13,16,3
3511,5,shop,16,18,2
3511,6,home,18,24,6
3511,7,<ENDS>,24,24,0
3512,0,<START>,0,0,0
3512,1,home,0,6,6
3512,2,shop,6,7,1
3512,3,home,7,13,6
3512,4,education,13,16,3
3512,5,shop,16,17,1
3512,6,home,17,21,4
3512,7,shop,21,22,1
3512,8,home,22,24,2
3512,9,<ENDS>,24,24,0
3513,0,<START>,0,0,0
3513,1,home,0,7,7
3513,2,work,7,14,7
3513,3,shop,14,15,1
3513,4,home,15,24,9
3513,5,<ENDS>,24,24,0
3514,0,<START>,0,0,0
3514,1,home,0,7,7
3514,2,work,7,14,7
3514,3,home,14,22,8
3514,4,work,22,23,1
3514,5,home,23,24,1
3514,6,<ENDS>,24,24,0
3515,0,<START>,0,0,0
3515,1,home,0,7,7
3515,2,work,7,13,6
3515,3,shop,13,14,1
3515,4,home,14,24,10
3515,5,<ENDS>,24,24,0
3516,0,<START>,0,0,0
3516,1,home,0,6,6
3516,2,work,6,8,2
3516,3,home,8,14,6
3516,4,work,14,17,3
3516,5,home,17,23,6
3516,6,work,23,24,1
3516,7,<ENDS>,24,24,0
3517,0,<START>,0,0,0
3517,1,home,0,7,7
3517,2,work,7,14,7
3517,3,home,14,24,10
3517,4,<ENDS>,24,24,0
3518,0,<START>,0,0,0
3518,1,home,0,7,7
3518,2,work,7,13,6
3518,3,home,13,21,8
3518,4,shop,21,22,1
3518,5,home,22,24,2
3518,6,<ENDS>,24,24,0
3519,0,<START>,0,0,0
3519,1,home,0,6,6
3519,2,shop,6,7,1
3519,3,work,7,13,6
3519,4,home,13,16,3
3519,5,work,16,20,4
3519,6,home,20,24,4
3519,7,<ENDS>,24,24,0
3520,0,<START>,0,0,0
3520,1,home,0,8,8
3520,2,work,8,15,7
3520,3,home,15,22,7
3520,4,work,22,23,1
3520,5,home,23,24,1
3520,6,<ENDS>,24,24,0
3521,0,<START>,0,0,0
3521,1,home,0,7,7
3521,2,work,7,13,6
3521,3,shop,13,14,1
3521,4,home,14,18,4
3521,5,work,18,20,2
3521,6,home,20,24,4
3521,7,<ENDS>,24,24,0
3522,0,<START>,0,0,0
3522,1,home,0,6,6
3522,2,shop,6,7,1
3522,3,work,7,13,6
3522,4,home,13,24,11
3522,5,<ENDS>,24,24,0
3523,0,<START>,0,0,0
3523,1,work,0,8,8
3523,2,shop,8,9,1
3523,3,work,9,15,6
3523,4,home,15,24,9
3523,5,<ENDS>,24,24,0
3524,0,<START>,0,0,0
3524,1,home,0,6,6
3524,2,shop,6,7,1
3524,3,work,7,14,7
3524,4,shop,14,15,1
3524,5,home,15,24,9
3524,6,<ENDS>,24,24,0
3525,0,<START>,0,0,0
3525,1,home,0,8,8
3525,2,work,8,15,7
3525,3,home,15,24,9
3525,4,<ENDS>,24,24,0
3526,0,<START>,0,0,0
3526,1,home,0,7,7
3526,2,education,7,13,6
3526,3,shop,13,15,2
3526,4,home,15,21,6
3526,5,shop,21,22,1
3526,6,home,22,24,2
3526,7,<ENDS>,24,24,0
3527,0,<START>,0,0,0
3527,1,home,0,9,9
3527,2,work,9,16,7
3527,3,home,16,24,8
3527,4,<ENDS>,24,24,0
3528,0,<START>,0,0,0
3528,1,home,0,6,6
3528,2,work,6,8,2
3528,3,home,8,10,2
3528,4,work,10,12,2
3528,5,home,12,16,4
3528,6,work,16,19,3
3528,7,home,19,24,5
3528,8,<ENDS>,24,24,0
3529,0,<START>,0,0,0
3529,1,home,0,8,8
3529,2,work,8,15,7
3529,3,home,15,24,9
3529,4,<ENDS>,24,24,0
3530,0,<START>,0,0,0
3530,1,home,0,7,7
3530,2,work,7,13,6
3530,3,shop,13,14,1
3530,4,home,14,24,10
3530,5,<ENDS>,24,24,0
3531,0,<START>,0,0,0
3531,1,home,0,8,8
3531,2,work,8,14,6
3531,3,home,14,19,5
3531,4,shop,19,20,1
3531,5,home,20,24,4
3531,6,<ENDS>,24,24,0
3532,0,<START>,0,0,0
3532,1,home,0,6,6
3532,2,work,6,13,7
3532,3,shop,13,15,2
3532,4,work,15,19,4
3532,5,home,19,24,5
3532,6,<ENDS>,24,24,0
3533,0,<START>,0,0,0
3533,1,home,0,7,7
3533,2,work,7,14,7
3533,3,home,14,22,8
3533,4,work,22,23,1
3533,5,home,23,24,1
3533,6,<ENDS>,24,24,0
3534,0,<START>,0,0,0
3534,1,home,0,7,7
3534,2,work,7,13,6
3534,3,home,13,24,11
3534,4,<ENDS>,24,24,0
3535,0,<START>,0,0,0
3535,1,home,0,7,7
3535,2,work,7,13,6
3535,3,shop,13,14,1
3535,4,home,14,19,5
3535,5,shop,19,20,1
3535,6,home,20,24,4
3535,7,<ENDS>,24,24,0
3536,0,<START>,0,0,0
3536,1,home,0,8,8
3536,2,work,8,15,7
3536,3,home,15,22,7
3536,4,work,22,23,1
3536,5,home,23,24,1
3536,6,<ENDS>,24,24,0
3537,0,<START>,0,0,0
3537,1,home,0,8,8
3537,2,work,8,16,8
3537,3,home,16,23,7
3537,4,work,23,24,1
3537,5,<ENDS>,24,24,0
3538,0,<START>,0,0,0
3538,1,home,0,8,8
3538,2,work,8,14,6
3538,3,shop,14,15,1
3538,4,work,15,19,4
3538,5,home,19,24,5
3538,6,<ENDS>,24,24,0
3539,0,<START>,0,0,0
3539,1,home,0,9,9
3539,2,work,9,14,5
3539,3,home,14,18,4
3539,4,shop,18,19,1
3539,5,home,19,24,5
3539,6,<ENDS>,24,24,0
3540,0,<START>,0,0,0
3540,1,home,0,7,7
3540,2,education,7,11,4
3540,3,home,11,20,9
3540,4,shop,20,21,1
3540,5,home,21,24,3
3540,6,<ENDS>,24,24,0
3541,0,<START>,0,0,0
3541,1,home,0,7,7
3541,2,work,7,8,1
3541,3,home,8,9,1
3541,4,work,9,11,2
3541,5,home,11,15,4
3541,6,work,15,17,2
3541,7,home,17,21,4
3541,8,work,21,22,1
3541,9,home,22,24,2
3541,10,<ENDS>,24,24,0
3542,0,<START>,0,0,0
3542,1,home,0,6,6
3542,2,shop,6,7,1
3542,3,home,7,9,2
3542,4,work,9,11,2
3542,5,home,11,15,4
3542,6,work,15,18,3
3542,7,home,18,24,6
3542,8,<ENDS>,24,24,0
3543,0,<START>,0,0,0
3543,1,home,0,9,9
3543,2,work,9,16,7
3543,3,home,16,24,8
3543,4,<ENDS>,24,24,0
3544,0,<START>,0,0,0
3544,1,home,0,6,6
3544,2,work,6,13,7
3544,3,home,13,20,7
3544,4,shop,20,21,1
3544,5,home,21,24,3
3544,6,<ENDS>,24,24,0
3545,0,<START>,0,0,0
3545,1,home,0,6,6
3545,2,work,6,7,1
3545,3,home,7,9,2
3545,4,work,9,10,1
3545,5,home,10,14,4
3545,6,work,14,16,2
3545,7,home,16,24,8
3545,8,<ENDS>,24,24,0
3546,0,<START>,0,0,0
3546,1,home,0,6,6
3546,2,work,6,13,7
3546,3,shop,13,14,1
3546,4,work,14,19,5
3546,5,home,19,24,5
3546,6,<ENDS>,24,24,0
3547,0,<START>,0,0,0
3547,1,home,0,7,7
3547,2,education,7,11,4
3547,3,home,11,17,6
3547,4,shop,17,18,1
3547,5,home,18,24,6
3547,6,<ENDS>,24,24,0
3548,0,<START>,0,0,0
3548,1,home,0,7,7
3548,2,work,7,13,6
3548,3,shop,13,14,1
3548,4,home,14,24,10
3548,5,<ENDS>,24,24,0
3549,0,<START>,0,0,0
3549,1,home,0,8,8
3549,2,work,8,15,7
3549,3,home,15,20,5
3549,4,shop,20,21,1
3549,5,home,21,24,3
3549,6,<ENDS>,24,24,0
3550,0,<START>,0,0,0
3550,1,home,0,7,7
3550,2,education,7,11,4
3550,3,home,11,16,5
3550,4,shop,16,17,1
3550,5,home,17,21,4
3550,6,shop,21,22,1
3550,7,home,22,24,2
3550,8,<ENDS>,24,24,0
3551,0,<START>,0,0,0
3551,1,home,0,7,7
3551,2,work,7,14,7
3551,3,shop,14,15,1
3551,4,home,15,24,9
3551,5,<ENDS>,24,24,0
3552,0,<START>,0,0,0
3552,1,home,0,7,7
3552,2,work,7,14,7
3552,3,home,14,23,9
3552,4,work,23,24,1
3552,5,<ENDS>,24,24,0
3553,0,<START>,0,0,0
3553,1,home,0,6,6
3553,2,work,6,12,6
3553,3,shop,12,13,1
3553,4,work,13,19,6
3553,5,home,19,24,5
3553,6,<ENDS>,24,24,0
3554,0,<START>,0,0,0
3554,1,home,0,7,7
3554,2,education,7,13,6
3554,3,home,13,19,6
3554,4,shop,19,20,1
3554,5,home,20,24,4
3554,6,<ENDS>,24,24,0
3555,0,<START>,0,0,0
3555,1,home,0,7,7
3555,2,education,7,11,4
3555,3,home,11,18,7
3555,4,shop,18,19,1
3555,5,home,19,24,5
3555,6,<ENDS>,24,24,0
3556,0,<START>,0,0,0
3556,1,home,0,6,6
3556,2,shop,6,7,1
3556,3,home,7,14,7
3556,4,work,14,20,6
3556,5,home,20,24,4
3556,6,<ENDS>,24,24,0
3557,0,<START>,0,0,0
3557,1,home,0,7,7
3557,2,work,7,14,7
3557,3,home,14,21,7
3557,4,work,21,22,1
3557,5,home,22,24,2
3557,6,<ENDS>,24,24,0
3558,0,<START>,0,0,0
3558,1,home,0,7,7
3558,2,work,7,13,6
3558,3,home,13,17,4
3558,4,work,17,20,3
3558,5,home,20,24,4
3558,6,<ENDS>,24,24,0
3559,0,<START>,0,0,0
3559,1,home,0,7,7
3559,2,work,7,13,6
3559,3,shop,13,14,1
3559,4,home,14,24,10
3559,5,<ENDS>,24,24,0
3560,0,<START>,0,0,0
3560,1,home,0,6,6
3560,2,shop,6,7,1
3560,3,work,7,14,7
3560,4,home,14,24,10
3560,5,<ENDS>,24,24,0
3561,0,<START>,0,0,0
3561,1,home,0,7,7
3561,2,work,7,14,7
3561,3,shop,14,15,1
3561,4,work,15,20,5
3561,5,home,20,24,4
3561,6,<ENDS>,24,24,0
3562,0,<START>,0,0,0
3562,1,home,0,7,7
3562,2,work,7,14,7
3562,3,home,14,24,10
3562,4,<ENDS>,24,24,0
3563,0,<START>,0,0,0
3563,1,home,0,7,7
3563,2,work,7,15,8
3563,3,home,15,24,9
3563,4,<ENDS>,24,24,0
3564,0,<START>,0,0,0
3564,1,home,0,7,7
3564,2,work,7,13,6
3564,3,home,13,18,5
3564,4,shop,18,19,1
3564,5,home,19,24,5
3564,6,<ENDS>,24,24,0
3565,0,<START>,0,0,0
3565,1,home,0,7,7
3565,2,education,7,13,6
3565,3,shop,13,15,2
3565,4,home,15,24,9
3565,5,<ENDS>,24,24,0
3566,0,<START>,0,0,0
3566,1,home,0,7,7
3566,2,work,7,13,6
3566,3,shop,13,14,1
3566,4,work,14,19,5
3566,5,home,19,24,5
3566,6,<ENDS>,24,24,0
3567,0,<START>,0,0,0
3567,1,home,0,6,6
3567,2,work,6,7,1
3567,3,home,7,9,2
3567,4,work,9,11,2
3567,5,home,11,15,4
3567,6,work,15,17,2
3567,7,home,17,23,6
3567,8,work,23,24,1
3567,9,<ENDS>,24,24,0
3568,0,<START>,0,0,0
3568,1,home,0,8,8
3568,2,work,8,15,7
3568,3,home,15,21,6
3568,4,work,21,22,1
3568,5,home,22,24,2
3568,6,<ENDS>,24,24,0
3569,0,<START>,0,0,0
3569,1,home,0,7,7
3569,2,work,7,13,6
3569,3,shop,13,14,1
3569,4,work,14,20,6
3569,5,home,20,24,4
3569,6,<ENDS>,24,24,0
3570,0,<START>,0,0,0
3570,1,home,0,7,7
3570,2,shop,7,9,2
3570,3,education,9,12,3
3570,4,shop,12,14,2
3570,5,home,14,24,10
3570,6,<ENDS>,24,24,0
3571,0,<START>,0,0,0
3571,1,home,0,8,8
3571,2,education,8,11,3
3571,3,home,11,17,6
3571,4,shop,17,18,1
3571,5,home,18,24,6
3571,6,<ENDS>,24,24,0
3572,0,<START>,0,0,0
3572,1,home,0,6,6
3572,2,shop,6,7,1
3572,3,work,7,14,7
3572,4,home,14,16,2
3572,5,work,16,19,3
3572,6,home,19,24,5
3572,7,<ENDS>,24,24,0
3573,0,<START>,0,0,0
3573,1,home,0,7,7
3573,2,work,7,14,7
3573,3,home,14,24,10
3573,4,<ENDS>,24,24,0
3574,0,<START>,0,0,0
3574,1,home,0,6,6
3574,2,shop,6,7,1
3574,3,home,7,10,3
3574,4,education,10,13,3
3574,5,shop,13,15,2
3574,6,home,15,24,9
3574,7,<ENDS>,24,24,0
3575,0,<START>,0,0,0
3575,1,home,0,8,8
3575,2,work,8,15,7
3575,3,home,15,24,9
3575,4,<ENDS>,24,24,0
3576,0,<START>,0,0,0
3576,1,home,0,6,6
3576,2,work,6,8,2
3576,3,home,8,13,5
3576,4,work,13,15,2
3576,5,shop,15,16,1
3576,6,work,16,18,2
3576,7,home,18,24,6
3576,8,<ENDS>,24,24,0
3577,0,<START>,0,0,0
3577,1,home,0,7,7
3577,2,work,7,13,6
3577,3,shop,13,14,1
3577,4,work,14,20,6
3577,5,home,20,24,4
3577,6,<ENDS>,24,24,0
3578,0,<START>,0,0,0
3578,1,home,0,8,8
3578,2,work,8,15,7
3578,3,home,15,16,1
3578,4,shop,16,17,1
3578,5,work,17,20,3
3578,6,home,20,24,4
3578,7,<ENDS>,24,24,0
3579,0,<START>,0,0,0
3579,1,home,0,7,7
3579,2,shop,7,8,1
3579,3,education,8,13,5
3579,4,shop,13,15,2
3579,5,home,15,24,9
3579,6,<ENDS>,24,24,0
3580,0,<START>,0,0,0
3580,1,home,0,8,8
3580,2,work,8,14,6
3580,3,home,14,23,9
3580,4,work,23,24,1
3580,5,<ENDS>,24,24,0
3581,0,<START>,0,0,0
3581,1,home,0,8,8
3581,2,education,8,14,6
3581,3,shop,14,16,2
3581,4,home,16,24,8
3581,5,<ENDS>,24,24,0
3582,0,<START>,0,0,0
3582,1,home,0,6,6
3582,2,work,6,13,7
3582,3,home,13,17,4
3582,4,shop,17,18,1
3582,5,home,18,24,6
3582,6,<ENDS>,24,24,0
3583,0,<START>,0,0,0
3583,1,home,0,6,6
3583,2,shop,6,7,1
3583,3,home,7,10,3
3583,4,education,10,11,1
3583,5,home,11,17,6
3583,6,shop,17,19,2
3583,7,home,19,24,5
3583,8,<ENDS>,24,24,0
3584,0,<START>,0,0,0
3584,1,home,0,8,8
3584,2,work,8,15,7
3584,3,home,15,24,9
3584,4,<ENDS>,24,24,0
3585,0,<START>,0,0,0
3585,1,home,0,8,8
3585,2,work,8,15,7
3585,3,home,15,24,9
3585,4,<ENDS>,24,24,0
3586,0,<START>,0,0,0
3586,1,home,0,8,8
3586,2,work,8,15,7
3586,3,home,15,24,9
3586,4,<ENDS>,24,24,0
3587,0,<START>,0,0,0
3587,1,home,0,6,6
3587,2,shop,6,7,1
3587,3,home,7,13,6
3587,4,education,13,16,3
3587,5,home,16,24,8
3587,6,<ENDS>,24,24,0
3588,0,<START>,0,0,0
3588,1,home,0,7,7
3588,2,work,7,15,8
3588,3,shop,15,16,1
3588,4,home,16,24,8
3588,5,<ENDS>,24,24,0
3589,0,<START>,0,0,0
3589,1,home,0,6,6
3589,2,shop,6,7,1
3589,3,home,7,12,5
3589,4,education,12,16,4
3589,5,home,16,24,8
3589,6,<ENDS>,24,24,0
3590,0,<START>,0,0,0
3590,1,home,0,7,7
3590,2,work,7,9,2
3590,3,home,9,14,5
3590,4,shop,14,15,1
3590,5,work,15,17,2
3590,6,home,17,24,7
3590,7,<ENDS>,24,24,0
3591,0,<START>,0,0,0
3591,1,home,0,7,7
3591,2,work,7,9,2
3591,3,home,9,15,6
3591,4,work,15,17,2
3591,5,home,17,23,6
3591,6,work,23,24,1
3591,7,<ENDS>,24,24,0
3592,0,<START>,0,0,0
3592,1,home,0,7,7
3592,2,work,7,13,6
3592,3,shop,13,14,1
3592,4,home,14,24,10
3592,5,<ENDS>,24,24,0
3593,0,<START>,0,0,0
3593,1,home,0,6,6
3593,2,work,6,8,2
3593,3,home,8,12,4
3593,4,work,12,14,2
3593,5,home,14,21,7
3593,6,work,21,22,1
3593,7,home,22,24,2
3593,8,<ENDS>,24,24,0
3594,0,<START>,0,0,0
3594,1,home,0,7,7
3594,2,work,7,13,6
3594,3,shop,13,14,1
3594,4,education,14,16,2
3594,5,home,16,24,8
3594,6,<ENDS>,24,24,0
3595,0,<START>,0,0,0
3595,1,home,0,6,6
3595,2,work,6,13,7
3595,3,home,13,21,8
3595,4,work,21,22,1
3595,5,home,22,24,2
3595,6,<ENDS>,24,24,0
3596,0,<START>,0,0,0
3596,1,home,0,6,6
3596,2,work,6,13,7
3596,3,home,13,24,11
3596,4,<ENDS>,24,24,0
3597,0,<START>,0,0,0
3597,1,home,0,7,7
3597,2,shop,7,8,1
3597,3,education,8,11,3
3597,4,home,11,14,3
3597,5,education,14,16,2
3597,6,shop,16,18,2
3597,7,home,18,24,6
3597,8,<ENDS>,24,24,0
3598,0,<START>,0,0,0
3598,1,home,0,6,6
3598,2,shop,6,7,1
3598,3,home,7,10,3
3598,4,education,10,16,6
3598,5,home,16,24,8
3598,6,<ENDS>,24,24,0
3599,0,<START>,0,0,0
3599,1,home,0,6,6
3599,2,shop,6,7,1
3599,3,home,7,10,3
3599,4,education,10,14,4
3599,5,shop,14,15,1
3599,6,home,15,24,9
3599,7,<ENDS>,24,24,0
3600,0,<START>,0,0,0
3600,1,home,0,7,7
3600,2,education,7,11,4
3600,3,home,11,18,7
3600,4,shop,18,19,1
3600,5,home,19,24,5
3600,6,<ENDS>,24,24,0
3601,0,<START>,0,0,0
3601,1,home,0,8,8
3601,2,education,8,14,6
3601,3,shop,14,15,1
3601,4,work,15,20,5
3601,5,home,20,24,4
3601,6,<ENDS>,24,24,0
3602,0,<START>,0,0,0
3602,1,home,0,7,7
3602,2,work,7,13,6
3602,3,home,13,24,11
3602,4,<ENDS>,24,24,0
3603,0,<START>,0,0,0
3603,1,home,0,7,7
3603,2,work,7,14,7
3603,3,home,14,17,3
3603,4,work,17,20,3
3603,5,home,20,24,4
3603,6,<ENDS>,24,24,0
3604,0,<START>,0,0,0
3604,1,home,0,8,8
3604,2,education,8,11,3
3604,3,home,11,23,12
3604,4,work,23,24,1
3604,5,<ENDS>,24,24,0
3605,0,<START>,0,0,0
3605,1,home,0,7,7
3605,2,work,7,9,2
3605,3,home,9,13,4
3605,4,work,13,15,2
3605,5,home,15,22,7
3605,6,work,22,23,1
3605,7,home,23,24,1
3605,8,<ENDS>,24,24,0
3606,0,<START>,0,0,0
3606,1,home,0,9,9
3606,2,shop,9,10,1
3606,3,work,10,17,7
3606,4,home,17,24,7
3606,5,<ENDS>,24,24,0
3607,0,<START>,0,0,0
3607,1,home,0,7,7
3607,2,work,7,13,6
3607,3,shop,13,14,1
3607,4,home,14,21,7
3607,5,work,21,22,1
3607,6,home,22,24,2
3607,7,<ENDS>,24,24,0
3608,0,<START>,0,0,0
3608,1,home,0,14,14
3608,2,education,14,16,2
3608,3,home,16,23,7
3608,4,work,23,24,1
3608,5,<ENDS>,24,24,0
3609,0,<START>,0,0,0
3609,1,home,0,6,6
3609,2,work,6,8,2
3609,3,home,8,11,3
3609,4,work,11,12,1
3609,5,home,12,16,4
3609,6,work,16,18,2
3609,7,home,18,24,6
3609,8,<ENDS>,24,24,0
3610,0,<START>,0,0,0
3610,1,home,0,6,6
3610,2,work,6,13,7
3610,3,home,13,15,2
3610,4,work,15,18,3
3610,5,home,18,24,6
3610,6,<ENDS>,24,24,0
3611,0,<START>,0,0,0
3611,1,home,0,6,6
3611,2,work,6,8,2
3611,3,home,8,14,6
3611,4,work,14,17,3
3611,5,home,17,24,7
3611,6,<ENDS>,24,24,0
3612,0,<START>,0,0,0
3612,1,home,0,7,7
3612,2,work,7,14,7
3612,3,home,14,20,6
3612,4,shop,20,21,1
3612,5,home,21,24,3
3612,6,<ENDS>,24,24,0
3613,0,<START>,0,0,0
3613,1,home,0,7,7
3613,2,education,7,11,4
3613,3,home,11,18,7
3613,4,shop,18,20,2
3613,5,home,20,24,4
3613,6,<ENDS>,24,24,0
3614,0,<START>,0,0,0
3614,1,home,0,8,8
3614,2,education,8,12,4
3614,3,home,12,24,12
3614,4,<ENDS>,24,24,0
3615,0,<START>,0,0,0
3615,1,home,0,7,7
3615,2,education,7,11,4
3615,3,home,11,18,7
3615,4,shop,18,20,2
3615,5,home,20,24,4
3615,6,<ENDS>,24,24,0
3616,0,<START>,0,0,0
3616,1,home,0,6,6
3616,2,shop,6,7,1
3616,3,home,7,13,6
3616,4,work,13,19,6
3616,5,home,19,24,5
3616,6,<ENDS>,24,24,0
3617,0,<START>,0,0,0
3617,1,home,0,8,8
3617,2,shop,8,9,1
3617,3,home,9,13,4
3617,4,work,13,19,6
3617,5,home,19,24,5
3617,6,<ENDS>,24,24,0
3618,0,<START>,0,0,0
3618,1,home,0,6,6
3618,2,shop,6,7,1
3618,3,home,7,10,3
3618,4,education,10,13,3
3618,5,shop,13,15,2
3618,6,home,15,24,9
3618,7,<ENDS>,24,24,0
3619,0,<START>,0,0,0
3619,1,home,0,7,7
3619,2,work,7,14,7
3619,3,shop,14,15,1
3619,4,home,15,24,9
3619,5,<ENDS>,24,24,0
3620,0,<START>,0,0,0
3620,1,home,0,8,8
3620,2,work,8,15,7
3620,3,home,15,24,9
3620,4,<ENDS>,24,24,0
3621,0,<START>,0,0,0
3621,1,home,0,7,7
3621,2,work,7,13,6
3621,3,shop,13,14,1
3621,4,work,14,20,6
3621,5,home,20,24,4
3621,6,<ENDS>,24,24,0
3622,0,<START>,0,0,0
3622,1,home,0,6,6
3622,2,work,6,13,7
3622,3,shop,13,14,1
3622,4,education,14,17,3
3622,5,home,17,24,7
3622,6,<ENDS>,24,24,0
3623,0,<START>,0,0,0
3623,1,home,0,8,8
3623,2,work,8,15,7
3623,3,home,15,21,6
3623,4,shop,21,22,1
3623,5,home,22,24,2
3623,6,<ENDS>,24,24,0
3624,0,<START>,0,0,0
3624,1,home,0,7,7
3624,2,education,7,11,4
3624,3,home,11,18,7
3624,4,shop,18,19,1
3624,5,home,19,24,5
3624,6,<ENDS>,24,24,0
3625,0,<START>,0,0,0
3625,1,home,0,7,7
3625,2,work,7,13,6
3625,3,shop,13,15,2
3625,4,work,15,20,5
3625,5,home,20,24,4
3625,6,<ENDS>,24,24,0
3626,0,<START>,0,0,0
3626,1,home,0,7,7
3626,2,shop,7,8,1
3626,3,education,8,11,3
3626,4,home,11,14,3
3626,5,education,14,16,2
3626,6,home,16,24,8
3626,7,<ENDS>,24,24,0
3627,0,<START>,0,0,0
3627,1,home,0,7,7
3627,2,work,7,13,6
3627,3,shop,13,14,1
3627,4,work,14,19,5
3627,5,home,19,24,5
3627,6,<ENDS>,24,24,0
3628,0,<START>,0,0,0
3628,1,home,0,7,7
3628,2,education,7,11,4
3628,3,home,11,14,3
3628,4,education,14,16,2
3628,5,home,16,21,5
3628,6,shop,21,22,1
3628,7,home,22,24,2
3628,8,<ENDS>,24,24,0
3629,0,<START>,0,0,0
3629,1,home,0,7,7
3629,2,work,7,14,7
3629,3,home,14,17,3
3629,4,work,17,20,3
3629,5,home,20,24,4
3629,6,<ENDS>,24,24,0
3630,0,<START>,0,0,0
3630,1,home,0,8,8
3630,2,work,8,14,6
3630,3,home,14,16,2
3630,4,work,16,20,4
3630,5,home,20,24,4
3630,6,<ENDS>,24,24,0
3631,0,<START>,0,0,0
3631,1,home,0,6,6
3631,2,work,6,12,6
3631,3,shop,12,13,1
3631,4,work,13,19,6
3631,5,home,19,24,5
3631,6,<ENDS>,24,24,0
3632,0,<START>,0,0,0
3632,1,home,0,7,7
3632,2,work,7,13,6
3632,3,home,13,24,11
3632,4,<ENDS>,24,24,0
3633,0,<START>,0,0,0
3633,1,home,0,6,6
3633,2,work,6,13,7
3633,3,shop,13,14,1
3633,4,work,14,20,6
3633,5,home,20,24,4
3633,6,<ENDS>,24,24,0
3634,0,<START>,0,0,0
3634,1,home,0,7,7
3634,2,shop,7,9,2
3634,3,education,9,12,3
3634,4,shop,12,14,2
3634,5,education,14,16,2
3634,6,home,16,24,8
3634,7,<ENDS>,24,24,0
3635,0,<START>,0,0,0
3635,1,home,0,6,6
3635,2,work,6,13,7
3635,3,home,13,21,8
3635,4,shop,21,22,1
3635,5,home,22,24,2
3635,6,<ENDS>,24,24,0
3636,0,<START>,0,0,0
3636,1,home,0,6,6
3636,2,work,6,13,7
3636,3,home,13,17,4
3636,4,shop,17,18,1
3636,5,home,18,24,6
3636,6,<ENDS>,24,24,0
3637,0,<START>,0,0,0
3637,1,home,0,8,8
3637,2,work,8,15,7
3637,3,home,15,24,9
3637,4,<ENDS>,24,24,0
3638,0,<START>,0,0,0
3638,1,home,0,9,9
3638,2,education,9,12,3
3638,3,home,12,22,10
3638,4,work,22,23,1
3638,5,home,23,24,1
3638,6,<ENDS>,24,24,0
3639,0,<START>,0,0,0
3639,1,home,0,7,7
3639,2,work,7,8,1
3639,3,home,8,13,5
3639,4,work,13,16,3
3639,5,home,16,23,7
3639,6,work,23,24,1
3639,7,<ENDS>,24,24,0
3640,0,<START>,0,0,0
3640,1,home,0,7,7
3640,2,education,7,13,6
3640,3,shop,13,14,1
3640,4,education,14,17,3
3640,5,home,17,24,7
3640,6,<ENDS>,24,24,0
3641,0,<START>,0,0,0
3641,1,home,0,7,7
3641,2,work,7,13,6
3641,3,home,13,24,11
3641,4,<ENDS>,24,24,0
3642,0,<START>,0,0,0
3642,1,home,0,8,8
3642,2,work,8,14,6
3642,3,home,14,24,10
3642,4,<ENDS>,24,24,0
3643,0,<START>,0,0,0
3643,1,home,0,7,7
3643,2,shop,7,8,1
3643,3,work,8,15,7
3643,4,home,15,24,9
3643,5,<ENDS>,24,24,0
3644,0,<START>,0,0,0
3644,1,home,0,7,7
3644,2,work,7,13,6
3644,3,home,13,24,11
3644,4,<ENDS>,24,24,0
3645,0,<START>,0,0,0
3645,1,home,0,6,6
3645,2,work,6,8,2
3645,3,home,8,12,4
3645,4,work,12,14,2
3645,5,home,14,21,7
3645,6,work,21,22,1
3645,7,home,22,24,2
3645,8,<ENDS>,24,24,0
3646,0,<START>,0,0,0
3646,1,home,0,7,7
3646,2,education,7,11,4
3646,3,home,11,18,7
3646,4,shop,18,20,2
3646,5,home,20,24,4
3646,6,<ENDS>,24,24,0
3647,0,<START>,0,0,0
3647,1,home,0,6,6
3647,2,work,6,13,7
3647,3,home,13,24,11
3647,4,<ENDS>,24,24,0
3648,0,<START>,0,0,0
3648,1,home,0,8,8
3648,2,work,8,14,6
3648,3,shop,14,15,1
3648,4,home,15,24,9
3648,5,<ENDS>,24,24,0
3649,0,<START>,0,0,0
3649,1,home,0,7,7
3649,2,work,7,14,7
3649,3,home,14,24,10
3649,4,<ENDS>,24,24,0
3650,0,<START>,0,0,0
3650,1,home,0,9,9
3650,2,education,9,12,3
3650,3,home,12,15,3
3650,4,work,15,20,5
3650,5,home,20,24,4
3650,6,<ENDS>,24,24,0
3651,0,<START>,0,0,0
3651,1,home,0,7,7
3651,2,work,7,13,6
3651,3,home,13,22,9
3651,4,work,22,23,1
3651,5,home,23,24,1
3651,6,<ENDS>,24,24,0
3652,0,<START>,0,0,0
3652,1,home,0,7,7
3652,2,shop,7,8,1
3652,3,education,8,11,3
3652,4,home,11,17,6
3652,5,shop,17,18,1
3652,6,home,18,24,6
3652,7,<ENDS>,24,24,0
3653,0,<START>,0,0,0
3653,1,home,0,6,6
3653,2,work,6,13,7
3653,3,home,13,17,4
3653,4,shop,17,18,1
3653,5,home,18,24,6
3653,6,<ENDS>,24,24,0
3654,0,<START>,0,0,0
3654,1,home,0,7,7
3654,2,education,7,11,4
3654,3,home,11,18,7
3654,4,shop,18,20,2
3654,5,home,20,24,4
3654,6,<ENDS>,24,24,0
3655,0,<START>,0,0,0
3655,1,home,0,8,8
3655,2,work,8,14,6
3655,3,home,14,19,5
3655,4,shop,19,20,1
3655,5,home,20,24,4
3655,6,<ENDS>,24,24,0
3656,0,<START>,0,0,0
3656,1,home,0,7,7
3656,2,work,7,13,6
3656,3,shop,13,14,1
3656,4,work,14,20,6
3656,5,home,20,24,4
3656,6,<ENDS>,24,24,0
3657,0,<START>,0,0,0
3657,1,home,0,7,7
3657,2,work,7,14,7
3657,3,shop,14,15,1
3657,4,home,15,24,9
3657,5,<ENDS>,24,24,0
3658,0,<START>,0,0,0
3658,1,home,0,8,8
3658,2,work,8,14,6
3658,3,home,14,24,10
3658,4,<ENDS>,24,24,0
3659,0,<START>,0,0,0
3659,1,home,0,6,6
3659,2,shop,6,7,1
3659,3,home,7,8,1
3659,4,education,8,11,3
3659,5,home,11,18,7
3659,6,shop,18,19,1
3659,7,home,19,24,5
3659,8,<ENDS>,24,24,0
3660,0,<START>,0,0,0
3660,1,home,0,6,6
3660,2,work,6,13,7
3660,3,shop,13,14,1
3660,4,work,14,20,6
3660,5,home,20,24,4
3660,6,<ENDS>,24,24,0
3661,0,<START>,0,0,0
3661,1,home,0,7,7
3661,2,work,7,13,6
3661,3,home,13,15,2
3661,4,shop,15,16,1
3661,5,home,16,21,5
3661,6,shop,21,22,1
3661,7,home,22,24,2
3661,8,<ENDS>,24,24,0
3662,0,<START>,0,0,0
3662,1,home,0,7,7
3662,2,work,7,9,2
3662,3,home,9,15,6
3662,4,work,15,17,2
3662,5,home,17,23,6
3662,6,work,23,24,1
3662,7,<ENDS>,24,24,0
3663,0,<START>,0,0,0
3663,1,home,0,8,8
3663,2,work,8,15,7
3663,3,home,15,24,9
3663,4,<ENDS>,24,24,0
3664,0,<START>,0,0,0
3664,1,home,0,7,7
3664,2,shop,7,8,1
3664,3,education,8,11,3
3664,4,home,11,17,6
3664,5,shop,17,18,1
3664,6,home,18,24,6
3664,7,<ENDS>,24,24,0
3665,0,<START>,0,0,0
3665,1,home,0,6,6
3665,2,shop,6,7,1
3665,3,work,7,14,7
3665,4,shop,14,15,1
3665,5,home,15,22,7
3665,6,work,22,23,1
3665,7,home,23,24,1
3665,8,<ENDS>,24,24,0
3666,0,<START>,0,0,0
3666,1,home,0,6,6
3666,2,work,6,14,8
3666,3,shop,14,15,1
3666,4,home,15,24,9
3666,5,<ENDS>,24,24,0
3667,0,<START>,0,0,0
3667,1,home,0,8,8
3667,2,work,8,15,7
3667,3,home,15,19,4
3667,4,shop,19,20,1
3667,5,home,20,24,4
3667,6,<ENDS>,24,24,0
3668,0,<START>,0,0,0
3668,1,home,0,7,7
3668,2,work,7,13,6
3668,3,home,13,22,9
3668,4,work,22,23,1
3668,5,home,23,24,1
3668,6,<ENDS>,24,24,0
3669,0,<START>,0,0,0
3669,1,home,0,7,7
3669,2,work,7,8,1
3669,3,home,8,15,7
3669,4,work,15,18,3
3669,5,home,18,24,6
3669,6,<ENDS>,24,24,0
3670,0,<START>,0,0,0
3670,1,home,0,8,8
3670,2,education,8,11,3
3670,3,home,11,18,7
3670,4,shop,18,19,1
3670,5,home,19,24,5
3670,6,<ENDS>,24,24,0
3671,0,<START>,0,0,0
3671,1,home,0,8,8
3671,2,work,8,15,7
3671,3,home,15,24,9
3671,4,<ENDS>,24,24,0
3672,0,<START>,0,0,0
3672,1,home,0,6,6
3672,2,shop,6,7,1
3672,3,home,7,9,2
3672,4,education,9,11,2
3672,5,home,11,18,7
3672,6,shop,18,19,1
3672,7,home,19,24,5
3672,8,<ENDS>,24,24,0
3673,0,<START>,0,0,0
3673,1,home,0,8,8
3673,2,work,8,15,7
3673,3,shop,15,16,1
3673,4,work,16,20,4
3673,5,home,20,24,4
3673,6,<ENDS>,24,24,0
3674,0,<START>,0,0,0
3674,1,home,0,7,7
3674,2,education,7,11,4
3674,3,home,11,18,7
3674,4,shop,18,19,1
3674,5,home,19,24,5
3674,6,<ENDS>,24,24,0
3675,0,<START>,0,0,0
3675,1,home,0,8,8
3675,2,work,8,16,8
3675,3,shop,16,17,1
3675,4,work,17,19,2
3675,5,home,19,24,5
3675,6,<ENDS>,24,24,0
3676,0,<START>,0,0,0
3676,1,home,0,8,8
3676,2,work,8,14,6
3676,3,shop,14,15,1
3676,4,home,15,24,9
3676,5,<ENDS>,24,24,0
3677,0,<START>,0,0,0
3677,1,home,0,6,6
3677,2,work,6,8,2
3677,3,shop,8,9,1
3677,4,work,9,10,1
3677,5,home,10,14,4
3677,6,work,14,16,2
3677,7,home,16,23,7
3677,8,work,23,24,1
3677,9,<ENDS>,24,24,0
3678,0,<START>,0,0,0
3678,1,home,0,6,6
3678,2,work,6,13,7
3678,3,home,13,17,4
3678,4,work,17,20,3
3678,5,home,20,24,4
3678,6,<ENDS>,24,24,0
3679,0,<START>,0,0,0
3679,1,home,0,7,7
3679,2,work,7,14,7
3679,3,shop,14,15,1
3679,4,home,15,24,9
3679,5,<ENDS>,24,24,0
3680,0,<START>,0,0,0
3680,1,home,0,8,8
3680,2,work,8,16,8
3680,3,shop,16,17,1
3680,4,work,17,20,3
3680,5,home,20,24,4
3680,6,<ENDS>,24,24,0
3681,0,<START>,0,0,0
3681,1,home,0,6,6
3681,2,shop,6,7,1
3681,3,home,7,10,3
3681,4,education,10,15,5
3681,5,shop,15,16,1
3681,6,home,16,24,8
3681,7,<ENDS>,24,24,0
3682,0,<START>,0,0,0
3682,1,home,0,8,8
3682,2,work,8,14,6
3682,3,shop,14,15,1
3682,4,home,15,24,9
3682,5,<ENDS>,24,24,0
3683,0,<START>,0,0,0
3683,1,home,0,7,7
3683,2,work,7,13,6
3683,3,shop,13,14,1
3683,4,work,14,19,5
3683,5,home,19,24,5
3683,6,<ENDS>,24,24,0
3684,0,<START>,0,0,0
3684,1,home,0,8,8
3684,2,education,8,12,4
3684,3,home,12,17,5
3684,4,work,17,18,1
3684,5,home,18,22,4
3684,6,work,22,23,1
3684,7,home,23,24,1
3684,8,<ENDS>,24,24,0
3685,0,<START>,0,0,0
3685,1,home,0,7,7
3685,2,work,7,14,7
3685,3,shop,14,15,1
3685,4,work,15,20,5
3685,5,home,20,24,4
3685,6,<ENDS>,24,24,0
3686,0,<START>,0,0,0
3686,1,home,0,6,6
3686,2,shop,6,7,1
3686,3,work,7,13,6
3686,4,shop,13,14,1
3686,5,work,14,18,4
3686,6,home,18,22,4
3686,7,work,22,23,1
3686,8,home,23,24,1
3686,9,<ENDS>,24,24,0
3687,0,<START>,0,0,0
3687,1,home,0,6,6
3687,2,work,6,13,7
3687,3,home,13,17,4
3687,4,work,17,20,3
3687,5,home,20,24,4
3687,6,<ENDS>,24,24,0
3688,0,<START>,0,0,0
3688,1,home,0,7,7
3688,2,work,7,13,6
3688,3,home,13,24,11
3688,4,<ENDS>,24,24,0
3689,0,<START>,0,0,0
3689,1,home,0,6,6
3689,2,shop,6,7,1
3689,3,home,7,9,2
3689,4,education,9,13,4
3689,5,shop,13,15,2
3689,6,home,15,21,6
3689,7,shop,21,22,1
3689,8,home,22,24,2
3689,9,<ENDS>,24,24,0
3690,0,<START>,0,0,0
3690,1,home,0,6,6
3690,2,work,6,8,2
3690,3,home,8,14,6
3690,4,work,14,17,3
3690,5,home,17,23,6
3690,6,work,23,24,1
3690,7,<ENDS>,24,24,0
3691,0,<START>,0,0,0
3691,1,home,0,7,7
3691,2,work,7,13,6
3691,3,shop,13,14,1
3691,4,home,14,21,7
3691,5,work,21,22,1
3691,6,home,22,24,2
3691,7,<ENDS>,24,24,0
3692,0,<START>,0,0,0
3692,1,home,0,6,6
3692,2,work,6,13,7
3692,3,shop,13,14,1
3692,4,work,14,20,6
3692,5,home,20,24,4
3692,6,<ENDS>,24,24,0
3693,0,<START>,0,0,0
3693,1,home,0,8,8
3693,2,work,8,14,6
3693,3,shop,14,15,1
3693,4,home,15,24,9
3693,5,<ENDS>,24,24,0
3694,0,<START>,0,0,0
3694,1,home,0,8,8
3694,2,work,8,14,6
3694,3,shop,14,15,1
3694,4,home,15,23,8
3694,5,work,23,24,1
3694,6,<ENDS>,24,24,0
3695,0,<START>,0,0,0
3695,1,home,0,8,8
3695,2,work,8,15,7
3695,3,home,15,23,8
3695,4,work,23,24,1
3695,5,<ENDS>,24,24,0
3696,0,<START>,0,0,0
3696,1,home,0,8,8
3696,2,work,8,14,6
3696,3,shop,14,15,1
3696,4,home,15,24,9
3696,5,<ENDS>,24,24,0
3697,0,<START>,0,0,0
3697,1,home,0,7,7
3697,2,work,7,14,7
3697,3,shop,14,15,1
3697,4,work,15,20,5
3697,5,home,20,24,4
3697,6,<ENDS>,24,24,0
3698,0,<START>,0,0,0
3698,1,home,0,6,6
3698,2,work,6,8,2
3698,3,home,8,14,6
3698,4,work,14,16,2
3698,5,home,16,22,6
3698,6,work,22,23,1
3698,7,home,23,24,1
3698,8,<ENDS>,24,24,0
3699,0,<START>,0,0,0
3699,1,home,0,8,8
3699,2,work,8,13,5
3699,3,home,13,24,11
3699,4,<ENDS>,24,24,0
3700,0,<START>,0,0,0
3700,1,home,0,7,7
3700,2,shop,7,9,2
3700,3,home,9,13,4
3700,4,education,13,16,3
3700,5,home,16,24,8
3700,6,<ENDS>,24,24,0
3701,0,<START>,0,0,0
3701,1,work,0,10,10
3701,2,shop,10,11,1
3701,3,work,11,18,7
3701,4,home,18,24,6
3701,5,<ENDS>,24,24,0
3702,0,<START>,0,0,0
3702,1,home,0,7,7
3702,2,work,7,14,7
3702,3,home,14,24,10
3702,4,<ENDS>,24,24,0
3703,0,<START>,0,0,0
3703,1,home,0,6,6
3703,2,work,6,13,7
3703,3,home,13,18,5
3703,4,shop,18,19,1
3703,5,home,19,24,5
3703,6,<ENDS>,24,24,0
3704,0,<START>,0,0,0
3704,1,home,0,6,6
3704,2,work,6,13,7
3704,3,shop,13,14,1
3704,4,home,14,24,10
3704,5,<ENDS>,24,24,0
3705,0,<START>,0,0,0
3705,1,home,0,8,8
3705,2,work,8,13,5
3705,3,home,13,18,5
3705,4,work,18,19,1
3705,5,home,19,24,5
3705,6,<ENDS>,24,24,0
3706,0,<START>,0,0,0
3706,1,home,0,6,6
3706,2,work,6,13,7
3706,3,shop,13,14,1
3706,4,home,14,24,10
3706,5,<ENDS>,24,24,0
3707,0,<START>,0,0,0
3707,1,home,0,7,7
3707,2,work,7,9,2
3707,3,home,9,15,6
3707,4,work,15,17,2
3707,5,home,17,22,5
3707,6,work,22,23,1
3707,7,home,23,24,1
3707,8,<ENDS>,24,24,0
3708,0,<START>,0,0,0
3708,1,home,0,7,7
3708,2,work,7,9,2
3708,3,home,9,15,6
3708,4,work,15,17,2
3708,5,home,17,22,5
3708,6,work,22,23,1
3708,7,home,23,24,1
3708,8,<ENDS>,24,24,0
3709,0,<START>,0,0,0
3709,1,home,0,7,7
3709,2,education,7,12,5
3709,3,shop,12,14,2
3709,4,education,14,16,2
3709,5,home,16,24,8
3709,6,<ENDS>,24,24,0
3710,0,<START>,0,0,0
3710,1,home,0,7,7
3710,2,work,7,13,6
3710,3,home,13,16,3
3710,4,work,16,20,4
3710,5,home,20,24,4
3710,6,<ENDS>,24,24,0
3711,0,<START>,0,0,0
3711,1,home,0,6,6
3711,2,work,6,8,2
3711,3,home,8,13,5
3711,4,work,13,16,3
3711,5,home,16,23,7
3711,6,work,23,24,1
3711,7,<ENDS>,24,24,0
3712,0,<START>,0,0,0
3712,1,home,0,6,6
3712,2,shop,6,7,1
3712,3,work,7,13,6
3712,4,shop,13,14,1
3712,5,work,14,20,6
3712,6,home,20,24,4
3712,7,<ENDS>,24,24,0
3713,0,<START>,0,0,0
3713,1,home,0,6,6
3713,2,work,6,13,7
3713,3,shop,13,14,1
3713,4,work,14,19,5
3713,5,home,19,24,5
3713,6,<ENDS>,24,24,0
3714,0,<START>,0,0,0
3714,1,home,0,9,9
3714,2,work,9,16,7
3714,3,home,16,24,8
3714,4,<ENDS>,24,24,0
3715,0,<START>,0,0,0
3715,1,home,0,6,6
3715,2,work,6,13,7
3715,3,home,13,17,4
3715,4,work,17,20,3
3715,5,home,20,24,4
3715,6,<ENDS>,24,24,0
3716,0,<START>,0,0,0
3716,1,home,0,8,8
3716,2,education,8,12,4
3716,3,shop,12,13,1
3716,4,work,13,19,6
3716,5,home,19,24,5
3716,6,<ENDS>,24,24,0
3717,0,<START>,0,0,0
3717,1,home,0,6,6
3717,2,shop,6,7,1
3717,3,work,7,15,8
3717,4,home,15,24,9
3717,5,<ENDS>,24,24,0
3718,0,<START>,0,0,0
3718,1,home,0,6,6
3718,2,shop,6,7,1
3718,3,work,7,14,7
3718,4,home,14,24,10
3718,5,<ENDS>,24,24,0
3719,0,<START>,0,0,0
3719,1,home,0,8,8
3719,2,work,8,15,7
3719,3,home,15,24,9
3719,4,<ENDS>,24,24,0
3720,0,<START>,0,0,0
3720,1,home,0,7,7
3720,2,shop,7,9,2
3720,3,work,9,16,7
3720,4,shop,16,17,1
3720,5,home,17,24,7
3720,6,<ENDS>,24,24,0
3721,0,<START>,0,0,0
3721,1,home,0,6,6
3721,2,work,6,8,2
3721,3,home,8,12,4
3721,4,work,12,14,2
3721,5,home,14,21,7
3721,6,work,21,22,1
3721,7,home,22,24,2
3721,8,<ENDS>,24,24,0
3722,0,<START>,0,0,0
3722,1,home,0,7,7
3722,2,education,7,11,4
3722,3,home,11,18,7
3722,4,shop,18,19,1
3722,5,home,19,24,5
3722,6,<ENDS>,24,24,0
3723,0,<START>,0,0,0
3723,1,home,0,7,7
3723,2,education,7,11,4
3723,3,home,11,18,7
3723,4,shop,18,19,1
3723,5,home,19,24,5
3723,6,<ENDS>,24,24,0
3724,0,<START>,0,0,0
3724,1,home,0,7,7
3724,2,work,7,14,7
3724,3,home,14,24,10
3724,4,<ENDS>,24,24,0
3725,0,<START>,0,0,0
3725,1,home,0,8,8
3725,2,education,8,11,3
3725,3,shop,11,12,1
3725,4,home,12,18,6
3725,5,work,18,20,2
3725,6,home,20,24,4
3725,7,<ENDS>,24,24,0
3726,0,<START>,0,0,0
3726,1,home,0,6,6
3726,2,shop,6,7,1
3726,3,work,7,13,6
3726,4,home,13,16,3
3726,5,work,16,20,4
3726,6,home,20,24,4
3726,7,<ENDS>,24,24,0
3727,0,<START>,0,0,0
3727,1,home,0,6,6
3727,2,shop,6,7,1
3727,3,home,7,10,3
3727,4,education,10,12,2
3727,5,home,12,21,9
3727,6,shop,21,22,1
3727,7,home,22,24,2
3727,8,<ENDS>,24,24,0
3728,0,<START>,0,0,0
3728,1,home,0,6,6
3728,2,work,6,13,7
3728,3,home,13,22,9
3728,4,work,22,23,1
3728,5,home,23,24,1
3728,6,<ENDS>,24,24,0
3729,0,<START>,0,0,0
3729,1,home,0,7,7
3729,2,work,7,13,6
3729,3,home,13,18,5
3729,4,work,18,20,2
3729,5,home,20,24,4
3729,6,<ENDS>,24,24,0
3730,0,<START>,0,0,0
3730,1,home,0,7,7
3730,2,education,7,11,4
3730,3,home,11,19,8
3730,4,shop,19,21,2
3730,5,home,21,24,3
3730,6,<ENDS>,24,24,0
3731,0,<START>,0,0,0
3731,1,home,0,7,7
3731,2,shop,7,8,1
3731,3,education,8,11,3
3731,4,home,11,14,3
3731,5,education,14,15,1
3731,6,shop,15,16,1
3731,7,home,16,21,5
3731,8,shop,21,22,1
3731,9,home,22,24,2
3731,10,<ENDS>,24,24,0
3732,0,<START>,0,0,0
3732,1,home,0,7,7
3732,2,work,7,13,6
3732,3,home,13,17,4
3732,4,shop,17,18,1
3732,5,home,18,22,4
3732,6,work,22,23,1
3732,7,home,23,24,1
3732,8,<ENDS>,24,24,0
3733,0,<START>,0,0,0
3733,1,home,0,9,9
3733,2,work,9,16,7
3733,3,home,16,24,8
3733,4,<ENDS>,24,24,0
3734,0,<START>,0,0,0
3734,1,home,0,8,8
3734,2,work,8,15,7
3734,3,shop,15,16,1
3734,4,home,16,24,8
3734,5,<ENDS>,24,24,0
3735,0,<START>,0,0,0
3735,1,home,0,7,7
3735,2,education,7,11,4
3735,3,home,11,17,6
3735,4,shop,17,18,1
3735,5,home,18,24,6
3735,6,<ENDS>,24,24,0
3736,0,<START>,0,0,0
3736,1,home,0,7,7
3736,2,work,7,9,2
3736,3,home,9,15,6
3736,4,work,15,17,2
3736,5,home,17,22,5
3736,6,work,22,23,1
3736,7,home,23,24,1
3736,8,<ENDS>,24,24,0
3737,0,<START>,0,0,0
3737,1,home,0,6,6
3737,2,work,6,13,7
3737,3,shop,13,14,1
3737,4,education,14,17,3
3737,5,home,17,24,7
3737,6,<ENDS>,24,24,0
3738,0,<START>,0,0,0
3738,1,home,0,7,7
3738,2,work,7,14,7
3738,3,shop,14,15,1
3738,4,home,15,21,6
3738,5,work,21,22,1
3738,6,home,22,24,2
3738,7,<ENDS>,24,24,0
3739,0,<START>,0,0,0
3739,1,home,0,7,7
3739,2,work,7,13,6
3739,3,shop,13,14,1
3739,4,education,14,16,2
3739,5,shop,16,17,1
3739,6,home,17,24,7
3739,7,<ENDS>,24,24,0
3740,0,<START>,0,0,0
3740,1,home,0,8,8
3740,2,work,8,15,7
3740,3,home,15,20,5
3740,4,shop,20,21,1
3740,5,home,21,24,3
3740,6,<ENDS>,24,24,0
3741,0,<START>,0,0,0
3741,1,home,0,6,6
3741,2,work,6,13,7
3741,3,shop,13,14,1
3741,4,home,14,24,10
3741,5,<ENDS>,24,24,0
3742,0,<START>,0,0,0
3742,1,home,0,7,7
3742,2,work,7,14,7
3742,3,home,14,24,10
3742,4,<ENDS>,24,24,0
3743,0,<START>,0,0,0
3743,1,home,0,6,6
3743,2,shop,6,7,1
3743,3,home,7,9,2
3743,4,education,9,12,3
3743,5,shop,12,14,2
3743,6,education,14,16,2
3743,7,home,16,24,8
3743,8,<ENDS>,24,24,0
3744,0,<START>,0,0,0
3744,1,home,0,8,8
3744,2,work,8,14,6
3744,3,home,14,16,2
3744,4,shop,16,17,1
3744,5,work,17,20,3
3744,6,home,20,24,4
3744,7,<ENDS>,24,24,0
3745,0,<START>,0,0,0
3745,1,home,0,7,7
3745,2,work,7,15,8
3745,3,home,15,24,9
3745,4,<ENDS>,24,24,0
3746,0,<START>,0,0,0
3746,1,home,0,7,7
3746,2,work,7,13,6
3746,3,shop,13,14,1
3746,4,work,14,20,6
3746,5,home,20,24,4
3746,6,<ENDS>,24,24,0
3747,0,<START>,0,0,0
3747,1,home,0,6,6
3747,2,work,6,8,2
3747,3,home,8,12,4
3747,4,work,12,14,2
3747,5,home,14,17,3
3747,6,work,17,19,2
3747,7,home,19,24,5
3747,8,<ENDS>,24,24,0
3748,0,<START>,0,0,0
3748,1,home,0,8,8
3748,2,work,8,15,7
3748,3,home,15,23,8
3748,4,work,23,24,1
3748,5,<ENDS>,24,24,0
3749,0,<START>,0,0,0
3749,1,home,0,7,7
3749,2,work,7,13,6
3749,3,shop,13,14,1
3749,4,work,14,20,6
3749,5,home,20,24,4
3749,6,<ENDS>,24,24,0
3750,0,<START>,0,0,0
3750,1,home,0,7,7
3750,2,work,7,14,7
3750,3,home,14,22,8
3750,4,work,22,23,1
3750,5,home,23,24,1
3750,6,<ENDS>,24,24,0
3751,0,<START>,0,0,0
3751,1,work,0,1,1
3751,2,home,1,8,7
3751,3,education,8,11,3
3751,4,home,11,14,3
3751,5,education,14,16,2
3751,6,home,16,24,8
3751,7,<ENDS>,24,24,0
3752,0,<START>,0,0,0
3752,1,home,0,6,6
3752,2,work,6,13,7
3752,3,shop,13,14,1
3752,4,home,14,18,4
3752,5,work,18,20,2
3752,6,home,20,24,4
3752,7,<ENDS>,24,24,0
3753,0,<START>,0,0,0
3753,1,home,0,7,7
3753,2,work,7,13,6
3753,3,home,13,17,4
3753,4,shop,17,18,1
3753,5,home,18,24,6
3753,6,<ENDS>,24,24,0
3754,0,<START>,0,0,0
3754,1,home,0,7,7
3754,2,work,7,14,7
3754,3,shop,14,16,2
3754,4,work,16,20,4
3754,5,home,20,24,4
3754,6,<ENDS>,24,24,0
3755,0,<START>,0,0,0
3755,1,home,0,7,7
3755,2,work,7,13,6
3755,3,shop,13,14,1
3755,4,work,14,16,2
3755,5,home,16,24,8
3755,6,<ENDS>,24,24,0
3756,0,<START>,0,0,0
3756,1,home,0,6,6
3756,2,shop,6,7,1
3756,3,work,7,14,7
3756,4,home,14,24,10
3756,5,<ENDS>,24,24,0
3757,0,<START>,0,0,0
3757,1,home,0,6,6
3757,2,work,6,13,7
3757,3,home,13,18,5
3757,4,shop,18,19,1
3757,5,home,19,24,5
3757,6,<ENDS>,24,24,0
3758,0,<START>,0,0,0
3758,1,home,0,8,8
3758,2,work,8,14,6
3758,3,home,14,21,7
3758,4,work,21,22,1
3758,5,home,22,24,2
3758,6,<ENDS>,24,24,0
3759,0,<START>,0,0,0
3759,1,home,0,9,9
3759,2,shop,9,10,1
3759,3,home,10,13,3
3759,4,work,13,19,6
3759,5,home,19,24,5
3759,6,<ENDS>,24,24,0
3760,0,<START>,0,0,0
3760,1,home,0,6,6
3760,2,work,6,8,2
3760,3,home,8,12,4
3760,4,work,12,13,1
3760,5,home,13,21,8
3760,6,work,21,22,1
3760,7,home,22,24,2
3760,8,<ENDS>,24,24,0
3761,0,<START>,0,0,0
3761,1,home,0,7,7
3761,2,work,7,13,6
3761,3,shop,13,14,1
3761,4,home,14,24,10
3761,5,<ENDS>,24,24,0
3762,0,<START>,0,0,0
3762,1,home,0,7,7
3762,2,education,7,11,4
3762,3,home,11,19,8
3762,4,shop,19,20,1
3762,5,home,20,24,4
3762,6,<ENDS>,24,24,0
3763,0,<START>,0,0,0
3763,1,home,0,8,8
3763,2,work,8,14,6
3763,3,home,14,20,6
3763,4,shop,20,21,1
3763,5,home,21,24,3
3763,6,<ENDS>,24,24,0
3764,0,<START>,0,0,0
3764,1,home,0,6,6
3764,2,work,6,8,2
3764,3,home,8,12,4
3764,4,work,12,14,2
3764,5,home,14,23,9
3764,6,work,23,24,1
3764,7,<ENDS>,24,24,0
3765,0,<START>,0,0,0
3765,1,home,0,5,5
3765,2,work,5,7,2
3765,3,home,7,13,6
3765,4,work,13,15,2
3765,5,home,15,22,7
3765,6,work,22,23,1
3765,7,home,23,24,1
3765,8,<ENDS>,24,24,0
3766,0,<START>,0,0,0
3766,1,home,0,6,6
3766,2,shop,6,7,1
3766,3,home,7,8,1
3766,4,education,8,11,3
3766,5,home,11,20,9
3766,6,shop,20,21,1
3766,7,home,21,24,3
3766,8,<ENDS>,24,24,0
3767,0,<START>,0,0,0
3767,1,home,0,7,7
3767,2,work,7,14,7
3767,3,shop,14,15,1
3767,4,work,15,19,4
3767,5,home,19,24,5
3767,6,<ENDS>,24,24,0
3768,0,<START>,0,0,0
3768,1,home,0,7,7
3768,2,education,7,12,5
3768,3,shop,12,14,2
3768,4,education,14,16,2
3768,5,home,16,24,8
3768,6,<ENDS>,24,24,0
3769,0,<START>,0,0,0
3769,1,home,0,7,7
3769,2,work,7,14,7
3769,3,shop,14,16,2
3769,4,home,16,23,7
3769,5,work,23,24,1
3769,6,<ENDS>,24,24,0
3770,0,<START>,0,0,0
3770,1,home,0,7,7
3770,2,work,7,12,5
3770,3,shop,12,13,1
3770,4,work,13,19,6
3770,5,home,19,24,5
3770,6,<ENDS>,24,24,0
3771,0,<START>,0,0,0
3771,1,home,0,8,8
3771,2,work,8,14,6
3771,3,home,14,16,2
3771,4,work,16,20,4
3771,5,home,20,24,4
3771,6,<ENDS>,24,24,0
3772,0,<START>,0,0,0
3772,1,home,0,7,7
3772,2,shop,7,8,1
3772,3,education,8,11,3
3772,4,home,11,15,4
3772,5,shop,15,16,1
3772,6,home,16,19,3
3772,7,shop,19,21,2
3772,8,home,21,24,3
3772,9,<ENDS>,24,24,0
3773,0,<START>,0,0,0
3773,1,home,0,7,7
3773,2,work,7,8,1
3773,3,home,8,12,4
3773,4,work,12,14,2
3773,5,home,14,18,4
3773,6,work,18,20,2
3773,7,home,20,24,4
3773,8,<ENDS>,24,24,0
3774,0,<START>,0,0,0
3774,1,home,0,7,7
3774,2,work,7,13,6
3774,3,home,13,17,4
3774,4,work,17,19,2
3774,5,home,19,24,5
3774,6,<ENDS>,24,24,0
3775,0,<START>,0,0,0
3775,1,home,0,7,7
3775,2,education,7,11,4
3775,3,home,11,19,8
3775,4,shop,19,20,1
3775,5,home,20,24,4
3775,6,<ENDS>,24,24,0
3776,0,<START>,0,0,0
3776,1,home,0,8,8
3776,2,work,8,15,7
3776,3,shop,15,16,1
3776,4,work,16,19,3
3776,5,home,19,24,5
3776,6,<ENDS>,24,24,0
3777,0,<START>,0,0,0
3777,1,home,0,7,7
3777,2,education,7,11,4
3777,3,home,11,17,6
3777,4,shop,17,18,1
3777,5,home,18,24,6
3777,6,<ENDS>,24,24,0
3778,0,<START>,0,0,0
3778,1,home,0,6,6
3778,2,work,6,13,7
3778,3,home,13,24,11
3778,4,<ENDS>,24,24,0
3779,0,<START>,0,0,0
3779,1,home,0,7,7
3779,2,shop,7,8,1
3779,3,education,8,11,3
3779,4,home,11,18,7
3779,5,shop,18,19,1
3779,6,home,19,24,5
3779,7,<ENDS>,24,24,0
3780,0,<START>,0,0,0
3780,1,home,0,7,7
3780,2,work,7,13,6
3780,3,home,13,23,10
3780,4,work,23,24,1
3780,5,<ENDS>,24,24,0
3781,0,<START>,0,0,0
3781,1,home,0,7,7
3781,2,work,7,14,7
3781,3,home,14,24,10
3781,4,<ENDS>,24,24,0
3782,0,<START>,0,0,0
3782,1,home,0,7,7
3782,2,work,7,14,7
3782,3,shop,14,15,1
3782,4,work,15,20,5
3782,5,home,20,24,4
3782,6,<ENDS>,24,24,0
3783,0,<START>,0,0,0
3783,1,home,0,6,6
3783,2,shop,6,7,1
3783,3,work,7,9,2
3783,4,home,9,15,6
3783,5,work,15,17,2
3783,6,home,17,24,7
3783,7,<ENDS>,24,24,0
3784,0,<START>,0,0,0
3784,1,home,0,6,6
3784,2,work,6,13,7
3784,3,shop,13,14,1
3784,4,home,14,24,10
3784,5,<ENDS>,24,24,0
3785,0,<START>,0,0,0
3785,1,home,0,7,7
3785,2,work,7,13,6
3785,3,home,13,24,11
3785,4,<ENDS>,24,24,0
3786,0,<START>,0,0,0
3786,1,home,0,6,6
3786,2,work,6,8,2
3786,3,home,8,13,5
3786,4,work,13,15,2
3786,5,home,15,22,7
3786,6,work,22,23,1
3786,7,home,23,24,1
3786,8,<ENDS>,24,24,0
3787,0,<START>,0,0,0
3787,1,home,0,8,8
3787,2,education,8,11,3
3787,3,home,11,17,6
3787,4,shop,17,19,2
3787,5,home,19,24,5
3787,6,<ENDS>,24,24,0
3788,0,<START>,0,0,0
3788,1,home,0,7,7
3788,2,work,7,13,6
3788,3,home,13,17,4
3788,4,shop,17,18,1
3788,5,home,18,24,6
3788,6,<ENDS>,24,24,0
3789,0,<START>,0,0,0
3789,1,home,0,7,7
3789,2,work,7,13,6
3789,3,home,13,21,8
3789,4,shop,21,22,1
3789,5,home,22,24,2
3789,6,<ENDS>,24,24,0
3790,0,<START>,0,0,0
3790,1,home,0,7,7
3790,2,work,7,14,7
3790,3,home,14,24,10
3790,4,<ENDS>,24,24,0
3791,0,<START>,0,0,0
3791,1,home,0,6,6
3791,2,shop,6,7,1
3791,3,home,7,10,3
3791,4,work,10,12,2
3791,5,home,12,21,9
3791,6,work,21,22,1
3791,7,home,22,24,2
3791,8,<ENDS>,24,24,0
3792,0,<START>,0,0,0
3792,1,home,0,8,8
3792,2,work,8,14,6
3792,3,home,14,17,3
3792,4,work,17,20,3
3792,5,home,20,24,4
3792,6,<ENDS>,24,24,0
3793,0,<START>,0,0,0
3793,1,home,0,8,8
3793,2,work,8,15,7
3793,3,home,15,22,7
3793,4,work,22,23,1
3793,5,home,23,24,1
3793,6,<ENDS>,24,24,0
3794,0,<START>,0,0,0
3794,1,home,0,8,8
3794,2,work,8,15,7
3794,3,shop,15,16,1
3794,4,home,16,22,6
3794,5,work,22,23,1
3794,6,home,23,24,1
3794,7,<ENDS>,24,24,0
3795,0,<START>,0,0,0
3795,1,home,0,7,7
3795,2,work,7,13,6
3795,3,home,13,24,11
3795,4,<ENDS>,24,24,0
3796,0,<START>,0,0,0
3796,1,home,0,8,8
3796,2,education,8,14,6
3796,3,shop,14,16,2
3796,4,home,16,24,8
3796,5,<ENDS>,24,24,0
3797,0,<START>,0,0,0
3797,1,home,0,7,7
3797,2,work,7,14,7
3797,3,home,14,18,4
3797,4,work,18,20,2
3797,5,home,20,24,4
3797,6,<ENDS>,24,24,0
3798,0,<START>,0,0,0
3798,1,home,0,6,6
3798,2,shop,6,7,1
3798,3,home,7,9,2
3798,4,work,9,16,7
3798,5,home,16,22,6
3798,6,work,22,23,1
3798,7,home,23,24,1
3798,8,<ENDS>,24,24,0
3799,0,<START>,0,0,0
3799,1,home,0,7,7
3799,2,work,7,14,7
3799,3,shop,14,15,1
3799,4,home,15,24,9
3799,5,<ENDS>,24,24,0
3800,0,<START>,0,0,0
3800,1,home,0,8,8
3800,2,shop,8,9,1
3800,3,work,9,15,6
3800,4,home,15,24,9
3800,5,<ENDS>,24,24,0
3801,0,<START>,0,0,0
3801,1,home,0,7,7
3801,2,work,7,13,6
3801,3,shop,13,14,1
3801,4,home,14,21,7
3801,5,work,21,22,1
3801,6,home,22,24,2
3801,7,<ENDS>,24,24,0
3802,0,<START>,0,0,0
3802,1,home,0,7,7
3802,2,work,7,8,1
3802,3,home,8,12,4
3802,4,work,12,14,2
3802,5,home,14,21,7
3802,6,work,21,22,1
3802,7,home,22,24,2
3802,8,<ENDS>,24,24,0
3803,0,<START>,0,0,0
3803,1,home,0,7,7
3803,2,work,7,14,7
3803,3,home,14,15,1
3803,4,shop,15,16,1
3803,5,work,16,20,4
3803,6,home,20,24,4
3803,7,<ENDS>,24,24,0
3804,0,<START>,0,0,0
3804,1,home,0,7,7
3804,2,work,7,14,7
3804,3,home,14,24,10
3804,4,<ENDS>,24,24,0
3805,0,<START>,0,0,0
3805,1,home,0,9,9
3805,2,work,9,15,6
3805,3,shop,15,16,1
3805,4,home,16,24,8
3805,5,<ENDS>,24,24,0
3806,0,<START>,0,0,0
3806,1,home,0,6,6
3806,2,shop,6,7,1
3806,3,home,7,9,2
3806,4,education,9,11,2
3806,5,home,11,18,7
3806,6,shop,18,19,1
3806,7,home,19,24,5
3806,8,<ENDS>,24,24,0
3807,0,<START>,0,0,0
3807,1,home,0,6,6
3807,2,work,6,13,7
3807,3,shop,13,14,1
3807,4,home,14,24,10
3807,5,<ENDS>,24,24,0
3808,0,<START>,0,0,0
3808,1,home,0,6,6
3808,2,shop,6,7,1
3808,3,work,7,15,8
3808,4,home,15,24,9
3808,5,<ENDS>,24,24,0
3809,0,<START>,0,0,0
3809,1,home,0,7,7
3809,2,work,7,14,7
3809,3,shop,14,15,1
3809,4,home,15,24,9
3809,5,<ENDS>,24,24,0
3810,0,<START>,0,0,0
3810,1,home,0,8,8
3810,2,work,8,15,7
3810,3,home,15,24,9
3810,4,<ENDS>,24,24,0
3811,0,<START>,0,0,0
3811,1,home,0,6,6
3811,2,work,6,8,2
3811,3,home,8,12,4
3811,4,work,12,14,2
3811,5,home,14,18,4
3811,6,work,18,19,1
3811,7,home,19,23,4
3811,8,work,23,24,1
3811,9,<ENDS>,24,24,0
3812,0,<START>,0,0,0
3812,1,home,0,7,7
3812,2,education,7,11,4
3812,3,home,11,15,4
3812,4,shop,15,16,1
3812,5,home,16,24,8
3812,6,<ENDS>,24,24,0
3813,0,<START>,0,0,0
3813,1,home,0,7,7
3813,2,work,7,13,6
3813,3,home,13,17,4
3813,4,shop,17,18,1
3813,5,home,18,24,6
3813,6,<ENDS>,24,24,0
3814,0,<START>,0,0,0
3814,1,home,0,7,7
3814,2,education,7,11,4
3814,3,home,11,13,2
3814,4,education,13,16,3
3814,5,home,16,24,8
3814,6,<ENDS>,24,24,0
3815,0,<START>,0,0,0
3815,1,home,0,7,7
3815,2,work,7,15,8
3815,3,shop,15,16,1
3815,4,work,16,20,4
3815,5,home,20,24,4
3815,6,<ENDS>,24,24,0
3816,0,<START>,0,0,0
3816,1,home,0,8,8
3816,2,work,8,13,5
3816,3,home,13,24,11
3816,4,<ENDS>,24,24,0
3817,0,<START>,0,0,0
3817,1,home,0,7,7
3817,2,work,7,13,6
3817,3,shop,13,14,1
3817,4,home,14,24,10
3817,5,<ENDS>,24,24,0
3818,0,<START>,0,0,0
3818,1,home,0,8,8
3818,2,work,8,15,7
3818,3,home,15,23,8
3818,4,work,23,24,1
3818,5,<ENDS>,24,24,0
3819,0,<START>,0,0,0
3819,1,home,0,7,7
3819,2,work,7,13,6
3819,3,home,13,17,4
3819,4,work,17,20,3
3819,5,home,20,24,4
3819,6,<ENDS>,24,24,0
3820,0,<START>,0,0,0
3820,1,home,0,6,6
3820,2,work,6,13,7
3820,3,home,13,24,11
3820,4,<ENDS>,24,24,0
3821,0,<START>,0,0,0
3821,1,home,0,7,7
3821,2,work,7,13,6
3821,3,home,13,22,9
3821,4,work,22,23,1
3821,5,home,23,24,1
3821,6,<ENDS>,24,24,0
3822,0,<START>,0,0,0
3822,1,home,0,7,7
3822,2,work,7,13,6
3822,3,home,13,17,4
3822,4,work,17,20,3
3822,5,home,20,24,4
3822,6,<ENDS>,24,24,0
3823,0,<START>,0,0,0
3823,1,home,0,6,6
3823,2,shop,6,8,2
3823,3,work,8,16,8
3823,4,home,16,21,5
3823,5,work,21,22,1
3823,6,home,22,24,2
3823,7,<ENDS>,24,24,0
3824,0,<START>,0,0,0
3824,1,home,0,7,7
3824,2,work,7,13,6
3824,3,shop,13,14,1
3824,4,work,14,19,5
3824,5,home,19,24,5
3824,6,<ENDS>,24,24,0
3825,0,<START>,0,0,0
3825,1,home,0,7,7
3825,2,work,7,13,6
3825,3,home,13,18,5
3825,4,work,18,20,2
3825,5,home,20,24,4
3825,6,<ENDS>,24,24,0
3826,0,<START>,0,0,0
3826,1,home,0,6,6
3826,2,shop,6,7,1
3826,3,work,7,14,7
3826,4,home,14,17,3
3826,5,shop,17,18,1
3826,6,home,18,24,6
3826,7,<ENDS>,24,24,0
3827,0,<START>,0,0,0
3827,1,home,0,7,7
3827,2,education,7,11,4
3827,3,home,11,18,7
3827,4,shop,18,19,1
3827,5,home,19,24,5
3827,6,<ENDS>,24,24,0
3828,0,<START>,0,0,0
3828,1,home,0,7,7
3828,2,education,7,12,5
3828,3,shop,12,13,1
3828,4,education,13,16,3
3828,5,home,16,24,8
3828,6,<ENDS>,24,24,0
3829,0,<START>,0,0,0
3829,1,home,0,8,8
3829,2,work,8,14,6
3829,3,shop,14,15,1
3829,4,home,15,24,9
3829,5,<ENDS>,24,24,0
3830,0,<START>,0,0,0
3830,1,home,0,6,6
3830,2,work,6,13,7
3830,3,shop,13,14,1
3830,4,home,14,24,10
3830,5,<ENDS>,24,24,0
3831,0,<START>,0,0,0
3831,1,home,0,7,7
3831,2,work,7,15,8
3831,3,shop,15,16,1
3831,4,home,16,24,8
3831,5,<ENDS>,24,24,0
3832,0,<START>,0,0,0
3832,1,home,0,7,7
3832,2,work,7,13,6
3832,3,home,13,24,11
3832,4,<ENDS>,24,24,0
3833,0,<START>,0,0,0
3833,1,home,0,6,6
3833,2,work,6,8,2
3833,3,home,8,14,6
3833,4,work,14,16,2
3833,5,home,16,22,6
3833,6,work,22,23,1
3833,7,home,23,24,1
3833,8,<ENDS>,24,24,0
3834,0,<START>,0,0,0
3834,1,home,0,8,8
3834,2,work,8,14,6
3834,3,shop,14,15,1
3834,4,home,15,24,9
3834,5,<ENDS>,24,24,0
3835,0,<START>,0,0,0
3835,1,home,0,8,8
3835,2,education,8,14,6
3835,3,shop,14,15,1
3835,4,work,15,20,5
3835,5,home,20,24,4
3835,6,<ENDS>,24,24,0
3836,0,<START>,0,0,0
3836,1,home,0,8,8
3836,2,education,8,11,3
3836,3,home,11,18,7
3836,4,shop,18,20,2
3836,5,home,20,24,4
3836,6,<ENDS>,24,24,0
3837,0,<START>,0,0,0
3837,1,home,0,8,8
3837,2,education,8,11,3
3837,3,home,11,16,5
3837,4,shop,16,17,1
3837,5,home,17,21,4
3837,6,shop,21,22,1
3837,7,home,22,24,2
3837,8,<ENDS>,24,24,0
3838,0,<START>,0,0,0
3838,1,home,0,6,6
3838,2,shop,6,7,1
3838,3,home,7,13,6
3838,4,education,13,16,3
3838,5,home,16,24,8
3838,6,<ENDS>,24,24,0
3839,0,<START>,0,0,0
3839,1,home,0,6,6
3839,2,work,6,8,2
3839,3,home,8,12,4
3839,4,work,12,14,2
3839,5,home,14,21,7
3839,6,work,21,22,1
3839,7,home,22,24,2
3839,8,<ENDS>,24,24,0
3840,0,<START>,0,0,0
3840,1,home,0,7,7
3840,2,work,7,13,6
3840,3,home,13,24,11
3840,4,<ENDS>,24,24,0
3841,0,<START>,0,0,0
3841,1,home,0,7,7
3841,2,work,7,9,2
3841,3,home,9,14,5
3841,4,work,14,16,2
3841,5,home,16,23,7
3841,6,work,23,24,1
3841,7,<ENDS>,24,24,0
3842,0,<START>,0,0,0
3842,1,home,0,8,8
3842,2,work,8,14,6
3842,3,home,14,24,10
3842,4,<ENDS>,24,24,0
3843,0,<START>,0,0,0
3843,1,home,0,6,6
3843,2,shop,6,7,1
3843,3,work,7,9,2
3843,4,home,9,14,5
3843,5,work,14,16,2
3843,6,home,16,21,5
3843,7,work,21,22,1
3843,8,home,22,24,2
3843,9,<ENDS>,24,24,0
3844,0,<START>,0,0,0
3844,1,home,0,7,7
3844,2,work,7,8,1
3844,3,home,8,9,1
3844,4,work,9,11,2
3844,5,home,11,17,6
3844,6,work,17,20,3
3844,7,home,20,24,4
3844,8,<ENDS>,24,24,0
3845,0,<START>,0,0,0
3845,1,home,0,7,7
3845,2,shop,7,8,1
3845,3,education,8,11,3
3845,4,home,11,17,6
3845,5,shop,17,18,1
3845,6,home,18,24,6
3845,7,<ENDS>,24,24,0
3846,0,<START>,0,0,0
3846,1,home,0,7,7
3846,2,work,7,14,7
3846,3,home,14,24,10
3846,4,<ENDS>,24,24,0
3847,0,<START>,0,0,0
3847,1,home,0,7,7
3847,2,work,7,13,6
3847,3,shop,13,14,1
3847,4,work,14,19,5
3847,5,home,19,24,5
3847,6,<ENDS>,24,24,0
3848,0,<START>,0,0,0
3848,1,home,0,9,9
3848,2,work,9,15,6
3848,3,home,15,24,9
3848,4,<ENDS>,24,24,0
3849,0,<START>,0,0,0
3849,1,home,0,8,8
3849,2,work,8,15,7
3849,3,home,15,24,9
3849,4,<ENDS>,24,24,0
3850,0,<START>,0,0,0
3850,1,home,0,7,7
3850,2,work,7,13,6
3850,3,shop,13,14,1
3850,4,work,14,19,5
3850,5,home,19,24,5
3850,6,<ENDS>,24,24,0
3851,0,<START>,0,0,0
3851,1,home,0,8,8
3851,2,work,8,14,6
3851,3,home,14,24,10
3851,4,<ENDS>,24,24,0
3852,0,<START>,0,0,0
3852,1,home,0,7,7
3852,2,work,7,14,7
3852,3,home,14,21,7
3852,4,shop,21,22,1
3852,5,home,22,24,2
3852,6,<ENDS>,24,24,0
3853,0,<START>,0,0,0
3853,1,home,0,8,8
3853,2,work,8,15,7
3853,3,shop,15,16,1
3853,4,work,16,19,3
3853,5,home,19,24,5
3853,6,<ENDS>,24,24,0
3854,0,<START>,0,0,0
3854,1,home,0,6,6
3854,2,work,6,13,7
3854,3,shop,13,14,1
3854,4,home,14,24,10
3854,5,<ENDS>,24,24,0
3855,0,<START>,0,0,0
3855,1,home,0,7,7
3855,2,work,7,13,6
3855,3,shop,13,14,1
3855,4,education,14,16,2
3855,5,home,16,21,5
3855,6,work,21,22,1
3855,7,home,22,24,2
3855,8,<ENDS>,24,24,0
3856,0,<START>,0,0,0
3856,1,home,0,7,7
3856,2,work,7,14,7
3856,3,home,14,24,10
3856,4,<ENDS>,24,24,0
3857,0,<START>,0,0,0
3857,1,home,0,7,7
3857,2,work,7,13,6
3857,3,home,13,18,5
3857,4,shop,18,19,1
3857,5,home,19,23,4
3857,6,work,23,24,1
3857,7,<ENDS>,24,24,0
3858,0,<START>,0,0,0
3858,1,home,0,6,6
3858,2,work,6,8,2
3858,3,home,8,13,5
3858,4,work,13,16,3
3858,5,home,16,24,8
3858,6,<ENDS>,24,24,0
3859,0,<START>,0,0,0
3859,1,home,0,7,7
3859,2,work,7,13,6
3859,3,home,13,19,6
3859,4,shop,19,20,1
3859,5,home,20,23,3
3859,6,work,23,24,1
3859,7,<ENDS>,24,24,0
3860,0,<START>,0,0,0
3860,1,home,0,6,6
3860,2,shop,6,7,1
3860,3,work,7,13,6
3860,4,shop,13,14,1
3860,5,home,14,22,8
3860,6,work,22,23,1
3860,7,home,23,24,1
3860,8,<ENDS>,24,24,0
3861,0,<START>,0,0,0
3861,1,home,0,8,8
3861,2,work,8,15,7
3861,3,shop,15,16,1
3861,4,home,16,24,8
3861,5,<ENDS>,24,24,0
3862,0,<START>,0,0,0
3862,1,home,0,7,7
3862,2,work,7,13,6
3862,3,shop,13,14,1
3862,4,work,14,20,6
3862,5,home,20,24,4
3862,6,<ENDS>,24,24,0
3863,0,<START>,0,0,0
3863,1,home,0,6,6
3863,2,work,6,8,2
3863,3,home,8,14,6
3863,4,work,14,16,2
3863,5,home,16,23,7
3863,6,work,23,24,1
3863,7,<ENDS>,24,24,0
3864,0,<START>,0,0,0
3864,1,home,0,7,7
3864,2,work,7,13,6
3864,3,home,13,22,9
3864,4,work,22,23,1
3864,5,home,23,24,1
3864,6,<ENDS>,24,24,0
3865,0,<START>,0,0,0
3865,1,home,0,7,7
3865,2,work,7,13,6
3865,3,home,13,17,4
3865,4,work,17,20,3
3865,5,home,20,24,4
3865,6,<ENDS>,24,24,0
3866,0,<START>,0,0,0
3866,1,home,0,9,9
3866,2,education,9,12,3
3866,3,home,12,17,5
3866,4,shop,17,18,1
3866,5,home,18,24,6
3866,6,<ENDS>,24,24,0
3867,0,<START>,0,0,0
3867,1,home,0,6,6
3867,2,work,6,13,7
3867,3,shop,13,14,1
3867,4,work,14,19,5
3867,5,home,19,24,5
3867,6,<ENDS>,24,24,0
3868,0,<START>,0,0,0
3868,1,home,0,8,8
3868,2,work,8,16,8
3868,3,shop,16,17,1
3868,4,home,17,21,4
3868,5,work,21,22,1
3868,6,home,22,24,2
3868,7,<ENDS>,24,24,0
3869,0,<START>,0,0,0
3869,1,home,0,8,8
3869,2,work,8,16,8
3869,3,shop,16,17,1
3869,4,home,17,21,4
3869,5,work,21,22,1
3869,6,home,22,24,2
3869,7,<ENDS>,24,24,0
3870,0,<START>,0,0,0
3870,1,home,0,6,6
3870,2,work,6,13,7
3870,3,home,13,24,11
3870,4,<ENDS>,24,24,0
3871,0,<START>,0,0,0
3871,1,home,0,7,7
3871,2,work,7,13,6
3871,3,shop,13,14,1
3871,4,work,14,20,6
3871,5,home,20,24,4
3871,6,<ENDS>,24,24,0
3872,0,<START>,0,0,0
3872,1,home,0,9,9
3872,2,work,9,17,8
3872,3,home,17,24,7
3872,4,<ENDS>,24,24,0
3873,0,<START>,0,0,0
3873,1,home,0,6,6
3873,2,work,6,8,2
3873,3,home,8,13,5
3873,4,work,13,15,2
3873,5,home,15,22,7
3873,6,work,22,23,1
3873,7,home,23,24,1
3873,8,<ENDS>,24,24,0
3874,0,<START>,0,0,0
3874,1,home,0,7,7
3874,2,work,7,13,6
3874,3,home,13,24,11
3874,4,<ENDS>,24,24,0
3875,0,<START>,0,0,0
3875,1,home,0,6,6
3875,2,work,6,13,7
3875,3,shop,13,14,1
3875,4,work,14,20,6
3875,5,home,20,24,4
3875,6,<ENDS>,24,24,0
3876,0,<START>,0,0,0
3876,1,home,0,8,8
3876,2,education,8,11,3
3876,3,home,11,18,7
3876,4,shop,18,19,1
3876,5,home,19,24,5
3876,6,<ENDS>,24,24,0
3877,0,<START>,0,0,0
3877,1,home,0,6,6
3877,2,work,6,8,2
3877,3,home,8,15,7
3877,4,work,15,18,3
3877,5,home,18,24,6
3877,6,<ENDS>,24,24,0
3878,0,<START>,0,0,0
3878,1,home,0,6,6
3878,2,work,6,13,7
3878,3,shop,13,14,1
3878,4,education,14,16,2
3878,5,home,16,24,8
3878,6,<ENDS>,24,24,0
3879,0,<START>,0,0,0
3879,1,home,0,8,8
3879,2,work,8,15,7
3879,3,home,15,19,4
3879,4,shop,19,20,1
3879,5,home,20,24,4
3879,6,<ENDS>,24,24,0
3880,0,<START>,0,0,0
3880,1,home,0,6,6
3880,2,work,6,7,1
3880,3,home,7,11,4
3880,4,work,11,12,1
3880,5,home,12,19,7
3880,6,shop,19,20,1
3880,7,home,20,24,4
3880,8,<ENDS>,24,24,0
3881,0,<START>,0,0,0
3881,1,home,0,7,7
3881,2,work,7,14,7
3881,3,shop,14,15,1
3881,4,work,15,20,5
3881,5,home,20,24,4
3881,6,<ENDS>,24,24,0
3882,0,<START>,0,0,0
3882,1,home,0,6,6
3882,2,shop,6,7,1
3882,3,home,7,13,6
3882,4,education,13,16,3
3882,5,home,16,24,8
3882,6,<ENDS>,24,24,0
3883,0,<START>,0,0,0
3883,1,home,0,8,8
3883,2,work,8,15,7
3883,3,home,15,21,6
3883,4,work,21,22,1
3883,5,home,22,24,2
3883,6,<ENDS>,24,24,0
3884,0,<START>,0,0,0
3884,1,home,0,6,6
3884,2,work,6,14,8
3884,3,shop,14,15,1
3884,4,home,15,24,9
3884,5,<ENDS>,24,24,0
3885,0,<START>,0,0,0
3885,1,home,0,7,7
3885,2,work,7,13,6
3885,3,shop,13,14,1
3885,4,work,14,19,5
3885,5,home,19,24,5
3885,6,<ENDS>,24,24,0
3886,0,<START>,0,0,0
3886,1,home,0,8,8
3886,2,education,8,12,4
3886,3,home,12,18,6
3886,4,shop,18,19,1
3886,5,home,19,24,5
3886,6,<ENDS>,24,24,0
3887,0,<START>,0,0,0
3887,1,home,0,8,8
3887,2,work,8,15,7
3887,3,home,15,24,9
3887,4,<ENDS>,24,24,0
3888,0,<START>,0,0,0
3888,1,home,0,8,8
3888,2,education,8,12,4
3888,3,home,12,19,7
3888,4,shop,19,20,1
3888,5,home,20,24,4
3888,6,<ENDS>,24,24,0
3889,0,<START>,0,0,0
3889,1,home,0,8,8
3889,2,work,8,15,7
3889,3,home,15,21,6
3889,4,work,21,22,1
3889,5,home,22,24,2
3889,6,<ENDS>,24,24,0
3890,0,<START>,0,0,0
3890,1,home,0,7,7
3890,2,education,7,11,4
3890,3,home,11,20,9
3890,4,shop,20,21,1
3890,5,home,21,24,3
3890,6,<ENDS>,24,24,0
3891,0,<START>,0,0,0
3891,1,home,0,6,6
3891,2,shop,6,7,1
3891,3,work,7,13,6
3891,4,home,13,16,3
3891,5,work,16,19,3
3891,6,home,19,24,5
3891,7,<ENDS>,24,24,0
3892,0,<START>,0,0,0
3892,1,home,0,8,8
3892,2,education,8,14,6
3892,3,shop,14,15,1
3892,4,home,15,21,6
3892,5,work,21,22,1
3892,6,home,22,24,2
3892,7,<ENDS>,24,24,0
3893,0,<START>,0,0,0
3893,1,home,0,6,6
3893,2,work,6,13,7
3893,3,home,13,22,9
3893,4,work,22,23,1
3893,5,home,23,24,1
3893,6,<ENDS>,24,24,0
3894,0,<START>,0,0,0
3894,1,home,0,6,6
3894,2,shop,6,7,1
3894,3,home,7,8,1
3894,4,work,8,11,3
3894,5,home,11,18,7
3894,6,work,18,20,2
3894,7,home,20,22,2
3894,8,work,22,23,1
3894,9,home,23,24,1
3894,10,<ENDS>,24,24,0
3895,0,<START>,0,0,0
3895,1,home,0,7,7
3895,2,work,7,14,7
3895,3,home,14,24,10
3895,4,<ENDS>,24,24,0
3896,0,<START>,0,0,0
3896,1,home,0,7,7
3896,2,shop,7,9,2
3896,3,education,9,12,3
3896,4,shop,12,14,2
3896,5,education,14,16,2
3896,6,home,16,24,8
3896,7,<ENDS>,24,24,0
3897,0,<START>,0,0,0
3897,1,home,0,7,7
3897,2,work,7,13,6
3897,3,home,13,24,11
3897,4,<ENDS>,24,24,0
3898,0,<START>,0,0,0
3898,1,home,0,6,6
3898,2,shop,6,7,1
3898,3,home,7,13,6
3898,4,education,13,16,3
3898,5,home,16,24,8
3898,6,<ENDS>,24,24,0
3899,0,<START>,0,0,0
3899,1,home,0,8,8
3899,2,education,8,11,3
3899,3,home,11,16,5
3899,4,shop,16,17,1
3899,5,home,17,24,7
3899,6,<ENDS>,24,24,0
3900,0,<START>,0,0,0
3900,1,home,0,6,6
3900,2,shop,6,7,1
3900,3,home,7,13,6
3900,4,education,13,16,3
3900,5,home,16,24,8
3900,6,<ENDS>,24,24,0
3901,0,<START>,0,0,0
3901,1,home,0,6,6
3901,2,work,6,13,7
3901,3,shop,13,14,1
3901,4,home,14,23,9
3901,5,work,23,24,1
3901,6,<ENDS>,24,24,0
3902,0,<START>,0,0,0
3902,1,home,0,7,7
3902,2,work,7,13,6
3902,3,home,13,15,2
3902,4,shop,15,16,1
3902,5,work,16,20,4
3902,6,home,20,24,4
3902,7,<ENDS>,24,24,0
3903,0,<START>,0,0,0
3903,1,home,0,6,6
3903,2,work,6,13,7
3903,3,shop,13,14,1
3903,4,work,14,19,5
3903,5,education,19,20,1
3903,6,home,20,24,4
3903,7,<ENDS>,24,24,0
3904,0,<START>,0,0,0
3904,1,home,0,7,7
3904,2,work,7,15,8
3904,3,home,15,19,4
3904,4,shop,19,20,1
3904,5,home,20,24,4
3904,6,<ENDS>,24,24,0
3905,0,<START>,0,0,0
3905,1,home,0,7,7
3905,2,education,7,11,4
3905,3,home,11,18,7
3905,4,shop,18,19,1
3905,5,home,19,24,5
3905,6,<ENDS>,24,24,0
3906,0,<START>,0,0,0
3906,1,home,0,8,8
3906,2,work,8,15,7
3906,3,home,15,21,6
3906,4,work,21,22,1
3906,5,home,22,24,2
3906,6,<ENDS>,24,24,0
3907,0,<START>,0,0,0
3907,1,home,0,9,9
3907,2,work,9,17,8
3907,3,home,17,24,7
3907,4,<ENDS>,24,24,0
3908,0,<START>,0,0,0
3908,1,home,0,6,6
3908,2,work,6,14,8
3908,3,home,14,21,7
3908,4,shop,21,22,1
3908,5,home,22,24,2
3908,6,<ENDS>,24,24,0
3909,0,<START>,0,0,0
3909,1,home,0,7,7
3909,2,work,7,14,7
3909,3,shop,14,15,1
3909,4,home,15,21,6
3909,5,work,21,22,1
3909,6,home,22,24,2
3909,7,<ENDS>,24,24,0
3910,0,<START>,0,0,0
3910,1,home,0,6,6
3910,2,work,6,7,1
3910,3,home,7,9,2
3910,4,work,9,11,2
3910,5,home,11,16,5
3910,6,work,16,18,2
3910,7,home,18,23,5
3910,8,work,23,24,1
3910,9,<ENDS>,24,24,0
3911,0,<START>,0,0,0
3911,1,home,0,7,7
3911,2,work,7,13,6
3911,3,shop,13,14,1
3911,4,work,14,20,6
3911,5,home,20,24,4
3911,6,<ENDS>,24,24,0
3912,0,<START>,0,0,0
3912,1,home,0,6,6
3912,2,shop,6,7,1
3912,3,home,7,9,2
3912,4,education,9,12,3
3912,5,shop,12,14,2
3912,6,home,14,24,10
3912,7,<ENDS>,24,24,0
3913,0,<START>,0,0,0
3913,1,home,0,9,9
3913,2,work,9,16,7
3913,3,shop,16,17,1
3913,4,home,17,24,7
3913,5,<ENDS>,24,24,0
3914,0,<START>,0,0,0
3914,1,home,0,7,7
3914,2,work,7,14,7
3914,3,shop,14,15,1
3914,4,home,15,24,9
3914,5,<ENDS>,24,24,0
3915,0,<START>,0,0,0
3915,1,home,0,6,6
3915,2,work,6,14,8
3915,3,home,14,24,10
3915,4,<ENDS>,24,24,0
3916,0,<START>,0,0,0
3916,1,home,0,6,6
3916,2,shop,6,7,1
3916,3,home,7,9,2
3916,4,education,9,11,2
3916,5,home,11,18,7
3916,6,shop,18,19,1
3916,7,home,19,24,5
3916,8,<ENDS>,24,24,0
3917,0,<START>,0,0,0
3917,1,home,0,7,7
3917,2,work,7,14,7
3917,3,home,14,18,4
3917,4,work,18,20,2
3917,5,home,20,24,4
3917,6,<ENDS>,24,24,0
3918,0,<START>,0,0,0
3918,1,home,0,6,6
3918,2,shop,6,7,1
3918,3,home,7,10,3
3918,4,education,10,12,2
3918,5,shop,12,14,2
3918,6,education,14,16,2
3918,7,home,16,24,8
3918,8,<ENDS>,24,24,0
3919,0,<START>,0,0,0
3919,1,home,0,6,6
3919,2,work,6,12,6
3919,3,shop,12,13,1
3919,4,work,13,19,6
3919,5,home,19,24,5
3919,6,<ENDS>,24,24,0
3920,0,<START>,0,0,0
3920,1,home,0,7,7
3920,2,shop,7,8,1
3920,3,education,8,12,4
3920,4,shop,12,15,3
3920,5,home,15,21,6
3920,6,shop,21,22,1
3920,7,home,22,24,2
3920,8,<ENDS>,24,24,0
3921,0,<START>,0,0,0
3921,1,home,0,6,6
3921,2,shop,6,7,1
3921,3,home,7,9,2
3921,4,education,9,15,6
3921,5,home,15,24,9
3921,6,<ENDS>,24,24,0
3922,0,<START>,0,0,0
3922,1,home,0,7,7
3922,2,work,7,14,7
3922,3,home,14,18,4
3922,4,work,18,20,2
3922,5,home,20,24,4
3922,6,<ENDS>,24,24,0
3923,0,<START>,0,0,0
3923,1,home,0,7,7
3923,2,education,7,11,4
3923,3,home,11,18,7
3923,4,shop,18,19,1
3923,5,home,19,24,5
3923,6,<ENDS>,24,24,0
3924,0,<START>,0,0,0
3924,1,home,0,8,8
3924,2,education,8,12,4
3924,3,home,12,13,1
3924,4,education,13,16,3
3924,5,home,16,24,8
3924,6,<ENDS>,24,24,0
3925,0,<START>,0,0,0
3925,1,home,0,7,7
3925,2,shop,7,8,1
3925,3,education,8,11,3
3925,4,home,11,17,6
3925,5,shop,17,18,1
3925,6,home,18,24,6
3925,7,<ENDS>,24,24,0
3926,0,<START>,0,0,0
3926,1,home,0,7,7
3926,2,work,7,13,6
3926,3,home,13,18,5
3926,4,shop,18,19,1
3926,5,home,19,24,5
3926,6,<ENDS>,24,24,0
3927,0,<START>,0,0,0
3927,1,home,0,6,6
3927,2,shop,6,7,1
3927,3,home,7,13,6
3927,4,education,13,16,3
3927,5,home,16,20,4
3927,6,shop,20,21,1
3927,7,home,21,24,3
3927,8,<ENDS>,24,24,0
3928,0,<START>,0,0,0
3928,1,home,0,6,6
3928,2,shop,6,7,1
3928,3,home,7,13,6
3928,4,education,13,16,3
3928,5,shop,16,17,1
3928,6,home,17,24,7
3928,7,<ENDS>,24,24,0
3929,0,<START>,0,0,0
3929,1,home,0,7,7
3929,2,work,7,13,6
3929,3,home,13,24,11
3929,4,<ENDS>,24,24,0
3930,0,<START>,0,0,0
3930,1,home,0,8,8
3930,2,work,8,15,7
3930,3,home,15,17,2
3930,4,shop,17,18,1
3930,5,home,18,24,6
3930,6,<ENDS>,24,24,0
3931,0,<START>,0,0,0
3931,1,home,0,7,7
3931,2,work,7,13,6
3931,3,home,13,17,4
3931,4,work,17,20,3
3931,5,home,20,24,4
3931,6,<ENDS>,24,24,0
3932,0,<START>,0,0,0
3932,1,home,0,7,7
3932,2,shop,7,8,1
3932,3,education,8,12,4
3932,4,shop,12,14,2
3932,5,education,14,16,2
3932,6,shop,16,18,2
3932,7,home,18,24,6
3932,8,<ENDS>,24,24,0
3933,0,<START>,0,0,0
3933,1,home,0,7,7
3933,2,work,7,13,6
3933,3,shop,13,14,1
3933,4,home,14,21,7
3933,5,work,21,22,1
3933,6,home,22,24,2
3933,7,<ENDS>,24,24,0
3934,0,<START>,0,0,0
3934,1,home,0,7,7
3934,2,work,7,13,6
3934,3,shop,13,14,1
3934,4,work,14,20,6
3934,5,home,20,24,4
3934,6,<ENDS>,24,24,0
3935,0,<START>,0,0,0
3935,1,home,0,7,7
3935,2,work,7,13,6
3935,3,shop,13,15,2
3935,4,work,15,20,5
3935,5,home,20,24,4
3935,6,<ENDS>,24,24,0
3936,0,<START>,0,0,0
3936,1,home,0,6,6
3936,2,work,6,8,2
3936,3,home,8,13,5
3936,4,work,13,15,2
3936,5,home,15,21,6
3936,6,shop,21,22,1
3936,7,home,22,24,2
3936,8,<ENDS>,24,24,0
3937,0,<START>,0,0,0
3937,1,home,0,7,7
3937,2,work,7,14,7
3937,3,home,14,24,10
3937,4,<ENDS>,24,24,0
3938,0,<START>,0,0,0
3938,1,home,0,6,6
3938,2,work,6,13,7
3938,3,home,13,17,4
3938,4,shop,17,18,1
3938,5,home,18,24,6
3938,6,<ENDS>,24,24,0
3939,0,<START>,0,0,0
3939,1,home,0,6,6
3939,2,shop,6,7,1
3939,3,home,7,9,2
3939,4,education,9,13,4
3939,5,home,13,20,7
3939,6,shop,20,21,1
3939,7,home,21,24,3
3939,8,<ENDS>,24,24,0
3940,0,<START>,0,0,0
3940,1,home,0,8,8
3940,2,education,8,13,5
3940,3,shop,13,14,1
3940,4,home,14,18,4
3940,5,work,18,20,2
3940,6,home,20,24,4
3940,7,<ENDS>,24,24,0
3941,0,<START>,0,0,0
3941,1,home,0,7,7
3941,2,work,7,13,6
3941,3,home,13,17,4
3941,4,work,17,20,3
3941,5,home,20,24,4
3941,6,<ENDS>,24,24,0
3942,0,<START>,0,0,0
3942,1,home,0,7,7
3942,2,education,7,11,4
3942,3,home,11,17,6
3942,4,shop,17,18,1
3942,5,home,18,24,6
3942,6,<ENDS>,24,24,0
3943,0,<START>,0,0,0
3943,1,home,0,7,7
3943,2,shop,7,9,2
3943,3,education,9,11,2
3943,4,home,11,19,8
3943,5,shop,19,21,2
3943,6,home,21,24,3
3943,7,<ENDS>,24,24,0
3944,0,<START>,0,0,0
3944,1,home,0,8,8
3944,2,work,8,15,7
3944,3,shop,15,16,1
3944,4,home,16,24,8
3944,5,<ENDS>,24,24,0
3945,0,<START>,0,0,0
3945,1,home,0,8,8
3945,2,work,8,14,6
3945,3,home,14,17,3
3945,4,work,17,20,3
3945,5,home,20,24,4
3945,6,<ENDS>,24,24,0
3946,0,<START>,0,0,0
3946,1,home,0,6,6
3946,2,shop,6,7,1
3946,3,home,7,16,9
3946,4,work,16,20,4
3946,5,home,20,24,4
3946,6,<ENDS>,24,24,0
3947,0,<START>,0,0,0
3947,1,home,0,7,7
3947,2,work,7,13,6
3947,3,home,13,17,4
3947,4,work,17,20,3
3947,5,home,20,24,4
3947,6,<ENDS>,24,24,0
3948,0,<START>,0,0,0
3948,1,home,0,6,6
3948,2,work,6,13,7
3948,3,shop,13,14,1
3948,4,work,14,19,5
3948,5,home,19,24,5
3948,6,<ENDS>,24,24,0
3949,0,<START>,0,0,0
3949,1,home,0,7,7
3949,2,work,7,13,6
3949,3,home,13,17,4
3949,4,work,17,20,3
3949,5,home,20,24,4
3949,6,<ENDS>,24,24,0
3950,0,<START>,0,0,0
3950,1,home,0,6,6
3950,2,work,6,13,7
3950,3,home,13,21,8
3950,4,work,21,22,1
3950,5,home,22,24,2
3950,6,<ENDS>,24,24,0
3951,0,<START>,0,0,0
3951,1,home,0,6,6
3951,2,work,6,8,2
3951,3,home,8,13,5
3951,4,work,13,15,2
3951,5,home,15,22,7
3951,6,work,22,23,1
3951,7,home,23,24,1
3951,8,<ENDS>,24,24,0
3952,0,<START>,0,0,0
3952,1,home,0,7,7
3952,2,education,7,11,4
3952,3,home,11,14,3
3952,4,education,14,16,2
3952,5,shop,16,18,2
3952,6,home,18,24,6
3952,7,<ENDS>,24,24,0
3953,0,<START>,0,0,0
3953,1,home,0,7,7
3953,2,education,7,12,5
3953,3,shop,12,14,2
3953,4,education,14,16,2
3953,5,home,16,24,8
3953,6,<ENDS>,24,24,0
3954,0,<START>,0,0,0
3954,1,home,0,6,6
3954,2,work,6,13,7
3954,3,home,13,22,9
3954,4,work,22,23,1
3954,5,home,23,24,1
3954,6,<ENDS>,24,24,0
3955,0,<START>,0,0,0
3955,1,home,0,7,7
3955,2,work,7,9,2
3955,3,home,9,12,3
3955,4,work,12,14,2
3955,5,home,14,20,6
3955,6,shop,20,21,1
3955,7,home,21,24,3
3955,8,<ENDS>,24,24,0
3956,0,<START>,0,0,0
3956,1,home,0,7,7
3956,2,work,7,15,8
3956,3,home,15,23,8
3956,4,work,23,24,1
3956,5,<ENDS>,24,24,0
3957,0,<START>,0,0,0
3957,1,home,0,8,8
3957,2,work,8,15,7
3957,3,home,15,20,5
3957,4,shop,20,21,1
3957,5,home,21,24,3
3957,6,<ENDS>,24,24,0
3958,0,<START>,0,0,0
3958,1,home,0,7,7
3958,2,work,7,9,2
3958,3,home,9,15,6
3958,4,work,15,17,2
3958,5,home,17,23,6
3958,6,work,23,24,1
3958,7,<ENDS>,24,24,0
3959,0,<START>,0,0,0
3959,1,home,0,7,7
3959,2,education,7,11,4
3959,3,home,11,19,8
3959,4,shop,19,20,1
3959,5,home,20,24,4
3959,6,<ENDS>,24,24,0
3960,0,<START>,0,0,0
3960,1,home,0,8,8
3960,2,work,8,14,6
3960,3,home,14,24,10
3960,4,<ENDS>,24,24,0
3961,0,<START>,0,0,0
3961,1,home,0,6,6
3961,2,work,6,13,7
3961,3,shop,13,14,1
3961,4,home,14,24,10
3961,5,<ENDS>,24,24,0
3962,0,<START>,0,0,0
3962,1,home,0,7,7
3962,2,education,7,13,6
3962,3,shop,13,15,2
3962,4,home,15,24,9
3962,5,<ENDS>,24,24,0
3963,0,<START>,0,0,0
3963,1,home,0,7,7
3963,2,work,7,14,7
3963,3,shop,14,15,1
3963,4,home,15,24,9
3963,5,<ENDS>,24,24,0
3964,0,<START>,0,0,0
3964,1,home,0,7,7
3964,2,work,7,13,6
3964,3,home,13,16,3
3964,4,work,16,19,3
3964,5,home,19,24,5
3964,6,<ENDS>,24,24,0
3965,0,<START>,0,0,0
3965,1,home,0,6,6
3965,2,work,6,7,1
3965,3,home,7,12,5
3965,4,work,12,14,2
3965,5,home,14,18,4
3965,6,work,18,19,1
3965,7,home,19,24,5
3965,8,<ENDS>,24,24,0
3966,0,<START>,0,0,0
3966,1,home,0,8,8
3966,2,work,8,14,6
3966,3,shop,14,15,1
3966,4,work,15,19,4
3966,5,home,19,24,5
3966,6,<ENDS>,24,24,0
3967,0,<START>,0,0,0
3967,1,home,0,6,6
3967,2,work,6,13,7
3967,3,home,13,24,11
3967,4,<ENDS>,24,24,0
3968,0,<START>,0,0,0
3968,1,home,0,7,7
3968,2,work,7,8,1
3968,3,home,8,13,5
3968,4,work,13,14,1
3968,5,home,14,21,7
3968,6,work,21,22,1
3968,7,home,22,24,2
3968,8,<ENDS>,24,24,0
3969,0,<START>,0,0,0
3969,1,home,0,6,6
3969,2,work,6,7,1
3969,3,home,7,11,4
3969,4,work,11,13,2
3969,5,home,13,20,7
3969,6,shop,20,21,1
3969,7,home,21,24,3
3969,8,<ENDS>,24,24,0
3970,0,<START>,0,0,0
3970,1,home,0,6,6
3970,2,work,6,7,1
3970,3,home,7,10,3
3970,4,work,10,12,2
3970,5,home,12,17,5
3970,6,work,17,19,2
3970,7,home,19,24,5
3970,8,<ENDS>,24,24,0
3971,0,<START>,0,0,0
3971,1,home,0,7,7
3971,2,work,7,13,6
3971,3,home,13,18,5
3971,4,work,18,19,1
3971,5,home,19,24,5
3971,6,<ENDS>,24,24,0
3972,0,<START>,0,0,0
3972,1,home,0,7,7
3972,2,work,7,9,2
3972,3,home,9,15,6
3972,4,work,15,17,2
3972,5,home,17,23,6
3972,6,work,23,24,1
3972,7,<ENDS>,24,24,0
3973,0,<START>,0,0,0
3973,1,home,0,7,7
3973,2,work,7,13,6
3973,3,shop,13,14,1
3973,4,work,14,20,6
3973,5,home,20,24,4
3973,6,<ENDS>,24,24,0
3974,0,<START>,0,0,0
3974,1,home,0,7,7
3974,2,work,7,13,6
3974,3,home,13,24,11
3974,4,<ENDS>,24,24,0
3975,0,<START>,0,0,0
3975,1,home,0,8,8
3975,2,work,8,15,7
3975,3,home,15,23,8
3975,4,work,23,24,1
3975,5,<ENDS>,24,24,0
3976,0,<START>,0,0,0
3976,1,home,0,7,7
3976,2,work,7,15,8
3976,3,home,15,24,9
3976,4,<ENDS>,24,24,0
3977,0,<START>,0,0,0
3977,1,home,0,6,6
3977,2,work,6,13,7
3977,3,home,13,16,3
3977,4,shop,16,17,1
3977,5,home,17,24,7
3977,6,<ENDS>,24,24,0
3978,0,<START>,0,0,0
3978,1,home,0,7,7
3978,2,work,7,9,2
3978,3,home,9,13,4
3978,4,work,13,15,2
3978,5,home,15,22,7
3978,6,work,22,23,1
3978,7,home,23,24,1
3978,8,<ENDS>,24,24,0
3979,0,<START>,0,0,0
3979,1,home,0,7,7
3979,2,work,7,14,7
3979,3,home,14,24,10
3979,4,<ENDS>,24,24,0
3980,0,<START>,0,0,0
3980,1,home,0,8,8
3980,2,work,8,14,6
3980,3,shop,14,15,1
3980,4,work,15,19,4
3980,5,home,19,24,5
3980,6,<ENDS>,24,24,0
3981,0,<START>,0,0,0
3981,1,home,0,9,9
3981,2,work,9,16,7
3981,3,home,16,24,8
3981,4,<ENDS>,24,24,0
3982,0,<START>,0,0,0
3982,1,home,0,7,7
3982,2,work,7,14,7
3982,3,shop,14,15,1
3982,4,home,15,24,9
3982,5,<ENDS>,24,24,0
3983,0,<START>,0,0,0
3983,1,home,0,6,6
3983,2,work,6,14,8
3983,3,shop,14,15,1
3983,4,home,15,24,9
3983,5,<ENDS>,24,24,0
3984,0,<START>,0,0,0
3984,1,home,0,6,6
3984,2,shop,6,7,1
3984,3,work,7,13,6
3984,4,home,13,24,11
3984,5,<ENDS>,24,24,0
3985,0,<START>,0,0,0
3985,1,home,0,8,8
3985,2,work,8,15,7
3985,3,home,15,24,9
3985,4,<ENDS>,24,24,0
3986,0,<START>,0,0,0
3986,1,home,0,7,7
3986,2,work,7,14,7
3986,3,home,14,23,9
3986,4,work,23,24,1
3986,5,<ENDS>,24,24,0
3987,0,<START>,0,0,0
3987,1,home,0,7,7
3987,2,work,7,14,7
3987,3,home,14,24,10
3987,4,<ENDS>,24,24,0
3988,0,<START>,0,0,0
3988,1,home,0,7,7
3988,2,work,7,13,6
3988,3,shop,13,14,1
3988,4,home,14,18,4
3988,5,work,18,20,2
3988,6,home,20,24,4
3988,7,<ENDS>,24,24,0
3989,0,<START>,0,0,0
3989,1,home,0,7,7
3989,2,work,7,9,2
3989,3,home,9,15,6
3989,4,work,15,17,2
3989,5,home,17,23,6
3989,6,work,23,24,1
3989,7,<ENDS>,24,24,0
3990,0,<START>,0,0,0
3990,1,home,0,7,7
3990,2,work,7,13,6
3990,3,home,13,22,9
3990,4,work,22,23,1
3990,5,home,23,24,1
3990,6,<ENDS>,24,24,0
3991,0,<START>,0,0,0
3991,1,home,0,6,6
3991,2,work,6,13,7
3991,3,shop,13,14,1
3991,4,home,14,24,10
3991,5,<ENDS>,24,24,0
3992,0,<START>,0,0,0
3992,1,home,0,7,7
3992,2,work,7,14,7
3992,3,home,14,24,10
3992,4,<ENDS>,24,24,0
3993,0,<START>,0,0,0
3993,1,home,0,7,7
3993,2,shop,7,8,1
3993,3,education,8,11,3
3993,4,home,11,18,7
3993,5,shop,18,19,1
3993,6,home,19,24,5
3993,7,<ENDS>,24,24,0
3994,0,<START>,0,0,0
3994,1,home,0,7,7
3994,2,education,7,11,4
3994,3,home,11,16,5
3994,4,shop,16,18,2
3994,5,home,18,24,6
3994,6,<ENDS>,24,24,0
3995,0,<START>,0,0,0
3995,1,home,0,8,8
3995,2,education,8,11,3
3995,3,home,11,15,4
3995,4,work,15,19,4
3995,5,home,19,24,5
3995,6,<ENDS>,24,24,0
3996,0,<START>,0,0,0
3996,1,home,0,6,6
3996,2,shop,6,7,1
3996,3,home,7,10,3
3996,4,education,10,14,4
3996,5,work,14,20,6
3996,6,home,20,24,4
3996,7,<ENDS>,24,24,0
3997,0,<START>,0,0,0
3997,1,home,0,6,6
3997,2,shop,6,7,1
3997,3,work,7,13,6
3997,4,shop,13,14,1
3997,5,work,14,19,5
3997,6,home,19,24,5
3997,7,<ENDS>,24,24,0
3998,0,<START>,0,0,0
3998,1,home,0,6,6
3998,2,shop,6,7,1
3998,3,home,7,13,6
3998,4,education,13,16,3
3998,5,home,16,24,8
3998,6,<ENDS>,24,24,0
3999,0,<START>,0,0,0
3999,1,home,0,6,6
3999,2,work,6,13,7
3999,3,home,13,17,4
3999,4,shop,17,18,1
3999,5,home,18,24,6
3999,6,<ENDS>,24,24,0
4000,0,<START>,0,0,0
4000,1,home,0,7,7
4000,2,work,7,9,2
4000,3,home,9,13,4
4000,4,work,13,15,2
4000,5,home,15,21,6
4000,6,work,21,22,1
4000,7,home,22,24,2
4000,8,<ENDS>,24,24,0
4001,0,<START>,0,0,0
4001,1,home,0,7,7
4001,2,work,7,14,7
4001,3,home,14,21,7
4001,4,shop,21,22,1
4001,5,home,22,24,2
4001,6,<ENDS>,24,24,0
4002,0,<START>,0,0,0
4002,1,home,0,6,6
4002,2,work,6,13,7
4002,3,home,13,17,4
4002,4,shop,17,18,1
4002,5,home,18,24,6
4002,6,<ENDS>,24,24,0
4003,0,<START>,0,0,0
4003,1,home,0,7,7
4003,2,education,7,11,4
4003,3,home,11,14,3
4003,4,education,14,16,2
4003,5,home,16,19,3
4003,6,shop,19,20,1
4003,7,home,20,24,4
4003,8,<ENDS>,24,24,0
4004,0,<START>,0,0,0
4004,1,home,0,9,9
4004,2,work,9,15,6
4004,3,home,15,24,9
4004,4,<ENDS>,24,24,0
4005,0,<START>,0,0,0
4005,1,home,0,7,7
4005,2,work,7,13,6
4005,3,shop,13,14,1
4005,4,work,14,20,6
4005,5,home,20,24,4
4005,6,<ENDS>,24,24,0
4006,0,<START>,0,0,0
4006,1,home,0,8,8
4006,2,work,8,14,6
4006,3,shop,14,15,1
4006,4,work,15,20,5
4006,5,home,20,24,4
4006,6,<ENDS>,24,24,0
4007,0,<START>,0,0,0
4007,1,work,0,1,1
4007,2,home,1,7,6
4007,3,education,7,11,4
4007,4,home,11,18,7
4007,5,shop,18,19,1
4007,6,home,19,24,5
4007,7,<ENDS>,24,24,0
4008,0,<START>,0,0,0
4008,1,home,0,6,6
4008,2,work,6,8,2
4008,3,home,8,13,5
4008,4,work,13,14,1
4008,5,home,14,18,4
4008,6,work,18,19,1
4008,7,home,19,24,5
4008,8,<ENDS>,24,24,0
4009,0,<START>,0,0,0
4009,1,home,0,8,8
4009,2,shop,8,9,1
4009,3,home,9,13,4
4009,4,work,13,19,6
4009,5,home,19,24,5
4009,6,<ENDS>,24,24,0
4010,0,<START>,0,0,0
4010,1,home,0,6,6
4010,2,work,6,8,2
4010,3,home,8,9,1
4010,4,work,9,11,2
4010,5,home,11,14,3
4010,6,work,14,16,2
4010,7,home,16,21,5
4010,8,work,21,22,1
4010,9,home,22,24,2
4010,10,<ENDS>,24,24,0
4011,0,<START>,0,0,0
4011,1,home,0,7,7
4011,2,shop,7,8,1
4011,3,work,8,15,7
4011,4,shop,15,16,1
4011,5,work,16,20,4
4011,6,home,20,24,4
4011,7,<ENDS>,24,24,0
4012,0,<START>,0,0,0
4012,1,home,0,6,6
4012,2,shop,6,7,1
4012,3,home,7,10,3
4012,4,education,10,13,3
4012,5,home,13,19,6
4012,6,shop,19,20,1
4012,7,home,20,24,4
4012,8,<ENDS>,24,24,0
4013,0,<START>,0,0,0
4013,1,home,0,8,8
4013,2,work,8,15,7
4013,3,home,15,22,7
4013,4,work,22,23,1
4013,5,home,23,24,1
4013,6,<ENDS>,24,24,0
4014,0,<START>,0,0,0
4014,1,home,0,6,6
4014,2,work,6,13,7
4014,3,shop,13,14,1
4014,4,work,14,18,4
4014,5,home,18,24,6
4014,6,<ENDS>,24,24,0
4015,0,<START>,0,0,0
4015,1,home,0,8,8
4015,2,education,8,11,3
4015,3,home,11,15,4
4015,4,work,15,20,5
4015,5,home,20,24,4
4015,6,<ENDS>,24,24,0
4016,0,<START>,0,0,0
4016,1,home,0,6,6
4016,2,work,6,13,7
4016,3,home,13,24,11
4016,4,<ENDS>,24,24,0
4017,0,<START>,0,0,0
4017,1,home,0,7,7
4017,2,work,7,13,6
4017,3,home,13,21,8
4017,4,work,21,22,1
4017,5,home,22,24,2
4017,6,<ENDS>,24,24,0
4018,0,<START>,0,0,0
4018,1,home,0,7,7
4018,2,work,7,13,6
4018,3,home,13,16,3
4018,4,work,16,20,4
4018,5,home,20,24,4
4018,6,<ENDS>,24,24,0
4019,0,<START>,0,0,0
4019,1,home,0,8,8
4019,2,education,8,11,3
4019,3,home,11,14,3
4019,4,education,14,15,1
4019,5,shop,15,17,2
4019,6,home,17,24,7
4019,7,<ENDS>,24,24,0
4020,0,<START>,0,0,0
4020,1,home,0,7,7
4020,2,work,7,13,6
4020,3,shop,13,14,1
4020,4,home,14,24,10
4020,5,<ENDS>,24,24,0
4021,0,<START>,0,0,0
4021,1,home,0,8,8
4021,2,work,8,15,7
4021,3,home,15,24,9
4021,4,<ENDS>,24,24,0
4022,0,<START>,0,0,0
4022,1,home,0,8,8
4022,2,work,8,15,7
4022,3,home,15,24,9
4022,4,<ENDS>,24,24,0
4023,0,<START>,0,0,0
4023,1,home,0,7,7
4023,2,work,7,13,6
4023,3,home,13,14,1
4023,4,work,14,18,4
4023,5,home,18,24,6
4023,6,<ENDS>,24,24,0
4024,0,<START>,0,0,0
4024,1,home,0,7,7
4024,2,work,7,13,6
4024,3,home,13,18,5
4024,4,shop,18,19,1
4024,5,home,19,23,4
4024,6,work,23,24,1
4024,7,<ENDS>,24,24,0
4025,0,<START>,0,0,0
4025,1,home,0,6,6
4025,2,work,6,13,7
4025,3,home,13,19,6
4025,4,shop,19,20,1
4025,5,home,20,24,4
4025,6,<ENDS>,24,24,0
4026,0,<START>,0,0,0
4026,1,home,0,6,6
4026,2,work,6,13,7
4026,3,shop,13,14,1
4026,4,home,14,24,10
4026,5,<ENDS>,24,24,0
4027,0,<START>,0,0,0
4027,1,home,0,7,7
4027,2,work,7,13,6
4027,3,shop,13,15,2
4027,4,work,15,19,4
4027,5,home,19,24,5
4027,6,<ENDS>,24,24,0
4028,0,<START>,0,0,0
4028,1,home,0,7,7
4028,2,shop,7,8,1
4028,3,home,8,20,12
4028,4,shop,20,21,1
4028,5,home,21,24,3
4028,6,<ENDS>,24,24,0
4029,0,<START>,0,0,0
4029,1,home,0,7,7
4029,2,work,7,14,7
4029,3,shop,14,15,1
4029,4,home,15,24,9
4029,5,<ENDS>,24,24,0
4030,0,<START>,0,0,0
4030,1,home,0,6,6
4030,2,work,6,13,7
4030,3,shop,13,14,1
4030,4,work,14,19,5
4030,5,home,19,24,5
4030,6,<ENDS>,24,24,0
4031,0,<START>,0,0,0
4031,1,home,0,7,7
4031,2,work,7,13,6
4031,3,home,13,17,4
4031,4,work,17,19,2
4031,5,home,19,24,5
4031,6,<ENDS>,24,24,0
4032,0,<START>,0,0,0
4032,1,home,0,6,6
4032,2,shop,6,7,1
4032,3,home,7,9,2
4032,4,education,9,11,2
4032,5,home,11,19,8
4032,6,shop,19,20,1
4032,7,home,20,24,4
4032,8,<ENDS>,24,24,0
4033,0,<START>,0,0,0
4033,1,home,0,7,7
4033,2,work,7,13,6
4033,3,shop,13,14,1
4033,4,work,14,20,6
4033,5,home,20,24,4
4033,6,<ENDS>,24,24,0
4034,0,<START>,0,0,0
4034,1,home,0,6,6
4034,2,shop,6,7,1
4034,3,work,7,14,7
4034,4,shop,14,15,1
4034,5,home,15,24,9
4034,6,<ENDS>,24,24,0
4035,0,<START>,0,0,0
4035,1,home,0,7,7
4035,2,work,7,13,6
4035,3,home,13,24,11
4035,4,<ENDS>,24,24,0
4036,0,<START>,0,0,0
4036,1,home,0,7,7
4036,2,shop,7,8,1
4036,3,education,8,11,3
4036,4,home,11,18,7
4036,5,shop,18,20,2
4036,6,home,20,24,4
4036,7,<ENDS>,24,24,0
4037,0,<START>,0,0,0
4037,1,home,0,8,8
4037,2,education,8,12,4
4037,3,shop,12,13,1
4037,4,work,13,19,6
4037,5,home,19,24,5
4037,6,<ENDS>,24,24,0
4038,0,<START>,0,0,0
4038,1,home,0,8,8
4038,2,education,8,11,3
4038,3,home,11,19,8
4038,4,shop,19,20,1
4038,5,home,20,24,4
4038,6,<ENDS>,24,24,0
4039,0,<START>,0,0,0
4039,1,home,0,8,8
4039,2,shop,8,9,1
4039,3,home,9,16,7
4039,4,work,16,20,4
4039,5,home,20,24,4
4039,6,<ENDS>,24,24,0
4040,0,<START>,0,0,0
4040,1,home,0,6,6
4040,2,work,6,13,7
4040,3,shop,13,14,1
4040,4,work,14,19,5
4040,5,home,19,24,5
4040,6,<ENDS>,24,24,0
4041,0,<START>,0,0,0
4041,1,home,0,8,8
4041,2,work,8,15,7
4041,3,home,15,24,9
4041,4,<ENDS>,24,24,0
4042,0,<START>,0,0,0
4042,1,home,0,6,6
4042,2,work,6,13,7
4042,3,shop,13,14,1
4042,4,work,14,19,5
4042,5,home,19,24,5
4042,6,<ENDS>,24,24,0
4043,0,<START>,0,0,0
4043,1,home,0,6,6
4043,2,shop,6,7,1
4043,3,home,7,14,7
4043,4,education,14,16,2
4043,5,shop,16,17,1
4043,6,home,17,24,7
4043,7,<ENDS>,24,24,0
4044,0,<START>,0,0,0
4044,1,home,0,7,7
4044,2,work,7,14,7
4044,3,home,14,18,4
4044,4,shop,18,19,1
4044,5,home,19,24,5
4044,6,<ENDS>,24,24,0
4045,0,<START>,0,0,0
4045,1,home,0,6,6
4045,2,work,6,13,7
4045,3,home,13,24,11
4045,4,<ENDS>,24,24,0
4046,0,<START>,0,0,0
4046,1,home,0,7,7
4046,2,shop,7,8,1
4046,3,education,8,11,3
4046,4,home,11,18,7
4046,5,shop,18,19,1
4046,6,home,19,24,5
4046,7,<ENDS>,24,24,0
4047,0,<START>,0,0,0
4047,1,home,0,7,7
4047,2,work,7,13,6
4047,3,home,13,21,8
4047,4,work,21,22,1
4047,5,home,22,24,2
4047,6,<ENDS>,24,24,0
4048,0,<START>,0,0,0
4048,1,home,0,7,7
4048,2,education,7,11,4
4048,3,home,11,19,8
4048,4,shop,19,20,1
4048,5,home,20,24,4
4048,6,<ENDS>,24,24,0
4049,0,<START>,0,0,0
4049,1,home,0,7,7
4049,2,work,7,13,6
4049,3,shop,13,14,1
4049,4,home,14,22,8
4049,5,work,22,23,1
4049,6,home,23,24,1
4049,7,<ENDS>,24,24,0
4050,0,<START>,0,0,0
4050,1,home,0,7,7
4050,2,work,7,13,6
4050,3,home,13,24,11
4050,4,<ENDS>,24,24,0
4051,0,<START>,0,0,0
4051,1,home,0,7,7
4051,2,education,7,12,5
4051,3,home,12,18,6
4051,4,shop,18,19,1
4051,5,home,19,24,5
4051,6,<ENDS>,24,24,0
4052,0,<START>,0,0,0
4052,1,home,0,9,9
4052,2,education,9,12,3
4052,3,shop,12,13,1
4052,4,work,13,19,6
4052,5,home,19,24,5
4052,6,<ENDS>,24,24,0
4053,0,<START>,0,0,0
4053,1,home,0,7,7
4053,2,education,7,11,4
4053,3,home,11,16,5
4053,4,shop,16,17,1
4053,5,home,17,24,7
4053,6,<ENDS>,24,24,0
4054,0,<START>,0,0,0
4054,1,home,0,6,6
4054,2,work,6,13,7
4054,3,home,13,24,11
4054,4,<ENDS>,24,24,0
4055,0,<START>,0,0,0
4055,1,home,0,7,7
4055,2,shop,7,9,2
4055,3,education,9,12,3
4055,4,shop,12,14,2
4055,5,home,14,21,7
4055,6,shop,21,22,1
4055,7,home,22,24,2
4055,8,<ENDS>,24,24,0
4056,0,<START>,0,0,0
4056,1,home,0,8,8
4056,2,work,8,16,8
4056,3,shop,16,17,1
4056,4,home,17,23,6
4056,5,work,23,24,1
4056,6,<ENDS>,24,24,0
4057,0,<START>,0,0,0
4057,1,home,0,8,8
4057,2,work,8,15,7
4057,3,home,15,24,9
4057,4,<ENDS>,24,24,0
4058,0,<START>,0,0,0
4058,1,home,0,7,7
4058,2,work,7,14,7
4058,3,home,14,24,10
4058,4,<ENDS>,24,24,0
4059,0,<START>,0,0,0
4059,1,home,0,7,7
4059,2,work,7,13,6
4059,3,shop,13,14,1
4059,4,work,14,20,6
4059,5,home,20,24,4
4059,6,<ENDS>,24,24,0
4060,0,<START>,0,0,0
4060,1,home,0,7,7
4060,2,work,7,13,6
4060,3,home,13,17,4
4060,4,work,17,20,3
4060,5,home,20,24,4
4060,6,<ENDS>,24,24,0
4061,0,<START>,0,0,0
4061,1,home,0,7,7
4061,2,work,7,14,7
4061,3,shop,14,15,1
4061,4,home,15,24,9
4061,5,<ENDS>,24,24,0
4062,0,<START>,0,0,0
4062,1,home,0,6,6
4062,2,work,6,14,8
4062,3,home,14,24,10
4062,4,<ENDS>,24,24,0
4063,0,<START>,0,0,0
4063,1,home,0,7,7
4063,2,work,7,13,6
4063,3,shop,13,14,1
4063,4,home,14,17,3
4063,5,shop,17,18,1
4063,6,home,18,24,6
4063,7,<ENDS>,24,24,0
4064,0,<START>,0,0,0
4064,1,home,0,7,7
4064,2,work,7,15,8
4064,3,home,15,22,7
4064,4,work,22,23,1
4064,5,home,23,24,1
4064,6,<ENDS>,24,24,0
4065,0,<START>,0,0,0
4065,1,home,0,7,7
4065,2,work,7,14,7
4065,3,home,14,24,10
4065,4,<ENDS>,24,24,0
4066,0,<START>,0,0,0
4066,1,home,0,7,7
4066,2,work,7,13,6
4066,3,home,13,17,4
4066,4,work,17,20,3
4066,5,home,20,24,4
4066,6,<ENDS>,24,24,0
4067,0,<START>,0,0,0
4067,1,home,0,7,7
4067,2,work,7,13,6
4067,3,shop,13,14,1
4067,4,work,14,19,5
4067,5,home,19,24,5
4067,6,<ENDS>,24,24,0
4068,0,<START>,0,0,0
4068,1,home,0,8,8
4068,2,work,8,15,7
4068,3,home,15,24,9
4068,4,<ENDS>,24,24,0
4069,0,<START>,0,0,0
4069,1,home,0,6,6
4069,2,work,6,7,1
4069,3,home,7,11,4
4069,4,work,11,13,2
4069,5,shop,13,15,2
4069,6,home,15,22,7
4069,7,work,22,23,1
4069,8,home,23,24,1
4069,9,<ENDS>,24,24,0
4070,0,<START>,0,0,0
4070,1,home,0,6,6
4070,2,work,6,8,2
4070,3,home,8,11,3
4070,4,work,11,12,1
4070,5,home,12,17,5
4070,6,work,17,19,2
4070,7,home,19,24,5
4070,8,<ENDS>,24,24,0
4071,0,<START>,0,0,0
4071,1,home,0,7,7
4071,2,work,7,13,6
4071,3,home,13,18,5
4071,4,shop,18,19,1
4071,5,home,19,24,5
4071,6,<ENDS>,24,24,0
4072,0,<START>,0,0,0
4072,1,home,0,7,7
4072,2,work,7,14,7
4072,3,shop,14,15,1
4072,4,home,15,23,8
4072,5,work,23,24,1
4072,6,<ENDS>,24,24,0
4073,0,<START>,0,0,0
4073,1,home,0,6,6
4073,2,work,6,13,7
4073,3,home,13,18,5
4073,4,work,18,20,2
4073,5,home,20,24,4
4073,6,<ENDS>,24,24,0
4074,0,<START>,0,0,0
4074,1,home,0,7,7
4074,2,work,7,14,7
4074,3,shop,14,16,2
4074,4,work,16,20,4
4074,5,home,20,24,4
4074,6,<ENDS>,24,24,0
4075,0,<START>,0,0,0
4075,1,home,0,7,7
4075,2,shop,7,9,2
4075,3,education,9,12,3
4075,4,shop,12,14,2
4075,5,home,14,24,10
4075,6,<ENDS>,24,24,0
4076,0,<START>,0,0,0
4076,1,home,0,8,8
4076,2,education,8,11,3
4076,3,home,11,23,12
4076,4,work,23,24,1
4076,5,<ENDS>,24,24,0
4077,0,<START>,0,0,0
4077,1,home,0,8,8
4077,2,work,8,14,6
4077,3,shop,14,15,1
4077,4,work,15,18,3
4077,5,home,18,24,6
4077,6,<ENDS>,24,24,0
4078,0,<START>,0,0,0
4078,1,home,0,6,6
4078,2,work,6,13,7
4078,3,shop,13,14,1
4078,4,home,14,23,9
4078,5,work,23,24,1
4078,6,<ENDS>,24,24,0
4079,0,<START>,0,0,0
4079,1,home,0,8,8
4079,2,work,8,14,6
4079,3,home,14,24,10
4079,4,<ENDS>,24,24,0
4080,0,<START>,0,0,0
4080,1,home,0,6,6
4080,2,work,6,8,2
4080,3,home,8,9,1
4080,4,work,9,11,2
4080,5,home,11,17,6
4080,6,work,17,18,1
4080,7,home,18,24,6
4080,8,<ENDS>,24,24,0
4081,0,<START>,0,0,0
4081,1,home,0,7,7
4081,2,work,7,13,6
4081,3,home,13,24,11
4081,4,<ENDS>,24,24,0
4082,0,<START>,0,0,0
4082,1,home,0,7,7
4082,2,shop,7,8,1
4082,3,education,8,11,3
4082,4,home,11,18,7
4082,5,shop,18,20,2
4082,6,home,20,24,4
4082,7,<ENDS>,24,24,0
4083,0,<START>,0,0,0
4083,1,work,0,9,9
4083,2,shop,9,10,1
4083,3,home,10,15,5
4083,4,work,15,19,4
4083,5,home,19,24,5
4083,6,<ENDS>,24,24,0
4084,0,<START>,0,0,0
4084,1,home,0,7,7
4084,2,work,7,13,6
4084,3,home,13,24,11
4084,4,<ENDS>,24,24,0
4085,0,<START>,0,0,0
4085,1,home,0,9,9
4085,2,work,9,16,7
4085,3,home,16,20,4
4085,4,shop,20,21,1
4085,5,home,21,24,3
4085,6,<ENDS>,24,24,0
4086,0,<START>,0,0,0
4086,1,home,0,6,6
4086,2,shop,6,7,1
4086,3,home,7,9,2
4086,4,work,9,17,8
4086,5,home,17,21,4
4086,6,work,21,22,1
4086,7,home,22,24,2
4086,8,<ENDS>,24,24,0
4087,0,<START>,0,0,0
4087,1,home,0,6,6
4087,2,work,6,8,2
4087,3,home,8,9,1
4087,4,work,9,11,2
4087,5,home,11,17,6
4087,6,work,17,19,2
4087,7,home,19,24,5
4087,8,<ENDS>,24,24,0
4088,0,<START>,0,0,0
4088,1,home,0,8,8
4088,2,education,8,12,4
4088,3,shop,12,13,1
4088,4,work,13,19,6
4088,5,home,19,24,5
4088,6,<ENDS>,24,24,0
4089,0,<START>,0,0,0
4089,1,home,0,6,6
4089,2,shop,6,7,1
4089,3,work,7,14,7
4089,4,home,14,19,5
4089,5,shop,19,20,1
4089,6,home,20,24,4
4089,7,<ENDS>,24,24,0
4090,0,<START>,0,0,0
4090,1,home,0,8,8
4090,2,education,8,12,4
4090,3,home,12,19,7
4090,4,shop,19,20,1
4090,5,home,20,24,4
4090,6,<ENDS>,24,24,0
4091,0,<START>,0,0,0
4091,1,home,0,7,7
4091,2,work,7,13,6
4091,3,home,13,24,11
4091,4,<ENDS>,24,24,0
4092,0,<START>,0,0,0
4092,1,home,0,7,7
4092,2,work,7,13,6
4092,3,shop,13,15,2
4092,4,work,15,19,4
4092,5,home,19,24,5
4092,6,<ENDS>,24,24,0
4093,0,<START>,0,0,0
4093,1,home,0,7,7
4093,2,work,7,14,7
4093,3,home,14,24,10
4093,4,<ENDS>,24,24,0
4094,0,<START>,0,0,0
4094,1,home,0,8,8
4094,2,education,8,11,3
4094,3,home,11,19,8
4094,4,shop,19,21,2
4094,5,home,21,24,3
4094,6,<ENDS>,24,24,0
4095,0,<START>,0,0,0
4095,1,home,0,7,7
4095,2,work,7,8,1
4095,3,home,8,14,6
4095,4,work,14,16,2
4095,5,home,16,22,6
4095,6,work,22,23,1
4095,7,home,23,24,1
4095,8,<ENDS>,24,24,0
4096,0,<START>,0,0,0
4096,1,home,0,7,7
4096,2,work,7,15,8
4096,3,home,15,24,9
4096,4,<ENDS>,24,24,0
4097,0,<START>,0,0,0
4097,1,home,0,7,7
4097,2,work,7,14,7
4097,3,home,14,23,9
4097,4,work,23,24,1
4097,5,<ENDS>,24,24,0
4098,0,<START>,0,0,0
4098,1,home,0,7,7
4098,2,work,7,14,7
4098,3,home,14,24,10
4098,4,<ENDS>,24,24,0
4099,0,<START>,0,0,0
4099,1,home,0,8,8
4099,2,work,8,15,7
4099,3,home,15,24,9
4099,4,<ENDS>,24,24,0
4100,0,<START>,0,0,0
4100,1,home,0,7,7
4100,2,work,7,9,2
4100,3,home,9,15,6
4100,4,work,15,17,2
4100,5,home,17,24,7
4100,6,<ENDS>,24,24,0
4101,0,<START>,0,0,0
4101,1,home,0,8,8
4101,2,education,8,12,4
4101,3,shop,12,14,2
4101,4,education,14,16,2
4101,5,shop,16,17,1
4101,6,home,17,24,7
4101,7,<ENDS>,24,24,0
4102,0,<START>,0,0,0
4102,1,home,0,7,7
4102,2,work,7,13,6
4102,3,home,13,19,6
4102,4,shop,19,20,1
4102,5,home,20,24,4
4102,6,<ENDS>,24,24,0
4103,0,<START>,0,0,0
4103,1,home,0,7,7
4103,2,work,7,14,7
4103,3,home,14,23,9
4103,4,work,23,24,1
4103,5,<ENDS>,24,24,0
4104,0,<START>,0,0,0
4104,1,home,0,7,7
4104,2,work,7,14,7
4104,3,home,14,20,6
4104,4,shop,20,21,1
4104,5,home,21,24,3
4104,6,<ENDS>,24,24,0
4105,0,<START>,0,0,0
4105,1,home,0,8,8
4105,2,education,8,11,3
4105,3,home,11,16,5
4105,4,work,16,20,4
4105,5,home,20,24,4
4105,6,<ENDS>,24,24,0
4106,0,<START>,0,0,0
4106,1,home,0,7,7
4106,2,work,7,13,6
4106,3,shop,13,14,1
4106,4,home,14,20,6
4106,5,shop,20,21,1
4106,6,home,21,24,3
4106,7,<ENDS>,24,24,0
4107,0,<START>,0,0,0
4107,1,home,0,8,8
4107,2,work,8,15,7
4107,3,home,15,24,9
4107,4,<ENDS>,24,24,0
4108,0,<START>,0,0,0
4108,1,home,0,8,8
4108,2,work,8,14,6
4108,3,shop,14,15,1
4108,4,home,15,24,9
4108,5,<ENDS>,24,24,0
4109,0,<START>,0,0,0
4109,1,home,0,8,8
4109,2,work,8,14,6
4109,3,home,14,24,10
4109,4,<ENDS>,24,24,0
4110,0,<START>,0,0,0
4110,1,home,0,6,6
4110,2,work,6,8,2
4110,3,home,8,15,7
4110,4,work,15,17,2
4110,5,home,17,21,4
4110,6,work,21,22,1
4110,7,home,22,24,2
4110,8,<ENDS>,24,24,0
4111,0,<START>,0,0,0
4111,1,home,0,8,8
4111,2,work,8,15,7
4111,3,shop,15,17,2
4111,4,home,17,24,7
4111,5,<ENDS>,24,24,0
4112,0,<START>,0,0,0
4112,1,home,0,8,8
4112,2,work,8,14,6
4112,3,shop,14,15,1
4112,4,home,15,20,5
4112,5,shop,20,21,1
4112,6,home,21,24,3
4112,7,<ENDS>,24,24,0
4113,0,<START>,0,0,0
4113,1,home,0,8,8
4113,2,work,8,14,6
4113,3,home,14,19,5
4113,4,shop,19,20,1
4113,5,home,20,24,4
4113,6,<ENDS>,24,24,0
4114,0,<START>,0,0,0
4114,1,home,0,7,7
4114,2,work,7,14,7
4114,3,home,14,18,4
4114,4,work,18,20,2
4114,5,home,20,24,4
4114,6,<ENDS>,24,24,0
4115,0,<START>,0,0,0
4115,1,home,0,7,7
4115,2,work,7,13,6
4115,3,shop,13,14,1
4115,4,home,14,24,10
4115,5,<ENDS>,24,24,0
4116,0,<START>,0,0,0
4116,1,home,0,8,8
4116,2,work,8,14,6
4116,3,shop,14,15,1
4116,4,home,15,24,9
4116,5,<ENDS>,24,24,0
4117,0,<START>,0,0,0
4117,1,home,0,7,7
4117,2,work,7,14,7
4117,3,home,14,24,10
4117,4,<ENDS>,24,24,0
4118,0,<START>,0,0,0
4118,1,home,0,7,7
4118,2,work,7,9,2
4118,3,home,9,12,3
4118,4,work,12,14,2
4118,5,home,14,21,7
4118,6,work,21,22,1
4118,7,home,22,24,2
4118,8,<ENDS>,24,24,0
4119,0,<START>,0,0,0
4119,1,home,0,7,7
4119,2,education,7,11,4
4119,3,home,11,17,6
4119,4,shop,17,18,1
4119,5,home,18,19,1
4119,6,shop,19,21,2
4119,7,home,21,24,3
4119,8,<ENDS>,24,24,0
4120,0,<START>,0,0,0
4120,1,home,0,7,7
4120,2,work,7,13,6
4120,3,shop,13,14,1
4120,4,work,14,18,4
4120,5,home,18,22,4
4120,6,work,22,23,1
4120,7,home,23,24,1
4120,8,<ENDS>,24,24,0
4121,0,<START>,0,0,0
4121,1,home,0,7,7
4121,2,shop,7,8,1
4121,3,home,8,12,4
4121,4,work,12,19,7
4121,5,home,19,24,5
4121,6,<ENDS>,24,24,0
4122,0,<START>,0,0,0
4122,1,home,0,6,6
4122,2,work,6,13,7
4122,3,shop,13,14,1
4122,4,home,14,24,10
4122,5,<ENDS>,24,24,0
4123,0,<START>,0,0,0
4123,1,home,0,6,6
4123,2,work,6,8,2
4123,3,home,8,14,6
4123,4,work,14,16,2
4123,5,home,16,23,7
4123,6,work,23,24,1
4123,7,<ENDS>,24,24,0
4124,0,<START>,0,0,0
4124,1,home,0,7,7
4124,2,work,7,13,6
4124,3,home,13,17,4
4124,4,work,17,20,3
4124,5,home,20,24,4
4124,6,<ENDS>,24,24,0
4125,0,<START>,0,0,0
4125,1,home,0,7,7
4125,2,work,7,9,2
4125,3,home,9,17,8
4125,4,work,17,19,2
4125,5,home,19,23,4
4125,6,work,23,24,1
4125,7,<ENDS>,24,24,0
4126,0,<START>,0,0,0
4126,1,home,0,7,7
4126,2,shop,7,8,1
4126,3,education,8,11,3
4126,4,home,11,18,7
4126,5,shop,18,20,2
4126,6,home,20,24,4
4126,7,<ENDS>,24,24,0
4127,0,<START>,0,0,0
4127,1,home,0,6,6
4127,2,work,6,9,3
4127,3,home,9,13,4
4127,4,work,13,16,3
4127,5,shop,16,17,1
4127,6,work,17,19,2
4127,7,home,19,24,5
4127,8,<ENDS>,24,24,0
4128,0,<START>,0,0,0
4128,1,home,0,8,8
4128,2,work,8,14,6
4128,3,shop,14,15,1
4128,4,home,15,24,9
4128,5,<ENDS>,24,24,0
4129,0,<START>,0,0,0
4129,1,home,0,8,8
4129,2,work,8,16,8
4129,3,home,16,24,8
4129,4,<ENDS>,24,24,0
4130,0,<START>,0,0,0
4130,1,home,0,7,7
4130,2,work,7,13,6
4130,3,shop,13,14,1
4130,4,home,14,24,10
4130,5,<ENDS>,24,24,0
4131,0,<START>,0,0,0
4131,1,home,0,8,8
4131,2,education,8,11,3
4131,3,home,11,19,8
4131,4,shop,19,20,1
4131,5,home,20,24,4
4131,6,<ENDS>,24,24,0
4132,0,<START>,0,0,0
4132,1,home,0,6,6
4132,2,shop,6,7,1
4132,3,home,7,10,3
4132,4,education,10,13,3
4132,5,home,13,24,11
4132,6,<ENDS>,24,24,0
4133,0,<START>,0,0,0
4133,1,home,0,7,7
4133,2,work,7,14,7
4133,3,shop,14,15,1
4133,4,work,15,20,5
4133,5,home,20,24,4
4133,6,<ENDS>,24,24,0
4134,0,<START>,0,0,0
4134,1,home,0,6,6
4134,2,work,6,13,7
4134,3,shop,13,14,1
4134,4,work,14,19,5
4134,5,home,19,23,4
4134,6,work,23,24,1
4134,7,<ENDS>,24,24,0
4135,0,<START>,0,0,0
4135,1,home,0,6,6
4135,2,work,6,13,7
4135,3,home,13,16,3
4135,4,work,16,20,4
4135,5,home,20,24,4
4135,6,<ENDS>,24,24,0
4136,0,<START>,0,0,0
4136,1,home,0,6,6
4136,2,work,6,13,7
4136,3,home,13,19,6
4136,4,shop,19,20,1
4136,5,home,20,24,4
4136,6,<ENDS>,24,24,0
4137,0,<START>,0,0,0
4137,1,home,0,7,7
4137,2,work,7,13,6
4137,3,shop,13,14,1
4137,4,home,14,24,10
4137,5,<ENDS>,24,24,0
4138,0,<START>,0,0,0
4138,1,home,0,6,6
4138,2,work,6,13,7
4138,3,home,13,21,8
4138,4,work,21,22,1
4138,5,home,22,24,2
4138,6,<ENDS>,24,24,0
4139,0,<START>,0,0,0
4139,1,home,0,6,6
4139,2,work,6,8,2
4139,3,home,8,12,4
4139,4,work,12,15,3
4139,5,home,15,19,4
4139,6,shop,19,20,1
4139,7,home,20,24,4
4139,8,<ENDS>,24,24,0
4140,0,<START>,0,0,0
4140,1,home,0,6,6
4140,2,work,6,13,7
4140,3,home,13,17,4
4140,4,work,17,20,3
4140,5,home,20,24,4
4140,6,<ENDS>,24,24,0
4141,0,<START>,0,0,0
4141,1,home,0,8,8
4141,2,education,8,11,3
4141,3,home,11,14,3
4141,4,work,14,20,6
4141,5,home,20,24,4
4141,6,<ENDS>,24,24,0
4142,0,<START>,0,0,0
4142,1,home,0,7,7
4142,2,work,7,13,6
4142,3,shop,13,14,1
4142,4,work,14,20,6
4142,5,home,20,24,4
4142,6,<ENDS>,24,24,0
4143,0,<START>,0,0,0
4143,1,home,0,6,6
4143,2,work,6,13,7
4143,3,home,13,24,11
4143,4,<ENDS>,24,24,0
4144,0,<START>,0,0,0
4144,1,home,0,9,9
4144,2,work,9,17,8
4144,3,home,17,24,7
4144,4,<ENDS>,24,24,0
4145,0,<START>,0,0,0
4145,1,home,0,7,7
4145,2,work,7,13,6
4145,3,home,13,18,5
4145,4,work,18,20,2
4145,5,home,20,24,4
4145,6,<ENDS>,24,24,0
4146,0,<START>,0,0,0
4146,1,home,0,7,7
4146,2,education,7,11,4
4146,3,home,11,18,7
4146,4,shop,18,19,1
4146,5,home,19,24,5
4146,6,<ENDS>,24,24,0
4147,0,<START>,0,0,0
4147,1,home,0,8,8
4147,2,work,8,13,5
4147,3,shop,13,14,1
4147,4,work,14,19,5
4147,5,home,19,24,5
4147,6,<ENDS>,24,24,0
4148,0,<START>,0,0,0
4148,1,home,0,8,8
4148,2,work,8,14,6
4148,3,home,14,16,2
4148,4,work,16,20,4
4148,5,home,20,24,4
4148,6,<ENDS>,24,24,0
4149,0,<START>,0,0,0
4149,1,home,0,7,7
4149,2,work,7,13,6
4149,3,home,13,19,6
4149,4,shop,19,20,1
4149,5,home,20,24,4
4149,6,<ENDS>,24,24,0
4150,0,<START>,0,0,0
4150,1,home,0,8,8
4150,2,work,8,15,7
4150,3,home,15,24,9
4150,4,<ENDS>,24,24,0
4151,0,<START>,0,0,0
4151,1,home,0,6,6
4151,2,work,6,13,7
4151,3,shop,13,14,1
4151,4,work,14,19,5
4151,5,home,19,24,5
4151,6,<ENDS>,24,24,0
4152,0,<START>,0,0,0
4152,1,home,0,6,6
4152,2,work,6,8,2
4152,3,home,8,9,1
4152,4,work,9,11,2
4152,5,home,11,17,6
4152,6,work,17,19,2
4152,7,home,19,24,5
4152,8,<ENDS>,24,24,0
4153,0,<START>,0,0,0
4153,1,home,0,6,6
4153,2,shop,6,7,1
4153,3,home,7,13,6
4153,4,education,13,16,3
4153,5,home,16,24,8
4153,6,<ENDS>,24,24,0
4154,0,<START>,0,0,0
4154,1,home,0,7,7
4154,2,work,7,14,7
4154,3,home,14,18,4
4154,4,work,18,20,2
4154,5,home,20,24,4
4154,6,<ENDS>,24,24,0
4155,0,<START>,0,0,0
4155,1,home,0,7,7
4155,2,work,7,13,6
4155,3,home,13,21,8
4155,4,work,21,22,1
4155,5,home,22,24,2
4155,6,<ENDS>,24,24,0
4156,0,<START>,0,0,0
4156,1,home,0,7,7
4156,2,work,7,14,7
4156,3,home,14,21,7
4156,4,work,21,22,1
4156,5,home,22,24,2
4156,6,<ENDS>,24,24,0
4157,0,<START>,0,0,0
4157,1,home,0,6,6
4157,2,work,6,13,7
4157,3,home,13,24,11
4157,4,<ENDS>,24,24,0
4158,0,<START>,0,0,0
4158,1,home,0,8,8
4158,2,work,8,15,7
4158,3,home,15,24,9
4158,4,<ENDS>,24,24,0
4159,0,<START>,0,0,0
4159,1,home,0,6,6
4159,2,shop,6,7,1
4159,3,home,7,11,4
4159,4,work,11,17,6
4159,5,home,17,24,7
4159,6,<ENDS>,24,24,0
4160,0,<START>,0,0,0
4160,1,home,0,8,8
4160,2,work,8,15,7
4160,3,shop,15,16,1
4160,4,home,16,21,5
4160,5,work,21,22,1
4160,6,home,22,24,2
4160,7,<ENDS>,24,24,0
4161,0,<START>,0,0,0
4161,1,home,0,8,8
4161,2,work,8,14,6
4161,3,home,14,24,10
4161,4,<ENDS>,24,24,0
4162,0,<START>,0,0,0
4162,1,home,0,7,7
4162,2,work,7,14,7
4162,3,shop,14,16,2
4162,4,home,16,24,8
4162,5,<ENDS>,24,24,0
4163,0,<START>,0,0,0
4163,1,home,0,7,7
4163,2,work,7,13,6
4163,3,home,13,21,8
4163,4,shop,21,22,1
4163,5,home,22,24,2
4163,6,<ENDS>,24,24,0
4164,0,<START>,0,0,0
4164,1,home,0,6,6
4164,2,shop,6,7,1
4164,3,home,7,10,3
4164,4,education,10,12,2
4164,5,home,12,16,4
4164,6,shop,16,17,1
4164,7,home,17,24,7
4164,8,<ENDS>,24,24,0
4165,0,<START>,0,0,0
4165,1,home,0,9,9
4165,2,work,9,16,7
4165,3,home,16,21,5
4165,4,work,21,22,1
4165,5,home,22,24,2
4165,6,<ENDS>,24,24,0
4166,0,<START>,0,0,0
4166,1,home,0,7,7
4166,2,work,7,9,2
4166,3,home,9,13,4
4166,4,work,13,15,2
4166,5,home,15,22,7
4166,6,work,22,23,1
4166,7,home,23,24,1
4166,8,<ENDS>,24,24,0
4167,0,<START>,0,0,0
4167,1,home,0,7,7
4167,2,shop,7,8,1
4167,3,education,8,11,3
4167,4,home,11,17,6
4167,5,shop,17,19,2
4167,6,home,19,24,5
4167,7,<ENDS>,24,24,0
4168,0,<START>,0,0,0
4168,1,home,0,6,6
4168,2,work,6,8,2
4168,3,home,8,14,6
4168,4,work,14,17,3
4168,5,home,17,22,5
4168,6,work,22,23,1
4168,7,home,23,24,1
4168,8,<ENDS>,24,24,0
4169,0,<START>,0,0,0
4169,1,home,0,6,6
4169,2,work,6,8,2
4169,3,home,8,9,1
4169,4,work,9,11,2
4169,5,home,11,16,5
4169,6,work,16,18,2
4169,7,home,18,24,6
4169,8,<ENDS>,24,24,0
4170,0,<START>,0,0,0
4170,1,home,0,8,8
4170,2,work,8,17,9
4170,3,home,17,23,6
4170,4,work,23,24,1
4170,5,<ENDS>,24,24,0
4171,0,<START>,0,0,0
4171,1,home,0,6,6
4171,2,work,6,13,7
4171,3,shop,13,14,1
4171,4,work,14,19,5
4171,5,home,19,23,4
4171,6,work,23,24,1
4171,7,<ENDS>,24,24,0
4172,0,<START>,0,0,0
4172,1,home,0,8,8
4172,2,work,8,13,5
4172,3,shop,13,14,1
4172,4,work,14,19,5
4172,5,home,19,24,5
4172,6,<ENDS>,24,24,0
4173,0,<START>,0,0,0
4173,1,home,0,6,6
4173,2,shop,6,7,1
4173,3,work,7,9,2
4173,4,home,9,13,4
4173,5,work,13,15,2
4173,6,home,15,22,7
4173,7,work,22,23,1
4173,8,home,23,24,1
4173,9,<ENDS>,24,24,0
4174,0,<START>,0,0,0
4174,1,home,0,6,6
4174,2,work,6,13,7
4174,3,home,13,23,10
4174,4,work,23,24,1
4174,5,<ENDS>,24,24,0
4175,0,<START>,0,0,0
4175,1,home,0,7,7
4175,2,education,7,12,5
4175,3,shop,12,14,2
4175,4,education,14,16,2
4175,5,shop,16,17,1
4175,6,home,17,24,7
4175,7,<ENDS>,24,24,0
4176,0,<START>,0,0,0
4176,1,home,0,8,8
4176,2,shop,8,9,1
4176,3,work,9,16,7
4176,4,home,16,24,8
4176,5,<ENDS>,24,24,0
4177,0,<START>,0,0,0
4177,1,home,0,6,6
4177,2,work,6,13,7
4177,3,shop,13,14,1
4177,4,home,14,24,10
4177,5,<ENDS>,24,24,0
4178,0,<START>,0,0,0
4178,1,home,0,7,7
4178,2,work,7,13,6
4178,3,home,13,17,4
4178,4,work,17,20,3
4178,5,home,20,24,4
4178,6,<ENDS>,24,24,0
4179,0,<START>,0,0,0
4179,1,home,0,9,9
4179,2,work,9,14,5
4179,3,home,14,20,6
4179,4,shop,20,21,1
4179,5,home,21,24,3
4179,6,<ENDS>,24,24,0
4180,0,<START>,0,0,0
4180,1,home,0,7,7
4180,2,work,7,13,6
4180,3,home,13,17,4
4180,4,work,17,19,2
4180,5,home,19,24,5
4180,6,<ENDS>,24,24,0
4181,0,<START>,0,0,0
4181,1,home,0,9,9
4181,2,work,9,16,7
4181,3,shop,16,17,1
4181,4,home,17,24,7
4181,5,<ENDS>,24,24,0
4182,0,<START>,0,0,0
4182,1,home,0,7,7
4182,2,education,7,13,6
4182,3,shop,13,15,2
4182,4,home,15,24,9
4182,5,<ENDS>,24,24,0
4183,0,<START>,0,0,0
4183,1,home,0,9,9
4183,2,shop,9,10,1
4183,3,work,10,17,7
4183,4,home,17,21,4
4183,5,work,21,22,1
4183,6,home,22,24,2
4183,7,<ENDS>,24,24,0
4184,0,<START>,0,0,0
4184,1,home,0,7,7
4184,2,work,7,13,6
4184,3,shop,13,14,1
4184,4,work,14,20,6
4184,5,home,20,24,4
4184,6,<ENDS>,24,24,0
4185,0,<START>,0,0,0
4185,1,home,0,7,7
4185,2,work,7,9,2
4185,3,home,9,15,6
4185,4,work,15,17,2
4185,5,home,17,23,6
4185,6,work,23,24,1
4185,7,<ENDS>,24,24,0
4186,0,<START>,0,0,0
4186,1,home,0,7,7
4186,2,shop,7,8,1
4186,3,home,8,12,4
4186,4,work,12,19,7
4186,5,home,19,24,5
4186,6,<ENDS>,24,24,0
4187,0,<START>,0,0,0
4187,1,home,0,6,6
4187,2,work,6,13,7
4187,3,home,13,15,2
4187,4,work,15,20,5
4187,5,home,20,24,4
4187,6,<ENDS>,24,24,0
4188,0,<START>,0,0,0
4188,1,home,0,6,6
4188,2,work,6,13,7
4188,3,home,13,17,4
4188,4,work,17,20,3
4188,5,home,20,24,4
4188,6,<ENDS>,24,24,0
4189,0,<START>,0,0,0
4189,1,home,0,7,7
4189,2,work,7,13,6
4189,3,home,13,24,11
4189,4,<ENDS>,24,24,0
4190,0,<START>,0,0,0
4190,1,home,0,6,6
4190,2,shop,6,7,1
4190,3,work,7,13,6
4190,4,home,13,24,11
4190,5,<ENDS>,24,24,0
4191,0,<START>,0,0,0
4191,1,home,0,6,6
4191,2,work,6,13,7
4191,3,home,13,17,4
4191,4,work,17,20,3
4191,5,home,20,24,4
4191,6,<ENDS>,24,24,0
4192,0,<START>,0,0,0
4192,1,home,0,8,8
4192,2,work,8,15,7
4192,3,home,15,24,9
4192,4,<ENDS>,24,24,0
4193,0,<START>,0,0,0
4193,1,home,0,6,6
4193,2,work,6,13,7
4193,3,home,13,21,8
4193,4,work,21,22,1
4193,5,home,22,24,2
4193,6,<ENDS>,24,24,0
4194,0,<START>,0,0,0
4194,1,home,0,6,6
4194,2,shop,6,7,1
4194,3,home,7,9,2
4194,4,education,9,12,3
4194,5,work,12,19,7
4194,6,home,19,24,5
4194,7,<ENDS>,24,24,0
4195,0,<START>,0,0,0
4195,1,home,0,8,8
4195,2,education,8,11,3
4195,3,home,11,15,4
4195,4,shop,15,16,1
4195,5,work,16,20,4
4195,6,home,20,24,4
4195,7,<ENDS>,24,24,0
4196,0,<START>,0,0,0
4196,1,home,0,7,7
4196,2,work,7,13,6
4196,3,home,13,16,3
4196,4,shop,16,17,1
4196,5,work,17,20,3
4196,6,home,20,24,4
4196,7,<ENDS>,24,24,0
4197,0,<START>,0,0,0
4197,1,home,0,6,6
4197,2,shop,6,7,1
4197,3,work,7,14,7
4197,4,home,14,24,10
4197,5,<ENDS>,24,24,0
4198,0,<START>,0,0,0
4198,1,home,0,8,8
4198,2,work,8,15,7
4198,3,home,15,24,9
4198,4,<ENDS>,24,24,0
4199,0,<START>,0,0,0
4199,1,home,0,8,8
4199,2,education,8,12,4
4199,3,home,12,16,4
4199,4,work,16,20,4
4199,5,home,20,24,4
4199,6,<ENDS>,24,24,0
4200,0,<START>,0,0,0
4200,1,home,0,6,6
4200,2,shop,6,7,1
4200,3,home,7,13,6
4200,4,education,13,16,3
4200,5,home,16,24,8
4200,6,<ENDS>,24,24,0
4201,0,<START>,0,0,0
4201,1,home,0,8,8
4201,2,work,8,16,8
4201,3,shop,16,17,1
4201,4,home,17,21,4
4201,5,work,21,22,1
4201,6,home,22,24,2
4201,7,<ENDS>,24,24,0
4202,0,<START>,0,0,0
4202,1,home,0,7,7
4202,2,work,7,13,6
4202,3,home,13,18,5
4202,4,work,18,20,2
4202,5,home,20,24,4
4202,6,<ENDS>,24,24,0
4203,0,<START>,0,0,0
4203,1,home,0,9,9
4203,2,work,9,16,7
4203,3,home,16,24,8
4203,4,<ENDS>,24,24,0
4204,0,<START>,0,0,0
4204,1,home,0,8,8
4204,2,education,8,11,3
4204,3,shop,11,12,1
4204,4,work,12,18,6
4204,5,home,18,24,6
4204,6,<ENDS>,24,24,0
4205,0,<START>,0,0,0
4205,1,home,0,8,8
4205,2,work,8,15,7
4205,3,home,15,24,9
4205,4,<ENDS>,24,24,0
4206,0,<START>,0,0,0
4206,1,home,0,7,7
4206,2,work,7,13,6
4206,3,shop,13,14,1
4206,4,work,14,19,5
4206,5,home,19,24,5
4206,6,<ENDS>,24,24,0
4207,0,<START>,0,0,0
4207,1,home,0,7,7
4207,2,work,7,13,6
4207,3,home,13,18,5
4207,4,work,18,20,2
4207,5,home,20,24,4
4207,6,<ENDS>,24,24,0
4208,0,<START>,0,0,0
4208,1,home,0,6,6
4208,2,shop,6,7,1
4208,3,home,7,13,6
4208,4,education,13,16,3
4208,5,home,16,24,8
4208,6,<ENDS>,24,24,0
4209,0,<START>,0,0,0
4209,1,home,0,7,7
4209,2,work,7,13,6
4209,3,home,13,18,5
4209,4,shop,18,19,1
4209,5,home,19,24,5
4209,6,<ENDS>,24,24,0
4210,0,<START>,0,0,0
4210,1,home,0,8,8
4210,2,work,8,15,7
4210,3,home,15,24,9
4210,4,<ENDS>,24,24,0
4211,0,<START>,0,0,0
4211,1,home,0,7,7
4211,2,education,7,11,4
4211,3,home,11,18,7
4211,4,shop,18,20,2
4211,5,home,20,24,4
4211,6,<ENDS>,24,24,0
4212,0,<START>,0,0,0
4212,1,home,0,6,6
4212,2,shop,6,7,1
4212,3,home,7,9,2
4212,4,education,9,13,4
4212,5,home,13,20,7
4212,6,shop,20,21,1
4212,7,home,21,24,3
4212,8,<ENDS>,24,24,0
4213,0,<START>,0,0,0
4213,1,home,0,7,7
4213,2,work,7,13,6
4213,3,shop,13,15,2
4213,4,home,15,24,9
4213,5,<ENDS>,24,24,0
4214,0,<START>,0,0,0
4214,1,home,0,6,6
4214,2,work,6,8,2
4214,3,home,8,13,5
4214,4,work,13,15,2
4214,5,home,15,22,7
4214,6,work,22,23,1
4214,7,home,23,24,1
4214,8,<ENDS>,24,24,0
4215,0,<START>,0,0,0
4215,1,home,0,7,7
4215,2,work,7,13,6
4215,3,home,13,16,3
4215,4,work,16,19,3
4215,5,home,19,24,5
4215,6,<ENDS>,24,24,0
4216,0,<START>,0,0,0
4216,1,home,0,7,7
4216,2,work,7,13,6
4216,3,shop,13,14,1
4216,4,home,14,19,5
4216,5,shop,19,20,1
4216,6,home,20,24,4
4216,7,<ENDS>,24,24,0
4217,0,<START>,0,0,0
4217,1,home,0,6,6
4217,2,shop,6,7,1
4217,3,work,7,14,7
4217,4,shop,14,15,1
4217,5,work,15,19,4
4217,6,home,19,23,4
4217,7,work,23,24,1
4217,8,<ENDS>,24,24,0
4218,0,<START>,0,0,0
4218,1,home,0,8,8
4218,2,work,8,14,6
4218,3,shop,14,16,2
4218,4,work,16,20,4
4218,5,home,20,24,4
4218,6,<ENDS>,24,24,0
4219,0,<START>,0,0,0
4219,1,home,0,6,6
4219,2,work,6,13,7
4219,3,shop,13,14,1
4219,4,home,14,24,10
4219,5,<ENDS>,24,24,0
4220,0,<START>,0,0,0
4220,1,home,0,7,7
4220,2,shop,7,8,1
4220,3,education,8,11,3
4220,4,home,11,17,6
4220,5,shop,17,18,1
4220,6,home,18,24,6
4220,7,<ENDS>,24,24,0
4221,0,<START>,0,0,0
4221,1,home,0,7,7
4221,2,work,7,13,6
4221,3,home,13,24,11
4221,4,<ENDS>,24,24,0
4222,0,<START>,0,0,0
4222,1,home,0,7,7
4222,2,work,7,14,7
4222,3,home,14,22,8
4222,4,work,22,23,1
4222,5,home,23,24,1
4222,6,<ENDS>,24,24,0
4223,0,<START>,0,0,0
4223,1,home,0,7,7
4223,2,education,7,11,4
4223,3,home,11,19,8
4223,4,shop,19,21,2
4223,5,home,21,24,3
4223,6,<ENDS>,24,24,0
4224,0,<START>,0,0,0
4224,1,home,0,7,7
4224,2,shop,7,8,1
4224,3,education,8,11,3
4224,4,home,11,17,6
4224,5,shop,17,18,1
4224,6,home,18,24,6
4224,7,<ENDS>,24,24,0
4225,0,<START>,0,0,0
4225,1,home,0,8,8
4225,2,education,8,12,4
4225,3,home,12,20,8
4225,4,shop,20,21,1
4225,5,home,21,24,3
4225,6,<ENDS>,24,24,0
4226,0,<START>,0,0,0
4226,1,home,0,6,6
4226,2,shop,6,7,1
4226,3,home,7,9,2
4226,4,education,9,12,3
4226,5,home,12,20,8
4226,6,shop,20,21,1
4226,7,home,21,24,3
4226,8,<ENDS>,24,24,0
4227,0,<START>,0,0,0
4227,1,home,0,6,6
4227,2,work,6,13,7
4227,3,shop,13,14,1
4227,4,home,14,24,10
4227,5,<ENDS>,24,24,0
4228,0,<START>,0,0,0
4228,1,home,0,6,6
4228,2,work,6,8,2
4228,3,home,8,14,6
4228,4,work,14,17,3
4228,5,home,17,23,6
4228,6,work,23,24,1
4228,7,<ENDS>,24,24,0
4229,0,<START>,0,0,0
4229,1,home,0,7,7
4229,2,education,7,11,4
4229,3,home,11,19,8
4229,4,shop,19,21,2
4229,5,home,21,24,3
4229,6,<ENDS>,24,24,0
4230,0,<START>,0,0,0
4230,1,home,0,6,6
4230,2,work,6,13,7
4230,3,shop,13,14,1
4230,4,home,14,24,10
4230,5,<ENDS>,24,24,0
4231,0,<START>,0,0,0
4231,1,home,0,8,8
4231,2,work,8,15,7
4231,3,home,15,21,6
4231,4,work,21,22,1
4231,5,home,22,24,2
4231,6,<ENDS>,24,24,0
4232,0,<START>,0,0,0
4232,1,home,0,7,7
4232,2,education,7,11,4
4232,3,home,11,18,7
4232,4,shop,18,20,2
4232,5,home,20,24,4
4232,6,<ENDS>,24,24,0
4233,0,<START>,0,0,0
4233,1,home,0,6,6
4233,2,work,6,8,2
4233,3,home,8,14,6
4233,4,work,14,17,3
4233,5,home,17,23,6
4233,6,work,23,24,1
4233,7,<ENDS>,24,24,0
4234,0,<START>,0,0,0
4234,1,home,0,8,8
4234,2,work,8,15,7
4234,3,shop,15,16,1
4234,4,work,16,20,4
4234,5,home,20,24,4
4234,6,<ENDS>,24,24,0
4235,0,<START>,0,0,0
4235,1,home,0,9,9
4235,2,work,9,17,8
4235,3,home,17,24,7
4235,4,<ENDS>,24,24,0
4236,0,<START>,0,0,0
4236,1,home,0,6,6
4236,2,shop,6,8,2
4236,3,home,8,17,9
4236,4,work,17,20,3
4236,5,home,20,24,4
4236,6,<ENDS>,24,24,0
4237,0,<START>,0,0,0
4237,1,home,0,6,6
4237,2,shop,6,7,1
4237,3,home,7,13,6
4237,4,education,13,16,3
4237,5,shop,16,17,1
4237,6,home,17,24,7
4237,7,<ENDS>,24,24,0
4238,0,<START>,0,0,0
4238,1,home,0,9,9
4238,2,work,9,16,7
4238,3,home,16,24,8
4238,4,<ENDS>,24,24,0
4239,0,<START>,0,0,0
4239,1,home,0,8,8
4239,2,work,8,15,7
4239,3,home,15,19,4
4239,4,shop,19,20,1
4239,5,home,20,24,4
4239,6,<ENDS>,24,24,0
4240,0,<START>,0,0,0
4240,1,home,0,6,6
4240,2,work,6,8,2
4240,3,home,8,13,5
4240,4,work,13,16,3
4240,5,home,16,22,6
4240,6,work,22,23,1
4240,7,home,23,24,1
4240,8,<ENDS>,24,24,0
4241,0,<START>,0,0,0
4241,1,home,0,7,7
4241,2,work,7,13,6
4241,3,shop,13,14,1
4241,4,home,14,21,7
4241,5,work,21,22,1
4241,6,home,22,24,2
4241,7,<ENDS>,24,24,0
4242,0,<START>,0,0,0
4242,1,home,0,7,7
4242,2,shop,7,8,1
4242,3,work,8,16,8
4242,4,home,16,24,8
4242,5,<ENDS>,24,24,0
4243,0,<START>,0,0,0
4243,1,home,0,8,8
4243,2,education,8,11,3
4243,3,home,11,15,4
4243,4,work,15,19,4
4243,5,home,19,23,4
4243,6,work,23,24,1
4243,7,<ENDS>,24,24,0
4244,0,<START>,0,0,0
4244,1,home,0,7,7
4244,2,work,7,14,7
4244,3,shop,14,15,1
4244,4,work,15,20,5
4244,5,home,20,24,4
4244,6,<ENDS>,24,24,0
4245,0,<START>,0,0,0
4245,1,home,0,7,7
4245,2,shop,7,8,1
4245,3,work,8,15,7
4245,4,home,15,21,6
4245,5,work,21,22,1
4245,6,home,22,24,2
4245,7,<ENDS>,24,24,0
4246,0,<START>,0,0,0
4246,1,home,0,6,6
4246,2,work,6,13,7
4246,3,shop,13,14,1
4246,4,work,14,20,6
4246,5,home,20,24,4
4246,6,<ENDS>,24,24,0
4247,0,<START>,0,0,0
4247,1,home,0,8,8
4247,2,work,8,15,7
4247,3,home,15,24,9
4247,4,<ENDS>,24,24,0
4248,0,<START>,0,0,0
4248,1,home,0,7,7
4248,2,education,7,11,4
4248,3,home,11,18,7
4248,4,shop,18,20,2
4248,5,home,20,24,4
4248,6,<ENDS>,24,24,0
4249,0,<START>,0,0,0
4249,1,home,0,7,7
4249,2,education,7,9,2
4249,3,home,9,14,5
4249,4,education,14,16,2
4249,5,home,16,24,8
4249,6,<ENDS>,24,24,0
4250,0,<START>,0,0,0
4250,1,home,0,7,7
4250,2,shop,7,8,1
4250,3,work,8,15,7
4250,4,home,15,21,6
4250,5,work,21,22,1
4250,6,home,22,24,2
4250,7,<ENDS>,24,24,0
4251,0,<START>,0,0,0
4251,1,home,0,8,8
4251,2,education,8,12,4
4251,3,work,12,18,6
4251,4,home,18,24,6
4251,5,<ENDS>,24,24,0
4252,0,<START>,0,0,0
4252,1,home,0,8,8
4252,2,work,8,14,6
4252,3,home,14,22,8
4252,4,work,22,23,1
4252,5,home,23,24,1
4252,6,<ENDS>,24,24,0
4253,0,<START>,0,0,0
4253,1,home,0,7,7
4253,2,work,7,14,7
4253,3,shop,14,15,1
4253,4,home,15,24,9
4253,5,<ENDS>,24,24,0
4254,0,<START>,0,0,0
4254,1,home,0,8,8
4254,2,education,8,11,3
4254,3,home,11,17,6
4254,4,shop,17,18,1
4254,5,home,18,24,6
4254,6,<ENDS>,24,24,0
4255,0,<START>,0,0,0
4255,1,home,0,6,6
4255,2,work,6,13,7
4255,3,home,13,15,2
4255,4,work,15,20,5
4255,5,home,20,24,4
4255,6,<ENDS>,24,24,0
4256,0,<START>,0,0,0
4256,1,home,0,7,7
4256,2,work,7,13,6
4256,3,shop,13,14,1
4256,4,work,14,19,5
4256,5,home,19,24,5
4256,6,<ENDS>,24,24,0
4257,0,<START>,0,0,0
4257,1,home,0,8,8
4257,2,work,8,15,7
4257,3,home,15,24,9
4257,4,<ENDS>,24,24,0
4258,0,<START>,0,0,0
4258,1,home,0,7,7
4258,2,work,7,13,6
4258,3,shop,13,14,1
4258,4,home,14,24,10
4258,5,<ENDS>,24,24,0
4259,0,<START>,0,0,0
4259,1,home,0,7,7
4259,2,work,7,13,6
4259,3,home,13,24,11
4259,4,<ENDS>,24,24,0
4260,0,<START>,0,0,0
4260,1,home,0,8,8
4260,2,work,8,16,8
4260,3,home,16,24,8
4260,4,<ENDS>,24,24,0
4261,0,<START>,0,0,0
4261,1,home,0,7,7
4261,2,work,7,14,7
4261,3,home,14,21,7
4261,4,work,21,22,1
4261,5,home,22,24,2
4261,6,<ENDS>,24,24,0
4262,0,<START>,0,0,0
4262,1,home,0,7,7
4262,2,education,7,10,3
4262,3,home,10,16,6
4262,4,shop,16,17,1
4262,5,home,17,24,7
4262,6,<ENDS>,24,24,0
4263,0,<START>,0,0,0
4263,1,home,0,7,7
4263,2,shop,7,8,1
4263,3,education,8,14,6
4263,4,shop,14,16,2
4263,5,home,16,24,8
4263,6,<ENDS>,24,24,0
4264,0,<START>,0,0,0
4264,1,home,0,8,8
4264,2,work,8,14,6
4264,3,home,14,24,10
4264,4,<ENDS>,24,24,0
4265,0,<START>,0,0,0
4265,1,home,0,7,7
4265,2,shop,7,8,1
4265,3,home,8,9,1
4265,4,work,9,15,6
4265,5,home,15,23,8
4265,6,work,23,24,1
4265,7,<ENDS>,24,24,0
4266,0,<START>,0,0,0
4266,1,home,0,6,6
4266,2,shop,6,7,1
4266,3,home,7,9,2
4266,4,work,9,16,7
4266,5,home,16,24,8
4266,6,<ENDS>,24,24,0
4267,0,<START>,0,0,0
4267,1,home,0,6,6
4267,2,shop,6,7,1
4267,3,home,7,10,3
4267,4,education,10,12,2
4267,5,shop,12,14,2
4267,6,education,14,16,2
4267,7,home,16,24,8
4267,8,<ENDS>,24,24,0
4268,0,<START>,0,0,0
4268,1,home,0,8,8
4268,2,work,8,14,6
4268,3,shop,14,15,1
4268,4,home,15,24,9
4268,5,<ENDS>,24,24,0
4269,0,<START>,0,0,0
4269,1,home,0,7,7
4269,2,work,7,13,6
4269,3,home,13,24,11
4269,4,<ENDS>,24,24,0
4270,0,<START>,0,0,0
4270,1,home,0,6,6
4270,2,work,6,8,2
4270,3,home,8,12,4
4270,4,work,12,14,2
4270,5,home,14,21,7
4270,6,work,21,22,1
4270,7,home,22,24,2
4270,8,<ENDS>,24,24,0
4271,0,<START>,0,0,0
4271,1,home,0,7,7
4271,2,work,7,14,7
4271,3,home,14,24,10
4271,4,<ENDS>,24,24,0
4272,0,<START>,0,0,0
4272,1,home,0,7,7
4272,2,work,7,13,6
4272,3,home,13,24,11
4272,4,<ENDS>,24,24,0
4273,0,<START>,0,0,0
4273,1,home,0,8,8
4273,2,work,8,14,6
4273,3,shop,14,15,1
4273,4,work,15,19,4
4273,5,home,19,23,4
4273,6,work,23,24,1
4273,7,<ENDS>,24,24,0
4274,0,<START>,0,0,0
4274,1,home,0,7,7
4274,2,work,7,13,6
4274,3,shop,13,14,1
4274,4,home,14,17,3
4274,5,work,17,20,3
4274,6,home,20,24,4
4274,7,<ENDS>,24,24,0
4275,0,<START>,0,0,0
4275,1,home,0,8,8
4275,2,work,8,14,6
4275,3,shop,14,15,1
4275,4,home,15,18,3
4275,5,work,18,20,2
4275,6,home,20,24,4
4275,7,<ENDS>,24,24,0
4276,0,<START>,0,0,0
4276,1,home,0,8,8
4276,2,work,8,17,9
4276,3,home,17,21,4
4276,4,shop,21,22,1
4276,5,home,22,24,2
4276,6,<ENDS>,24,24,0
4277,0,<START>,0,0,0
4277,1,home,0,6,6
4277,2,work,6,13,7
4277,3,home,13,24,11
4277,4,<ENDS>,24,24,0
4278,0,<START>,0,0,0
4278,1,home,0,6,6
4278,2,work,6,13,7
4278,3,home,13,17,4
4278,4,work,17,20,3
4278,5,home,20,24,4
4278,6,<ENDS>,24,24,0
4279,0,<START>,0,0,0
4279,1,home,0,8,8
4279,2,work,8,14,6
4279,3,shop,14,15,1
4279,4,work,15,19,4
4279,5,home,19,24,5
4279,6,<ENDS>,24,24,0
4280,0,<START>,0,0,0
4280,1,home,0,6,6
4280,2,shop,6,7,1
4280,3,home,7,10,3
4280,4,education,10,13,3
4280,5,shop,13,14,1
4280,6,home,14,21,7
4280,7,shop,21,22,1
4280,8,home,22,24,2
4280,9,<ENDS>,24,24,0
4281,0,<START>,0,0,0
4281,1,home,0,8,8
4281,2,work,8,15,7
4281,3,shop,15,16,1
4281,4,home,16,24,8
4281,5,<ENDS>,24,24,0
4282,0,<START>,0,0,0
4282,1,home,0,6,6
4282,2,shop,6,7,1
4282,3,home,7,9,2
4282,4,education,9,12,3
4282,5,home,12,20,8
4282,6,shop,20,21,1
4282,7,home,21,24,3
4282,8,<ENDS>,24,24,0
4283,0,<START>,0,0,0
4283,1,home,0,8,8
4283,2,work,8,15,7
4283,3,home,15,24,9
4283,4,<ENDS>,24,24,0
4284,0,<START>,0,0,0
4284,1,home,0,8,8
4284,2,education,8,11,3
4284,3,home,11,17,6
4284,4,shop,17,18,1
4284,5,home,18,24,6
4284,6,<ENDS>,24,24,0
4285,0,<START>,0,0,0
4285,1,home,0,7,7
4285,2,education,7,12,5
4285,3,home,12,19,7
4285,4,shop,19,21,2
4285,5,home,21,24,3
4285,6,<ENDS>,24,24,0
4286,0,<START>,0,0,0
4286,1,home,0,8,8
4286,2,education,8,12,4
4286,3,work,12,18,6
4286,4,home,18,20,2
4286,5,shop,20,21,1
4286,6,home,21,24,3
4286,7,<ENDS>,24,24,0
4287,0,<START>,0,0,0
4287,1,home,0,8,8
4287,2,education,8,11,3
4287,3,shop,11,12,1
4287,4,work,12,19,7
4287,5,home,19,24,5
4287,6,<ENDS>,24,24,0
4288,0,<START>,0,0,0
4288,1,home,0,7,7
4288,2,shop,7,9,2
4288,3,education,9,12,3
4288,4,home,12,20,8
4288,5,shop,20,21,1
4288,6,home,21,24,3
4288,7,<ENDS>,24,24,0
4289,0,<START>,0,0,0
4289,1,home,0,7,7
4289,2,work,7,9,2
4289,3,home,9,14,5
4289,4,work,14,17,3
4289,5,home,17,24,7
4289,6,<ENDS>,24,24,0
4290,0,<START>,0,0,0
4290,1,home,0,6,6
4290,2,work,6,13,7
4290,3,shop,13,14,1
4290,4,home,14,24,10
4290,5,<ENDS>,24,24,0
4291,0,<START>,0,0,0
4291,1,home,0,7,7
4291,2,work,7,14,7
4291,3,home,14,21,7
4291,4,work,21,22,1
4291,5,home,22,24,2
4291,6,<ENDS>,24,24,0
4292,0,<START>,0,0,0
4292,1,home,0,7,7
4292,2,work,7,14,7
4292,3,home,14,24,10
4292,4,<ENDS>,24,24,0
4293,0,<START>,0,0,0
4293,1,home,0,7,7
4293,2,shop,7,8,1
4293,3,home,8,12,4
4293,4,work,12,18,6
4293,5,home,18,24,6
4293,6,<ENDS>,24,24,0
4294,0,<START>,0,0,0
4294,1,home,0,6,6
4294,2,work,6,8,2
4294,3,home,8,14,6
4294,4,work,14,17,3
4294,5,home,17,24,7
4294,6,<ENDS>,24,24,0
4295,0,<START>,0,0,0
4295,1,home,0,6,6
4295,2,work,6,13,7
4295,3,shop,13,14,1
4295,4,work,14,19,5
4295,5,home,19,24,5
4295,6,<ENDS>,24,24,0
4296,0,<START>,0,0,0
4296,1,home,0,6,6
4296,2,work,6,13,7
4296,3,home,13,21,8
4296,4,work,21,22,1
4296,5,home,22,24,2
4296,6,<ENDS>,24,24,0
4297,0,<START>,0,0,0
4297,1,home,0,6,6
4297,2,work,6,13,7
4297,3,home,13,20,7
4297,4,shop,20,21,1
4297,5,home,21,24,3
4297,6,<ENDS>,24,24,0
4298,0,<START>,0,0,0
4298,1,home,0,6,6
4298,2,shop,6,7,1
4298,3,home,7,13,6
4298,4,education,13,16,3
4298,5,home,16,24,8
4298,6,<ENDS>,24,24,0
4299,0,<START>,0,0,0
4299,1,home,0,6,6
4299,2,shop,6,7,1
4299,3,home,7,9,2
4299,4,work,9,15,6
4299,5,home,15,21,6
4299,6,work,21,22,1
4299,7,home,22,24,2
4299,8,<ENDS>,24,24,0
4300,0,<START>,0,0,0
4300,1,home,0,7,7
4300,2,work,7,13,6
4300,3,home,13,18,5
4300,4,shop,18,19,1
4300,5,home,19,24,5
4300,6,<ENDS>,24,24,0
4301,0,<START>,0,0,0
4301,1,home,0,6,6
4301,2,work,6,13,7
4301,3,shop,13,14,1
4301,4,education,14,16,2
4301,5,home,16,24,8
4301,6,<ENDS>,24,24,0
4302,0,<START>,0,0,0
4302,1,home,0,8,8
4302,2,work,8,15,7
4302,3,home,15,24,9
4302,4,<ENDS>,24,24,0
4303,0,<START>,0,0,0
4303,1,home,0,7,7
4303,2,shop,7,8,1
4303,3,work,8,14,6
4303,4,home,14,18,4
4303,5,work,18,20,2
4303,6,home,20,24,4
4303,7,<ENDS>,24,24,0
4304,0,<START>,0,0,0
4304,1,home,0,7,7
4304,2,work,7,14,7
4304,3,home,14,24,10
4304,4,<ENDS>,24,24,0
4305,0,<START>,0,0,0
4305,1,home,0,7,7
4305,2,work,7,14,7
4305,3,home,14,24,10
4305,4,<ENDS>,24,24,0
4306,0,<START>,0,0,0
4306,1,home,0,6,6
4306,2,work,6,14,8
4306,3,home,14,24,10
4306,4,<ENDS>,24,24,0
4307,0,<START>,0,0,0
4307,1,home,0,6,6
4307,2,shop,6,7,1
4307,3,home,7,10,3
4307,4,education,10,14,4
4307,5,shop,14,16,2
4307,6,home,16,24,8
4307,7,<ENDS>,24,24,0
4308,0,<START>,0,0,0
4308,1,home,0,6,6
4308,2,shop,6,7,1
4308,3,home,7,9,2
4308,4,education,9,12,3
4308,5,shop,12,14,2
4308,6,home,14,21,7
4308,7,shop,21,22,1
4308,8,home,22,24,2
4308,9,<ENDS>,24,24,0
4309,0,<START>,0,0,0
4309,1,home,0,7,7
4309,2,work,7,13,6
4309,3,home,13,17,4
4309,4,work,17,20,3
4309,5,home,20,24,4
4309,6,<ENDS>,24,24,0
4310,0,<START>,0,0,0
4310,1,home,0,7,7
4310,2,work,7,14,7
4310,3,home,14,24,10
4310,4,<ENDS>,24,24,0
4311,0,<START>,0,0,0
4311,1,home,0,8,8
4311,2,work,8,15,7
4311,3,home,15,24,9
4311,4,<ENDS>,24,24,0
4312,0,<START>,0,0,0
4312,1,home,0,7,7
4312,2,work,7,14,7
4312,3,home,14,24,10
4312,4,<ENDS>,24,24,0
4313,0,<START>,0,0,0
4313,1,home,0,6,6
4313,2,work,6,13,7
4313,3,home,13,22,9
4313,4,work,22,23,1
4313,5,home,23,24,1
4313,6,<ENDS>,24,24,0
4314,0,<START>,0,0,0
4314,1,home,0,6,6
4314,2,work,6,8,2
4314,3,home,8,9,1
4314,4,work,9,11,2
4314,5,home,11,16,5
4314,6,work,16,18,2
4314,7,home,18,24,6
4314,8,<ENDS>,24,24,0
4315,0,<START>,0,0,0
4315,1,home,0,8,8
4315,2,work,8,14,6
4315,3,shop,14,15,1
4315,4,work,15,20,5
4315,5,home,20,24,4
4315,6,<ENDS>,24,24,0
4316,0,<START>,0,0,0
4316,1,home,0,9,9
4316,2,work,9,16,7
4316,3,home,16,23,7
4316,4,work,23,24,1
4316,5,<ENDS>,24,24,0
4317,0,<START>,0,0,0
4317,1,home,0,8,8
4317,2,work,8,14,6
4317,3,home,14,20,6
4317,4,shop,20,21,1
4317,5,home,21,24,3
4317,6,<ENDS>,24,24,0
4318,0,<START>,0,0,0
4318,1,home,0,6,6
4318,2,work,6,13,7
4318,3,shop,13,15,2
4318,4,work,15,20,5
4318,5,home,20,24,4
4318,6,<ENDS>,24,24,0
4319,0,<START>,0,0,0
4319,1,home,0,6,6
4319,2,work,6,7,1
4319,3,home,7,10,3
4319,4,work,10,12,2
4319,5,home,12,18,6
4319,6,work,18,20,2
4319,7,home,20,24,4
4319,8,<ENDS>,24,24,0
4320,0,<START>,0,0,0
4320,1,home,0,6,6
4320,2,work,6,8,2
4320,3,home,8,9,1
4320,4,work,9,11,2
4320,5,home,11,18,7
4320,6,shop,18,19,1
4320,7,home,19,23,4
4320,8,work,23,24,1
4320,9,<ENDS>,24,24,0
4321,0,<START>,0,0,0
4321,1,home,0,6,6
4321,2,work,6,13,7
4321,3,home,13,17,4
4321,4,work,17,20,3
4321,5,home,20,24,4
4321,6,<ENDS>,24,24,0
4322,0,<START>,0,0,0
4322,1,home,0,6,6
4322,2,work,6,13,7
4322,3,home,13,17,4
4322,4,work,17,20,3
4322,5,home,20,24,4
4322,6,<ENDS>,24,24,0
4323,0,<START>,0,0,0
4323,1,home,0,7,7
4323,2,education,7,12,5
4323,3,home,12,19,7
4323,4,shop,19,21,2
4323,5,home,21,24,3
4323,6,<ENDS>,24,24,0
4324,0,<START>,0,0,0
4324,1,home,0,7,7
4324,2,work,7,14,7
4324,3,shop,14,15,1
4324,4,home,15,24,9
4324,5,<ENDS>,24,24,0
4325,0,<START>,0,0,0
4325,1,home,0,7,7
4325,2,work,7,13,6
4325,3,shop,13,14,1
4325,4,home,14,24,10
4325,5,<ENDS>,24,24,0
4326,0,<START>,0,0,0
4326,1,home,0,7,7
4326,2,shop,7,8,1
4326,3,work,8,16,8
4326,4,home,16,24,8
4326,5,<ENDS>,24,24,0
4327,0,<START>,0,0,0
4327,1,home,0,7,7
4327,2,work,7,8,1
4327,3,home,8,12,4
4327,4,work,12,14,2
4327,5,home,14,21,7
4327,6,work,21,22,1
4327,7,home,22,24,2
4327,8,<ENDS>,24,24,0
4328,0,<START>,0,0,0
4328,1,home,0,8,8
4328,2,work,8,16,8
4328,3,home,16,20,4
4328,4,shop,20,21,1
4328,5,home,21,24,3
4328,6,<ENDS>,24,24,0
4329,0,<START>,0,0,0
4329,1,home,0,7,7
4329,2,shop,7,8,1
4329,3,work,8,15,7
4329,4,home,15,24,9
4329,5,<ENDS>,24,24,0
4330,0,<START>,0,0,0
4330,1,home,0,7,7
4330,2,work,7,14,7
4330,3,shop,14,15,1
4330,4,work,15,19,4
4330,5,home,19,24,5
4330,6,<ENDS>,24,24,0
4331,0,<START>,0,0,0
4331,1,home,0,7,7
4331,2,work,7,14,7
4331,3,shop,14,15,1
4331,4,home,15,24,9
4331,5,<ENDS>,24,24,0
4332,0,<START>,0,0,0
4332,1,home,0,9,9
4332,2,education,9,13,4
4332,3,shop,13,14,1
4332,4,work,14,20,6
4332,5,home,20,24,4
4332,6,<ENDS>,24,24,0
4333,0,<START>,0,0,0
4333,1,home,0,8,8
4333,2,work,8,15,7
4333,3,home,15,24,9
4333,4,<ENDS>,24,24,0
4334,0,<START>,0,0,0
4334,1,home,0,8,8
4334,2,work,8,14,6
4334,3,home,14,24,10
4334,4,<ENDS>,24,24,0
4335,0,<START>,0,0,0
4335,1,home,0,8,8
4335,2,work,8,15,7
4335,3,shop,15,16,1
4335,4,home,16,24,8
4335,5,<ENDS>,24,24,0
4336,0,<START>,0,0,0
4336,1,home,0,8,8
4336,2,work,8,14,6
4336,3,shop,14,15,1
4336,4,home,15,24,9
4336,5,<ENDS>,24,24,0
4337,0,<START>,0,0,0
4337,1,home,0,8,8
4337,2,work,8,15,7
4337,3,home,15,24,9
4337,4,<ENDS>,24,24,0
4338,0,<START>,0,0,0
4338,1,home,0,6,6
4338,2,work,6,8,2
4338,3,home,8,12,4
4338,4,work,12,14,2
4338,5,home,14,21,7
4338,6,work,21,22,1
4338,7,home,22,24,2
4338,8,<ENDS>,24,24,0
4339,0,<START>,0,0,0
4339,1,home,0,8,8
4339,2,work,8,14,6
4339,3,home,14,24,10
4339,4,<ENDS>,24,24,0
4340,0,<START>,0,0,0
4340,1,home,0,8,8
4340,2,work,8,14,6
4340,3,shop,14,15,1
4340,4,home,15,24,9
4340,5,<ENDS>,24,24,0
4341,0,<START>,0,0,0
4341,1,home,0,7,7
4341,2,work,7,13,6
4341,3,home,13,24,11
4341,4,<ENDS>,24,24,0
4342,0,<START>,0,0,0
4342,1,home,0,7,7
4342,2,education,7,11,4
4342,3,home,11,21,10
4342,4,shop,21,22,1
4342,5,home,22,24,2
4342,6,<ENDS>,24,24,0
4343,0,<START>,0,0,0
4343,1,home,0,8,8
4343,2,education,8,11,3
4343,3,home,11,18,7
4343,4,work,18,20,2
4343,5,home,20,24,4
4343,6,<ENDS>,24,24,0
4344,0,<START>,0,0,0
4344,1,home,0,8,8
4344,2,work,8,15,7
4344,3,home,15,24,9
4344,4,<ENDS>,24,24,0
4345,0,<START>,0,0,0
4345,1,home,0,7,7
4345,2,work,7,14,7
4345,3,shop,14,15,1
4345,4,home,15,21,6
4345,5,work,21,22,1
4345,6,home,22,24,2
4345,7,<ENDS>,24,24,0
4346,0,<START>,0,0,0
4346,1,home,0,8,8
4346,2,work,8,15,7
4346,3,home,15,23,8
4346,4,work,23,24,1
4346,5,<ENDS>,24,24,0
4347,0,<START>,0,0,0
4347,1,home,0,6,6
4347,2,shop,6,7,1
4347,3,work,7,14,7
4347,4,home,14,18,4
4347,5,work,18,19,1
4347,6,home,19,24,5
4347,7,<ENDS>,24,24,0
4348,0,<START>,0,0,0
4348,1,home,0,6,6
4348,2,work,6,13,7
4348,3,home,13,18,5
4348,4,work,18,20,2
4348,5,home,20,24,4
4348,6,<ENDS>,24,24,0
4349,0,<START>,0,0,0
4349,1,home,0,7,7
4349,2,work,7,13,6
4349,3,shop,13,15,2
4349,4,home,15,24,9
4349,5,<ENDS>,24,24,0
4350,0,<START>,0,0,0
4350,1,home,0,7,7
4350,2,work,7,13,6
4350,3,shop,13,14,1
4350,4,work,14,20,6
4350,5,home,20,24,4
4350,6,<ENDS>,24,24,0
4351,0,<START>,0,0,0
4351,1,home,0,6,6
4351,2,work,6,13,7
4351,3,home,13,24,11
4351,4,<ENDS>,24,24,0
4352,0,<START>,0,0,0
4352,1,home,0,8,8
4352,2,work,8,15,7
4352,3,shop,15,16,1
4352,4,work,16,19,3
4352,5,home,19,24,5
4352,6,<ENDS>,24,24,0
4353,0,<START>,0,0,0
4353,1,home,0,7,7
4353,2,education,7,12,5
4353,3,home,12,18,6
4353,4,shop,18,19,1
4353,5,home,19,24,5
4353,6,<ENDS>,24,24,0
4354,0,<START>,0,0,0
4354,1,home,0,6,6
4354,2,work,6,13,7
4354,3,home,13,21,8
4354,4,shop,21,22,1
4354,5,home,22,24,2
4354,6,<ENDS>,24,24,0
4355,0,<START>,0,0,0
4355,1,home,0,6,6
4355,2,work,6,8,2
4355,3,home,8,12,4
4355,4,work,12,14,2
4355,5,home,14,18,4
4355,6,work,18,20,2
4355,7,home,20,24,4
4355,8,<ENDS>,24,24,0
4356,0,<START>,0,0,0
4356,1,home,0,7,7
4356,2,work,7,15,8
4356,3,shop,15,16,1
4356,4,work,16,19,3
4356,5,home,19,24,5
4356,6,<ENDS>,24,24,0
4357,0,<START>,0,0,0
4357,1,home,0,7,7
4357,2,work,7,14,7
4357,3,shop,14,15,1
4357,4,work,15,17,2
4357,5,home,17,24,7
4357,6,<ENDS>,24,24,0
4358,0,<START>,0,0,0
4358,1,home,0,7,7
4358,2,work,7,14,7
4358,3,home,14,24,10
4358,4,<ENDS>,24,24,0
4359,0,<START>,0,0,0
4359,1,home,0,6,6
4359,2,work,6,9,3
4359,3,home,9,14,5
4359,4,work,14,18,4
4359,5,home,18,24,6
4359,6,<ENDS>,24,24,0
4360,0,<START>,0,0,0
4360,1,home,0,6,6
4360,2,work,6,13,7
4360,3,shop,13,14,1
4360,4,work,14,19,5
4360,5,home,19,24,5
4360,6,<ENDS>,24,24,0
4361,0,<START>,0,0,0
4361,1,home,0,7,7
4361,2,education,7,13,6
4361,3,shop,13,15,2
4361,4,home,15,24,9
4361,5,<ENDS>,24,24,0
4362,0,<START>,0,0,0
4362,1,home,0,7,7
4362,2,education,7,11,4
4362,3,home,11,18,7
4362,4,shop,18,19,1
4362,5,home,19,24,5
4362,6,<ENDS>,24,24,0
4363,0,<START>,0,0,0
4363,1,home,0,6,6
4363,2,work,6,8,2
4363,3,home,8,12,4
4363,4,work,12,13,1
4363,5,home,13,17,4
4363,6,work,17,19,2
4363,7,home,19,24,5
4363,8,<ENDS>,24,24,0
4364,0,<START>,0,0,0
4364,1,home,0,7,7
4364,2,work,7,13,6
4364,3,shop,13,14,1
4364,4,home,14,24,10
4364,5,<ENDS>,24,24,0
4365,0,<START>,0,0,0
4365,1,home,0,8,8
4365,2,shop,8,9,1
4365,3,home,9,21,12
4365,4,work,21,22,1
4365,5,home,22,24,2
4365,6,<ENDS>,24,24,0
4366,0,<START>,0,0,0
4366,1,home,0,6,6
4366,2,work,6,13,7
4366,3,shop,13,15,2
4366,4,home,15,24,9
4366,5,<ENDS>,24,24,0
4367,0,<START>,0,0,0
4367,1,home,0,7,7
4367,2,work,7,9,2
4367,3,home,9,16,7
4367,4,work,16,18,2
4367,5,home,18,23,5
4367,6,work,23,24,1
4367,7,<ENDS>,24,24,0
4368,0,<START>,0,0,0
4368,1,home,0,7,7
4368,2,education,7,11,4
4368,3,home,11,14,3
4368,4,education,14,16,2
4368,5,home,16,24,8
4368,6,<ENDS>,24,24,0
4369,0,<START>,0,0,0
4369,1,home,0,7,7
4369,2,work,7,14,7
4369,3,home,14,24,10
4369,4,<ENDS>,24,24,0
4370,0,<START>,0,0,0
4370,1,home,0,7,7
4370,2,work,7,14,7
4370,3,home,14,24,10
4370,4,<ENDS>,24,24,0
4371,0,<START>,0,0,0
4371,1,home,0,8,8
4371,2,education,8,11,3
4371,3,home,11,19,8
4371,4,shop,19,20,1
4371,5,home,20,24,4
4371,6,<ENDS>,24,24,0
4372,0,<START>,0,0,0
4372,1,home,0,8,8
4372,2,work,8,13,5
4372,3,shop,13,14,1
4372,4,home,14,24,10
4372,5,<ENDS>,24,24,0
4373,0,<START>,0,0,0
4373,1,home,0,6,6
4373,2,work,6,8,2
4373,3,home,8,9,1
4373,4,work,9,11,2
4373,5,home,11,16,5
4373,6,work,16,18,2
4373,7,home,18,24,6
4373,8,<ENDS>,24,24,0
4374,0,<START>,0,0,0
4374,1,home,0,9,9
4374,2,education,9,12,3
4374,3,home,12,24,12
4374,4,<ENDS>,24,24,0
4375,0,<START>,0,0,0
4375,1,home,0,8,8
4375,2,work,8,14,6
4375,3,home,14,22,8
4375,4,work,22,23,1
4375,5,home,23,24,1
4375,6,<ENDS>,24,24,0
4376,0,<START>,0,0,0
4376,1,home,0,7,7
4376,2,work,7,8,1
4376,3,home,8,11,3
4376,4,work,11,12,1
4376,5,home,12,18,6
4376,6,work,18,20,2
4376,7,home,20,24,4
4376,8,<ENDS>,24,24,0
4377,0,<START>,0,0,0
4377,1,home,0,7,7
4377,2,work,7,14,7
4377,3,shop,14,15,1
4377,4,home,15,24,9
4377,5,<ENDS>,24,24,0
4378,0,<START>,0,0,0
4378,1,home,0,6,6
4378,2,shop,6,7,1
4378,3,home,7,10,3
4378,4,education,10,12,2
4378,5,shop,12,14,2
4378,6,education,14,16,2
4378,7,home,16,24,8
4378,8,<ENDS>,24,24,0
4379,0,<START>,0,0,0
4379,1,home,0,8,8
4379,2,work,8,18,10
4379,3,home,18,24,6
4379,4,<ENDS>,24,24,0
4380,0,<START>,0,0,0
4380,1,home,0,7,7
4380,2,work,7,14,7
4380,3,shop,14,15,1
4380,4,work,15,20,5
4380,5,home,20,24,4
4380,6,<ENDS>,24,24,0
4381,0,<START>,0,0,0
4381,1,home,0,6,6
4381,2,work,6,13,7
4381,3,home,13,17,4
4381,4,work,17,20,3
4381,5,home,20,24,4
4381,6,<ENDS>,24,24,0
4382,0,<START>,0,0,0
4382,1,home,0,8,8
4382,2,work,8,13,5
4382,3,home,13,19,6
4382,4,shop,19,20,1
4382,5,home,20,24,4
4382,6,<ENDS>,24,24,0
4383,0,<START>,0,0,0
4383,1,home,0,8,8
4383,2,work,8,16,8
4383,3,home,16,24,8
4383,4,<ENDS>,24,24,0
4384,0,<START>,0,0,0
4384,1,home,0,7,7
4384,2,shop,7,9,2
4384,3,home,9,13,4
4384,4,education,13,16,3
4384,5,shop,16,17,1
4384,6,home,17,24,7
4384,7,<ENDS>,24,24,0
4385,0,<START>,0,0,0
4385,1,home,0,7,7
4385,2,work,7,13,6
4385,3,home,13,22,9
4385,4,work,22,23,1
4385,5,home,23,24,1
4385,6,<ENDS>,24,24,0
4386,0,<START>,0,0,0
4386,1,home,0,8,8
4386,2,work,8,15,7
4386,3,home,15,23,8
4386,4,work,23,24,1
4386,5,<ENDS>,24,24,0
4387,0,<START>,0,0,0
4387,1,home,0,8,8
4387,2,shop,8,9,1
4387,3,work,9,17,8
4387,4,home,17,23,6
4387,5,work,23,24,1
4387,6,<ENDS>,24,24,0
4388,0,<START>,0,0,0
4388,1,home,0,7,7
4388,2,work,7,13,6
4388,3,shop,13,14,1
4388,4,work,14,19,5
4388,5,home,19,24,5
4388,6,<ENDS>,24,24,0
4389,0,<START>,0,0,0
4389,1,home,0,7,7
4389,2,work,7,14,7
4389,3,home,14,19,5
4389,4,shop,19,20,1
4389,5,home,20,24,4
4389,6,<ENDS>,24,24,0
4390,0,<START>,0,0,0
4390,1,home,0,7,7
4390,2,work,7,13,6
4390,3,shop,13,14,1
4390,4,education,14,17,3
4390,5,home,17,24,7
4390,6,<ENDS>,24,24,0
4391,0,<START>,0,0,0
4391,1,home,0,7,7
4391,2,work,7,14,7
4391,3,shop,14,15,1
4391,4,home,15,24,9
4391,5,<ENDS>,24,24,0
4392,0,<START>,0,0,0
4392,1,home,0,9,9
4392,2,work,9,16,7
4392,3,home,16,24,8
4392,4,<ENDS>,24,24,0
4393,0,<START>,0,0,0
4393,1,home,0,8,8
4393,2,education,8,15,7
4393,3,shop,15,17,2
4393,4,home,17,23,6
4393,5,work,23,24,1
4393,6,<ENDS>,24,24,0
4394,0,<START>,0,0,0
4394,1,home,0,7,7
4394,2,shop,7,8,1
4394,3,home,8,11,3
4394,4,work,11,16,5
4394,5,home,16,21,5
4394,6,work,21,22,1
4394,7,home,22,24,2
4394,8,<ENDS>,24,24,0
4395,0,<START>,0,0,0
4395,1,home,0,7,7
4395,2,work,7,13,6
4395,3,shop,13,14,1
4395,4,home,14,21,7
4395,5,work,21,22,1
4395,6,home,22,24,2
4395,7,<ENDS>,24,24,0
4396,0,<START>,0,0,0
4396,1,home,0,7,7
4396,2,work,7,9,2
4396,3,home,9,15,6
4396,4,work,15,18,3
4396,5,home,18,24,6
4396,6,<ENDS>,24,24,0
4397,0,<START>,0,0,0
4397,1,home,0,7,7
4397,2,work,7,14,7
4397,3,shop,14,15,1
4397,4,home,15,24,9
4397,5,<ENDS>,24,24,0
4398,0,<START>,0,0,0
4398,1,home,0,7,7
4398,2,work,7,14,7
4398,3,shop,14,16,2
4398,4,work,16,20,4
4398,5,home,20,24,4
4398,6,<ENDS>,24,24,0
4399,0,<START>,0,0,0
4399,1,home,0,7,7
4399,2,work,7,14,7
4399,3,shop,14,15,1
4399,4,home,15,24,9
4399,5,<ENDS>,24,24,0
4400,0,<START>,0,0,0
4400,1,home,0,7,7
4400,2,work,7,13,6
4400,3,shop,13,14,1
4400,4,work,14,20,6
4400,5,home,20,24,4
4400,6,<ENDS>,24,24,0
4401,0,<START>,0,0,0
4401,1,home,0,7,7
4401,2,work,7,13,6
4401,3,home,13,17,4
4401,4,shop,17,18,1
4401,5,home,18,24,6
4401,6,<ENDS>,24,24,0
4402,0,<START>,0,0,0
4402,1,home,0,6,6
4402,2,shop,6,7,1
4402,3,home,7,10,3
4402,4,education,10,12,2
4402,5,shop,12,14,2
4402,6,home,14,21,7
4402,7,shop,21,22,1
4402,8,home,22,24,2
4402,9,<ENDS>,24,24,0
4403,0,<START>,0,0,0
4403,1,home,0,6,6
4403,2,work,6,13,7
4403,3,shop,13,15,2
4403,4,home,15,24,9
4403,5,<ENDS>,24,24,0
4404,0,<START>,0,0,0
4404,1,home,0,7,7
4404,2,education,7,12,5
4404,3,home,12,19,7
4404,4,shop,19,20,1
4404,5,home,20,24,4
4404,6,<ENDS>,24,24,0
4405,0,<START>,0,0,0
4405,1,home,0,8,8
4405,2,work,8,15,7
4405,3,home,15,24,9
4405,4,<ENDS>,24,24,0
4406,0,<START>,0,0,0
4406,1,home,0,6,6
4406,2,work,6,13,7
4406,3,home,13,16,3
4406,4,work,16,19,3
4406,5,home,19,24,5
4406,6,<ENDS>,24,24,0
4407,0,<START>,0,0,0
4407,1,home,0,6,6
4407,2,work,6,9,3
4407,3,home,9,15,6
4407,4,work,15,17,2
4407,5,home,17,21,4
4407,6,work,21,22,1
4407,7,home,22,24,2
4407,8,<ENDS>,24,24,0
4408,0,<START>,0,0,0
4408,1,home,0,7,7
4408,2,education,7,11,4
4408,3,home,11,16,5
4408,4,shop,16,17,1
4408,5,home,17,24,7
4408,6,<ENDS>,24,24,0
4409,0,<START>,0,0,0
4409,1,home,0,8,8
4409,2,work,8,15,7
4409,3,home,15,24,9
4409,4,<ENDS>,24,24,0
4410,0,<START>,0,0,0
4410,1,home,0,7,7
4410,2,education,7,11,4
4410,3,home,11,18,7
4410,4,shop,18,19,1
4410,5,home,19,24,5
4410,6,<ENDS>,24,24,0
4411,0,<START>,0,0,0
4411,1,home,0,7,7
4411,2,education,7,11,4
4411,3,home,11,17,6
4411,4,shop,17,18,1
4411,5,home,18,24,6
4411,6,<ENDS>,24,24,0
4412,0,<START>,0,0,0
4412,1,home,0,9,9
4412,2,work,9,15,6
4412,3,home,15,24,9
4412,4,<ENDS>,24,24,0
4413,0,<START>,0,0,0
4413,1,home,0,7,7
4413,2,shop,7,8,1
4413,3,education,8,13,5
4413,4,shop,13,15,2
4413,5,home,15,24,9
4413,6,<ENDS>,24,24,0
4414,0,<START>,0,0,0
4414,1,home,0,7,7
4414,2,work,7,8,1
4414,3,home,8,9,1
4414,4,work,9,10,1
4414,5,home,10,16,6
4414,6,work,16,18,2
4414,7,home,18,23,5
4414,8,work,23,24,1
4414,9,<ENDS>,24,24,0
4415,0,<START>,0,0,0
4415,1,home,0,9,9
4415,2,work,9,16,7
4415,3,home,16,22,6
4415,4,work,22,23,1
4415,5,home,23,24,1
4415,6,<ENDS>,24,24,0
4416,0,<START>,0,0,0
4416,1,home,0,7,7
4416,2,work,7,9,2
4416,3,home,9,15,6
4416,4,work,15,17,2
4416,5,home,17,22,5
4416,6,work,22,23,1
4416,7,home,23,24,1
4416,8,<ENDS>,24,24,0
4417,0,<START>,0,0,0
4417,1,home,0,9,9
4417,2,education,9,12,3
4417,3,home,12,22,10
4417,4,work,22,23,1
4417,5,home,23,24,1
4417,6,<ENDS>,24,24,0
4418,0,<START>,0,0,0
4418,1,home,0,8,8
4418,2,education,8,11,3
4418,3,home,11,19,8
4418,4,shop,19,20,1
4418,5,home,20,24,4
4418,6,<ENDS>,24,24,0
4419,0,<START>,0,0,0
4419,1,home,0,7,7
4419,2,education,7,11,4
4419,3,home,11,15,4
4419,4,shop,15,16,1
4419,5,home,16,24,8
4419,6,<ENDS>,24,24,0
4420,0,<START>,0,0,0
4420,1,home,0,7,7
4420,2,education,7,12,5
4420,3,shop,12,13,1
4420,4,home,13,19,6
4420,5,shop,19,21,2
4420,6,home,21,24,3
4420,7,<ENDS>,24,24,0
4421,0,<START>,0,0,0
4421,1,home,0,6,6
4421,2,shop,6,7,1
4421,3,home,7,13,6
4421,4,education,13,16,3
4421,5,home,16,24,8
4421,6,<ENDS>,24,24,0
4422,0,<START>,0,0,0
4422,1,home,0,8,8
4422,2,work,8,15,7
4422,3,shop,15,16,1
4422,4,work,16,19,3
4422,5,home,19,24,5
4422,6,<ENDS>,24,24,0
4423,0,<START>,0,0,0
4423,1,home,0,6,6
4423,2,work,6,8,2
4423,3,home,8,12,4
4423,4,shop,12,13,1
4423,5,work,13,15,2
4423,6,home,15,22,7
4423,7,work,22,23,1
4423,8,home,23,24,1
4423,9,<ENDS>,24,24,0
4424,0,<START>,0,0,0
4424,1,home,0,6,6
4424,2,work,6,8,2
4424,3,home,8,14,6
4424,4,work,14,17,3
4424,5,home,17,23,6
4424,6,work,23,24,1
4424,7,<ENDS>,24,24,0
4425,0,<START>,0,0,0
4425,1,home,0,7,7
4425,2,work,7,13,6
4425,3,home,13,23,10
4425,4,work,23,24,1
4425,5,<ENDS>,24,24,0
4426,0,<START>,0,0,0
4426,1,home,0,8,8
4426,2,education,8,11,3
4426,3,home,11,16,5
4426,4,shop,16,18,2
4426,5,home,18,23,5
4426,6,work,23,24,1
4426,7,<ENDS>,24,24,0
4427,0,<START>,0,0,0
4427,1,home,0,8,8
4427,2,education,8,14,6
4427,3,work,14,20,6
4427,4,home,20,24,4
4427,5,<ENDS>,24,24,0
4428,0,<START>,0,0,0
4428,1,home,0,7,7
4428,2,work,7,14,7
4428,3,shop,14,15,1
4428,4,home,15,24,9
4428,5,<ENDS>,24,24,0
4429,0,<START>,0,0,0
4429,1,home,0,7,7
4429,2,education,7,11,4
4429,3,home,11,18,7
4429,4,shop,18,20,2
4429,5,home,20,24,4
4429,6,<ENDS>,24,24,0
4430,0,<START>,0,0,0
4430,1,home,0,7,7
4430,2,work,7,13,6
4430,3,home,13,21,8
4430,4,work,21,22,1
4430,5,home,22,24,2
4430,6,<ENDS>,24,24,0
4431,0,<START>,0,0,0
4431,1,home,0,8,8
4431,2,work,8,15,7
4431,3,home,15,24,9
4431,4,<ENDS>,24,24,0
4432,0,<START>,0,0,0
4432,1,home,0,7,7
4432,2,work,7,9,2
4432,3,home,9,13,4
4432,4,work,13,14,1
4432,5,home,14,21,7
4432,6,work,21,22,1
4432,7,home,22,24,2
4432,8,<ENDS>,24,24,0
4433,0,<START>,0,0,0
4433,1,home,0,7,7
4433,2,shop,7,8,1
4433,3,education,8,13,5
4433,4,home,13,20,7
4433,5,shop,20,21,1
4433,6,home,21,24,3
4433,7,<ENDS>,24,24,0
4434,0,<START>,0,0,0
4434,1,home,0,6,6
4434,2,shop,6,7,1
4434,3,home,7,10,3
4434,4,education,10,11,1
4434,5,home,11,18,7
4434,6,shop,18,19,1
4434,7,home,19,24,5
4434,8,<ENDS>,24,24,0
4435,0,<START>,0,0,0
4435,1,home,0,7,7
4435,2,work,7,13,6
4435,3,shop,13,14,1
4435,4,home,14,18,4
4435,5,shop,18,19,1
4435,6,home,19,24,5
4435,7,<ENDS>,24,24,0
4436,0,<START>,0,0,0
4436,1,home,0,7,7
4436,2,shop,7,9,2
4436,3,education,9,12,3
4436,4,home,12,20,8
4436,5,shop,20,21,1
4436,6,home,21,24,3
4436,7,<ENDS>,24,24,0
4437,0,<START>,0,0,0
4437,1,home,0,7,7
4437,2,work,7,14,7
4437,3,home,14,20,6
4437,4,shop,20,21,1
4437,5,home,21,24,3
4437,6,<ENDS>,24,24,0
4438,0,<START>,0,0,0
4438,1,home,0,7,7
4438,2,work,7,13,6
4438,3,shop,13,14,1
4438,4,home,14,18,4
4438,5,work,18,20,2
4438,6,home,20,24,4
4438,7,<ENDS>,24,24,0
4439,0,<START>,0,0,0
4439,1,home,0,6,6
4439,2,work,6,13,7
4439,3,shop,13,14,1
4439,4,home,14,18,4
4439,5,work,18,20,2
4439,6,home,20,24,4
4439,7,<ENDS>,24,24,0
4440,0,<START>,0,0,0
4440,1,home,0,8,8
4440,2,education,8,11,3
4440,3,home,11,23,12
4440,4,work,23,24,1
4440,5,<ENDS>,24,24,0
4441,0,<START>,0,0,0
4441,1,home,0,6,6
4441,2,work,6,13,7
4441,3,home,13,24,11
4441,4,<ENDS>,24,24,0
4442,0,<START>,0,0,0
4442,1,home,0,8,8
4442,2,work,8,14,6
4442,3,home,14,22,8
4442,4,work,22,23,1
4442,5,home,23,24,1
4442,6,<ENDS>,24,24,0
4443,0,<START>,0,0,0
4443,1,home,0,8,8
4443,2,work,8,17,9
4443,3,home,17,23,6
4443,4,work,23,24,1
4443,5,<ENDS>,24,24,0
4444,0,<START>,0,0,0
4444,1,home,0,7,7
4444,2,work,7,13,6
4444,3,shop,13,14,1
4444,4,work,14,19,5
4444,5,home,19,24,5
4444,6,<ENDS>,24,24,0
4445,0,<START>,0,0,0
4445,1,home,0,7,7
4445,2,work,7,14,7
4445,3,home,14,23,9
4445,4,work,23,24,1
4445,5,<ENDS>,24,24,0
4446,0,<START>,0,0,0
4446,1,home,0,6,6
4446,2,work,6,13,7
4446,3,shop,13,14,1
4446,4,work,14,18,4
4446,5,home,18,24,6
4446,6,<ENDS>,24,24,0
4447,0,<START>,0,0,0
4447,1,home,0,7,7
4447,2,work,7,14,7
4447,3,home,14,24,10
4447,4,<ENDS>,24,24,0
4448,0,<START>,0,0,0
4448,1,home,0,8,8
4448,2,shop,8,9,1
4448,3,home,9,15,6
4448,4,work,15,19,4
4448,5,home,19,24,5
4448,6,<ENDS>,24,24,0
4449,0,<START>,0,0,0
4449,1,home,0,7,7
4449,2,work,7,13,6
4449,3,home,13,17,4
4449,4,work,17,20,3
4449,5,home,20,24,4
4449,6,<ENDS>,24,24,0
4450,0,<START>,0,0,0
4450,1,home,0,7,7
4450,2,shop,7,8,1
4450,3,work,8,15,7
4450,4,home,15,22,7
4450,5,work,22,23,1
4450,6,home,23,24,1
4450,7,<ENDS>,24,24,0
4451,0,<START>,0,0,0
4451,1,home,0,7,7
4451,2,education,7,11,4
4451,3,home,11,20,9
4451,4,shop,20,21,1
4451,5,home,21,24,3
4451,6,<ENDS>,24,24,0
4452,0,<START>,0,0,0
4452,1,home,0,7,7
4452,2,work,7,13,6
4452,3,home,13,24,11
4452,4,<ENDS>,24,24,0
4453,0,<START>,0,0,0
4453,1,home,0,7,7
4453,2,work,7,13,6
4453,3,shop,13,14,1
4453,4,work,14,18,4
4453,5,home,18,24,6
4453,6,<ENDS>,24,24,0
4454,0,<START>,0,0,0
4454,1,home,0,6,6
4454,2,work,6,13,7
4454,3,home,13,17,4
4454,4,work,17,20,3
4454,5,home,20,24,4
4454,6,<ENDS>,24,24,0
4455,0,<START>,0,0,0
4455,1,home,0,7,7
4455,2,work,7,14,7
4455,3,shop,14,15,1
4455,4,work,15,19,4
4455,5,home,19,24,5
4455,6,<ENDS>,24,24,0
4456,0,<START>,0,0,0
4456,1,home,0,7,7
4456,2,shop,7,8,1
4456,3,education,8,11,3
4456,4,home,11,18,7
4456,5,shop,18,19,1
4456,6,home,19,24,5
4456,7,<ENDS>,24,24,0
4457,0,<START>,0,0,0
4457,1,home,0,7,7
4457,2,work,7,9,2
4457,3,home,9,15,6
4457,4,work,15,17,2
4457,5,home,17,23,6
4457,6,work,23,24,1
4457,7,<ENDS>,24,24,0
4458,0,<START>,0,0,0
4458,1,home,0,6,6
4458,2,work,6,13,7
4458,3,home,13,16,3
4458,4,work,16,20,4
4458,5,home,20,24,4
4458,6,<ENDS>,24,24,0
4459,0,<START>,0,0,0
4459,1,home,0,7,7
4459,2,shop,7,8,1
4459,3,education,8,11,3
4459,4,home,11,14,3
4459,5,education,14,16,2
4459,6,shop,16,17,1
4459,7,home,17,24,7
4459,8,<ENDS>,24,24,0
4460,0,<START>,0,0,0
4460,1,home,0,7,7
4460,2,work,7,13,6
4460,3,shop,13,14,1
4460,4,work,14,19,5
4460,5,home,19,24,5
4460,6,<ENDS>,24,24,0
4461,0,<START>,0,0,0
4461,1,home,0,7,7
4461,2,shop,7,8,1
4461,3,education,8,12,4
4461,4,home,12,19,7
4461,5,shop,19,21,2
4461,6,home,21,24,3
4461,7,<ENDS>,24,24,0
4462,0,<START>,0,0,0
4462,1,home,0,8,8
4462,2,work,8,15,7
4462,3,home,15,21,6
4462,4,work,21,22,1
4462,5,home,22,24,2
4462,6,<ENDS>,24,24,0
4463,0,<START>,0,0,0
4463,1,home,0,6,6
4463,2,shop,6,7,1
4463,3,work,7,13,6
4463,4,shop,13,14,1
4463,5,home,14,18,4
4463,6,work,18,20,2
4463,7,home,20,24,4
4463,8,<ENDS>,24,24,0
4464,0,<START>,0,0,0
4464,1,home,0,7,7
4464,2,work,7,13,6
4464,3,shop,13,14,1
4464,4,home,14,22,8
4464,5,work,22,23,1
4464,6,home,23,24,1
4464,7,<ENDS>,24,24,0
4465,0,<START>,0,0,0
4465,1,home,0,8,8
4465,2,work,8,15,7
4465,3,home,15,24,9
4465,4,<ENDS>,24,24,0
4466,0,<START>,0,0,0
4466,1,home,0,8,8
4466,2,work,8,15,7
4466,3,home,15,24,9
4466,4,<ENDS>,24,24,0
4467,0,<START>,0,0,0
4467,1,home,0,6,6
4467,2,work,6,8,2
4467,3,home,8,9,1
4467,4,work,9,11,2
4467,5,home,11,17,6
4467,6,work,17,18,1
4467,7,home,18,24,6
4467,8,<ENDS>,24,24,0
4468,0,<START>,0,0,0
4468,1,work,0,9,9
4468,2,shop,9,10,1
4468,3,work,10,16,6
4468,4,home,16,24,8
4468,5,<ENDS>,24,24,0
4469,0,<START>,0,0,0
4469,1,home,0,7,7
4469,2,work,7,14,7
4469,3,shop,14,15,1
4469,4,home,15,22,7
4469,5,work,22,23,1
4469,6,home,23,24,1
4469,7,<ENDS>,24,24,0
4470,0,<START>,0,0,0
4470,1,home,0,8,8
4470,2,work,8,14,6
4470,3,home,14,18,4
4470,4,work,18,20,2
4470,5,home,20,24,4
4470,6,<ENDS>,24,24,0
4471,0,<START>,0,0,0
4471,1,home,0,7,7
4471,2,work,7,14,7
4471,3,shop,14,15,1
4471,4,work,15,19,4
4471,5,home,19,24,5
4471,6,<ENDS>,24,24,0
4472,0,<START>,0,0,0
4472,1,home,0,7,7
4472,2,work,7,14,7
4472,3,shop,14,15,1
4472,4,home,15,24,9
4472,5,<ENDS>,24,24,0
4473,0,<START>,0,0,0
4473,1,home,0,6,6
4473,2,work,6,8,2
4473,3,home,8,12,4
4473,4,work,12,14,2
4473,5,home,14,21,7
4473,6,work,21,22,1
4473,7,home,22,24,2
4473,8,<ENDS>,24,24,0
4474,0,<START>,0,0,0
4474,1,home,0,6,6
4474,2,work,6,13,7
4474,3,shop,13,14,1
4474,4,work,14,19,5
4474,5,home,19,24,5
4474,6,<ENDS>,24,24,0
4475,0,<START>,0,0,0
4475,1,home,0,7,7
4475,2,work,7,13,6
4475,3,home,13,24,11
4475,4,<ENDS>,24,24,0
4476,0,<START>,0,0,0
4476,1,home,0,8,8
4476,2,work,8,15,7
4476,3,home,15,24,9
4476,4,<ENDS>,24,24,0
4477,0,<START>,0,0,0
4477,1,home,0,8,8
4477,2,work,8,15,7
4477,3,home,15,24,9
4477,4,<ENDS>,24,24,0
4478,0,<START>,0,0,0
4478,1,home,0,6,6
4478,2,work,6,13,7
4478,3,shop,13,15,2
4478,4,work,15,20,5
4478,5,home,20,24,4
4478,6,<ENDS>,24,24,0
4479,0,<START>,0,0,0
4479,1,home,0,8,8
4479,2,shop,8,9,1
4479,3,work,9,16,7
4479,4,home,16,24,8
4479,5,<ENDS>,24,24,0
4480,0,<START>,0,0,0
4480,1,home,0,8,8
4480,2,work,8,15,7
4480,3,home,15,24,9
4480,4,<ENDS>,24,24,0
4481,0,<START>,0,0,0
4481,1,home,0,7,7
4481,2,shop,7,8,1
4481,3,education,8,11,3
4481,4,home,11,14,3
4481,5,education,14,16,2
4481,6,home,16,24,8
4481,7,<ENDS>,24,24,0
4482,0,<START>,0,0,0
4482,1,home,0,7,7
4482,2,work,7,14,7
4482,3,shop,14,16,2
4482,4,home,16,24,8
4482,5,<ENDS>,24,24,0
4483,0,<START>,0,0,0
4483,1,home,0,6,6
4483,2,work,6,13,7
4483,3,home,13,24,11
4483,4,<ENDS>,24,24,0
4484,0,<START>,0,0,0
4484,1,home,0,7,7
4484,2,education,7,12,5
4484,3,shop,12,13,1
4484,4,education,13,16,3
4484,5,home,16,24,8
4484,6,<ENDS>,24,24,0
4485,0,<START>,0,0,0
4485,1,home,0,6,6
4485,2,shop,6,7,1
4485,3,work,7,13,6
4485,4,home,13,14,1
4485,5,work,14,20,6
4485,6,home,20,24,4
4485,7,<ENDS>,24,24,0
4486,0,<START>,0,0,0
4486,1,home,0,7,7
4486,2,education,7,12,5
4486,3,shop,12,14,2
4486,4,education,14,16,2
4486,5,shop,16,17,1
4486,6,home,17,24,7
4486,7,<ENDS>,24,24,0
4487,0,<START>,0,0,0
4487,1,home,0,7,7
4487,2,education,7,11,4
4487,3,home,11,18,7
4487,4,shop,18,19,1
4487,5,home,19,24,5
4487,6,<ENDS>,24,24,0
4488,0,<START>,0,0,0
4488,1,home,0,7,7
4488,2,work,7,13,6
4488,3,shop,13,14,1
4488,4,work,14,20,6
4488,5,home,20,24,4
4488,6,<ENDS>,24,24,0
4489,0,<START>,0,0,0
4489,1,home,0,7,7
4489,2,education,7,11,4
4489,3,home,11,17,6
4489,4,shop,17,18,1
4489,5,home,18,24,6
4489,6,<ENDS>,24,24,0
4490,0,<START>,0,0,0
4490,1,home,0,8,8
4490,2,work,8,15,7
4490,3,home,15,21,6
4490,4,shop,21,22,1
4490,5,home,22,24,2
4490,6,<ENDS>,24,24,0
4491,0,<START>,0,0,0
4491,1,home,0,8,8
4491,2,work,8,16,8
4491,3,home,16,22,6
4491,4,work,22,23,1
4491,5,home,23,24,1
4491,6,<ENDS>,24,24,0
4492,0,<START>,0,0,0
4492,1,home,0,8,8
4492,2,work,8,14,6
4492,3,home,14,24,10
4492,4,<ENDS>,24,24,0
4493,0,<START>,0,0,0
4493,1,home,0,6,6
4493,2,shop,6,7,1
4493,3,home,7,9,2
4493,4,education,9,12,3
4493,5,shop,12,14,2
4493,6,home,14,21,7
4493,7,shop,21,22,1
4493,8,home,22,24,2
4493,9,<ENDS>,24,24,0
4494,0,<START>,0,0,0
4494,1,home,0,7,7
4494,2,work,7,14,7
4494,3,home,14,24,10
4494,4,<ENDS>,24,24,0
4495,0,<START>,0,0,0
4495,1,home,0,6,6
4495,2,work,6,13,7
4495,3,home,13,18,5
4495,4,work,18,20,2
4495,5,home,20,24,4
4495,6,<ENDS>,24,24,0
4496,0,<START>,0,0,0
4496,1,home,0,6,6
4496,2,work,6,14,8
4496,3,home,14,18,4
4496,4,work,18,19,1
4496,5,home,19,24,5
4496,6,<ENDS>,24,24,0
4497,0,<START>,0,0,0
4497,1,home,0,7,7
4497,2,work,7,13,6
4497,3,shop,13,14,1
4497,4,work,14,19,5
4497,5,home,19,24,5
4497,6,<ENDS>,24,24,0
4498,0,<START>,0,0,0
4498,1,home,0,7,7
4498,2,work,7,13,6
4498,3,home,13,24,11
4498,4,<ENDS>,24,24,0
4499,0,<START>,0,0,0
4499,1,home,0,6,6
4499,2,work,6,8,2
4499,3,home,8,12,4
4499,4,work,12,13,1
4499,5,home,13,22,9
4499,6,work,22,23,1
4499,7,home,23,24,1
4499,8,<ENDS>,24,24,0
4500,0,<START>,0,0,0
4500,1,home,0,6,6
4500,2,shop,6,8,2
4500,3,work,8,15,7
4500,4,home,15,21,6
4500,5,work,21,22,1
4500,6,home,22,24,2
4500,7,<ENDS>,24,24,0
4501,0,<START>,0,0,0
4501,1,home,0,7,7
4501,2,education,7,12,5
4501,3,home,12,18,6
4501,4,shop,18,20,2
4501,5,home,20,24,4
4501,6,<ENDS>,24,24,0
4502,0,<START>,0,0,0
4502,1,home,0,8,8
4502,2,work,8,14,6
4502,3,home,14,23,9
4502,4,work,23,24,1
4502,5,<ENDS>,24,24,0
4503,0,<START>,0,0,0
4503,1,home,0,8,8
4503,2,education,8,11,3
4503,3,home,11,17,6
4503,4,shop,17,18,1
4503,5,home,18,24,6
4503,6,<ENDS>,24,24,0
4504,0,<START>,0,0,0
4504,1,home,0,7,7
4504,2,work,7,15,8
4504,3,shop,15,16,1
4504,4,home,16,24,8
4504,5,<ENDS>,24,24,0
4505,0,<START>,0,0,0
4505,1,home,0,7,7
4505,2,shop,7,8,1
4505,3,home,8,13,5
4505,4,work,13,19,6
4505,5,home,19,24,5
4505,6,<ENDS>,24,24,0
4506,0,<START>,0,0,0
4506,1,home,0,6,6
4506,2,work,6,13,7
4506,3,home,13,24,11
4506,4,<ENDS>,24,24,0
4507,0,<START>,0,0,0
4507,1,home,0,6,6
4507,2,shop,6,7,1
4507,3,home,7,10,3
4507,4,education,10,12,2
4507,5,shop,12,13,1
4507,6,education,13,16,3
4507,7,home,16,24,8
4507,8,<ENDS>,24,24,0
4508,0,<START>,0,0,0
4508,1,home,0,8,8
4508,2,work,8,15,7
4508,3,home,15,22,7
4508,4,work,22,23,1
4508,5,home,23,24,1
4508,6,<ENDS>,24,24,0
4509,0,<START>,0,0,0
4509,1,home,0,7,7
4509,2,work,7,14,7
4509,3,home,14,24,10
4509,4,<ENDS>,24,24,0
4510,0,<START>,0,0,0
4510,1,home,0,7,7
4510,2,work,7,13,6
4510,3,shop,13,14,1
4510,4,home,14,24,10
4510,5,<ENDS>,24,24,0
4511,0,<START>,0,0,0
4511,1,home,0,6,6
4511,2,shop,6,7,1
4511,3,home,7,13,6
4511,4,education,13,14,1
4511,5,shop,14,15,1
4511,6,home,15,24,9
4511,7,<ENDS>,24,24,0
4512,0,<START>,0,0,0
4512,1,home,0,7,7
4512,2,education,7,11,4
4512,3,home,11,14,3
4512,4,education,14,16,2
4512,5,home,16,24,8
4512,6,<ENDS>,24,24,0
4513,0,<START>,0,0,0
4513,1,home,0,7,7
4513,2,education,7,11,4
4513,3,home,11,14,3
4513,4,education,14,16,2
4513,5,shop,16,18,2
4513,6,home,18,24,6
4513,7,<ENDS>,24,24,0
4514,0,<START>,0,0,0
4514,1,home,0,7,7
4514,2,shop,7,8,1
4514,3,work,8,15,7
4514,4,home,15,22,7
4514,5,work,22,23,1
4514,6,home,23,24,1
4514,7,<ENDS>,24,24,0
4515,0,<START>,0,0,0
4515,1,home,0,6,6
4515,2,work,6,7,1
4515,3,home,7,9,2
4515,4,work,9,11,2
4515,5,home,11,17,6
4515,6,work,17,19,2
4515,7,home,19,22,3
4515,8,work,22,23,1
4515,9,home,23,24,1
4515,10,<ENDS>,24,24,0
4516,0,<START>,0,0,0
4516,1,home,0,7,7
4516,2,work,7,13,6
4516,3,home,13,15,2
4516,4,work,15,20,5
4516,5,home,20,24,4
4516,6,<ENDS>,24,24,0
4517,0,<START>,0,0,0
4517,1,home,0,6,6
4517,2,work,6,13,7
4517,3,shop,13,14,1
4517,4,work,14,19,5
4517,5,home,19,24,5
4517,6,<ENDS>,24,24,0
4518,0,<START>,0,0,0
4518,1,home,0,6,6
4518,2,work,6,13,7
4518,3,home,13,15,2
4518,4,work,15,19,4
4518,5,home,19,24,5
4518,6,<ENDS>,24,24,0
4519,0,<START>,0,0,0
4519,1,home,0,8,8
4519,2,work,8,15,7
4519,3,home,15,24,9
4519,4,<ENDS>,24,24,0
4520,0,<START>,0,0,0
4520,1,home,0,7,7
4520,2,work,7,13,6
4520,3,shop,13,14,1
4520,4,home,14,24,10
4520,5,<ENDS>,24,24,0
4521,0,<START>,0,0,0
4521,1,home,0,8,8
4521,2,education,8,11,3
4521,3,home,11,18,7
4521,4,work,18,20,2
4521,5,home,20,24,4
4521,6,<ENDS>,24,24,0
4522,0,<START>,0,0,0
4522,1,home,0,10,10
4522,2,work,10,16,6
4522,3,home,16,24,8
4522,4,<ENDS>,24,24,0
4523,0,<START>,0,0,0
4523,1,home,0,6,6
4523,2,work,6,8,2
4523,3,home,8,12,4
4523,4,work,12,14,2
4523,5,home,14,21,7
4523,6,work,21,22,1
4523,7,home,22,24,2
4523,8,<ENDS>,24,24,0
4524,0,<START>,0,0,0
4524,1,home,0,7,7
4524,2,work,7,13,6
4524,3,shop,13,14,1
4524,4,work,14,19,5
4524,5,home,19,24,5
4524,6,<ENDS>,24,24,0
4525,0,<START>,0,0,0
4525,1,home,0,7,7
4525,2,work,7,13,6
4525,3,shop,13,14,1
4525,4,home,14,21,7
4525,5,work,21,22,1
4525,6,home,22,24,2
4525,7,<ENDS>,24,24,0
4526,0,<START>,0,0,0
4526,1,home,0,8,8
4526,2,shop,8,9,1
4526,3,home,9,15,6
4526,4,work,15,20,5
4526,5,home,20,24,4
4526,6,<ENDS>,24,24,0
4527,0,<START>,0,0,0
4527,1,home,0,6,6
4527,2,shop,6,7,1
4527,3,home,7,10,3
4527,4,education,10,12,2
4527,5,home,12,19,7
4527,6,shop,19,20,1
4527,7,home,20,24,4
4527,8,<ENDS>,24,24,0
4528,0,<START>,0,0,0
4528,1,home,0,7,7
4528,2,shop,7,8,1
4528,3,home,8,22,14
4528,4,work,22,23,1
4528,5,home,23,24,1
4528,6,<ENDS>,24,24,0
4529,0,<START>,0,0,0
4529,1,home,0,7,7
4529,2,work,7,13,6
4529,3,home,13,17,4
4529,4,work,17,19,2
4529,5,home,19,24,5
4529,6,<ENDS>,24,24,0
4530,0,<START>,0,0,0
4530,1,home,0,6,6
4530,2,work,6,13,7
4530,3,home,13,18,5
4530,4,shop,18,19,1
4530,5,home,19,23,4
4530,6,work,23,24,1
4530,7,<ENDS>,24,24,0
4531,0,<START>,0,0,0
4531,1,home,0,6,6
4531,2,work,6,8,2
4531,3,home,8,11,3
4531,4,shop,11,12,1
4531,5,work,12,13,1
4531,6,home,13,18,5
4531,7,work,18,19,1
4531,8,home,19,24,5
4531,9,<ENDS>,24,24,0
4532,0,<START>,0,0,0
4532,1,home,0,6,6
4532,2,work,6,12,6
4532,3,shop,12,13,1
4532,4,work,13,19,6
4532,5,home,19,24,5
4532,6,<ENDS>,24,24,0
4533,0,<START>,0,0,0
4533,1,home,0,6,6
4533,2,work,6,13,7
4533,3,shop,13,14,1
4533,4,work,14,20,6
4533,5,home,20,24,4
4533,6,<ENDS>,24,24,0
4534,0,<START>,0,0,0
4534,1,home,0,7,7
4534,2,work,7,9,2
4534,3,home,9,13,4
4534,4,work,13,15,2
4534,5,home,15,21,6
4534,6,work,21,22,1
4534,7,home,22,24,2
4534,8,<ENDS>,24,24,0
4535,0,<START>,0,0,0
4535,1,home,0,6,6
4535,2,work,6,13,7
4535,3,home,13,24,11
4535,4,<ENDS>,24,24,0
4536,0,<START>,0,0,0
4536,1,home,0,6,6
4536,2,shop,6,7,1
4536,3,work,7,14,7
4536,4,home,14,24,10
4536,5,<ENDS>,24,24,0
4537,0,<START>,0,0,0
4537,1,home,0,8,8
4537,2,work,8,15,7
4537,3,home,15,20,5
4537,4,shop,20,21,1
4537,5,home,21,24,3
4537,6,<ENDS>,24,24,0
4538,0,<START>,0,0,0
4538,1,home,0,6,6
4538,2,work,6,7,1
4538,3,home,7,13,6
4538,4,work,13,15,2
4538,5,home,15,24,9
4538,6,<ENDS>,24,24,0
4539,0,<START>,0,0,0
4539,1,home,0,7,7
4539,2,work,7,14,7
4539,3,home,14,24,10
4539,4,<ENDS>,24,24,0
4540,0,<START>,0,0,0
4540,1,home,0,7,7
4540,2,work,7,9,2
4540,3,home,9,15,6
4540,4,work,15,17,2
4540,5,home,17,24,7
4540,6,<ENDS>,24,24,0
4541,0,<START>,0,0,0
4541,1,home,0,8,8
4541,2,work,8,16,8
4541,3,home,16,21,5
4541,4,work,21,22,1
4541,5,home,22,24,2
4541,6,<ENDS>,24,24,0
4542,0,<START>,0,0,0
4542,1,home,0,6,6
4542,2,shop,6,7,1
4542,3,home,7,10,3
4542,4,education,10,13,3
4542,5,home,13,19,6
4542,6,shop,19,20,1
4542,7,home,20,24,4
4542,8,<ENDS>,24,24,0
4543,0,<START>,0,0,0
4543,1,home,0,7,7
4543,2,work,7,13,6
4543,3,home,13,24,11
4543,4,<ENDS>,24,24,0
4544,0,<START>,0,0,0
4544,1,home,0,7,7
4544,2,shop,7,9,2
4544,3,education,9,12,3
4544,4,home,12,18,6
4544,5,shop,18,19,1
4544,6,home,19,24,5
4544,7,<ENDS>,24,24,0
4545,0,<START>,0,0,0
4545,1,home,0,7,7
4545,2,work,7,14,7
4545,3,home,14,24,10
4545,4,<ENDS>,24,24,0
4546,0,<START>,0,0,0
4546,1,home,0,6,6
4546,2,shop,6,7,1
4546,3,home,7,10,3
4546,4,education,10,16,6
4546,5,shop,16,18,2
4546,6,home,18,24,6
4546,7,<ENDS>,24,24,0
4547,0,<START>,0,0,0
4547,1,home,0,7,7
4547,2,work,7,13,6
4547,3,home,13,17,4
4547,4,work,17,19,2
4547,5,home,19,24,5
4547,6,<ENDS>,24,24,0
4548,0,<START>,0,0,0
4548,1,home,0,8,8
4548,2,work,8,15,7
4548,3,home,15,24,9
4548,4,<ENDS>,24,24,0
4549,0,<START>,0,0,0
4549,1,home,0,8,8
4549,2,work,8,14,6
4549,3,home,14,24,10
4549,4,<ENDS>,24,24,0
4550,0,<START>,0,0,0
4550,1,home,0,8,8
4550,2,work,8,15,7
4550,3,home,15,23,8
4550,4,work,23,24,1
4550,5,<ENDS>,24,24,0
4551,0,<START>,0,0,0
4551,1,home,0,7,7
4551,2,work,7,13,6
4551,3,home,13,22,9
4551,4,work,22,23,1
4551,5,home,23,24,1
4551,6,<ENDS>,24,24,0
4552,0,<START>,0,0,0
4552,1,home,0,7,7
4552,2,work,7,14,7
4552,3,home,14,18,4
4552,4,work,18,20,2
4552,5,home,20,24,4
4552,6,<ENDS>,24,24,0
4553,0,<START>,0,0,0
4553,1,home,0,6,6
4553,2,shop,6,7,1
4553,3,home,7,9,2
4553,4,education,9,13,4
4553,5,home,13,20,7
4553,6,shop,20,21,1
4553,7,home,21,24,3
4553,8,<ENDS>,24,24,0
4554,0,<START>,0,0,0
4554,1,home,0,6,6
4554,2,shop,6,7,1
4554,3,home,7,13,6
4554,4,education,13,16,3
4554,5,shop,16,17,1
4554,6,home,17,24,7
4554,7,<ENDS>,24,24,0
4555,0,<START>,0,0,0
4555,1,home,0,6,6
4555,2,work,6,13,7
4555,3,home,13,24,11
4555,4,<ENDS>,24,24,0
4556,0,<START>,0,0,0
4556,1,home,0,8,8
4556,2,work,8,13,5
4556,3,home,13,16,3
4556,4,work,16,20,4
4556,5,home,20,24,4
4556,6,<ENDS>,24,24,0
4557,0,<START>,0,0,0
4557,1,home,0,6,6
4557,2,shop,6,7,1
4557,3,work,7,15,8
4557,4,home,15,23,8
4557,5,work,23,24,1
4557,6,<ENDS>,24,24,0
4558,0,<START>,0,0,0
4558,1,home,0,6,6
4558,2,work,6,12,6
4558,3,shop,12,13,1
4558,4,work,13,19,6
4558,5,home,19,22,3
4558,6,work,22,23,1
4558,7,home,23,24,1
4558,8,<ENDS>,24,24,0
4559,0,<START>,0,0,0
4559,1,home,0,7,7
4559,2,shop,7,8,1
4559,3,work,8,15,7
4559,4,home,15,21,6
4559,5,work,21,22,1
4559,6,home,22,24,2
4559,7,<ENDS>,24,24,0
4560,0,<START>,0,0,0
4560,1,home,0,8,8
4560,2,education,8,11,3
4560,3,home,11,15,4
4560,4,shop,15,16,1
4560,5,home,16,22,6
4560,6,work,22,23,1
4560,7,home,23,24,1
4560,8,<ENDS>,24,24,0
4561,0,<START>,0,0,0
4561,1,home,0,7,7
4561,2,work,7,13,6
4561,3,home,13,17,4
4561,4,shop,17,18,1
4561,5,home,18,22,4
4561,6,work,22,23,1
4561,7,home,23,24,1
4561,8,<ENDS>,24,24,0
4562,0,<START>,0,0,0
4562,1,home,0,6,6
4562,2,work,6,13,7
4562,3,home,13,16,3
4562,4,work,16,20,4
4562,5,home,20,24,4
4562,6,<ENDS>,24,24,0
4563,0,<START>,0,0,0
4563,1,home,0,6,6
4563,2,work,6,13,7
4563,3,home,13,22,9
4563,4,work,22,23,1
4563,5,home,23,24,1
4563,6,<ENDS>,24,24,0
4564,0,<START>,0,0,0
4564,1,home,0,7,7
4564,2,education,7,9,2
4564,3,home,9,17,8
4564,4,shop,17,18,1
4564,5,home,18,24,6
4564,6,<ENDS>,24,24,0
4565,0,<START>,0,0,0
4565,1,home,0,7,7
4565,2,work,7,14,7
4565,3,home,14,24,10
4565,4,<ENDS>,24,24,0
4566,0,<START>,0,0,0
4566,1,home,0,8,8
4566,2,education,8,11,3
4566,3,home,11,24,13
4566,4,<ENDS>,24,24,0
4567,0,<START>,0,0,0
4567,1,home,0,7,7
4567,2,education,7,11,4
4567,3,home,11,19,8
4567,4,shop,19,21,2
4567,5,home,21,24,3
4567,6,<ENDS>,24,24,0
4568,0,<START>,0,0,0
4568,1,home,0,8,8
4568,2,education,8,11,3
4568,3,home,11,18,7
4568,4,shop,18,19,1
4568,5,home,19,24,5
4568,6,<ENDS>,24,24,0
4569,0,<START>,0,0,0
4569,1,home,0,6,6
4569,2,work,6,13,7
4569,3,home,13,24,11
4569,4,<ENDS>,24,24,0
4570,0,<START>,0,0,0
4570,1,home,0,6,6
4570,2,shop,6,7,1
4570,3,home,7,13,6
4570,4,work,13,19,6
4570,5,home,19,24,5
4570,6,<ENDS>,24,24,0
4571,0,<START>,0,0,0
4571,1,home,0,7,7
4571,2,work,7,13,6
4571,3,shop,13,14,1
4571,4,work,14,20,6
4571,5,home,20,24,4
4571,6,<ENDS>,24,24,0
4572,0,<START>,0,0,0
4572,1,home,0,8,8
4572,2,work,8,15,7
4572,3,home,15,21,6
4572,4,work,21,22,1
4572,5,home,22,24,2
4572,6,<ENDS>,24,24,0
4573,0,<START>,0,0,0
4573,1,home,0,8,8
4573,2,education,8,11,3
4573,3,home,11,17,6
4573,4,shop,17,19,2
4573,5,home,19,24,5
4573,6,<ENDS>,24,24,0
4574,0,<START>,0,0,0
4574,1,home,0,7,7
4574,2,shop,7,8,1
4574,3,work,8,15,7
4574,4,home,15,24,9
4574,5,<ENDS>,24,24,0
4575,0,<START>,0,0,0
4575,1,home,0,7,7
4575,2,work,7,14,7
4575,3,home,14,24,10
4575,4,<ENDS>,24,24,0
4576,0,<START>,0,0,0
4576,1,home,0,6,6
4576,2,shop,6,7,1
4576,3,home,7,13,6
4576,4,education,13,15,2
4576,5,shop,15,17,2
4576,6,home,17,24,7
4576,7,<ENDS>,24,24,0
4577,0,<START>,0,0,0
4577,1,home,0,6,6
4577,2,work,6,12,6
4577,3,shop,12,13,1
4577,4,work,13,19,6
4577,5,home,19,24,5
4577,6,<ENDS>,24,24,0
4578,0,<START>,0,0,0
4578,1,home,0,6,6
4578,2,shop,6,7,1
4578,3,home,7,10,3
4578,4,education,10,14,4
4578,5,shop,14,15,1
4578,6,home,15,24,9
4578,7,<ENDS>,24,24,0
4579,0,<START>,0,0,0
4579,1,home,0,7,7
4579,2,work,7,13,6
4579,3,home,13,24,11
4579,4,<ENDS>,24,24,0
4580,0,<START>,0,0,0
4580,1,home,0,7,7
4580,2,work,7,14,7
4580,3,home,14,22,8
4580,4,work,22,23,1
4580,5,home,23,24,1
4580,6,<ENDS>,24,24,0
4581,0,<START>,0,0,0
4581,1,home,0,8,8
4581,2,work,8,14,6
4581,3,home,14,21,7
4581,4,work,21,22,1
4581,5,home,22,24,2
4581,6,<ENDS>,24,24,0
4582,0,<START>,0,0,0
4582,1,home,0,6,6
4582,2,work,6,8,2
4582,3,home,8,12,4
4582,4,work,12,14,2
4582,5,home,14,21,7
4582,6,work,21,22,1
4582,7,home,22,24,2
4582,8,<ENDS>,24,24,0
4583,0,<START>,0,0,0
4583,1,home,0,7,7
4583,2,work,7,13,6
4583,3,home,13,20,7
4583,4,shop,20,21,1
4583,5,home,21,24,3
4583,6,<ENDS>,24,24,0
4584,0,<START>,0,0,0
4584,1,home,0,7,7
4584,2,work,7,13,6
4584,3,shop,13,14,1
4584,4,work,14,18,4
4584,5,home,18,24,6
4584,6,<ENDS>,24,24,0
4585,0,<START>,0,0,0
4585,1,home,0,8,8
4585,2,education,8,12,4
4585,3,work,12,19,7
4585,4,home,19,23,4
4585,5,work,23,24,1
4585,6,<ENDS>,24,24,0
4586,0,<START>,0,0,0
4586,1,home,0,6,6
4586,2,shop,6,7,1
4586,3,work,7,14,7
4586,4,home,14,24,10
4586,5,<ENDS>,24,24,0
4587,0,<START>,0,0,0
4587,1,home,0,4,4
4587,2,work,4,13,9
4587,3,shop,13,14,1
4587,4,work,14,19,5
4587,5,home,19,24,5
4587,6,<ENDS>,24,24,0
4588,0,<START>,0,0,0
4588,1,home,0,6,6
4588,2,work,6,13,7
4588,3,home,13,19,6
4588,4,shop,19,20,1
4588,5,home,20,24,4
4588,6,<ENDS>,24,24,0
4589,0,<START>,0,0,0
4589,1,home,0,8,8
4589,2,work,8,14,6
4589,3,home,14,16,2
4589,4,work,16,20,4
4589,5,home,20,24,4
4589,6,<ENDS>,24,24,0
4590,0,<START>,0,0,0
4590,1,home,0,8,8
4590,2,work,8,14,6
4590,3,shop,14,15,1
4590,4,home,15,24,9
4590,5,<ENDS>,24,24,0
4591,0,<START>,0,0,0
4591,1,home,0,8,8
4591,2,work,8,15,7
4591,3,home,15,24,9
4591,4,<ENDS>,24,24,0
4592,0,<START>,0,0,0
4592,1,home,0,6,6
4592,2,work,6,12,6
4592,3,shop,12,13,1
4592,4,work,13,19,6
4592,5,home,19,24,5
4592,6,<ENDS>,24,24,0
4593,0,<START>,0,0,0
4593,1,home,0,7,7
4593,2,work,7,13,6
4593,3,shop,13,14,1
4593,4,home,14,24,10
4593,5,<ENDS>,24,24,0
4594,0,<START>,0,0,0
4594,1,home,0,7,7
4594,2,work,7,13,6
4594,3,shop,13,14,1
4594,4,home,14,24,10
4594,5,<ENDS>,24,24,0
4595,0,<START>,0,0,0
4595,1,home,0,6,6
4595,2,shop,6,7,1
4595,3,home,7,10,3
4595,4,education,10,13,3
4595,5,shop,13,15,2
4595,6,home,15,24,9
4595,7,<ENDS>,24,24,0
4596,0,<START>,0,0,0
4596,1,home,0,7,7
4596,2,work,7,13,6
4596,3,shop,13,14,1
4596,4,home,14,24,10
4596,5,<ENDS>,24,24,0
4597,0,<START>,0,0,0
4597,1,home,0,6,6
4597,2,shop,6,7,1
4597,3,home,7,13,6
4597,4,education,13,16,3
4597,5,home,16,24,8
4597,6,<ENDS>,24,24,0
4598,0,<START>,0,0,0
4598,1,home,0,7,7
4598,2,education,7,10,3
4598,3,home,10,14,4
4598,4,education,14,17,3
4598,5,home,17,24,7
4598,6,<ENDS>,24,24,0
4599,0,<START>,0,0,0
4599,1,home,0,9,9
4599,2,work,9,17,8
4599,3,home,17,20,3
4599,4,shop,20,21,1
4599,5,home,21,24,3
4599,6,<ENDS>,24,24,0
4600,0,<START>,0,0,0
4600,1,home,0,6,6
4600,2,work,6,8,2
4600,3,home,8,13,5
4600,4,work,13,15,2
4600,5,home,15,21,6
4600,6,work,21,22,1
4600,7,home,22,24,2
4600,8,<ENDS>,24,24,0
4601,0,<START>,0,0,0
4601,1,home,0,7,7
4601,2,work,7,14,7
4601,3,shop,14,15,1
4601,4,home,15,18,3
4601,5,work,18,20,2
4601,6,home,20,24,4
4601,7,<ENDS>,24,24,0
4602,0,<START>,0,0,0
4602,1,home,0,6,6
4602,2,shop,6,7,1
4602,3,home,7,11,4
4602,4,work,11,18,7
4602,5,home,18,23,5
4602,6,work,23,24,1
4602,7,<ENDS>,24,24,0
4603,0,<START>,0,0,0
4603,1,home,0,6,6
4603,2,work,6,8,2
4603,3,home,8,12,4
4603,4,work,12,15,3
4603,5,home,15,23,8
4603,6,work,23,24,1
4603,7,<ENDS>,24,24,0
4604,0,<START>,0,0,0
4604,1,home,0,7,7
4604,2,education,7,13,6
4604,3,home,13,20,7
4604,4,shop,20,21,1
4604,5,home,21,24,3
4604,6,<ENDS>,24,24,0
4605,0,<START>,0,0,0
4605,1,home,0,8,8
4605,2,work,8,15,7
4605,3,home,15,24,9
4605,4,<ENDS>,24,24,0
4606,0,<START>,0,0,0
4606,1,home,0,7,7
4606,2,shop,7,8,1
4606,3,education,8,12,4
4606,4,shop,12,14,2
4606,5,education,14,17,3
4606,6,home,17,24,7
4606,7,<ENDS>,24,24,0
4607,0,<START>,0,0,0
4607,1,home,0,7,7
4607,2,shop,7,8,1
4607,3,education,8,11,3
4607,4,home,11,13,2
4607,5,education,13,16,3
4607,6,home,16,20,4
4607,7,shop,20,21,1
4607,8,home,21,24,3
4607,9,<ENDS>,24,24,0
4608,0,<START>,0,0,0
4608,1,home,0,6,6
4608,2,work,6,8,2
4608,3,home,8,13,5
4608,4,work,13,15,2
4608,5,home,15,22,7
4608,6,work,22,23,1
4608,7,home,23,24,1
4608,8,<ENDS>,24,24,0
4609,0,<START>,0,0,0
4609,1,home,0,8,8
4609,2,work,8,15,7
4609,3,home,15,20,5
4609,4,shop,20,21,1
4609,5,home,21,24,3
4609,6,<ENDS>,24,24,0
4610,0,<START>,0,0,0
4610,1,home,0,6,6
4610,2,work,6,13,7
4610,3,shop,13,14,1
4610,4,work,14,19,5
4610,5,home,19,24,5
4610,6,<ENDS>,24,24,0
4611,0,<START>,0,0,0
4611,1,home,0,7,7
4611,2,work,7,13,6
4611,3,home,13,14,1
4611,4,education,14,15,1
4611,5,shop,15,16,1
4611,6,work,16,19,3
4611,7,home,19,24,5
4611,8,<ENDS>,24,24,0
4612,0,<START>,0,0,0
4612,1,home,0,7,7
4612,2,shop,7,8,1
4612,3,home,8,10,2
4612,4,education,10,13,3
4612,5,home,13,17,4
4612,6,shop,17,18,1
4612,7,home,18,24,6
4612,8,<ENDS>,24,24,0
4613,0,<START>,0,0,0
4613,1,home,0,7,7
4613,2,work,7,14,7
4613,3,home,14,21,7
4613,4,work,21,22,1
4613,5,home,22,24,2
4613,6,<ENDS>,24,24,0
4614,0,<START>,0,0,0
4614,1,home,0,4,4
4614,2,work,4,5,1
4614,3,home,5,9,4
4614,4,work,9,11,2
4614,5,home,11,16,5
4614,6,work,16,18,2
4614,7,home,18,24,6
4614,8,<ENDS>,24,24,0
4615,0,<START>,0,0,0
4615,1,work,0,2,2
4615,2,home,2,6,4
4615,3,work,6,8,2
4615,4,home,8,10,2
4615,5,work,10,12,2
4615,6,shop,12,13,1
4615,7,work,13,15,2
4615,8,home,15,22,7
4615,9,work,22,23,1
4615,10,home,23,24,1
4615,11,<ENDS>,24,24,0
4616,0,<START>,0,0,0
4616,1,home,0,7,7
4616,2,work,7,14,7
4616,3,home,14,18,4
4616,4,work,18,20,2
4616,5,home,20,24,4
4616,6,<ENDS>,24,24,0
4617,0,<START>,0,0,0
4617,1,home,0,7,7
4617,2,work,7,14,7
4617,3,shop,14,15,1
4617,4,work,15,20,5
4617,5,home,20,24,4
4617,6,<ENDS>,24,24,0
4618,0,<START>,0,0,0
4618,1,home,0,6,6
4618,2,work,6,13,7
4618,3,shop,13,14,1
4618,4,work,14,20,6
4618,5,home,20,24,4
4618,6,<ENDS>,24,24,0
4619,0,<START>,0,0,0
4619,1,home,0,8,8
4619,2,work,8,13,5
4619,3,home,13,24,11
4619,4,<ENDS>,24,24,0
4620,0,<START>,0,0,0
4620,1,home,0,7,7
4620,2,shop,7,9,2
4620,3,education,9,12,3
4620,4,shop,12,13,1
4620,5,education,13,16,3
4620,6,home,16,24,8
4620,7,<ENDS>,24,24,0
4621,0,<START>,0,0,0
4621,1,home,0,8,8
4621,2,work,8,15,7
4621,3,home,15,18,3
4621,4,work,18,20,2
4621,5,home,20,24,4
4621,6,<ENDS>,24,24,0
4622,0,<START>,0,0,0
4622,1,home,0,7,7
4622,2,work,7,13,6
4622,3,shop,13,14,1
4622,4,work,14,19,5
4622,5,home,19,24,5
4622,6,<ENDS>,24,24,0
4623,0,<START>,0,0,0
4623,1,home,0,6,6
4623,2,shop,6,7,1
4623,3,home,7,10,3
4623,4,education,10,16,6
4623,5,shop,16,18,2
4623,6,home,18,24,6
4623,7,<ENDS>,24,24,0
4624,0,<START>,0,0,0
4624,1,home,0,7,7
4624,2,work,7,13,6
4624,3,shop,13,14,1
4624,4,education,14,17,3
4624,5,home,17,24,7
4624,6,<ENDS>,24,24,0
4625,0,<START>,0,0,0
4625,1,home,0,8,8
4625,2,work,8,15,7
4625,3,home,15,24,9
4625,4,<ENDS>,24,24,0
4626,0,<START>,0,0,0
4626,1,home,0,6,6
4626,2,work,6,13,7
4626,3,home,13,20,7
4626,4,shop,20,21,1
4626,5,home,21,24,3
4626,6,<ENDS>,24,24,0
4627,0,<START>,0,0,0
4627,1,home,0,7,7
4627,2,work,7,13,6
4627,3,home,13,23,10
4627,4,work,23,24,1
4627,5,<ENDS>,24,24,0
4628,0,<START>,0,0,0
4628,1,home,0,7,7
4628,2,work,7,13,6
4628,3,home,13,24,11
4628,4,<ENDS>,24,24,0
4629,0,<START>,0,0,0
4629,1,home,0,7,7
4629,2,work,7,14,7
4629,3,home,14,22,8
4629,4,work,22,23,1
4629,5,home,23,24,1
4629,6,<ENDS>,24,24,0
4630,0,<START>,0,0,0
4630,1,home,0,7,7
4630,2,work,7,13,6
4630,3,shop,13,14,1
4630,4,education,14,17,3
4630,5,home,17,24,7
4630,6,<ENDS>,24,24,0
4631,0,<START>,0,0,0
4631,1,home,0,7,7
4631,2,work,7,14,7
4631,3,home,14,24,10
4631,4,<ENDS>,24,24,0
4632,0,<START>,0,0,0
4632,1,home,0,8,8
4632,2,work,8,14,6
4632,3,home,14,24,10
4632,4,<ENDS>,24,24,0
4633,0,<START>,0,0,0
4633,1,home,0,7,7
4633,2,shop,7,8,1
4633,3,home,8,13,5
4633,4,education,13,17,4
4633,5,home,17,24,7
4633,6,<ENDS>,24,24,0
4634,0,<START>,0,0,0
4634,1,home,0,6,6
4634,2,shop,6,7,1
4634,3,home,7,10,3
4634,4,education,10,12,2
4634,5,home,12,19,7
4634,6,shop,19,21,2
4634,7,home,21,24,3
4634,8,<ENDS>,24,24,0
4635,0,<START>,0,0,0
4635,1,home,0,7,7
4635,2,work,7,14,7
4635,3,home,14,22,8
4635,4,work,22,23,1
4635,5,home,23,24,1
4635,6,<ENDS>,24,24,0
4636,0,<START>,0,0,0
4636,1,home,0,7,7
4636,2,work,7,14,7
4636,3,shop,14,15,1
4636,4,home,15,24,9
4636,5,<ENDS>,24,24,0
4637,0,<START>,0,0,0
4637,1,home,0,6,6
4637,2,work,6,8,2
4637,3,home,8,12,4
4637,4,work,12,14,2
4637,5,home,14,17,3
4637,6,work,17,19,2
4637,7,home,19,24,5
4637,8,<ENDS>,24,24,0
4638,0,<START>,0,0,0
4638,1,home,0,7,7
4638,2,education,7,11,4
4638,3,home,11,18,7
4638,4,shop,18,19,1
4638,5,home,19,24,5
4638,6,<ENDS>,24,24,0
4639,0,<START>,0,0,0
4639,1,home,0,6,6
4639,2,work,6,13,7
4639,3,home,13,17,4
4639,4,work,17,20,3
4639,5,home,20,24,4
4639,6,<ENDS>,24,24,0
4640,0,<START>,0,0,0
4640,1,home,0,6,6
4640,2,work,6,8,2
4640,3,home,8,12,4
4640,4,work,12,14,2
4640,5,home,14,21,7
4640,6,work,21,22,1
4640,7,home,22,24,2
4640,8,<ENDS>,24,24,0
4641,0,<START>,0,0,0
4641,1,home,0,7,7
4641,2,work,7,13,6
4641,3,shop,13,14,1
4641,4,work,14,20,6
4641,5,home,20,24,4
4641,6,<ENDS>,24,24,0
4642,0,<START>,0,0,0
4642,1,home,0,7,7
4642,2,work,7,14,7
4642,3,home,14,18,4
4642,4,work,18,20,2
4642,5,home,20,24,4
4642,6,<ENDS>,24,24,0
4643,0,<START>,0,0,0
4643,1,home,0,7,7
4643,2,education,7,11,4
4643,3,home,11,18,7
4643,4,shop,18,19,1
4643,5,home,19,24,5
4643,6,<ENDS>,24,24,0
4644,0,<START>,0,0,0
4644,1,home,0,8,8
4644,2,work,8,14,6
4644,3,shop,14,15,1
4644,4,home,15,22,7
4644,5,work,22,23,1
4644,6,home,23,24,1
4644,7,<ENDS>,24,24,0
4645,0,<START>,0,0,0
4645,1,home,0,7,7
4645,2,shop,7,8,1
4645,3,home,8,10,2
4645,4,work,10,17,7
4645,5,home,17,24,7
4645,6,<ENDS>,24,24,0
4646,0,<START>,0,0,0
4646,1,home,0,6,6
4646,2,work,6,13,7
4646,3,shop,13,14,1
4646,4,work,14,19,5
4646,5,home,19,24,5
4646,6,<ENDS>,24,24,0
4647,0,<START>,0,0,0
4647,1,home,0,7,7
4647,2,education,7,11,4
4647,3,home,11,18,7
4647,4,shop,18,19,1
4647,5,home,19,24,5
4647,6,<ENDS>,24,24,0
4648,0,<START>,0,0,0
4648,1,home,0,9,9
4648,2,education,9,11,2
4648,3,home,11,16,5
4648,4,work,16,20,4
4648,5,home,20,24,4
4648,6,<ENDS>,24,24,0
4649,0,<START>,0,0,0
4649,1,home,0,6,6
4649,2,shop,6,7,1
4649,3,home,7,13,6
4649,4,education,13,15,2
4649,5,shop,15,16,1
4649,6,home,16,24,8
4649,7,<ENDS>,24,24,0
4650,0,<START>,0,0,0
4650,1,home,0,8,8
4650,2,education,8,12,4
4650,3,home,12,16,4
4650,4,shop,16,17,1
4650,5,home,17,24,7
4650,6,<ENDS>,24,24,0
4651,0,<START>,0,0,0
4651,1,home,0,7,7
4651,2,work,7,13,6
4651,3,shop,13,14,1
4651,4,home,14,24,10
4651,5,<ENDS>,24,24,0
4652,0,<START>,0,0,0
4652,1,home,0,6,6
4652,2,work,6,12,6
4652,3,shop,12,13,1
4652,4,work,13,19,6
4652,5,home,19,24,5
4652,6,<ENDS>,24,24,0
4653,0,<START>,0,0,0
4653,1,home,0,7,7
4653,2,work,7,14,7
4653,3,shop,14,15,1
4653,4,home,15,24,9
4653,5,<ENDS>,24,24,0
4654,0,<START>,0,0,0
4654,1,home,0,7,7
4654,2,work,7,13,6
4654,3,shop,13,14,1
4654,4,work,14,19,5
4654,5,home,19,24,5
4654,6,<ENDS>,24,24,0
4655,0,<START>,0,0,0
4655,1,home,0,6,6
4655,2,shop,6,7,1
4655,3,home,7,9,2
4655,4,education,9,12,3
4655,5,shop,12,14,2
4655,6,education,14,16,2
4655,7,home,16,24,8
4655,8,<ENDS>,24,24,0
4656,0,<START>,0,0,0
4656,1,home,0,7,7
4656,2,shop,7,8,1
4656,3,education,8,11,3
4656,4,home,11,19,8
4656,5,shop,19,20,1
4656,6,home,20,24,4
4656,7,<ENDS>,24,24,0
4657,0,<START>,0,0,0
4657,1,home,0,7,7
4657,2,work,7,14,7
4657,3,home,14,23,9
4657,4,work,23,24,1
4657,5,<ENDS>,24,24,0
4658,0,<START>,0,0,0
4658,1,work,0,8,8
4658,2,shop,8,9,1
4658,3,home,9,14,5
4658,4,education,14,16,2
4658,5,home,16,24,8
4658,6,<ENDS>,24,24,0
4659,0,<START>,0,0,0
4659,1,home,0,10,10
4659,2,shop,10,11,1
4659,3,work,11,18,7
4659,4,home,18,24,6
4659,5,<ENDS>,24,24,0
4660,0,<START>,0,0,0
4660,1,home,0,7,7
4660,2,work,7,13,6
4660,3,shop,13,14,1
4660,4,home,14,24,10
4660,5,<ENDS>,24,24,0
4661,0,<START>,0,0,0
4661,1,home,0,7,7
4661,2,work,7,9,2
4661,3,home,9,13,4
4661,4,work,13,15,2
4661,5,home,15,22,7
4661,6,work,22,23,1
4661,7,home,23,24,1
4661,8,<ENDS>,24,24,0
4662,0,<START>,0,0,0
4662,1,home,0,7,7
4662,2,education,7,11,4
4662,3,home,11,19,8
4662,4,shop,19,20,1
4662,5,home,20,24,4
4662,6,<ENDS>,24,24,0
4663,0,<START>,0,0,0
4663,1,home,0,6,6
4663,2,work,6,15,9
4663,3,home,15,18,3
4663,4,work,18,20,2
4663,5,home,20,24,4
4663,6,<ENDS>,24,24,0
4664,0,<START>,0,0,0
4664,1,home,0,8,8
4664,2,work,8,15,7
4664,3,home,15,24,9
4664,4,<ENDS>,24,24,0
4665,0,<START>,0,0,0
4665,1,home,0,7,7
4665,2,work,7,14,7
4665,3,shop,14,15,1
4665,4,home,15,24,9
4665,5,<ENDS>,24,24,0
4666,0,<START>,0,0,0
4666,1,home,0,6,6
4666,2,shop,6,7,1
4666,3,home,7,10,3
4666,4,education,10,13,3
4666,5,home,13,20,7
4666,6,shop,20,21,1
4666,7,home,21,24,3
4666,8,<ENDS>,24,24,0
4667,0,<START>,0,0,0
4667,1,home,0,6,6
4667,2,work,6,13,7
4667,3,home,13,24,11
4667,4,<ENDS>,24,24,0
4668,0,<START>,0,0,0
4668,1,home,0,6,6
4668,2,work,6,12,6
4668,3,shop,12,13,1
4668,4,work,13,19,6
4668,5,home,19,24,5
4668,6,<ENDS>,24,24,0
4669,0,<START>,0,0,0
4669,1,home,0,8,8
4669,2,work,8,15,7
4669,3,shop,15,16,1
4669,4,work,16,19,3
4669,5,home,19,24,5
4669,6,<ENDS>,24,24,0
4670,0,<START>,0,0,0
4670,1,home,0,7,7
4670,2,work,7,9,2
4670,3,home,9,15,6
4670,4,work,15,17,2
4670,5,home,17,23,6
4670,6,work,23,24,1
4670,7,<ENDS>,24,24,0
4671,0,<START>,0,0,0
4671,1,home,0,8,8
4671,2,work,8,12,4
4671,3,shop,12,13,1
4671,4,work,13,19,6
4671,5,home,19,24,5
4671,6,<ENDS>,24,24,0
4672,0,<START>,0,0,0
4672,1,home,0,9,9
4672,2,work,9,16,7
4672,3,home,16,24,8
4672,4,<ENDS>,24,24,0
4673,0,<START>,0,0,0
4673,1,home,0,7,7
4673,2,shop,7,8,1
4673,3,education,8,11,3
4673,4,home,11,19,8
4673,5,shop,19,20,1
4673,6,home,20,24,4
4673,7,<ENDS>,24,24,0
4674,0,<START>,0,0,0
4674,1,home,0,8,8
4674,2,education,8,11,3
4674,3,shop,11,12,1
4674,4,work,12,19,7
4674,5,home,19,24,5
4674,6,<ENDS>,24,24,0
4675,0,<START>,0,0,0
4675,1,home,0,6,6
4675,2,work,6,13,7
4675,3,shop,13,14,1
4675,4,home,14,21,7
4675,5,shop,21,22,1
4675,6,home,22,24,2
4675,7,<ENDS>,24,24,0
4676,0,<START>,0,0,0
4676,1,home,0,6,6
4676,2,work,6,8,2
4676,3,home,8,9,1
4676,4,work,9,11,2
4676,5,home,11,18,7
4676,6,work,18,19,1
4676,7,home,19,24,5
4676,8,<ENDS>,24,24,0
4677,0,<START>,0,0,0
4677,1,home,0,8,8
4677,2,education,8,11,3
4677,3,home,11,16,5
4677,4,work,16,20,4
4677,5,home,20,24,4
4677,6,<ENDS>,24,24,0
4678,0,<START>,0,0,0
4678,1,home,0,6,6
4678,2,work,6,13,7
4678,3,shop,13,14,1
4678,4,home,14,24,10
4678,5,<ENDS>,24,24,0
4679,0,<START>,0,0,0
4679,1,home,0,7,7
4679,2,shop,7,8,1
4679,3,work,8,15,7
4679,4,home,15,22,7
4679,5,work,22,23,1
4679,6,home,23,24,1
4679,7,<ENDS>,24,24,0
4680,0,<START>,0,0,0
4680,1,home,0,8,8
4680,2,work,8,15,7
4680,3,home,15,24,9
4680,4,<ENDS>,24,24,0
4681,0,<START>,0,0,0
4681,1,home,0,8,8
4681,2,work,8,15,7
4681,3,home,15,22,7
4681,4,work,22,23,1
4681,5,home,23,24,1
4681,6,<ENDS>,24,24,0
4682,0,<START>,0,0,0
4682,1,home,0,9,9
4682,2,work,9,14,5
4682,3,home,14,24,10
4682,4,<ENDS>,24,24,0
4683,0,<START>,0,0,0
4683,1,home,0,6,6
4683,2,shop,6,7,1
4683,3,home,7,10,3
4683,4,education,10,16,6
4683,5,home,16,24,8
4683,6,<ENDS>,24,24,0
4684,0,<START>,0,0,0
4684,1,home,0,7,7
4684,2,work,7,13,6
4684,3,home,13,17,4
4684,4,work,17,19,2
4684,5,home,19,24,5
4684,6,<ENDS>,24,24,0
4685,0,<START>,0,0,0
4685,1,home,0,9,9
4685,2,work,9,16,7
4685,3,shop,16,17,1
4685,4,home,17,24,7
4685,5,<ENDS>,24,24,0
4686,0,<START>,0,0,0
4686,1,home,0,7,7
4686,2,shop,7,8,1
4686,3,work,8,14,6
4686,4,home,14,21,7
4686,5,work,21,22,1
4686,6,home,22,24,2
4686,7,<ENDS>,24,24,0
4687,0,<START>,0,0,0
4687,1,home,0,7,7
4687,2,education,7,11,4
4687,3,home,11,17,6
4687,4,shop,17,19,2
4687,5,home,19,24,5
4687,6,<ENDS>,24,24,0
4688,0,<START>,0,0,0
4688,1,home,0,7,7
4688,2,work,7,13,6
4688,3,home,13,21,8
4688,4,work,21,22,1
4688,5,home,22,24,2
4688,6,<ENDS>,24,24,0
4689,0,<START>,0,0,0
4689,1,home,0,9,9
4689,2,work,9,15,6
4689,3,home,15,24,9
4689,4,<ENDS>,24,24,0
4690,0,<START>,0,0,0
4690,1,home,0,7,7
4690,2,work,7,13,6
4690,3,shop,13,14,1
4690,4,work,14,20,6
4690,5,home,20,24,4
4690,6,<ENDS>,24,24,0
4691,0,<START>,0,0,0
4691,1,home,0,7,7
4691,2,shop,7,8,1
4691,3,work,8,15,7
4691,4,home,15,24,9
4691,5,<ENDS>,24,24,0
4692,0,<START>,0,0,0
4692,1,home,0,6,6
4692,2,work,6,13,7
4692,3,home,13,21,8
4692,4,work,21,22,1
4692,5,home,22,24,2
4692,6,<ENDS>,24,24,0
4693,0,<START>,0,0,0
4693,1,home,0,7,7
4693,2,work,7,14,7
4693,3,shop,14,15,1
4693,4,work,15,20,5
4693,5,home,20,24,4
4693,6,<ENDS>,24,24,0
4694,0,<START>,0,0,0
4694,1,home,0,6,6
4694,2,work,6,8,2
4694,3,home,8,14,6
4694,4,work,14,16,2
4694,5,home,16,22,6
4694,6,work,22,23,1
4694,7,home,23,24,1
4694,8,<ENDS>,24,24,0
4695,0,<START>,0,0,0
4695,1,home,0,7,7
4695,2,work,7,13,6
4695,3,shop,13,14,1
4695,4,work,14,20,6
4695,5,home,20,24,4
4695,6,<ENDS>,24,24,0
4696,0,<START>,0,0,0
4696,1,home,0,7,7
4696,2,work,7,14,7
4696,3,home,14,24,10
4696,4,<ENDS>,24,24,0
4697,0,<START>,0,0,0
4697,1,home,0,8,8
4697,2,education,8,11,3
4697,3,shop,11,12,1
4697,4,work,12,18,6
4697,5,home,18,24,6
4697,6,<ENDS>,24,24,0
4698,0,<START>,0,0,0
4698,1,home,0,7,7
4698,2,shop,7,8,1
4698,3,work,8,14,6
4698,4,home,14,24,10
4698,5,<ENDS>,24,24,0
4699,0,<START>,0,0,0
4699,1,home,0,6,6
4699,2,work,6,8,2
4699,3,home,8,14,6
4699,4,work,14,17,3
4699,5,home,17,23,6
4699,6,work,23,24,1
4699,7,<ENDS>,24,24,0
4700,0,<START>,0,0,0
4700,1,home,0,6,6
4700,2,work,6,13,7
4700,3,home,13,17,4
4700,4,work,17,20,3
4700,5,home,20,24,4
4700,6,<ENDS>,24,24,0
4701,0,<START>,0,0,0
4701,1,home,0,6,6
4701,2,work,6,13,7
4701,3,shop,13,14,1
4701,4,home,14,24,10
4701,5,<ENDS>,24,24,0
4702,0,<START>,0,0,0
4702,1,work,0,1,1
4702,2,home,1,7,6
4702,3,education,7,11,4
4702,4,home,11,20,9
4702,5,shop,20,21,1
4702,6,home,21,24,3
4702,7,<ENDS>,24,24,0
4703,0,<START>,0,0,0
4703,1,home,0,7,7
4703,2,work,7,14,7
4703,3,shop,14,15,1
4703,4,home,15,22,7
4703,5,work,22,23,1
4703,6,home,23,24,1
4703,7,<ENDS>,24,24,0
4704,0,<START>,0,0,0
4704,1,home,0,7,7
4704,2,work,7,13,6
4704,3,shop,13,14,1
4704,4,work,14,19,5
4704,5,home,19,24,5
4704,6,<ENDS>,24,24,0
4705,0,<START>,0,0,0
4705,1,home,0,6,6
4705,2,shop,6,7,1
4705,3,home,7,9,2
4705,4,education,9,12,3
4705,5,home,12,21,9
4705,6,shop,21,22,1
4705,7,home,22,24,2
4705,8,<ENDS>,24,24,0
4706,0,<START>,0,0,0
4706,1,home,0,7,7
4706,2,work,7,13,6
4706,3,home,13,17,4
4706,4,work,17,20,3
4706,5,home,20,24,4
4706,6,<ENDS>,24,24,0
4707,0,<START>,0,0,0
4707,1,home,0,6,6
4707,2,work,6,8,2
4707,3,home,8,12,4
4707,4,work,12,14,2
4707,5,home,14,21,7
4707,6,work,21,22,1
4707,7,home,22,24,2
4707,8,<ENDS>,24,24,0
4708,0,<START>,0,0,0
4708,1,home,0,6,6
4708,2,work,6,7,1
4708,3,home,7,11,4
4708,4,work,11,13,2
4708,5,home,13,17,4
4708,6,work,17,19,2
4708,7,home,19,24,5
4708,8,<ENDS>,24,24,0
4709,0,<START>,0,0,0
4709,1,home,0,7,7
4709,2,work,7,14,7
4709,3,shop,14,15,1
4709,4,home,15,24,9
4709,5,<ENDS>,24,24,0
4710,0,<START>,0,0,0
4710,1,home,0,7,7
4710,2,education,7,11,4
4710,3,home,11,14,3
4710,4,education,14,16,2
4710,5,shop,16,17,1
4710,6,home,17,24,7
4710,7,<ENDS>,24,24,0
4711,0,<START>,0,0,0
4711,1,home,0,7,7
4711,2,education,7,11,4
4711,3,home,11,18,7
4711,4,shop,18,19,1
4711,5,home,19,24,5
4711,6,<ENDS>,24,24,0
4712,0,<START>,0,0,0
4712,1,home,0,8,8
4712,2,work,8,14,6
4712,3,home,14,18,4
4712,4,shop,18,19,1
4712,5,home,19,24,5
4712,6,<ENDS>,24,24,0
4713,0,<START>,0,0,0
4713,1,home,0,6,6
4713,2,work,6,13,7
4713,3,shop,13,14,1
4713,4,home,14,21,7
4713,5,work,21,22,1
4713,6,home,22,24,2
4713,7,<ENDS>,24,24,0
4714,0,<START>,0,0,0
4714,1,home,0,8,8
4714,2,shop,8,9,1
4714,3,work,9,17,8
4714,4,home,17,24,7
4714,5,<ENDS>,24,24,0
4715,0,<START>,0,0,0
4715,1,home,0,6,6
4715,2,work,6,8,2
4715,3,home,8,13,5
4715,4,work,13,16,3
4715,5,home,16,21,5
4715,6,work,21,22,1
4715,7,home,22,24,2
4715,8,<ENDS>,24,24,0
4716,0,<START>,0,0,0
4716,1,home,0,7,7
4716,2,shop,7,8,1
4716,3,home,8,13,5
4716,4,work,13,19,6
4716,5,home,19,24,5
4716,6,<ENDS>,24,24,0
4717,0,<START>,0,0,0
4717,1,home,0,9,9
4717,2,work,9,17,8
4717,3,home,17,24,7
4717,4,<ENDS>,24,24,0
4718,0,<START>,0,0,0
4718,1,home,0,6,6
4718,2,shop,6,7,1
4718,3,home,7,9,2
4718,4,education,9,12,3
4718,5,home,12,20,8
4718,6,shop,20,21,1
4718,7,home,21,24,3
4718,8,<ENDS>,24,24,0
4719,0,<START>,0,0,0
4719,1,home,0,6,6
4719,2,work,6,13,7
4719,3,shop,13,14,1
4719,4,home,14,18,4
4719,5,work,18,20,2
4719,6,home,20,24,4
4719,7,<ENDS>,24,24,0
4720,0,<START>,0,0,0
4720,1,home,0,6,6
4720,2,work,6,8,2
4720,3,home,8,10,2
4720,4,work,10,12,2
4720,5,home,12,19,7
4720,6,shop,19,20,1
4720,7,home,20,24,4
4720,8,<ENDS>,24,24,0
4721,0,<START>,0,0,0
4721,1,work,0,9,9
4721,2,shop,9,10,1
4721,3,work,10,17,7
4721,4,home,17,24,7
4721,5,<ENDS>,24,24,0
4722,0,<START>,0,0,0
4722,1,home,0,7,7
4722,2,education,7,11,4
4722,3,home,11,19,8
4722,4,shop,19,20,1
4722,5,home,20,24,4
4722,6,<ENDS>,24,24,0
4723,0,<START>,0,0,0
4723,1,home,0,7,7
4723,2,education,7,11,4
4723,3,home,11,19,8
4723,4,shop,19,20,1
4723,5,home,20,24,4
4723,6,<ENDS>,24,24,0
4724,0,<START>,0,0,0
4724,1,home,0,6,6
4724,2,work,6,13,7
4724,3,home,13,17,4
4724,4,work,17,20,3
4724,5,home,20,24,4
4724,6,<ENDS>,24,24,0
4725,0,<START>,0,0,0
4725,1,home,0,6,6
4725,2,shop,6,7,1
4725,3,home,7,9,2
4725,4,work,9,16,7
4725,5,home,16,24,8
4725,6,<ENDS>,24,24,0
4726,0,<START>,0,0,0
4726,1,home,0,7,7
4726,2,work,7,14,7
4726,3,shop,14,15,1
4726,4,home,15,24,9
4726,5,<ENDS>,24,24,0
4727,0,<START>,0,0,0
4727,1,home,0,7,7
4727,2,work,7,13,6
4727,3,shop,13,14,1
4727,4,home,14,18,4
4727,5,work,18,19,1
4727,6,home,19,24,5
4727,7,<ENDS>,24,24,0
4728,0,<START>,0,0,0
4728,1,home,0,6,6
4728,2,shop,6,7,1
4728,3,home,7,13,6
4728,4,education,13,17,4
4728,5,home,17,24,7
4728,6,<ENDS>,24,24,0
4729,0,<START>,0,0,0
4729,1,home,0,7,7
4729,2,work,7,13,6
4729,3,home,13,24,11
4729,4,<ENDS>,24,24,0
4730,0,<START>,0,0,0
4730,1,home,0,8,8
4730,2,work,8,14,6
4730,3,shop,14,15,1
4730,4,home,15,21,6
4730,5,work,21,22,1
4730,6,home,22,24,2
4730,7,<ENDS>,24,24,0
4731,0,<START>,0,0,0
4731,1,home,0,6,6
4731,2,work,6,7,1
4731,3,home,7,9,2
4731,4,work,9,11,2
4731,5,home,11,15,4
4731,6,work,15,17,2
4731,7,home,17,23,6
4731,8,work,23,24,1
4731,9,<ENDS>,24,24,0
4732,0,<START>,0,0,0
4732,1,home,0,7,7
4732,2,work,7,9,2
4732,3,home,9,13,4
4732,4,work,13,16,3
4732,5,home,16,22,6
4732,6,work,22,23,1
4732,7,home,23,24,1
4732,8,<ENDS>,24,24,0
4733,0,<START>,0,0,0
4733,1,home,0,6,6
4733,2,shop,6,7,1
4733,3,home,7,9,2
4733,4,education,9,12,3
4733,5,home,12,18,6
4733,6,work,18,20,2
4733,7,home,20,24,4
4733,8,<ENDS>,24,24,0
4734,0,<START>,0,0,0
4734,1,home,0,7,7
4734,2,work,7,13,6
4734,3,shop,13,14,1
4734,4,work,14,19,5
4734,5,home,19,24,5
4734,6,<ENDS>,24,24,0
4735,0,<START>,0,0,0
4735,1,home,0,6,6
4735,2,shop,6,7,1
4735,3,home,7,9,2
4735,4,education,9,13,4
4735,5,home,13,19,6
4735,6,shop,19,21,2
4735,7,home,21,24,3
4735,8,<ENDS>,24,24,0
4736,0,<START>,0,0,0
4736,1,home,0,8,8
4736,2,work,8,15,7
4736,3,home,15,24,9
4736,4,<ENDS>,24,24,0
4737,0,<START>,0,0,0
4737,1,home,0,7,7
4737,2,work,7,8,1
4737,3,home,8,12,4
4737,4,work,12,13,1
4737,5,home,13,21,8
4737,6,work,21,22,1
4737,7,home,22,24,2
4737,8,<ENDS>,24,24,0
4738,0,<START>,0,0,0
4738,1,home,0,8,8
4738,2,education,8,12,4
4738,3,shop,12,14,2
4738,4,education,14,16,2
4738,5,home,16,24,8
4738,6,<ENDS>,24,24,0
4739,0,<START>,0,0,0
4739,1,home,0,7,7
4739,2,work,7,13,6
4739,3,shop,13,14,1
4739,4,home,14,24,10
4739,5,<ENDS>,24,24,0
4740,0,<START>,0,0,0
4740,1,home,0,7,7
4740,2,work,7,14,7
4740,3,home,14,17,3
4740,4,work,17,20,3
4740,5,home,20,24,4
4740,6,<ENDS>,24,24,0
4741,0,<START>,0,0,0
4741,1,home,0,6,6
4741,2,shop,6,7,1
4741,3,work,7,13,6
4741,4,home,13,16,3
4741,5,work,16,20,4
4741,6,home,20,24,4
4741,7,<ENDS>,24,24,0
4742,0,<START>,0,0,0
4742,1,home,0,8,8
4742,2,work,8,13,5
4742,3,home,13,24,11
4742,4,<ENDS>,24,24,0
4743,0,<START>,0,0,0
4743,1,home,0,8,8
4743,2,work,8,14,6
4743,3,home,14,24,10
4743,4,<ENDS>,24,24,0
4744,0,<START>,0,0,0
4744,1,home,0,6,6
4744,2,work,6,7,1
4744,3,home,7,8,1
4744,4,work,8,11,3
4744,5,home,11,17,6
4744,6,work,17,19,2
4744,7,home,19,24,5
4744,8,<ENDS>,24,24,0
4745,0,<START>,0,0,0
4745,1,home,0,8,8
4745,2,work,8,15,7
4745,3,home,15,23,8
4745,4,work,23,24,1
4745,5,<ENDS>,24,24,0
4746,0,<START>,0,0,0
4746,1,home,0,7,7
4746,2,shop,7,8,1
4746,3,home,8,13,5
4746,4,education,13,16,3
4746,5,shop,16,18,2
4746,6,home,18,24,6
4746,7,<ENDS>,24,24,0
4747,0,<START>,0,0,0
4747,1,home,0,7,7
4747,2,work,7,13,6
4747,3,shop,13,14,1
4747,4,work,14,19,5
4747,5,home,19,24,5
4747,6,<ENDS>,24,24,0
4748,0,<START>,0,0,0
4748,1,home,0,7,7
4748,2,work,7,13,6
4748,3,shop,13,14,1
4748,4,home,14,24,10
4748,5,<ENDS>,24,24,0
4749,0,<START>,0,0,0
4749,1,home,0,7,7
4749,2,education,7,11,4
4749,3,home,11,15,4
4749,4,shop,15,16,1
4749,5,home,16,24,8
4749,6,<ENDS>,24,24,0
4750,0,<START>,0,0,0
4750,1,home,0,7,7
4750,2,work,7,15,8
4750,3,home,15,24,9
4750,4,<ENDS>,24,24,0
4751,0,<START>,0,0,0
4751,1,home,0,7,7
4751,2,work,7,14,7
4751,3,shop,14,15,1
4751,4,work,15,19,4
4751,5,home,19,24,5
4751,6,<ENDS>,24,24,0
4752,0,<START>,0,0,0
4752,1,home,0,7,7
4752,2,work,7,13,6
4752,3,home,13,24,11
4752,4,<ENDS>,24,24,0
4753,0,<START>,0,0,0
4753,1,home,0,6,6
4753,2,shop,6,7,1
4753,3,home,7,13,6
4753,4,education,13,16,3
4753,5,home,16,24,8
4753,6,<ENDS>,24,24,0
4754,0,<START>,0,0,0
4754,1,home,0,7,7
4754,2,education,7,11,4
4754,3,home,11,18,7
4754,4,shop,18,19,1
4754,5,home,19,24,5
4754,6,<ENDS>,24,24,0
4755,0,<START>,0,0,0
4755,1,home,0,6,6
4755,2,work,6,13,7
4755,3,home,13,17,4
4755,4,shop,17,18,1
4755,5,home,18,24,6
4755,6,<ENDS>,24,24,0
4756,0,<START>,0,0,0
4756,1,home,0,7,7
4756,2,work,7,13,6
4756,3,shop,13,14,1
4756,4,home,14,24,10
4756,5,<ENDS>,24,24,0
4757,0,<START>,0,0,0
4757,1,home,0,8,8
4757,2,shop,8,9,1
4757,3,work,9,16,7
4757,4,home,16,24,8
4757,5,<ENDS>,24,24,0
4758,0,<START>,0,0,0
4758,1,home,0,7,7
4758,2,work,7,9,2
4758,3,home,9,12,3
4758,4,work,12,14,2
4758,5,home,14,21,7
4758,6,work,21,22,1
4758,7,home,22,24,2
4758,8,<ENDS>,24,24,0
4759,0,<START>,0,0,0
4759,1,home,0,7,7
4759,2,work,7,13,6
4759,3,shop,13,14,1
4759,4,work,14,19,5
4759,5,education,19,20,1
4759,6,home,20,24,4
4759,7,<ENDS>,24,24,0
4760,0,<START>,0,0,0
4760,1,home,0,7,7
4760,2,work,7,13,6
4760,3,shop,13,14,1
4760,4,work,14,20,6
4760,5,home,20,24,4
4760,6,<ENDS>,24,24,0
4761,0,<START>,0,0,0
4761,1,home,0,7,7
4761,2,work,7,8,1
4761,3,home,8,12,4
4761,4,education,12,14,2
4761,5,home,14,21,7
4761,6,work,21,22,1
4761,7,home,22,24,2
4761,8,<ENDS>,24,24,0
4762,0,<START>,0,0,0
4762,1,home,0,7,7
4762,2,work,7,14,7
4762,3,shop,14,15,1
4762,4,home,15,19,4
4762,5,shop,19,20,1
4762,6,home,20,24,4
4762,7,<ENDS>,24,24,0
4763,0,<START>,0,0,0
4763,1,home,0,7,7
4763,2,education,7,11,4
4763,3,home,11,18,7
4763,4,shop,18,19,1
4763,5,home,19,24,5
4763,6,<ENDS>,24,24,0
4764,0,<START>,0,0,0
4764,1,home,0,7,7
4764,2,education,7,12,5
4764,3,home,12,19,7
4764,4,shop,19,20,1
4764,5,home,20,24,4
4764,6,<ENDS>,24,24,0
4765,0,<START>,0,0,0
4765,1,home,0,6,6
4765,2,shop,6,7,1
4765,3,work,7,13,6
4765,4,home,13,17,4
4765,5,work,17,20,3
4765,6,home,20,24,4
4765,7,<ENDS>,24,24,0
4766,0,<START>,0,0,0
4766,1,home,0,7,7
4766,2,work,7,14,7
4766,3,home,14,24,10
4766,4,<ENDS>,24,24,0
4767,0,<START>,0,0,0
4767,1,home,0,7,7
4767,2,work,7,9,2
4767,3,home,9,13,4
4767,4,work,13,15,2
4767,5,home,15,21,6
4767,6,work,21,22,1
4767,7,home,22,24,2
4767,8,<ENDS>,24,24,0
4768,0,<START>,0,0,0
4768,1,home,0,7,7
4768,2,work,7,13,6
4768,3,shop,13,14,1
4768,4,work,14,20,6
4768,5,home,20,24,4
4768,6,<ENDS>,24,24,0
4769,0,<START>,0,0,0
4769,1,home,0,8,8
4769,2,work,8,13,5
4769,3,shop,13,14,1
4769,4,work,14,19,5
4769,5,home,19,24,5
4769,6,<ENDS>,24,24,0
4770,0,<START>,0,0,0
4770,1,home,0,7,7
4770,2,work,7,13,6
4770,3,home,13,16,3
4770,4,shop,16,17,1
4770,5,home,17,24,7
4770,6,<ENDS>,24,24,0
4771,0,<START>,0,0,0
4771,1,home,0,9,9
4771,2,work,9,16,7
4771,3,shop,16,17,1
4771,4,home,17,24,7
4771,5,<ENDS>,24,24,0
4772,0,<START>,0,0,0
4772,1,home,0,8,8
4772,2,work,8,14,6
4772,3,home,14,22,8
4772,4,work,22,23,1
4772,5,home,23,24,1
4772,6,<ENDS>,24,24,0
4773,0,<START>,0,0,0
4773,1,home,0,6,6
4773,2,work,6,8,2
4773,3,home,8,12,4
4773,4,work,12,14,2
4773,5,home,14,22,8
4773,6,work,22,23,1
4773,7,home,23,24,1
4773,8,<ENDS>,24,24,0
4774,0,<START>,0,0,0
4774,1,home,0,7,7
4774,2,work,7,15,8
4774,3,home,15,24,9
4774,4,<ENDS>,24,24,0
4775,0,<START>,0,0,0
4775,1,home,0,7,7
4775,2,work,7,14,7
4775,3,home,14,20,6
4775,4,shop,20,21,1
4775,5,home,21,24,3
4775,6,<ENDS>,24,24,0
4776,0,<START>,0,0,0
4776,1,home,0,7,7
4776,2,work,7,14,7
4776,3,home,14,24,10
4776,4,<ENDS>,24,24,0
4777,0,<START>,0,0,0
4777,1,home,0,7,7
4777,2,work,7,13,6
4777,3,home,13,18,5
4777,4,work,18,20,2
4777,5,home,20,24,4
4777,6,<ENDS>,24,24,0
4778,0,<START>,0,0,0
4778,1,home,0,6,6
4778,2,shop,6,7,1
4778,3,home,7,9,2
4778,4,work,9,15,6
4778,5,home,15,24,9
4778,6,<ENDS>,24,24,0
4779,0,<START>,0,0,0
4779,1,home,0,6,6
4779,2,shop,6,7,1
4779,3,home,7,13,6
4779,4,work,13,15,2
4779,5,home,15,21,6
4779,6,work,21,22,1
4779,7,home,22,24,2
4779,8,<ENDS>,24,24,0
4780,0,<START>,0,0,0
4780,1,home,0,7,7
4780,2,work,7,13,6
4780,3,home,13,24,11
4780,4,<ENDS>,24,24,0
4781,0,<START>,0,0,0
4781,1,home,0,6,6
4781,2,work,6,13,7
4781,3,home,13,24,11
4781,4,<ENDS>,24,24,0
4782,0,<START>,0,0,0
4782,1,home,0,8,8
4782,2,work,8,15,7
4782,3,home,15,24,9
4782,4,<ENDS>,24,24,0
4783,0,<START>,0,0,0
4783,1,home,0,6,6
4783,2,work,6,13,7
4783,3,shop,13,14,1
4783,4,work,14,20,6
4783,5,home,20,24,4
4783,6,<ENDS>,24,24,0
4784,0,<START>,0,0,0
4784,1,home,0,7,7
4784,2,work,7,14,7
4784,3,home,14,20,6
4784,4,shop,20,21,1
4784,5,home,21,24,3
4784,6,<ENDS>,24,24,0
4785,0,<START>,0,0,0
4785,1,home,0,8,8
4785,2,shop,8,9,1
4785,3,work,9,15,6
4785,4,home,15,24,9
4785,5,<ENDS>,24,24,0
4786,0,<START>,0,0,0
4786,1,home,0,7,7
4786,2,work,7,16,9
4786,3,home,16,24,8
4786,4,<ENDS>,24,24,0
4787,0,<START>,0,0,0
4787,1,home,0,8,8
4787,2,work,8,15,7
4787,3,home,15,21,6
4787,4,shop,21,22,1
4787,5,home,22,24,2
4787,6,<ENDS>,24,24,0
4788,0,<START>,0,0,0
4788,1,home,0,9,9
4788,2,work,9,15,6
4788,3,shop,15,16,1
4788,4,work,16,20,4
4788,5,home,20,24,4
4788,6,<ENDS>,24,24,0
4789,0,<START>,0,0,0
4789,1,home,0,7,7
4789,2,shop,7,8,1
4789,3,home,8,9,1
4789,4,education,9,12,3
4789,5,home,12,15,3
4789,6,work,15,20,5
4789,7,home,20,24,4
4789,8,<ENDS>,24,24,0
4790,0,<START>,0,0,0
4790,1,home,0,7,7
4790,2,education,7,11,4
4790,3,home,11,17,6
4790,4,shop,17,19,2
4790,5,home,19,24,5
4790,6,<ENDS>,24,24,0
4791,0,<START>,0,0,0
4791,1,home,0,6,6
4791,2,work,6,12,6
4791,3,shop,12,13,1
4791,4,work,13,19,6
4791,5,home,19,24,5
4791,6,<ENDS>,24,24,0
4792,0,<START>,0,0,0
4792,1,home,0,7,7
4792,2,work,7,13,6
4792,3,home,13,24,11
4792,4,<ENDS>,24,24,0
4793,0,<START>,0,0,0
4793,1,home,0,6,6
4793,2,work,6,8,2
4793,3,shop,8,9,1
4793,4,work,9,11,2
4793,5,home,11,18,7
4793,6,work,18,20,2
4793,7,home,20,24,4
4793,8,<ENDS>,24,24,0
4794,0,<START>,0,0,0
4794,1,home,0,7,7
4794,2,work,7,13,6
4794,3,home,13,17,4
4794,4,shop,17,18,1
4794,5,work,18,20,2
4794,6,home,20,24,4
4794,7,<ENDS>,24,24,0
4795,0,<START>,0,0,0
4795,1,home,0,7,7
4795,2,education,7,11,4
4795,3,home,11,18,7
4795,4,shop,18,19,1
4795,5,home,19,24,5
4795,6,<ENDS>,24,24,0
4796,0,<START>,0,0,0
4796,1,home,0,7,7
4796,2,shop,7,8,1
4796,3,education,8,12,4
4796,4,shop,12,14,2
4796,5,home,14,21,7
4796,6,shop,21,22,1
4796,7,home,22,24,2
4796,8,<ENDS>,24,24,0
4797,0,<START>,0,0,0
4797,1,home,0,7,7
4797,2,work,7,13,6
4797,3,shop,13,14,1
4797,4,work,14,20,6
4797,5,home,20,24,4
4797,6,<ENDS>,24,24,0
4798,0,<START>,0,0,0
4798,1,home,0,7,7
4798,2,work,7,13,6
4798,3,shop,13,14,1
4798,4,work,14,18,4
4798,5,home,18,24,6
4798,6,<ENDS>,24,24,0
4799,0,<START>,0,0,0
4799,1,home,0,8,8
4799,2,education,8,12,4
4799,3,shop,12,14,2
4799,4,home,14,21,7
4799,5,shop,21,22,1
4799,6,home,22,24,2
4799,7,<ENDS>,24,24,0
4800,0,<START>,0,0,0
4800,1,home,0,6,6
4800,2,work,6,8,2
4800,3,home,8,9,1
4800,4,work,9,10,1
4800,5,home,10,14,4
4800,6,work,14,17,3
4800,7,home,17,24,7
4800,8,<ENDS>,24,24,0
4801,0,<START>,0,0,0
4801,1,home,0,6,6
4801,2,shop,6,7,1
4801,3,home,7,9,2
4801,4,education,9,12,3
4801,5,home,12,18,6
4801,6,shop,18,19,1
4801,7,home,19,24,5
4801,8,<ENDS>,24,24,0
4802,0,<START>,0,0,0
4802,1,home,0,6,6
4802,2,work,6,7,1
4802,3,home,7,9,2
4802,4,work,9,11,2
4802,5,home,11,17,6
4802,6,work,17,19,2
4802,7,home,19,24,5
4802,8,<ENDS>,24,24,0
4803,0,<START>,0,0,0
4803,1,home,0,7,7
4803,2,work,7,9,2
4803,3,home,9,13,4
4803,4,work,13,15,2
4803,5,home,15,21,6
4803,6,work,21,22,1
4803,7,home,22,24,2
4803,8,<ENDS>,24,24,0
4804,0,<START>,0,0,0
4804,1,home,0,9,9
4804,2,work,9,15,6
4804,3,shop,15,16,1
4804,4,home,16,22,6
4804,5,work,22,23,1
4804,6,home,23,24,1
4804,7,<ENDS>,24,24,0
4805,0,<START>,0,0,0
4805,1,home,0,7,7
4805,2,work,7,14,7
4805,3,home,14,24,10
4805,4,<ENDS>,24,24,0
4806,0,<START>,0,0,0
4806,1,home,0,6,6
4806,2,shop,6,7,1
4806,3,home,7,10,3
4806,4,education,10,13,3
4806,5,shop,13,15,2
4806,6,home,15,24,9
4806,7,<ENDS>,24,24,0
4807,0,<START>,0,0,0
4807,1,home,0,8,8
4807,2,work,8,14,6
4807,3,shop,14,15,1
4807,4,home,15,24,9
4807,5,<ENDS>,24,24,0
4808,0,<START>,0,0,0
4808,1,home,0,8,8
4808,2,work,8,14,6
4808,3,shop,14,15,1
4808,4,home,15,24,9
4808,5,<ENDS>,24,24,0
4809,0,<START>,0,0,0
4809,1,home,0,7,7
4809,2,work,7,14,7
4809,3,home,14,24,10
4809,4,<ENDS>,24,24,0
4810,0,<START>,0,0,0
4810,1,home,0,8,8
4810,2,work,8,15,7
4810,3,home,15,23,8
4810,4,work,23,24,1
4810,5,<ENDS>,24,24,0
4811,0,<START>,0,0,0
4811,1,home,0,9,9
4811,2,education,9,13,4
4811,3,shop,13,14,1
4811,4,work,14,20,6
4811,5,home,20,24,4
4811,6,<ENDS>,24,24,0
4812,0,<START>,0,0,0
4812,1,home,0,6,6
4812,2,shop,6,8,2
4812,3,work,8,15,7
4812,4,home,15,18,3
4812,5,work,18,20,2
4812,6,home,20,24,4
4812,7,<ENDS>,24,24,0
4813,0,<START>,0,0,0
4813,1,home,0,8,8
4813,2,education,8,14,6
4813,3,home,14,24,10
4813,4,<ENDS>,24,24,0
4814,0,<START>,0,0,0
4814,1,home,0,6,6
4814,2,shop,6,7,1
4814,3,home,7,10,3
4814,4,education,10,16,6
4814,5,home,16,24,8
4814,6,<ENDS>,24,24,0
4815,0,<START>,0,0,0
4815,1,home,0,7,7
4815,2,education,7,11,4
4815,3,home,11,18,7
4815,4,shop,18,20,2
4815,5,home,20,24,4
4815,6,<ENDS>,24,24,0
4816,0,<START>,0,0,0
4816,1,home,0,6,6
4816,2,work,6,12,6
4816,3,shop,12,13,1
4816,4,work,13,19,6
4816,5,home,19,24,5
4816,6,<ENDS>,24,24,0
4817,0,<START>,0,0,0
4817,1,home,0,6,6
4817,2,work,6,13,7
4817,3,shop,13,14,1
4817,4,work,14,19,5
4817,5,home,19,24,5
4817,6,<ENDS>,24,24,0
4818,0,<START>,0,0,0
4818,1,home,0,6,6
4818,2,work,6,14,8
4818,3,home,14,24,10
4818,4,<ENDS>,24,24,0
4819,0,<START>,0,0,0
4819,1,home,0,7,7
4819,2,education,7,11,4
4819,3,home,11,24,13
4819,4,<ENDS>,24,24,0
4820,0,<START>,0,0,0
4820,1,home,0,8,8
4820,2,work,8,14,6
4820,3,home,14,24,10
4820,4,<ENDS>,24,24,0
4821,0,<START>,0,0,0
4821,1,home,0,6,6
4821,2,shop,6,7,1
4821,3,work,7,14,7
4821,4,home,14,24,10
4821,5,<ENDS>,24,24,0
4822,0,<START>,0,0,0
4822,1,home,0,7,7
4822,2,work,7,14,7
4822,3,home,14,24,10
4822,4,<ENDS>,24,24,0
4823,0,<START>,0,0,0
4823,1,home,0,8,8
4823,2,education,8,12,4
4823,3,shop,12,13,1
4823,4,work,13,19,6
4823,5,home,19,24,5
4823,6,<ENDS>,24,24,0
4824,0,<START>,0,0,0
4824,1,home,0,7,7
4824,2,work,7,13,6
4824,3,home,13,23,10
4824,4,work,23,24,1
4824,5,<ENDS>,24,24,0
4825,0,<START>,0,0,0
4825,1,home,0,6,6
4825,2,work,6,13,7
4825,3,home,13,23,10
4825,4,work,23,24,1
4825,5,<ENDS>,24,24,0
4826,0,<START>,0,0,0
4826,1,home,0,7,7
4826,2,shop,7,8,1
4826,3,education,8,13,5
4826,4,shop,13,15,2
4826,5,home,15,21,6
4826,6,shop,21,22,1
4826,7,home,22,24,2
4826,8,<ENDS>,24,24,0
4827,0,<START>,0,0,0
4827,1,home,0,6,6
4827,2,work,6,8,2
4827,3,home,8,13,5
4827,4,work,13,17,4
4827,5,home,17,24,7
4827,6,<ENDS>,24,24,0
4828,0,<START>,0,0,0
4828,1,home,0,8,8
4828,2,education,8,13,5
4828,3,shop,13,14,1
4828,4,home,14,24,10
4828,5,<ENDS>,24,24,0
4829,0,<START>,0,0,0
4829,1,home,0,8,8
4829,2,work,8,14,6
4829,3,home,14,23,9
4829,4,work,23,24,1
4829,5,<ENDS>,24,24,0
4830,0,<START>,0,0,0
4830,1,home,0,8,8
4830,2,shop,8,9,1
4830,3,work,9,15,6
4830,4,home,15,24,9
4830,5,<ENDS>,24,24,0
4831,0,<START>,0,0,0
4831,1,home,0,9,9
4831,2,work,9,16,7
4831,3,shop,16,17,1
4831,4,home,17,24,7
4831,5,<ENDS>,24,24,0
4832,0,<START>,0,0,0
4832,1,home,0,8,8
4832,2,education,8,14,6
4832,3,shop,14,15,1
4832,4,home,15,22,7
4832,5,work,22,23,1
4832,6,home,23,24,1
4832,7,<ENDS>,24,24,0
4833,0,<START>,0,0,0
4833,1,home,0,6,6
4833,2,shop,6,7,1
4833,3,home,7,8,1
4833,4,education,8,12,4
4833,5,home,12,24,12
4833,6,<ENDS>,24,24,0
4834,0,<START>,0,0,0
4834,1,home,0,6,6
4834,2,work,6,13,7
4834,3,home,13,24,11
4834,4,<ENDS>,24,24,0
4835,0,<START>,0,0,0
4835,1,home,0,8,8
4835,2,work,8,15,7
4835,3,home,15,24,9
4835,4,<ENDS>,24,24,0
4836,0,<START>,0,0,0
4836,1,home,0,7,7
4836,2,shop,7,8,1
4836,3,education,8,12,4
4836,4,shop,12,13,1
4836,5,education,13,16,3
4836,6,home,16,24,8
4836,7,<ENDS>,24,24,0
4837,0,<START>,0,0,0
4837,1,home,0,6,6
4837,2,work,6,13,7
4837,3,shop,13,14,1
4837,4,home,14,24,10
4837,5,<ENDS>,24,24,0
4838,0,<START>,0,0,0
4838,1,home,0,7,7
4838,2,work,7,13,6
4838,3,home,13,18,5
4838,4,work,18,20,2
4838,5,home,20,24,4
4838,6,<ENDS>,24,24,0
4839,0,<START>,0,0,0
4839,1,home,0,6,6
4839,2,work,6,8,2
4839,3,home,8,12,4
4839,4,work,12,14,2
4839,5,home,14,21,7
4839,6,work,21,22,1
4839,7,home,22,24,2
4839,8,<ENDS>,24,24,0
4840,0,<START>,0,0,0
4840,1,home,0,7,7
4840,2,education,7,11,4
4840,3,home,11,17,6
4840,4,shop,17,18,1
4840,5,home,18,24,6
4840,6,<ENDS>,24,24,0
4841,0,<START>,0,0,0
4841,1,home,0,8,8
4841,2,work,8,14,6
4841,3,home,14,17,3
4841,4,work,17,20,3
4841,5,home,20,24,4
4841,6,<ENDS>,24,24,0
4842,0,<START>,0,0,0
4842,1,home,0,7,7
4842,2,work,7,15,8
4842,3,shop,15,16,1
4842,4,work,16,20,4
4842,5,home,20,24,4
4842,6,<ENDS>,24,24,0
4843,0,<START>,0,0,0
4843,1,home,0,6,6
4843,2,shop,6,7,1
4843,3,home,7,10,3
4843,4,education,10,13,3
4843,5,home,13,20,7
4843,6,shop,20,21,1
4843,7,home,21,24,3
4843,8,<ENDS>,24,24,0
4844,0,<START>,0,0,0
4844,1,home,0,7,7
4844,2,work,7,14,7
4844,3,shop,14,15,1
4844,4,home,15,24,9
4844,5,<ENDS>,24,24,0
4845,0,<START>,0,0,0
4845,1,home,0,7,7
4845,2,education,7,11,4
4845,3,home,11,17,6
4845,4,shop,17,18,1
4845,5,home,18,24,6
4845,6,<ENDS>,24,24,0
4846,0,<START>,0,0,0
4846,1,home,0,8,8
4846,2,work,8,15,7
4846,3,home,15,24,9
4846,4,<ENDS>,24,24,0
4847,0,<START>,0,0,0
4847,1,home,0,8,8
4847,2,shop,8,9,1
4847,3,education,9,16,7
4847,4,home,16,24,8
4847,5,<ENDS>,24,24,0
4848,0,<START>,0,0,0
4848,1,home,0,8,8
4848,2,work,8,15,7
4848,3,home,15,24,9
4848,4,<ENDS>,24,24,0
4849,0,<START>,0,0,0
4849,1,home,0,7,7
4849,2,education,7,11,4
4849,3,home,11,17,6
4849,4,shop,17,19,2
4849,5,home,19,24,5
4849,6,<ENDS>,24,24,0
4850,0,<START>,0,0,0
4850,1,home,0,7,7
4850,2,work,7,14,7
4850,3,shop,14,15,1
4850,4,home,15,24,9
4850,5,<ENDS>,24,24,0
4851,0,<START>,0,0,0
4851,1,home,0,9,9
4851,2,work,9,15,6
4851,3,shop,15,16,1
4851,4,home,16,21,5
4851,5,work,21,22,1
4851,6,home,22,24,2
4851,7,<ENDS>,24,24,0
4852,0,<START>,0,0,0
4852,1,home,0,6,6
4852,2,work,6,13,7
4852,3,home,13,24,11
4852,4,<ENDS>,24,24,0
4853,0,<START>,0,0,0
4853,1,home,0,7,7
4853,2,work,7,13,6
4853,3,shop,13,14,1
4853,4,home,14,24,10
4853,5,<ENDS>,24,24,0
4854,0,<START>,0,0,0
4854,1,home,0,6,6
4854,2,work,6,13,7
4854,3,shop,13,14,1
4854,4,home,14,23,9
4854,5,work,23,24,1
4854,6,<ENDS>,24,24,0
4855,0,<START>,0,0,0
4855,1,home,0,6,6
4855,2,work,6,13,7
4855,3,shop,13,14,1
4855,4,home,14,24,10
4855,5,<ENDS>,24,24,0
4856,0,<START>,0,0,0
4856,1,home,0,7,7
4856,2,work,7,15,8
4856,3,home,15,24,9
4856,4,<ENDS>,24,24,0
4857,0,<START>,0,0,0
4857,1,home,0,8,8
4857,2,shop,8,9,1
4857,3,work,9,16,7
4857,4,home,16,24,8
4857,5,<ENDS>,24,24,0
4858,0,<START>,0,0,0
4858,1,home,0,7,7
4858,2,education,7,11,4
4858,3,home,11,20,9
4858,4,shop,20,21,1
4858,5,home,21,24,3
4858,6,<ENDS>,24,24,0
4859,0,<START>,0,0,0
4859,1,home,0,7,7
4859,2,work,7,9,2
4859,3,home,9,15,6
4859,4,work,15,17,2
4859,5,home,17,23,6
4859,6,work,23,24,1
4859,7,<ENDS>,24,24,0
4860,0,<START>,0,0,0
4860,1,home,0,8,8
4860,2,work,8,15,7
4860,3,shop,15,16,1
4860,4,work,16,19,3
4860,5,home,19,24,5
4860,6,<ENDS>,24,24,0
4861,0,<START>,0,0,0
4861,1,home,0,6,6
4861,2,work,6,13,7
4861,3,shop,13,14,1
4861,4,work,14,19,5
4861,5,home,19,24,5
4861,6,<ENDS>,24,24,0
4862,0,<START>,0,0,0
4862,1,home,0,8,8
4862,2,work,8,15,7
4862,3,shop,15,16,1
4862,4,home,16,24,8
4862,5,<ENDS>,24,24,0
4863,0,<START>,0,0,0
4863,1,home,0,6,6
4863,2,work,6,13,7
4863,3,home,13,24,11
4863,4,<ENDS>,24,24,0
4864,0,<START>,0,0,0
4864,1,home,0,8,8
4864,2,work,8,15,7
4864,3,home,15,24,9
4864,4,<ENDS>,24,24,0
4865,0,<START>,0,0,0
4865,1,home,0,7,7
4865,2,work,7,14,7
4865,3,home,14,24,10
4865,4,<ENDS>,24,24,0
4866,0,<START>,0,0,0
4866,1,home,0,7,7
4866,2,work,7,13,6
4866,3,home,13,24,11
4866,4,<ENDS>,24,24,0
4867,0,<START>,0,0,0
4867,1,home,0,6,6
4867,2,shop,6,7,1
4867,3,home,7,9,2
4867,4,work,9,15,6
4867,5,home,15,24,9
4867,6,<ENDS>,24,24,0
4868,0,<START>,0,0,0
4868,1,home,0,7,7
4868,2,work,7,13,6
4868,3,home,13,20,7
4868,4,shop,20,21,1
4868,5,home,21,24,3
4868,6,<ENDS>,24,24,0
4869,0,<START>,0,0,0
4869,1,home,0,7,7
4869,2,work,7,16,9
4869,3,home,16,24,8
4869,4,<ENDS>,24,24,0
4870,0,<START>,0,0,0
4870,1,home,0,8,8
4870,2,work,8,14,6
4870,3,shop,14,15,1
4870,4,home,15,23,8
4870,5,work,23,24,1
4870,6,<ENDS>,24,24,0
4871,0,<START>,0,0,0
4871,1,home,0,8,8
4871,2,work,8,15,7
4871,3,home,15,20,5
4871,4,shop,20,21,1
4871,5,home,21,24,3
4871,6,<ENDS>,24,24,0
4872,0,<START>,0,0,0
4872,1,home,0,8,8
4872,2,work,8,16,8
4872,3,shop,16,17,1
4872,4,home,17,24,7
4872,5,<ENDS>,24,24,0
4873,0,<START>,0,0,0
4873,1,home,0,7,7
4873,2,shop,7,9,2
4873,3,education,9,12,3
4873,4,shop,12,14,2
4873,5,education,14,16,2
4873,6,home,16,20,4
4873,7,shop,20,21,1
4873,8,home,21,24,3
4873,9,<ENDS>,24,24,0
4874,0,<START>,0,0,0
4874,1,home,0,7,7
4874,2,work,7,13,6
4874,3,home,13,24,11
4874,4,<ENDS>,24,24,0
4875,0,<START>,0,0,0
4875,1,home,0,8,8
4875,2,education,8,12,4
4875,3,home,12,20,8
4875,4,shop,20,21,1
4875,5,home,21,24,3
4875,6,<ENDS>,24,24,0
4876,0,<START>,0,0,0
4876,1,home,0,7,7
4876,2,work,7,13,6
4876,3,home,13,15,2
4876,4,work,15,20,5
4876,5,home,20,24,4
4876,6,<ENDS>,24,24,0
4877,0,<START>,0,0,0
4877,1,home,0,6,6
4877,2,work,6,13,7
4877,3,home,13,17,4
4877,4,work,17,20,3
4877,5,home,20,24,4
4877,6,<ENDS>,24,24,0
4878,0,<START>,0,0,0
4878,1,home,0,9,9
4878,2,work,9,16,7
4878,3,home,16,24,8
4878,4,<ENDS>,24,24,0
4879,0,<START>,0,0,0
4879,1,home,0,7,7
4879,2,work,7,14,7
4879,3,shop,14,15,1
4879,4,home,15,21,6
4879,5,work,21,22,1
4879,6,home,22,24,2
4879,7,<ENDS>,24,24,0
4880,0,<START>,0,0,0
4880,1,home,0,8,8
4880,2,work,8,15,7
4880,3,home,15,21,6
4880,4,work,21,22,1
4880,5,home,22,24,2
4880,6,<ENDS>,24,24,0
4881,0,<START>,0,0,0
4881,1,home,0,7,7
4881,2,education,7,11,4
4881,3,home,11,17,6
4881,4,shop,17,18,1
4881,5,home,18,24,6
4881,6,<ENDS>,24,24,0
4882,0,<START>,0,0,0
4882,1,home,0,8,8
4882,2,work,8,15,7
4882,3,home,15,24,9
4882,4,<ENDS>,24,24,0
4883,0,<START>,0,0,0
4883,1,home,0,6,6
4883,2,work,6,13,7
4883,3,home,13,22,9
4883,4,work,22,23,1
4883,5,home,23,24,1
4883,6,<ENDS>,24,24,0
4884,0,<START>,0,0,0
4884,1,home,0,7,7
4884,2,shop,7,8,1
4884,3,education,8,11,3
4884,4,home,11,15,4
4884,5,shop,15,16,1
4884,6,home,16,24,8
4884,7,<ENDS>,24,24,0
4885,0,<START>,0,0,0
4885,1,home,0,7,7
4885,2,work,7,14,7
4885,3,shop,14,15,1
4885,4,work,15,20,5
4885,5,home,20,24,4
4885,6,<ENDS>,24,24,0
4886,0,<START>,0,0,0
4886,1,home,0,7,7
4886,2,work,7,14,7
4886,3,shop,14,15,1
4886,4,home,15,24,9
4886,5,<ENDS>,24,24,0
4887,0,<START>,0,0,0
4887,1,home,0,6,6
4887,2,shop,6,7,1
4887,3,work,7,13,6
4887,4,home,13,24,11
4887,5,<ENDS>,24,24,0
4888,0,<START>,0,0,0
4888,1,home,0,8,8
4888,2,work,8,14,6
4888,3,home,14,24,10
4888,4,<ENDS>,24,24,0
4889,0,<START>,0,0,0
4889,1,home,0,6,6
4889,2,shop,6,7,1
4889,3,home,7,9,2
4889,4,education,9,12,3
4889,5,home,12,20,8
4889,6,shop,20,21,1
4889,7,home,21,24,3
4889,8,<ENDS>,24,24,0
4890,0,<START>,0,0,0
4890,1,home,0,6,6
4890,2,shop,6,7,1
4890,3,home,7,13,6
4890,4,education,13,16,3
4890,5,home,16,24,8
4890,6,<ENDS>,24,24,0
4891,0,<START>,0,0,0
4891,1,home,0,6,6
4891,2,work,6,13,7
4891,3,shop,13,14,1
4891,4,home,14,18,4
4891,5,work,18,20,2
4891,6,home,20,24,4
4891,7,<ENDS>,24,24,0
4892,0,<START>,0,0,0
4892,1,home,0,7,7
4892,2,education,7,11,4
4892,3,home,11,14,3
4892,4,education,14,16,2
4892,5,home,16,24,8
4892,6,<ENDS>,24,24,0
4893,0,<START>,0,0,0
4893,1,home,0,7,7
4893,2,work,7,13,6
4893,3,home,13,22,9
4893,4,work,22,23,1
4893,5,home,23,24,1
4893,6,<ENDS>,24,24,0
4894,0,<START>,0,0,0
4894,1,home,0,8,8
4894,2,work,8,15,7
4894,3,home,15,23,8
4894,4,work,23,24,1
4894,5,<ENDS>,24,24,0
4895,0,<START>,0,0,0
4895,1,home,0,8,8
4895,2,work,8,14,6
4895,3,shop,14,15,1
4895,4,home,15,24,9
4895,5,<ENDS>,24,24,0
4896,0,<START>,0,0,0
4896,1,home,0,8,8
4896,2,work,8,15,7
4896,3,shop,15,16,1
4896,4,home,16,24,8
4896,5,<ENDS>,24,24,0
4897,0,<START>,0,0,0
4897,1,home,0,8,8
4897,2,education,8,11,3
4897,3,home,11,18,7
4897,4,shop,18,19,1
4897,5,home,19,24,5
4897,6,<ENDS>,24,24,0
4898,0,<START>,0,0,0
4898,1,home,0,8,8
4898,2,shop,8,9,1
4898,3,home,9,14,5
4898,4,work,14,19,5
4898,5,home,19,23,4
4898,6,work,23,24,1
4898,7,<ENDS>,24,24,0
4899,0,<START>,0,0,0
4899,1,home,0,8,8
4899,2,work,8,15,7
4899,3,home,15,19,4
4899,4,shop,19,20,1
4899,5,home,20,24,4
4899,6,<ENDS>,24,24,0
4900,0,<START>,0,0,0
4900,1,home,0,6,6
4900,2,work,6,13,7
4900,3,shop,13,14,1
4900,4,home,14,24,10
4900,5,<ENDS>,24,24,0
4901,0,<START>,0,0,0
4901,1,home,0,8,8
4901,2,education,8,11,3
4901,3,home,11,18,7
4901,4,shop,18,19,1
4901,5,home,19,24,5
4901,6,<ENDS>,24,24,0
4902,0,<START>,0,0,0
4902,1,home,0,7,7
4902,2,shop,7,8,1
4902,3,work,8,14,6
4902,4,home,14,24,10
4902,5,<ENDS>,24,24,0
4903,0,<START>,0,0,0
4903,1,home,0,6,6
4903,2,shop,6,7,1
4903,3,home,7,10,3
4903,4,education,10,13,3
4903,5,home,13,20,7
4903,6,shop,20,21,1
4903,7,home,21,24,3
4903,8,<ENDS>,24,24,0
4904,0,<START>,0,0,0
4904,1,home,0,6,6
4904,2,work,6,13,7
4904,3,shop,13,14,1
4904,4,work,14,19,5
4904,5,education,19,20,1
4904,6,home,20,24,4
4904,7,<ENDS>,24,24,0
4905,0,<START>,0,0,0
4905,1,home,0,6,6
4905,2,work,6,14,8
4905,3,home,14,20,6
4905,4,shop,20,21,1
4905,5,home,21,24,3
4905,6,<ENDS>,24,24,0
4906,0,<START>,0,0,0
4906,1,home,0,8,8
4906,2,work,8,15,7
4906,3,home,15,24,9
4906,4,<ENDS>,24,24,0
4907,0,<START>,0,0,0
4907,1,home,0,6,6
4907,2,work,6,13,7
4907,3,home,13,24,11
4907,4,<ENDS>,24,24,0
4908,0,<START>,0,0,0
4908,1,home,0,7,7
4908,2,work,7,13,6
4908,3,home,13,17,4
4908,4,shop,17,18,1
4908,5,home,18,24,6
4908,6,<ENDS>,24,24,0
4909,0,<START>,0,0,0
4909,1,home,0,6,6
4909,2,shop,6,7,1
4909,3,home,7,10,3
4909,4,education,10,14,4
4909,5,shop,14,15,1
4909,6,home,15,21,6
4909,7,shop,21,22,1
4909,8,home,22,24,2
4909,9,<ENDS>,24,24,0
4910,0,<START>,0,0,0
4910,1,home,0,8,8
4910,2,work,8,15,7
4910,3,home,15,24,9
4910,4,<ENDS>,24,24,0
4911,0,<START>,0,0,0
4911,1,home,0,6,6
4911,2,work,6,8,2
4911,3,home,8,11,3
4911,4,work,11,13,2
4911,5,home,13,21,8
4911,6,work,21,22,1
4911,7,home,22,24,2
4911,8,<ENDS>,24,24,0
4912,0,<START>,0,0,0
4912,1,home,0,7,7
4912,2,work,7,14,7
4912,3,home,14,24,10
4912,4,<ENDS>,24,24,0
4913,0,<START>,0,0,0
4913,1,home,0,6,6
4913,2,work,6,13,7
4913,3,home,13,24,11
4913,4,<ENDS>,24,24,0
4914,0,<START>,0,0,0
4914,1,home,0,7,7
4914,2,work,7,14,7
4914,3,home,14,24,10
4914,4,<ENDS>,24,24,0
4915,0,<START>,0,0,0
4915,1,home,0,8,8
4915,2,education,8,12,4
4915,3,home,12,24,12
4915,4,<ENDS>,24,24,0
4916,0,<START>,0,0,0
4916,1,home,0,8,8
4916,2,education,8,14,6
4916,3,home,14,18,4
4916,4,shop,18,19,1
4916,5,home,19,24,5
4916,6,<ENDS>,24,24,0
4917,0,<START>,0,0,0
4917,1,home,0,7,7
4917,2,shop,7,9,2
4917,3,education,9,12,3
4917,4,shop,12,14,2
4917,5,education,14,16,2
4917,6,home,16,24,8
4917,7,<ENDS>,24,24,0
4918,0,<START>,0,0,0
4918,1,home,0,8,8
4918,2,work,8,16,8
4918,3,home,16,21,5
4918,4,shop,21,22,1
4918,5,home,22,24,2
4918,6,<ENDS>,24,24,0
4919,0,<START>,0,0,0
4919,1,home,0,8,8
4919,2,work,8,13,5
4919,3,home,13,17,4
4919,4,work,17,20,3
4919,5,home,20,21,1
4919,6,work,21,22,1
4919,7,home,22,24,2
4919,8,<ENDS>,24,24,0
4920,0,<START>,0,0,0
4920,1,home,0,6,6
4920,2,work,6,13,7
4920,3,home,13,24,11
4920,4,<ENDS>,24,24,0
4921,0,<START>,0,0,0
4921,1,home,0,6,6
4921,2,shop,6,7,1
4921,3,home,7,13,6
4921,4,education,13,16,3
4921,5,home,16,24,8
4921,6,<ENDS>,24,24,0
4922,0,<START>,0,0,0
4922,1,work,0,7,7
4922,2,shop,7,8,1
4922,3,home,8,12,4
4922,4,work,12,18,6
4922,5,home,18,23,5
4922,6,work,23,24,1
4922,7,<ENDS>,24,24,0
4923,0,<START>,0,0,0
4923,1,home,0,7,7
4923,2,shop,7,9,2
4923,3,home,9,13,4
4923,4,education,13,16,3
4923,5,home,16,24,8
4923,6,<ENDS>,24,24,0
4924,0,<START>,0,0,0
4924,1,home,0,7,7
4924,2,work,7,14,7
4924,3,home,14,19,5
4924,4,shop,19,20,1
4924,5,home,20,24,4
4924,6,<ENDS>,24,24,0
4925,0,<START>,0,0,0
4925,1,home,0,7,7
4925,2,education,7,11,4
4925,3,home,11,14,3
4925,4,education,14,16,2
4925,5,home,16,24,8
4925,6,<ENDS>,24,24,0
4926,0,<START>,0,0,0
4926,1,home,0,8,8
4926,2,work,8,15,7
4926,3,home,15,24,9
4926,4,<ENDS>,24,24,0
4927,0,<START>,0,0,0
4927,1,home,0,6,6
4927,2,shop,6,7,1
4927,3,home,7,9,2
4927,4,education,9,15,6
4927,5,shop,15,17,2
4927,6,home,17,24,7
4927,7,<ENDS>,24,24,0
4928,0,<START>,0,0,0
4928,1,home,0,7,7
4928,2,shop,7,8,1
4928,3,home,8,11,3
4928,4,education,11,17,6
4928,5,home,17,24,7
4928,6,<ENDS>,24,24,0
4929,0,<START>,0,0,0
4929,1,home,0,6,6
4929,2,shop,6,7,1
4929,3,home,7,9,2
4929,4,education,9,12,3
4929,5,shop,12,13,1
4929,6,home,13,20,7
4929,7,shop,20,21,1
4929,8,home,21,24,3
4929,9,<ENDS>,24,24,0
4930,0,<START>,0,0,0
4930,1,home,0,7,7
4930,2,work,7,14,7
4930,3,shop,14,15,1
4930,4,home,15,24,9
4930,5,<ENDS>,24,24,0
4931,0,<START>,0,0,0
4931,1,home,0,7,7
4931,2,work,7,9,2
4931,3,home,9,13,4
4931,4,work,13,15,2
4931,5,home,15,21,6
4931,6,work,21,22,1
4931,7,home,22,24,2
4931,8,<ENDS>,24,24,0
4932,0,<START>,0,0,0
4932,1,home,0,8,8
4932,2,work,8,14,6
4932,3,home,14,18,4
4932,4,work,18,20,2
4932,5,home,20,24,4
4932,6,<ENDS>,24,24,0
4933,0,<START>,0,0,0
4933,1,home,0,7,7
4933,2,work,7,15,8
4933,3,shop,15,16,1
4933,4,work,16,20,4
4933,5,home,20,24,4
4933,6,<ENDS>,24,24,0
4934,0,<START>,0,0,0
4934,1,home,0,7,7
4934,2,work,7,13,6
4934,3,shop,13,14,1
4934,4,home,14,18,4
4934,5,work,18,20,2
4934,6,home,20,24,4
4934,7,<ENDS>,24,24,0
4935,0,<START>,0,0,0
4935,1,home,0,8,8
4935,2,work,8,14,6
4935,3,shop,14,15,1
4935,4,work,15,19,4
4935,5,home,19,24,5
4935,6,<ENDS>,24,24,0
4936,0,<START>,0,0,0
4936,1,home,0,6,6
4936,2,work,6,8,2
4936,3,home,8,12,4
4936,4,work,12,13,1
4936,5,home,13,21,8
4936,6,work,21,22,1
4936,7,home,22,24,2
4936,8,<ENDS>,24,24,0
4937,0,<START>,0,0,0
4937,1,home,0,9,9
4937,2,work,9,15,6
4937,3,home,15,21,6
4937,4,work,21,22,1
4937,5,home,22,24,2
4937,6,<ENDS>,24,24,0
4938,0,<START>,0,0,0
4938,1,home,0,7,7
4938,2,education,7,13,6
4938,3,shop,13,15,2
4938,4,home,15,24,9
4938,5,<ENDS>,24,24,0
4939,0,<START>,0,0,0
4939,1,home,0,7,7
4939,2,work,7,14,7
4939,3,shop,14,15,1
4939,4,home,15,22,7
4939,5,work,22,23,1
4939,6,home,23,24,1
4939,7,<ENDS>,24,24,0
4940,0,<START>,0,0,0
4940,1,home,0,8,8
4940,2,work,8,14,6
4940,3,shop,14,15,1
4940,4,work,15,20,5
4940,5,home,20,24,4
4940,6,<ENDS>,24,24,0
4941,0,<START>,0,0,0
4941,1,home,0,7,7
4941,2,work,7,13,6
4941,3,home,13,24,11
4941,4,<ENDS>,24,24,0
4942,0,<START>,0,0,0
4942,1,home,0,7,7
4942,2,work,7,14,7
4942,3,shop,14,16,2
4942,4,home,16,24,8
4942,5,<ENDS>,24,24,0
4943,0,<START>,0,0,0
4943,1,home,0,8,8
4943,2,work,8,15,7
4943,3,home,15,17,2
4943,4,work,17,20,3
4943,5,home,20,24,4
4943,6,<ENDS>,24,24,0
4944,0,<START>,0,0,0
4944,1,home,0,6,6
4944,2,shop,6,7,1
4944,3,home,7,9,2
4944,4,education,9,12,3
4944,5,home,12,19,7
4944,6,shop,19,20,1
4944,7,home,20,24,4
4944,8,<ENDS>,24,24,0
4945,0,<START>,0,0,0
4945,1,home,0,6,6
4945,2,work,6,13,7
4945,3,home,13,24,11
4945,4,<ENDS>,24,24,0
4946,0,<START>,0,0,0
4946,1,home,0,7,7
4946,2,education,7,12,5
4946,3,shop,12,14,2
4946,4,education,14,17,3
4946,5,home,17,24,7
4946,6,<ENDS>,24,24,0
4947,0,<START>,0,0,0
4947,1,home,0,7,7
4947,2,work,7,9,2
4947,3,home,9,14,5
4947,4,work,14,16,2
4947,5,home,16,22,6
4947,6,work,22,23,1
4947,7,home,23,24,1
4947,8,<ENDS>,24,24,0
4948,0,<START>,0,0,0
4948,1,home,0,6,6
4948,2,shop,6,7,1
4948,3,home,7,13,6
4948,4,education,13,16,3
4948,5,shop,16,17,1
4948,6,home,17,24,7
4948,7,<ENDS>,24,24,0
4949,0,<START>,0,0,0
4949,1,home,0,7,7
4949,2,work,7,13,6
4949,3,home,13,24,11
4949,4,<ENDS>,24,24,0
4950,0,<START>,0,0,0
4950,1,home,0,8,8
4950,2,shop,8,9,1
4950,3,work,9,15,6
4950,4,home,15,24,9
4950,5,<ENDS>,24,24,0
4951,0,<START>,0,0,0
4951,1,home,0,7,7
4951,2,work,7,13,6
4951,3,shop,13,14,1
4951,4,home,14,23,9
4951,5,work,23,24,1
4951,6,<ENDS>,24,24,0
4952,0,<START>,0,0,0
4952,1,home,0,8,8
4952,2,work,8,14,6
4952,3,shop,14,15,1
4952,4,home,15,21,6
4952,5,work,21,22,1
4952,6,home,22,24,2
4952,7,<ENDS>,24,24,0
4953,0,<START>,0,0,0
4953,1,home,0,6,6
4953,2,work,6,13,7
4953,3,home,13,24,11
4953,4,<ENDS>,24,24,0
4954,0,<START>,0,0,0
4954,1,home,0,7,7
4954,2,work,7,13,6
4954,3,home,13,18,5
4954,4,work,18,20,2
4954,5,home,20,24,4
4954,6,<ENDS>,24,24,0
4955,0,<START>,0,0,0
4955,1,home,0,6,6
4955,2,shop,6,7,1
4955,3,home,7,13,6
4955,4,education,13,16,3
4955,5,home,16,24,8
4955,6,<ENDS>,24,24,0
4956,0,<START>,0,0,0
4956,1,home,0,7,7
4956,2,work,7,13,6
4956,3,shop,13,14,1
4956,4,home,14,24,10
4956,5,<ENDS>,24,24,0
4957,0,<START>,0,0,0
4957,1,home,0,8,8
4957,2,education,8,12,4
4957,3,home,12,15,3
4957,4,work,15,20,5
4957,5,home,20,24,4
4957,6,<ENDS>,24,24,0
4958,0,<START>,0,0,0
4958,1,home,0,8,8
4958,2,work,8,15,7
4958,3,home,15,21,6
4958,4,shop,21,22,1
4958,5,home,22,24,2
4958,6,<ENDS>,24,24,0
4959,0,<START>,0,0,0
4959,1,home,0,7,7
4959,2,work,7,13,6
4959,3,home,13,21,8
4959,4,work,21,22,1
4959,5,home,22,24,2
4959,6,<ENDS>,24,24,0
4960,0,<START>,0,0,0
4960,1,home,0,7,7
4960,2,work,7,13,6
4960,3,home,13,17,4
4960,4,shop,17,18,1
4960,5,home,18,22,4
4960,6,work,22,23,1
4960,7,home,23,24,1
4960,8,<ENDS>,24,24,0
4961,0,<START>,0,0,0
4961,1,home,0,7,7
4961,2,education,7,11,4
4961,3,home,11,19,8
4961,4,shop,19,20,1
4961,5,home,20,24,4
4961,6,<ENDS>,24,24,0
4962,0,<START>,0,0,0
4962,1,home,0,6,6
4962,2,work,6,8,2
4962,3,home,8,14,6
4962,4,shop,14,15,1
4962,5,home,15,21,6
4962,6,work,21,22,1
4962,7,home,22,24,2
4962,8,<ENDS>,24,24,0
4963,0,<START>,0,0,0
4963,1,home,0,8,8
4963,2,work,8,15,7
4963,3,home,15,24,9
4963,4,<ENDS>,24,24,0
4964,0,<START>,0,0,0
4964,1,home,0,7,7
4964,2,work,7,14,7
4964,3,home,14,24,10
4964,4,<ENDS>,24,24,0
4965,0,<START>,0,0,0
4965,1,home,0,7,7
4965,2,work,7,15,8
4965,3,home,15,21,6
4965,4,work,21,22,1
4965,5,home,22,24,2
4965,6,<ENDS>,24,24,0
4966,0,<START>,0,0,0
4966,1,home,0,6,6
4966,2,work,6,13,7
4966,3,home,13,24,11
4966,4,<ENDS>,24,24,0
4967,0,<START>,0,0,0
4967,1,home,0,7,7
4967,2,work,7,14,7
4967,3,home,14,24,10
4967,4,<ENDS>,24,24,0
4968,0,<START>,0,0,0
4968,1,home,0,7,7
4968,2,work,7,13,6
4968,3,shop,13,14,1
4968,4,work,14,19,5
4968,5,home,19,23,4
4968,6,work,23,24,1
4968,7,<ENDS>,24,24,0
4969,0,<START>,0,0,0
4969,1,home,0,7,7
4969,2,work,7,13,6
4969,3,home,13,23,10
4969,4,work,23,24,1
4969,5,<ENDS>,24,24,0
4970,0,<START>,0,0,0
4970,1,home,0,7,7
4970,2,work,7,13,6
4970,3,shop,13,15,2
4970,4,work,15,20,5
4970,5,home,20,24,4
4970,6,<ENDS>,24,24,0
4971,0,<START>,0,0,0
4971,1,home,0,7,7
4971,2,work,7,13,6
4971,3,home,13,24,11
4971,4,<ENDS>,24,24,0
4972,0,<START>,0,0,0
4972,1,home,0,8,8
4972,2,work,8,14,6
4972,3,shop,14,16,2
4972,4,home,16,24,8
4972,5,<ENDS>,24,24,0
4973,0,<START>,0,0,0
4973,1,home,0,8,8
4973,2,work,8,15,7
4973,3,shop,15,17,2
4973,4,home,17,21,4
4973,5,work,21,22,1
4973,6,home,22,24,2
4973,7,<ENDS>,24,24,0
4974,0,<START>,0,0,0
4974,1,home,0,7,7
4974,2,work,7,14,7
4974,3,home,14,21,7
4974,4,work,21,22,1
4974,5,home,22,24,2
4974,6,<ENDS>,24,24,0
4975,0,<START>,0,0,0
4975,1,home,0,8,8
4975,2,work,8,14,6
4975,3,home,14,18,4
4975,4,shop,18,19,1
4975,5,home,19,24,5
4975,6,<ENDS>,24,24,0
4976,0,<START>,0,0,0
4976,1,home,0,6,6
4976,2,shop,6,7,1
4976,3,work,7,14,7
4976,4,home,14,24,10
4976,5,<ENDS>,24,24,0
4977,0,<START>,0,0,0
4977,1,home,0,8,8
4977,2,work,8,15,7
4977,3,shop,15,16,1
4977,4,home,16,23,7
4977,5,work,23,24,1
4977,6,<ENDS>,24,24,0
4978,0,<START>,0,0,0
4978,1,home,0,7,7
4978,2,work,7,13,6
4978,3,home,13,24,11
4978,4,<ENDS>,24,24,0
4979,0,<START>,0,0,0
4979,1,home,0,7,7
4979,2,work,7,14,7
4979,3,shop,14,15,1
4979,4,work,15,19,4
4979,5,home,19,24,5
4979,6,<ENDS>,24,24,0
4980,0,<START>,0,0,0
4980,1,home,0,7,7
4980,2,work,7,13,6
4980,3,home,13,24,11
4980,4,<ENDS>,24,24,0
4981,0,<START>,0,0,0
4981,1,home,0,6,6
4981,2,work,6,13,7
4981,3,shop,13,14,1
4981,4,work,14,20,6
4981,5,home,20,24,4
4981,6,<ENDS>,24,24,0
4982,0,<START>,0,0,0
4982,1,home,0,9,9
4982,2,work,9,17,8
4982,3,home,17,24,7
4982,4,<ENDS>,24,24,0
4983,0,<START>,0,0,0
4983,1,home,0,7,7
4983,2,work,7,14,7
4983,3,home,14,18,4
4983,4,shop,18,19,1
4983,5,home,19,24,5
4983,6,<ENDS>,24,24,0
4984,0,<START>,0,0,0
4984,1,home,0,7,7
4984,2,work,7,14,7
4984,3,home,14,24,10
4984,4,<ENDS>,24,24,0
4985,0,<START>,0,0,0
4985,1,home,0,6,6
4985,2,work,6,13,7
4985,3,shop,13,14,1
4985,4,work,14,20,6
4985,5,home,20,24,4
4985,6,<ENDS>,24,24,0
4986,0,<START>,0,0,0
4986,1,home,0,7,7
4986,2,education,7,13,6
4986,3,shop,13,14,1
4986,4,education,14,16,2
4986,5,home,16,24,8
4986,6,<ENDS>,24,24,0
4987,0,<START>,0,0,0
4987,1,home,0,7,7
4987,2,work,7,15,8
4987,3,home,15,23,8
4987,4,work,23,24,1
4987,5,<ENDS>,24,24,0
4988,0,<START>,0,0,0
4988,1,home,0,6,6
4988,2,shop,6,7,1
4988,3,work,7,13,6
4988,4,home,13,16,3
4988,5,work,16,20,4
4988,6,home,20,24,4
4988,7,<ENDS>,24,24,0
4989,0,<START>,0,0,0
4989,1,home,0,7,7
4989,2,work,7,14,7
4989,3,home,14,24,10
4989,4,<ENDS>,24,24,0
4990,0,<START>,0,0,0
4990,1,home,0,8,8
4990,2,education,8,12,4
4990,3,home,12,19,7
4990,4,shop,19,20,1
4990,5,home,20,24,4
4990,6,<ENDS>,24,24,0
4991,0,<START>,0,0,0
4991,1,home,0,8,8
4991,2,work,8,15,7
4991,3,shop,15,16,1
4991,4,home,16,24,8
4991,5,<ENDS>,24,24,0
4992,0,<START>,0,0,0
4992,1,home,0,8,8
4992,2,work,8,13,5
4992,3,home,13,18,5
4992,4,work,18,20,2
4992,5,home,20,24,4
4992,6,<ENDS>,24,24,0
4993,0,<START>,0,0,0
4993,1,home,0,7,7
4993,2,work,7,13,6
4993,3,shop,13,14,1
4993,4,home,14,16,2
4993,5,work,16,20,4
4993,6,home,20,24,4
4993,7,<ENDS>,24,24,0
4994,0,<START>,0,0,0
4994,1,home,0,7,7
4994,2,work,7,13,6
4994,3,home,13,16,3
4994,4,shop,16,17,1
4994,5,work,17,20,3
4994,6,home,20,24,4
4994,7,<ENDS>,24,24,0
4995,0,<START>,0,0,0
4995,1,home,0,6,6
4995,2,work,6,13,7
4995,3,home,13,24,11
4995,4,<ENDS>,24,24,0
4996,0,<START>,0,0,0
4996,1,home,0,6,6
4996,2,work,6,7,1
4996,3,home,7,9,2
4996,4,work,9,11,2
4996,5,home,11,18,7
4996,6,shop,18,19,1
4996,7,home,19,24,5
4996,8,<ENDS>,24,24,0
4997,0,<START>,0,0,0
4997,1,home,0,7,7
4997,2,work,7,13,6
4997,3,home,13,16,3
4997,4,work,16,20,4
4997,5,home,20,24,4
4997,6,<ENDS>,24,24,0
4998,0,<START>,0,0,0
4998,1,home,0,8,8
4998,2,education,8,11,3
4998,3,home,11,24,13
4998,4,<ENDS>,24,24,0
4999,0,<START>,0,0,0
4999,1,home,0,8,8
4999,2,work,8,15,7
4999,3,shop,15,16,1
4999,4,work,16,20,4
4999,5,home,20,24,4
4999,6,<ENDS>,24,24,0
5000,0,<START>,0,0,0
5000,1,home,0,6,6
5000,2,work,6,8,2
5000,3,home,8,10,2
5000,4,work,10,12,2
5000,5,home,12,22,10
5000,6,work,22,23,1
5000,7,home,23,24,1
5000,8,<ENDS>,24,24,0
5001,0,<START>,0,0,0
5001,1,home,0,7,7
5001,2,work,7,13,6
5001,3,home,13,24,11
5001,4,<ENDS>,24,24,0
5002,0,<START>,0,0,0
5002,1,home,0,6,6
5002,2,work,6,13,7
5002,3,home,13,18,5
5002,4,work,18,20,2
5002,5,home,20,24,4
5002,6,<ENDS>,24,24,0
5003,0,<START>,0,0,0
5003,1,home,0,6,6
5003,2,work,6,8,2
5003,3,home,8,14,6
5003,4,work,14,17,3
5003,5,home,17,24,7
5003,6,<ENDS>,24,24,0
5004,0,<START>,0,0,0
5004,1,home,0,7,7
5004,2,work,7,13,6
5004,3,shop,13,14,1
5004,4,home,14,24,10
5004,5,<ENDS>,24,24,0
5005,0,<START>,0,0,0
5005,1,home,0,8,8
5005,2,education,8,11,3
5005,3,home,11,18,7
5005,4,shop,18,19,1
5005,5,home,19,24,5
5005,6,<ENDS>,24,24,0
5006,0,<START>,0,0,0
5006,1,home,0,9,9
5006,2,work,9,16,7
5006,3,home,16,24,8
5006,4,<ENDS>,24,24,0
5007,0,<START>,0,0,0
5007,1,home,0,8,8
5007,2,work,8,14,6
5007,3,shop,14,15,1
5007,4,home,15,22,7
5007,5,work,22,23,1
5007,6,home,23,24,1
5007,7,<ENDS>,24,24,0
5008,0,<START>,0,0,0
5008,1,home,0,7,7
5008,2,work,7,13,6
5008,3,home,13,24,11
5008,4,<ENDS>,24,24,0
5009,0,<START>,0,0,0
5009,1,home,0,7,7
5009,2,work,7,14,7
5009,3,shop,14,15,1
5009,4,home,15,20,5
5009,5,shop,20,21,1
5009,6,home,21,24,3
5009,7,<ENDS>,24,24,0
5010,0,<START>,0,0,0
5010,1,home,0,9,9
5010,2,work,9,15,6
5010,3,home,15,24,9
5010,4,<ENDS>,24,24,0
5011,0,<START>,0,0,0
5011,1,home,0,7,7
5011,2,work,7,14,7
5011,3,shop,14,15,1
5011,4,home,15,24,9
5011,5,<ENDS>,24,24,0
5012,0,<START>,0,0,0
5012,1,home,0,8,8
5012,2,education,8,11,3
5012,3,home,11,18,7
5012,4,shop,18,19,1
5012,5,home,19,24,5
5012,6,<ENDS>,24,24,0
5013,0,<START>,0,0,0
5013,1,home,0,7,7
5013,2,shop,7,8,1
5013,3,education,8,12,4
5013,4,shop,12,13,1
5013,5,home,13,14,1
5013,6,education,14,16,2
5013,7,home,16,24,8
5013,8,<ENDS>,24,24,0
5014,0,<START>,0,0,0
5014,1,home,0,9,9
5014,2,work,9,16,7
5014,3,shop,16,17,1
5014,4,work,17,20,3
5014,5,home,20,24,4
5014,6,<ENDS>,24,24,0
5015,0,<START>,0,0,0
5015,1,home,0,6,6
5015,2,shop,6,7,1
5015,3,home,7,10,3
5015,4,education,10,13,3
5015,5,shop,13,15,2
5015,6,home,15,24,9
5015,7,<ENDS>,24,24,0
5016,0,<START>,0,0,0
5016,1,home,0,8,8
5016,2,work,8,14,6
5016,3,home,14,18,4
5016,4,shop,18,19,1
5016,5,home,19,24,5
5016,6,<ENDS>,24,24,0
5017,0,<START>,0,0,0
5017,1,home,0,6,6
5017,2,work,6,13,7
5017,3,home,13,15,2
5017,4,work,15,20,5
5017,5,home,20,24,4
5017,6,<ENDS>,24,24,0
5018,0,<START>,0,0,0
5018,1,home,0,8,8
5018,2,work,8,15,7
5018,3,home,15,16,1
5018,4,work,16,20,4
5018,5,home,20,24,4
5018,6,<ENDS>,24,24,0
5019,0,<START>,0,0,0
5019,1,home,0,7,7
5019,2,work,7,14,7
5019,3,home,14,18,4
5019,4,shop,18,19,1
5019,5,home,19,24,5
5019,6,<ENDS>,24,24,0
5020,0,<START>,0,0,0
5020,1,home,0,6,6
5020,2,work,6,13,7
5020,3,home,13,24,11
5020,4,<ENDS>,24,24,0
5021,0,<START>,0,0,0
5021,1,home,0,8,8
5021,2,work,8,14,6
5021,3,shop,14,15,1
5021,4,work,15,20,5
5021,5,home,20,24,4
5021,6,<ENDS>,24,24,0
5022,0,<START>,0,0,0
5022,1,home,0,7,7
5022,2,work,7,9,2
5022,3,home,9,13,4
5022,4,work,13,15,2
5022,5,home,15,22,7
5022,6,work,22,23,1
5022,7,home,23,24,1
5022,8,<ENDS>,24,24,0
5023,0,<START>,0,0,0
5023,1,home,0,6,6
5023,2,shop,6,7,1
5023,3,work,7,15,8
5023,4,home,15,24,9
5023,5,<ENDS>,24,24,0
5024,0,<START>,0,0,0
5024,1,home,0,7,7
5024,2,education,7,12,5
5024,3,home,12,16,4
5024,4,shop,16,17,1
5024,5,home,17,24,7
5024,6,<ENDS>,24,24,0
5025,0,<START>,0,0,0
5025,1,home,0,6,6
5025,2,work,6,8,2
5025,3,home,8,12,4
5025,4,work,12,14,2
5025,5,home,14,21,7
5025,6,work,21,22,1
5025,7,home,22,24,2
5025,8,<ENDS>,24,24,0
5026,0,<START>,0,0,0
5026,1,home,0,7,7
5026,2,work,7,14,7
5026,3,shop,14,15,1
5026,4,home,15,24,9
5026,5,<ENDS>,24,24,0
5027,0,<START>,0,0,0
5027,1,home,0,6,6
5027,2,work,6,13,7
5027,3,home,13,18,5
5027,4,work,18,20,2
5027,5,home,20,24,4
5027,6,<ENDS>,24,24,0
5028,0,<START>,0,0,0
5028,1,home,0,6,6
5028,2,work,6,13,7
5028,3,shop,13,14,1
5028,4,home,14,24,10
5028,5,<ENDS>,24,24,0
5029,0,<START>,0,0,0
5029,1,home,0,7,7
5029,2,education,7,11,4
5029,3,home,11,15,4
5029,4,shop,15,16,1
5029,5,home,16,24,8
5029,6,<ENDS>,24,24,0
5030,0,<START>,0,0,0
5030,1,home,0,7,7
5030,2,work,7,14,7
5030,3,home,14,24,10
5030,4,<ENDS>,24,24,0
5031,0,<START>,0,0,0
5031,1,home,0,9,9
5031,2,work,9,16,7
5031,3,home,16,24,8
5031,4,<ENDS>,24,24,0
5032,0,<START>,0,0,0
5032,1,home,0,8,8
5032,2,work,8,15,7
5032,3,home,15,24,9
5032,4,<ENDS>,24,24,0
5033,0,<START>,0,0,0
5033,1,home,0,7,7
5033,2,work,7,14,7
5033,3,shop,14,15,1
5033,4,home,15,24,9
5033,5,<ENDS>,24,24,0
5034,0,<START>,0,0,0
5034,1,home,0,7,7
5034,2,shop,7,8,1
5034,3,education,8,12,4
5034,4,shop,12,13,1
5034,5,education,13,14,1
5034,6,shop,14,16,2
5034,7,home,16,20,4
5034,8,shop,20,21,1
5034,9,home,21,24,3
5034,10,<ENDS>,24,24,0
5035,0,<START>,0,0,0
5035,1,home,0,6,6
5035,2,shop,6,7,1
5035,3,home,7,10,3
5035,4,education,10,13,3
5035,5,shop,13,15,2
5035,6,home,15,19,4
5035,7,shop,19,21,2
5035,8,home,21,24,3
5035,9,<ENDS>,24,24,0
5036,0,<START>,0,0,0
5036,1,home,0,7,7
5036,2,work,7,14,7
5036,3,shop,14,15,1
5036,4,home,15,24,9
5036,5,<ENDS>,24,24,0
5037,0,<START>,0,0,0
5037,1,home,0,7,7
5037,2,work,7,14,7
5037,3,home,14,24,10
5037,4,<ENDS>,24,24,0
5038,0,<START>,0,0,0
5038,1,home,0,9,9
5038,2,work,9,16,7
5038,3,home,16,24,8
5038,4,<ENDS>,24,24,0
5039,0,<START>,0,0,0
5039,1,home,0,7,7
5039,2,work,7,14,7
5039,3,shop,14,15,1
5039,4,work,15,19,4
5039,5,home,19,24,5
5039,6,<ENDS>,24,24,0
5040,0,<START>,0,0,0
5040,1,home,0,6,6
5040,2,work,6,13,7
5040,3,home,13,24,11
5040,4,<ENDS>,24,24,0
5041,0,<START>,0,0,0
5041,1,home,0,7,7
5041,2,shop,7,8,1
5041,3,education,8,12,4
5041,4,home,12,14,2
5041,5,education,14,16,2
5041,6,home,16,24,8
5041,7,<ENDS>,24,24,0
5042,0,<START>,0,0,0
5042,1,home,0,7,7
5042,2,work,7,13,6
5042,3,home,13,24,11
5042,4,<ENDS>,24,24,0
5043,0,<START>,0,0,0
5043,1,home,0,8,8
5043,2,work,8,16,8
5043,3,home,16,24,8
5043,4,<ENDS>,24,24,0
5044,0,<START>,0,0,0
5044,1,home,0,8,8
5044,2,work,8,13,5
5044,3,home,13,17,4
5044,4,work,17,20,3
5044,5,home,20,24,4
5044,6,<ENDS>,24,24,0
5045,0,<START>,0,0,0
5045,1,home,0,8,8
5045,2,work,8,16,8
5045,3,home,16,24,8
5045,4,<ENDS>,24,24,0
5046,0,<START>,0,0,0
5046,1,home,0,9,9
5046,2,education,9,11,2
5046,3,home,11,15,4
5046,4,shop,15,16,1
5046,5,home,16,24,8
5046,6,<ENDS>,24,24,0
5047,0,<START>,0,0,0
5047,1,home,0,7,7
5047,2,work,7,14,7
5047,3,shop,14,15,1
5047,4,home,15,18,3
5047,5,work,18,19,1
5047,6,home,19,24,5
5047,7,<ENDS>,24,24,0
5048,0,<START>,0,0,0
5048,1,home,0,6,6
5048,2,work,6,13,7
5048,3,home,13,23,10
5048,4,work,23,24,1
5048,5,<ENDS>,24,24,0
5049,0,<START>,0,0,0
5049,1,home,0,7,7
5049,2,education,7,11,4
5049,3,home,11,18,7
5049,4,shop,18,19,1
5049,5,home,19,24,5
5049,6,<ENDS>,24,24,0
5050,0,<START>,0,0,0
5050,1,home,0,7,7
5050,2,shop,7,8,1
5050,3,education,8,12,4
5050,4,shop,12,13,1
5050,5,home,13,20,7
5050,6,shop,20,21,1
5050,7,home,21,24,3
5050,8,<ENDS>,24,24,0
5051,0,<START>,0,0,0
5051,1,home,0,7,7
5051,2,education,7,11,4
5051,3,home,11,16,5
5051,4,shop,16,18,2
5051,5,home,18,24,6
5051,6,<ENDS>,24,24,0
5052,0,<START>,0,0,0
5052,1,home,0,7,7
5052,2,work,7,13,6
5052,3,shop,13,14,1
5052,4,work,14,19,5
5052,5,home,19,24,5
5052,6,<ENDS>,24,24,0
5053,0,<START>,0,0,0
5053,1,home,0,8,8
5053,2,work,8,15,7
5053,3,shop,15,16,1
5053,4,home,16,22,6
5053,5,work,22,23,1
5053,6,home,23,24,1
5053,7,<ENDS>,24,24,0
5054,0,<START>,0,0,0
5054,1,home,0,7,7
5054,2,work,7,14,7
5054,3,shop,14,15,1
5054,4,home,15,21,6
5054,5,work,21,22,1
5054,6,home,22,24,2
5054,7,<ENDS>,24,24,0
5055,0,<START>,0,0,0
5055,1,home,0,6,6
5055,2,shop,6,7,1
5055,3,home,7,9,2
5055,4,education,9,12,3
5055,5,shop,12,14,2
5055,6,education,14,16,2
5055,7,home,16,24,8
5055,8,<ENDS>,24,24,0
5056,0,<START>,0,0,0
5056,1,home,0,8,8
5056,2,shop,8,9,1
5056,3,work,9,15,6
5056,4,home,15,24,9
5056,5,<ENDS>,24,24,0
5057,0,<START>,0,0,0
5057,1,home,0,8,8
5057,2,work,8,15,7
5057,3,shop,15,16,1
5057,4,home,16,24,8
5057,5,<ENDS>,24,24,0
5058,0,<START>,0,0,0
5058,1,home,0,7,7
5058,2,work,7,14,7
5058,3,shop,14,15,1
5058,4,home,15,19,4
5058,5,shop,19,20,1
5058,6,home,20,24,4
5058,7,<ENDS>,24,24,0
5059,0,<START>,0,0,0
5059,1,home,0,6,6
5059,2,shop,6,7,1
5059,3,home,7,13,6
5059,4,education,13,17,4
5059,5,shop,17,18,1
5059,6,home,18,24,6
5059,7,<ENDS>,24,24,0
5060,0,<START>,0,0,0
5060,1,home,0,7,7
5060,2,work,7,8,1
5060,3,home,8,9,1
5060,4,work,9,10,1
5060,5,shop,10,11,1
5060,6,work,11,13,2
5060,7,home,13,21,8
5060,8,work,21,22,1
5060,9,home,22,24,2
5060,10,<ENDS>,24,24,0
5061,0,<START>,0,0,0
5061,1,home,0,8,8
5061,2,education,8,11,3
5061,3,home,11,16,5
5061,4,work,16,20,4
5061,5,home,20,24,4
5061,6,<ENDS>,24,24,0
5062,0,<START>,0,0,0
5062,1,home,0,6,6
5062,2,work,6,13,7
5062,3,home,13,20,7
5062,4,shop,20,21,1
5062,5,home,21,24,3
5062,6,<ENDS>,24,24,0
5063,0,<START>,0,0,0
5063,1,home,0,8,8
5063,2,work,8,16,8
5063,3,home,16,23,7
5063,4,work,23,24,1
5063,5,<ENDS>,24,24,0
5064,0,<START>,0,0,0
5064,1,home,0,7,7
5064,2,work,7,14,7
5064,3,shop,14,15,1
5064,4,home,15,22,7
5064,5,work,22,23,1
5064,6,home,23,24,1
5064,7,<ENDS>,24,24,0
5065,0,<START>,0,0,0
5065,1,home,0,7,7
5065,2,work,7,14,7
5065,3,home,14,24,10
5065,4,<ENDS>,24,24,0
5066,0,<START>,0,0,0
5066,1,home,0,6,6
5066,2,work,6,12,6
5066,3,shop,12,13,1
5066,4,work,13,18,5
5066,5,home,18,24,6
5066,6,<ENDS>,24,24,0
5067,0,<START>,0,0,0
5067,1,home,0,8,8
5067,2,work,8,16,8
5067,3,home,16,23,7
5067,4,work,23,24,1
5067,5,<ENDS>,24,24,0
5068,0,<START>,0,0,0
5068,1,home,0,6,6
5068,2,shop,6,7,1
5068,3,home,7,10,3
5068,4,education,10,13,3
5068,5,home,13,19,6
5068,6,shop,19,20,1
5068,7,home,20,24,4
5068,8,<ENDS>,24,24,0
5069,0,<START>,0,0,0
5069,1,home,0,8,8
5069,2,work,8,16,8
5069,3,home,16,22,6
5069,4,work,22,23,1
5069,5,home,23,24,1
5069,6,<ENDS>,24,24,0
5070,0,<START>,0,0,0
5070,1,home,0,6,6
5070,2,work,6,13,7
5070,3,shop,13,14,1
5070,4,home,14,24,10
5070,5,<ENDS>,24,24,0
5071,0,<START>,0,0,0
5071,1,home,0,8,8
5071,2,work,8,14,6
5071,3,home,14,18,4
5071,4,shop,18,19,1
5071,5,home,19,24,5
5071,6,<ENDS>,24,24,0
5072,0,<START>,0,0,0
5072,1,home,0,6,6
5072,2,work,6,13,7
5072,3,home,13,24,11
5072,4,<ENDS>,24,24,0
5073,0,<START>,0,0,0
5073,1,home,0,7,7
5073,2,work,7,14,7
5073,3,home,14,22,8
5073,4,work,22,23,1
5073,5,home,23,24,1
5073,6,<ENDS>,24,24,0
5074,0,<START>,0,0,0
5074,1,home,0,8,8
5074,2,work,8,15,7
5074,3,shop,15,16,1
5074,4,home,16,24,8
5074,5,<ENDS>,24,24,0
5075,0,<START>,0,0,0
5075,1,home,0,7,7
5075,2,shop,7,8,1
5075,3,education,8,11,3
5075,4,home,11,18,7
5075,5,shop,18,19,1
5075,6,home,19,24,5
5075,7,<ENDS>,24,24,0
5076,0,<START>,0,0,0
5076,1,home,0,8,8
5076,2,work,8,15,7
5076,3,home,15,24,9
5076,4,<ENDS>,24,24,0
5077,0,<START>,0,0,0
5077,1,home,0,7,7
5077,2,work,7,14,7
5077,3,home,14,18,4
5077,4,shop,18,19,1
5077,5,home,19,24,5
5077,6,<ENDS>,24,24,0
5078,0,<START>,0,0,0
5078,1,home,0,7,7
5078,2,education,7,11,4
5078,3,home,11,18,7
5078,4,shop,18,20,2
5078,5,home,20,24,4
5078,6,<ENDS>,24,24,0
5079,0,<START>,0,0,0
5079,1,home,0,6,6
5079,2,work,6,12,6
5079,3,shop,12,14,2
5079,4,work,14,19,5
5079,5,home,19,24,5
5079,6,<ENDS>,24,24,0
5080,0,<START>,0,0,0
5080,1,home,0,9,9
5080,2,work,9,16,7
5080,3,home,16,21,5
5080,4,work,21,22,1
5080,5,home,22,24,2
5080,6,<ENDS>,24,24,0
5081,0,<START>,0,0,0
5081,1,home,0,8,8
5081,2,work,8,15,7
5081,3,home,15,21,6
5081,4,shop,21,22,1
5081,5,home,22,24,2
5081,6,<ENDS>,24,24,0
5082,0,<START>,0,0,0
5082,1,home,0,7,7
5082,2,work,7,14,7
5082,3,shop,14,15,1
5082,4,home,15,24,9
5082,5,<ENDS>,24,24,0
5083,0,<START>,0,0,0
5083,1,home,0,7,7
5083,2,work,7,14,7
5083,3,shop,14,15,1
5083,4,work,15,20,5
5083,5,home,20,24,4
5083,6,<ENDS>,24,24,0
5084,0,<START>,0,0,0
5084,1,home,0,6,6
5084,2,work,6,12,6
5084,3,shop,12,13,1
5084,4,education,13,17,4
5084,5,home,17,22,5
5084,6,work,22,23,1
5084,7,home,23,24,1
5084,8,<ENDS>,24,24,0
5085,0,<START>,0,0,0
5085,1,home,0,8,8
5085,2,work,8,14,6
5085,3,home,14,23,9
5085,4,work,23,24,1
5085,5,<ENDS>,24,24,0
5086,0,<START>,0,0,0
5086,1,home,0,6,6
5086,2,work,6,13,7
5086,3,home,13,14,1
5086,4,work,14,20,6
5086,5,home,20,24,4
5086,6,<ENDS>,24,24,0
5087,0,<START>,0,0,0
5087,1,home,0,7,7
5087,2,work,7,14,7
5087,3,home,14,24,10
5087,4,<ENDS>,24,24,0
5088,0,<START>,0,0,0
5088,1,home,0,9,9
5088,2,work,9,15,6
5088,3,home,15,19,4
5088,4,shop,19,20,1
5088,5,home,20,24,4
5088,6,<ENDS>,24,24,0
5089,0,<START>,0,0,0
5089,1,home,0,7,7
5089,2,work,7,13,6
5089,3,home,13,22,9
5089,4,work,22,23,1
5089,5,home,23,24,1
5089,6,<ENDS>,24,24,0
5090,0,<START>,0,0,0
5090,1,home,0,6,6
5090,2,work,6,8,2
5090,3,home,8,9,1
5090,4,work,9,11,2
5090,5,home,11,18,7
5090,6,work,18,20,2
5090,7,home,20,24,4
5090,8,<ENDS>,24,24,0
5091,0,<START>,0,0,0
5091,1,home,0,6,6
5091,2,work,6,13,7
5091,3,shop,13,14,1
5091,4,home,14,16,2
5091,5,work,16,20,4
5091,6,home,20,24,4
5091,7,<ENDS>,24,24,0
5092,0,<START>,0,0,0
5092,1,home,0,6,6
5092,2,shop,6,7,1
5092,3,home,7,13,6
5092,4,education,13,16,3
5092,5,home,16,24,8
5092,6,<ENDS>,24,24,0
5093,0,<START>,0,0,0
5093,1,home,0,6,6
5093,2,work,6,13,7
5093,3,shop,13,14,1
5093,4,work,14,19,5
5093,5,home,19,24,5
5093,6,<ENDS>,24,24,0
5094,0,<START>,0,0,0
5094,1,home,0,6,6
5094,2,shop,6,7,1
5094,3,home,7,10,3
5094,4,education,10,13,3
5094,5,shop,13,15,2
5094,6,home,15,21,6
5094,7,shop,21,22,1
5094,8,home,22,24,2
5094,9,<ENDS>,24,24,0
5095,0,<START>,0,0,0
5095,1,home,0,8,8
5095,2,work,8,14,6
5095,3,home,14,18,4
5095,4,shop,18,19,1
5095,5,home,19,23,4
5095,6,work,23,24,1
5095,7,<ENDS>,24,24,0
5096,0,<START>,0,0,0
5096,1,home,0,6,6
5096,2,shop,6,7,1
5096,3,home,7,9,2
5096,4,education,9,11,2
5096,5,home,11,19,8
5096,6,shop,19,20,1
5096,7,home,20,24,4
5096,8,<ENDS>,24,24,0
5097,0,<START>,0,0,0
5097,1,home,0,8,8
5097,2,work,8,15,7
5097,3,home,15,24,9
5097,4,<ENDS>,24,24,0
5098,0,<START>,0,0,0
5098,1,home,0,6,6
5098,2,work,6,13,7
5098,3,home,13,19,6
5098,4,shop,19,20,1
5098,5,home,20,24,4
5098,6,<ENDS>,24,24,0
5099,0,<START>,0,0,0
5099,1,home,0,7,7
5099,2,work,7,13,6
5099,3,home,13,18,5
5099,4,work,18,20,2
5099,5,home,20,24,4
5099,6,<ENDS>,24,24,0
5100,0,<START>,0,0,0
5100,1,home,0,7,7
5100,2,shop,7,8,1
5100,3,work,8,15,7
5100,4,home,15,24,9
5100,5,<ENDS>,24,24,0
5101,0,<START>,0,0,0
5101,1,home,0,6,6
5101,2,work,6,13,7
5101,3,shop,13,14,1
5101,4,work,14,19,5
5101,5,home,19,24,5
5101,6,<ENDS>,24,24,0
5102,0,<START>,0,0,0
5102,1,home,0,7,7
5102,2,work,7,14,7
5102,3,shop,14,15,1
5102,4,home,15,24,9
5102,5,<ENDS>,24,24,0
5103,0,<START>,0,0,0
5103,1,home,0,6,6
5103,2,work,6,13,7
5103,3,home,13,24,11
5103,4,<ENDS>,24,24,0
5104,0,<START>,0,0,0
5104,1,home,0,7,7
5104,2,work,7,14,7
5104,3,home,14,18,4
5104,4,work,18,20,2
5104,5,home,20,24,4
5104,6,<ENDS>,24,24,0
5105,0,<START>,0,0,0
5105,1,home,0,6,6
5105,2,shop,6,7,1
5105,3,home,7,9,2
5105,4,education,9,12,3
5105,5,home,12,19,7
5105,6,shop,19,20,1
5105,7,home,20,24,4
5105,8,<ENDS>,24,24,0
5106,0,<START>,0,0,0
5106,1,home,0,6,6
5106,2,shop,6,7,1
5106,3,home,7,13,6
5106,4,work,13,19,6
5106,5,home,19,24,5
5106,6,<ENDS>,24,24,0
5107,0,<START>,0,0,0
5107,1,home,0,6,6
5107,2,work,6,13,7
5107,3,home,13,24,11
5107,4,<ENDS>,24,24,0
5108,0,<START>,0,0,0
5108,1,home,0,7,7
5108,2,education,7,11,4
5108,3,home,11,14,3
5108,4,education,14,16,2
5108,5,shop,16,17,1
5108,6,home,17,24,7
5108,7,<ENDS>,24,24,0
5109,0,<START>,0,0,0
5109,1,home,0,7,7
5109,2,work,7,14,7
5109,3,shop,14,15,1
5109,4,work,15,20,5
5109,5,home,20,24,4
5109,6,<ENDS>,24,24,0
5110,0,<START>,0,0,0
5110,1,home,0,7,7
5110,2,education,7,11,4
5110,3,home,11,14,3
5110,4,education,14,16,2
5110,5,shop,16,17,1
5110,6,home,17,24,7
5110,7,<ENDS>,24,24,0
5111,0,<START>,0,0,0
5111,1,home,0,7,7
5111,2,work,7,14,7
5111,3,home,14,24,10
5111,4,<ENDS>,24,24,0
5112,0,<START>,0,0,0
5112,1,home,0,7,7
5112,2,work,7,14,7
5112,3,shop,14,15,1
5112,4,work,15,20,5
5112,5,home,20,24,4
5112,6,<ENDS>,24,24,0
5113,0,<START>,0,0,0
5113,1,home,0,7,7
5113,2,work,7,13,6
5113,3,shop,13,14,1
5113,4,home,14,24,10
5113,5,<ENDS>,24,24,0
5114,0,<START>,0,0,0
5114,1,home,0,8,8
5114,2,work,8,15,7
5114,3,home,15,24,9
5114,4,<ENDS>,24,24,0
5115,0,<START>,0,0,0
5115,1,home,0,6,6
5115,2,work,6,8,2
5115,3,home,8,9,1
5115,4,work,9,11,2
5115,5,home,11,15,4
5115,6,work,15,17,2
5115,7,home,17,23,6
5115,8,work,23,24,1
5115,9,<ENDS>,24,24,0
5116,0,<START>,0,0,0
5116,1,home,0,6,6
5116,2,shop,6,7,1
5116,3,home,7,9,2
5116,4,education,9,12,3
5116,5,home,12,19,7
5116,6,shop,19,20,1
5116,7,home,20,24,4
5116,8,<ENDS>,24,24,0
5117,0,<START>,0,0,0
5117,1,home,0,6,6
5117,2,work,6,13,7
5117,3,shop,13,14,1
5117,4,work,14,19,5
5117,5,home,19,24,5
5117,6,<ENDS>,24,24,0
5118,0,<START>,0,0,0
5118,1,home,0,6,6
5118,2,work,6,13,7
5118,3,home,13,24,11
5118,4,<ENDS>,24,24,0
5119,0,<START>,0,0,0
5119,1,home,0,6,6
5119,2,work,6,13,7
5119,3,shop,13,14,1
5119,4,work,14,19,5
5119,5,home,19,24,5
5119,6,<ENDS>,24,24,0
5120,0,<START>,0,0,0
5120,1,home,0,7,7
5120,2,shop,7,8,1
5120,3,education,8,10,2
5120,4,home,10,16,6
5120,5,shop,16,17,1
5120,6,home,17,24,7
5120,7,<ENDS>,24,24,0
5121,0,<START>,0,0,0
5121,1,home,0,6,6
5121,2,work,6,13,7
5121,3,shop,13,14,1
5121,4,home,14,18,4
5121,5,work,18,20,2
5121,6,home,20,24,4
5121,7,<ENDS>,24,24,0
5122,0,<START>,0,0,0
5122,1,home,0,8,8
5122,2,work,8,15,7
5122,3,home,15,24,9
5122,4,<ENDS>,24,24,0
5123,0,<START>,0,0,0
5123,1,home,0,8,8
5123,2,work,8,15,7
5123,3,shop,15,16,1
5123,4,home,16,24,8
5123,5,<ENDS>,24,24,0
5124,0,<START>,0,0,0
5124,1,home,0,7,7
5124,2,work,7,13,6
5124,3,home,13,17,4
5124,4,shop,17,18,1
5124,5,work,18,19,1
5124,6,home,19,24,5
5124,7,<ENDS>,24,24,0
5125,0,<START>,0,0,0
5125,1,home,0,8,8
5125,2,work,8,15,7
5125,3,home,15,24,9
5125,4,<ENDS>,24,24,0
5126,0,<START>,0,0,0
5126,1,home,0,6,6
5126,2,work,6,8,2
5126,3,home,8,9,1
5126,4,work,9,11,2
5126,5,home,11,14,3
5126,6,work,14,16,2
5126,7,shop,16,17,1
5126,8,home,17,24,7
5126,9,<ENDS>,24,24,0
5127,0,<START>,0,0,0
5127,1,home,0,7,7
5127,2,education,7,12,5
5127,3,shop,12,13,1
5127,4,home,13,19,6
5127,5,shop,19,20,1
5127,6,home,20,24,4
5127,7,<ENDS>,24,24,0
5128,0,<START>,0,0,0
5128,1,home,0,8,8
5128,2,work,8,13,5
5128,3,shop,13,14,1
5128,4,education,14,18,4
5128,5,home,18,23,5
5128,6,work,23,24,1
5128,7,<ENDS>,24,24,0
5129,0,<START>,0,0,0
5129,1,home,0,7,7
5129,2,education,7,12,5
5129,3,shop,12,14,2
5129,4,education,14,16,2
5129,5,home,16,24,8
5129,6,<ENDS>,24,24,0
5130,0,<START>,0,0,0
5130,1,home,0,6,6
5130,2,work,6,8,2
5130,3,home,8,13,5
5130,4,work,13,15,2
5130,5,home,15,23,8
5130,6,work,23,24,1
5130,7,<ENDS>,24,24,0
5131,0,<START>,0,0,0
5131,1,home,0,6,6
5131,2,work,6,8,2
5131,3,home,8,14,6
5131,4,work,14,16,2
5131,5,home,16,21,5
5131,6,work,21,22,1
5131,7,home,22,24,2
5131,8,<ENDS>,24,24,0
5132,0,<START>,0,0,0
5132,1,home,0,9,9
5132,2,work,9,16,7
5132,3,shop,16,17,1
5132,4,work,17,20,3
5132,5,home,20,24,4
5132,6,<ENDS>,24,24,0
5133,0,<START>,0,0,0
5133,1,home,0,7,7
5133,2,education,7,12,5
5133,3,shop,12,13,1
5133,4,home,13,20,7
5133,5,shop,20,21,1
5133,6,home,21,24,3
5133,7,<ENDS>,24,24,0
5134,0,<START>,0,0,0
5134,1,home,0,8,8
5134,2,work,8,15,7
5134,3,home,15,19,4
5134,4,shop,19,20,1
5134,5,home,20,24,4
5134,6,<ENDS>,24,24,0
5135,0,<START>,0,0,0
5135,1,home,0,6,6
5135,2,work,6,13,7
5135,3,home,13,15,2
5135,4,work,15,20,5
5135,5,home,20,24,4
5135,6,<ENDS>,24,24,0
5136,0,<START>,0,0,0
5136,1,home,0,8,8
5136,2,shop,8,9,1
5136,3,home,9,13,4
5136,4,work,13,19,6
5136,5,home,19,23,4
5136,6,work,23,24,1
5136,7,<ENDS>,24,24,0
5137,0,<START>,0,0,0
5137,1,home,0,7,7
5137,2,work,7,14,7
5137,3,shop,14,15,1
5137,4,home,15,24,9
5137,5,<ENDS>,24,24,0
5138,0,<START>,0,0,0
5138,1,home,0,6,6
5138,2,work,6,8,2
5138,3,home,8,12,4
5138,4,work,12,14,2
5138,5,shop,14,15,1
5138,6,home,15,22,7
5138,7,work,22,23,1
5138,8,home,23,24,1
5138,9,<ENDS>,24,24,0
5139,0,<START>,0,0,0
5139,1,home,0,9,9
5139,2,work,9,14,5
5139,3,home,14,21,7
5139,4,work,21,22,1
5139,5,home,22,24,2
5139,6,<ENDS>,24,24,0
5140,0,<START>,0,0,0
5140,1,home,0,7,7
5140,2,work,7,14,7
5140,3,shop,14,15,1
5140,4,home,15,24,9
5140,5,<ENDS>,24,24,0
5141,0,<START>,0,0,0
5141,1,home,0,6,6
5141,2,work,6,13,7
5141,3,home,13,17,4
5141,4,work,17,20,3
5141,5,home,20,24,4
5141,6,<ENDS>,24,24,0
5142,0,<START>,0,0,0
5142,1,home,0,6,6
5142,2,work,6,9,3
5142,3,home,9,13,4
5142,4,work,13,15,2
5142,5,home,15,24,9
5142,6,<ENDS>,24,24,0
5143,0,<START>,0,0,0
5143,1,home,0,7,7
5143,2,work,7,14,7
5143,3,shop,14,15,1
5143,4,home,15,23,8
5143,5,work,23,24,1
5143,6,<ENDS>,24,24,0
5144,0,<START>,0,0,0
5144,1,home,0,8,8
5144,2,work,8,14,6
5144,3,shop,14,15,1
5144,4,home,15,24,9
5144,5,<ENDS>,24,24,0
5145,0,<START>,0,0,0
5145,1,home,0,6,6
5145,2,shop,6,7,1
5145,3,work,7,13,6
5145,4,shop,13,14,1
5145,5,work,14,20,6
5145,6,home,20,24,4
5145,7,<ENDS>,24,24,0
5146,0,<START>,0,0,0
5146,1,home,0,8,8
5146,2,work,8,14,6
5146,3,home,14,22,8
5146,4,work,22,23,1
5146,5,home,23,24,1
5146,6,<ENDS>,24,24,0
5147,0,<START>,0,0,0
5147,1,home,0,8,8
5147,2,education,8,12,4
5147,3,shop,12,13,1
5147,4,work,13,19,6
5147,5,home,19,23,4
5147,6,work,23,24,1
5147,7,<ENDS>,24,24,0
5148,0,<START>,0,0,0
5148,1,home,0,7,7
5148,2,work,7,14,7
5148,3,home,14,22,8
5148,4,work,22,23,1
5148,5,home,23,24,1
5148,6,<ENDS>,24,24,0
5149,0,<START>,0,0,0
5149,1,home,0,8,8
5149,2,work,8,14,6
5149,3,shop,14,15,1
5149,4,home,15,21,6
5149,5,work,21,22,1
5149,6,home,22,24,2
5149,7,<ENDS>,24,24,0
5150,0,<START>,0,0,0
5150,1,home,0,6,6
5150,2,work,6,8,2
5150,3,home,8,12,4
5150,4,work,12,14,2
5150,5,home,14,18,4
5150,6,work,18,19,1
5150,7,home,19,22,3
5150,8,work,22,23,1
5150,9,home,23,24,1
5150,10,<ENDS>,24,24,0
5151,0,<START>,0,0,0
5151,1,home,0,7,7
5151,2,work,7,13,6
5151,3,home,13,22,9
5151,4,work,22,23,1
5151,5,home,23,24,1
5151,6,<ENDS>,24,24,0
5152,0,<START>,0,0,0
5152,1,home,0,8,8
5152,2,work,8,15,7
5152,3,shop,15,16,1
5152,4,work,16,20,4
5152,5,home,20,24,4
5152,6,<ENDS>,24,24,0
5153,0,<START>,0,0,0
5153,1,home,0,8,8
5153,2,shop,8,9,1
5153,3,work,9,17,8
5153,4,home,17,24,7
5153,5,<ENDS>,24,24,0
5154,0,<START>,0,0,0
5154,1,home,0,7,7
5154,2,work,7,9,2
5154,3,home,9,13,4
5154,4,work,13,17,4
5154,5,home,17,22,5
5154,6,work,22,23,1
5154,7,home,23,24,1
5154,8,<ENDS>,24,24,0
5155,0,<START>,0,0,0
5155,1,home,0,8,8
5155,2,work,8,14,6
5155,3,home,14,19,5
5155,4,shop,19,20,1
5155,5,home,20,24,4
5155,6,<ENDS>,24,24,0
5156,0,<START>,0,0,0
5156,1,home,0,7,7
5156,2,work,7,13,6
5156,3,shop,13,14,1
5156,4,education,14,17,3
5156,5,home,17,21,4
5156,6,work,21,22,1
5156,7,home,22,24,2
5156,8,<ENDS>,24,24,0
5157,0,<START>,0,0,0
5157,1,home,0,7,7
5157,2,shop,7,8,1
5157,3,home,8,15,7
5157,4,work,15,19,4
5157,5,home,19,24,5
5157,6,<ENDS>,24,24,0
5158,0,<START>,0,0,0
5158,1,home,0,8,8
5158,2,education,8,12,4
5158,3,home,12,19,7
5158,4,shop,19,20,1
5158,5,home,20,24,4
5158,6,<ENDS>,24,24,0
5159,0,<START>,0,0,0
5159,1,home,0,6,6
5159,2,work,6,13,7
5159,3,home,13,17,4
5159,4,work,17,20,3
5159,5,home,20,24,4
5159,6,<ENDS>,24,24,0
5160,0,<START>,0,0,0
5160,1,home,0,8,8
5160,2,shop,8,9,1
5160,3,work,9,16,7
5160,4,home,16,21,5
5160,5,work,21,22,1
5160,6,home,22,24,2
5160,7,<ENDS>,24,24,0
5161,0,<START>,0,0,0
5161,1,home,0,6,6
5161,2,shop,6,8,2
5161,3,work,8,14,6
5161,4,home,14,17,3
5161,5,work,17,20,3
5161,6,home,20,24,4
5161,7,<ENDS>,24,24,0
5162,0,<START>,0,0,0
5162,1,home,0,7,7
5162,2,education,7,12,5
5162,3,home,12,18,6
5162,4,shop,18,19,1
5162,5,home,19,24,5
5162,6,<ENDS>,24,24,0
5163,0,<START>,0,0,0
5163,1,home,0,9,9
5163,2,work,9,16,7
5163,3,shop,16,17,1
5163,4,home,17,22,5
5163,5,work,22,23,1
5163,6,home,23,24,1
5163,7,<ENDS>,24,24,0
5164,0,<START>,0,0,0
5164,1,work,0,9,9
5164,2,shop,9,10,1
5164,3,home,10,15,5
5164,4,work,15,20,5
5164,5,home,20,24,4
5164,6,<ENDS>,24,24,0
5165,0,<START>,0,0,0
5165,1,home,0,7,7
5165,2,work,7,14,7
5165,3,shop,14,15,1
5165,4,home,15,18,3
5165,5,work,18,20,2
5165,6,home,20,24,4
5165,7,<ENDS>,24,24,0
5166,0,<START>,0,0,0
5166,1,home,0,6,6
5166,2,work,6,13,7
5166,3,home,13,24,11
5166,4,<ENDS>,24,24,0
5167,0,<START>,0,0,0
5167,1,home,0,7,7
5167,2,shop,7,8,1
5167,3,education,8,12,4
5167,4,shop,12,13,1
5167,5,home,13,24,11
5167,6,<ENDS>,24,24,0
5168,0,<START>,0,0,0
5168,1,home,0,8,8
5168,2,work,8,15,7
5168,3,home,15,24,9
5168,4,<ENDS>,24,24,0
5169,0,<START>,0,0,0
5169,1,home,0,6,6
5169,2,work,6,8,2
5169,3,home,8,12,4
5169,4,work,12,14,2
5169,5,home,14,21,7
5169,6,work,21,22,1
5169,7,home,22,24,2
5169,8,<ENDS>,24,24,0
5170,0,<START>,0,0,0
5170,1,home,0,7,7
5170,2,education,7,8,1
5170,3,home,8,16,8
5170,4,shop,16,17,1
5170,5,home,17,24,7
5170,6,<ENDS>,24,24,0
5171,0,<START>,0,0,0
5171,1,home,0,8,8
5171,2,work,8,14,6
5171,3,home,14,24,10
5171,4,<ENDS>,24,24,0
5172,0,<START>,0,0,0
5172,1,home,0,6,6
5172,2,work,6,13,7
5172,3,home,13,22,9
5172,4,work,22,23,1
5172,5,home,23,24,1
5172,6,<ENDS>,24,24,0
5173,0,<START>,0,0,0
5173,1,home,0,7,7
5173,2,education,7,11,4
5173,3,home,11,15,4
5173,4,shop,15,16,1
5173,5,home,16,24,8
5173,6,<ENDS>,24,24,0
5174,0,<START>,0,0,0
5174,1,home,0,7,7
5174,2,shop,7,8,1
5174,3,home,8,22,14
5174,4,work,22,23,1
5174,5,home,23,24,1
5174,6,<ENDS>,24,24,0
5175,0,<START>,0,0,0
5175,1,home,0,6,6
5175,2,shop,6,7,1
5175,3,work,7,13,6
5175,4,home,13,22,9
5175,5,work,22,23,1
5175,6,home,23,24,1
5175,7,<ENDS>,24,24,0
5176,0,<START>,0,0,0
5176,1,home,0,6,6
5176,2,work,6,8,2
5176,3,home,8,13,5
5176,4,work,13,15,2
5176,5,home,15,21,6
5176,6,work,21,22,1
5176,7,home,22,24,2
5176,8,<ENDS>,24,24,0
5177,0,<START>,0,0,0
5177,1,home,0,8,8
5177,2,work,8,15,7
5177,3,home,15,24,9
5177,4,<ENDS>,24,24,0
5178,0,<START>,0,0,0
5178,1,home,0,7,7
5178,2,work,7,13,6
5178,3,shop,13,14,1
5178,4,work,14,19,5
5178,5,home,19,24,5
5178,6,<ENDS>,24,24,0
5179,0,<START>,0,0,0
5179,1,home,0,7,7
5179,2,education,7,11,4
5179,3,home,11,20,9
5179,4,shop,20,21,1
5179,5,home,21,24,3
5179,6,<ENDS>,24,24,0
5180,0,<START>,0,0,0
5180,1,home,0,6,6
5180,2,shop,6,7,1
5180,3,home,7,10,3
5180,4,education,10,11,1
5180,5,home,11,17,6
5180,6,shop,17,19,2
5180,7,home,19,24,5
5180,8,<ENDS>,24,24,0
5181,0,<START>,0,0,0
5181,1,home,0,6,6
5181,2,work,6,8,2
5181,3,home,8,13,5
5181,4,work,13,15,2
5181,5,home,15,21,6
5181,6,work,21,22,1
5181,7,home,22,24,2
5181,8,<ENDS>,24,24,0
5182,0,<START>,0,0,0
5182,1,home,0,7,7
5182,2,work,7,9,2
5182,3,home,9,12,3
5182,4,work,12,13,1
5182,5,home,13,17,4
5182,6,work,17,19,2
5182,7,home,19,24,5
5182,8,<ENDS>,24,24,0
5183,0,<START>,0,0,0
5183,1,home,0,8,8
5183,2,work,8,15,7
5183,3,home,15,21,6
5183,4,work,21,22,1
5183,5,home,22,24,2
5183,6,<ENDS>,24,24,0
5184,0,<START>,0,0,0
5184,1,home,0,6,6
5184,2,work,6,13,7
5184,3,home,13,24,11
5184,4,<ENDS>,24,24,0
5185,0,<START>,0,0,0
5185,1,home,0,6,6
5185,2,work,6,8,2
5185,3,home,8,15,7
5185,4,work,15,17,2
5185,5,home,17,24,7
5185,6,<ENDS>,24,24,0
5186,0,<START>,0,0,0
5186,1,home,0,7,7
5186,2,education,7,10,3
5186,3,home,10,17,7
5186,4,shop,17,18,1
5186,5,home,18,24,6
5186,6,<ENDS>,24,24,0
5187,0,<START>,0,0,0
5187,1,home,0,8,8
5187,2,work,8,15,7
5187,3,home,15,22,7
5187,4,work,22,23,1
5187,5,home,23,24,1
5187,6,<ENDS>,24,24,0
5188,0,<START>,0,0,0
5188,1,home,0,7,7
5188,2,shop,7,8,1
5188,3,work,8,13,5
5188,4,home,13,21,8
5188,5,work,21,22,1
5188,6,home,22,24,2
5188,7,<ENDS>,24,24,0
5189,0,<START>,0,0,0
5189,1,home,0,6,6
5189,2,shop,6,7,1
5189,3,home,7,9,2
5189,4,work,9,16,7
5189,5,home,16,21,5
5189,6,work,21,22,1
5189,7,home,22,24,2
5189,8,<ENDS>,24,24,0
5190,0,<START>,0,0,0
5190,1,home,0,7,7
5190,2,work,7,13,6
5190,3,home,13,22,9
5190,4,work,22,23,1
5190,5,home,23,24,1
5190,6,<ENDS>,24,24,0
5191,0,<START>,0,0,0
5191,1,work,0,8,8
5191,2,shop,8,10,2
5191,3,work,10,15,5
5191,4,home,15,22,7
5191,5,work,22,23,1
5191,6,home,23,24,1
5191,7,<ENDS>,24,24,0
5192,0,<START>,0,0,0
5192,1,home,0,6,6
5192,2,shop,6,7,1
5192,3,home,7,9,2
5192,4,education,9,12,3
5192,5,home,12,19,7
5192,6,shop,19,20,1
5192,7,home,20,24,4
5192,8,<ENDS>,24,24,0
5193,0,<START>,0,0,0
5193,1,home,0,7,7
5193,2,work,7,13,6
5193,3,shop,13,14,1
5193,4,home,14,19,5
5193,5,shop,19,20,1
5193,6,home,20,24,4
5193,7,<ENDS>,24,24,0
5194,0,<START>,0,0,0
5194,1,home,0,6,6
5194,2,shop,6,7,1
5194,3,work,7,14,7
5194,4,home,14,24,10
5194,5,<ENDS>,24,24,0
5195,0,<START>,0,0,0
5195,1,home,0,7,7
5195,2,education,7,12,5
5195,3,shop,12,14,2
5195,4,education,14,16,2
5195,5,home,16,24,8
5195,6,<ENDS>,24,24,0
5196,0,<START>,0,0,0
5196,1,home,0,8,8
5196,2,education,8,13,5
5196,3,shop,13,15,2
5196,4,home,15,20,5
5196,5,shop,20,21,1
5196,6,home,21,24,3
5196,7,<ENDS>,24,24,0
5197,0,<START>,0,0,0
5197,1,home,0,8,8
5197,2,education,8,11,3
5197,3,home,11,14,3
5197,4,education,14,16,2
5197,5,home,16,20,4
5197,6,shop,20,21,1
5197,7,home,21,24,3
5197,8,<ENDS>,24,24,0
5198,0,<START>,0,0,0
5198,1,home,0,6,6
5198,2,work,6,7,1
5198,3,home,7,9,2
5198,4,work,9,10,1
5198,5,home,10,14,4
5198,6,work,14,17,3
5198,7,home,17,21,4
5198,8,work,21,22,1
5198,9,home,22,24,2
5198,10,<ENDS>,24,24,0
5199,0,<START>,0,0,0
5199,1,home,0,8,8
5199,2,education,8,12,4
5199,3,shop,12,14,2
5199,4,home,14,24,10
5199,5,<ENDS>,24,24,0
5200,0,<START>,0,0,0
5200,1,home,0,6,6
5200,2,shop,6,7,1
5200,3,home,7,10,3
5200,4,education,10,15,5
5200,5,shop,15,16,1
5200,6,home,16,24,8
5200,7,<ENDS>,24,24,0
5201,0,<START>,0,0,0
5201,1,home,0,8,8
5201,2,work,8,16,8
5201,3,home,16,24,8
5201,4,<ENDS>,24,24,0
5202,0,<START>,0,0,0
5202,1,home,0,8,8
5202,2,work,8,15,7
5202,3,home,15,23,8
5202,4,work,23,24,1
5202,5,<ENDS>,24,24,0
5203,0,<START>,0,0,0
5203,1,home,0,7,7
5203,2,work,7,13,6
5203,3,shop,13,14,1
5203,4,work,14,19,5
5203,5,home,19,24,5
5203,6,<ENDS>,24,24,0
5204,0,<START>,0,0,0
5204,1,home,0,8,8
5204,2,work,8,15,7
5204,3,home,15,24,9
5204,4,<ENDS>,24,24,0
5205,0,<START>,0,0,0
5205,1,home,0,8,8
5205,2,work,8,16,8
5205,3,home,16,24,8
5205,4,<ENDS>,24,24,0
5206,0,<START>,0,0,0
5206,1,home,0,7,7
5206,2,work,7,13,6
5206,3,shop,13,14,1
5206,4,home,14,24,10
5206,5,<ENDS>,24,24,0
5207,0,<START>,0,0,0
5207,1,home,0,7,7
5207,2,work,7,14,7
5207,3,home,14,21,7
5207,4,shop,21,22,1
5207,5,home,22,24,2
5207,6,<ENDS>,24,24,0
5208,0,<START>,0,0,0
5208,1,home,0,6,6
5208,2,work,6,9,3
5208,3,home,9,15,6
5208,4,work,15,17,2
5208,5,home,17,23,6
5208,6,work,23,24,1
5208,7,<ENDS>,24,24,0
5209,0,<START>,0,0,0
5209,1,home,0,7,7
5209,2,work,7,13,6
5209,3,shop,13,14,1
5209,4,home,14,24,10
5209,5,<ENDS>,24,24,0
5210,0,<START>,0,0,0
5210,1,home,0,7,7
5210,2,education,7,11,4
5210,3,home,11,17,6
5210,4,shop,17,18,1
5210,5,home,18,24,6
5210,6,<ENDS>,24,24,0
5211,0,<START>,0,0,0
5211,1,home,0,8,8
5211,2,education,8,12,4
5211,3,shop,12,13,1
5211,4,education,13,14,1
5211,5,shop,14,16,2
5211,6,home,16,24,8
5211,7,<ENDS>,24,24,0
5212,0,<START>,0,0,0
5212,1,home,0,6,6
5212,2,shop,6,7,1
5212,3,home,7,10,3
5212,4,education,10,12,2
5212,5,shop,12,14,2
5212,6,education,14,16,2
5212,7,home,16,24,8
5212,8,<ENDS>,24,24,0
5213,0,<START>,0,0,0
5213,1,home,0,6,6
5213,2,work,6,13,7
5213,3,home,13,16,3
5213,4,work,16,20,4
5213,5,home,20,24,4
5213,6,<ENDS>,24,24,0
5214,0,<START>,0,0,0
5214,1,home,0,9,9
5214,2,work,9,17,8
5214,3,home,17,24,7
5214,4,<ENDS>,24,24,0
5215,0,<START>,0,0,0
5215,1,home,0,7,7
5215,2,work,7,14,7
5215,3,home,14,24,10
5215,4,<ENDS>,24,24,0
5216,0,<START>,0,0,0
5216,1,home,0,7,7
5216,2,work,7,14,7
5216,3,home,14,22,8
5216,4,work,22,23,1
5216,5,home,23,24,1
5216,6,<ENDS>,24,24,0
5217,0,<START>,0,0,0
5217,1,home,0,6,6
5217,2,work,6,13,7
5217,3,home,13,22,9
5217,4,work,22,23,1
5217,5,home,23,24,1
5217,6,<ENDS>,24,24,0
5218,0,<START>,0,0,0
5218,1,home,0,8,8
5218,2,work,8,14,6
5218,3,home,14,22,8
5218,4,work,22,23,1
5218,5,home,23,24,1
5218,6,<ENDS>,24,24,0
5219,0,<START>,0,0,0
5219,1,home,0,7,7
5219,2,education,7,12,5
5219,3,shop,12,13,1
5219,4,education,13,16,3
5219,5,shop,16,17,1
5219,6,home,17,24,7
5219,7,<ENDS>,24,24,0
5220,0,<START>,0,0,0
5220,1,home,0,8,8
5220,2,shop,8,9,1
5220,3,home,9,13,4
5220,4,work,13,20,7
5220,5,home,20,24,4
5220,6,<ENDS>,24,24,0
5221,0,<START>,0,0,0
5221,1,home,0,7,7
5221,2,education,7,12,5
5221,3,home,12,20,8
5221,4,shop,20,21,1
5221,5,home,21,24,3
5221,6,<ENDS>,24,24,0
5222,0,<START>,0,0,0
5222,1,home,0,8,8
5222,2,education,8,11,3
5222,3,home,11,18,7
5222,4,work,18,20,2
5222,5,home,20,24,4
5222,6,<ENDS>,24,24,0
5223,0,<START>,0,0,0
5223,1,home,0,6,6
5223,2,work,6,8,2
5223,3,home,8,12,4
5223,4,work,12,14,2
5223,5,home,14,22,8
5223,6,work,22,23,1
5223,7,home,23,24,1
5223,8,<ENDS>,24,24,0
5224,0,<START>,0,0,0
5224,1,home,0,7,7
5224,2,work,7,14,7
5224,3,shop,14,15,1
5224,4,work,15,19,4
5224,5,home,19,24,5
5224,6,<ENDS>,24,24,0
5225,0,<START>,0,0,0
5225,1,home,0,8,8
5225,2,shop,8,9,1
5225,3,work,9,19,10
5225,4,home,19,23,4
5225,5,work,23,24,1
5225,6,<ENDS>,24,24,0
5226,0,<START>,0,0,0
5226,1,home,0,6,6
5226,2,shop,6,7,1
5226,3,home,7,13,6
5226,4,education,13,16,3
5226,5,shop,16,17,1
5226,6,home,17,21,4
5226,7,shop,21,22,1
5226,8,home,22,24,2
5226,9,<ENDS>,24,24,0
5227,0,<START>,0,0,0
5227,1,home,0,7,7
5227,2,work,7,13,6
5227,3,home,13,17,4
5227,4,shop,17,18,1
5227,5,home,18,24,6
5227,6,<ENDS>,24,24,0
5228,0,<START>,0,0,0
5228,1,home,0,6,6
5228,2,work,6,14,8
5228,3,home,14,20,6
5228,4,shop,20,21,1
5228,5,home,21,24,3
5228,6,<ENDS>,24,24,0
5229,0,<START>,0,0,0
5229,1,home,0,9,9
5229,2,work,9,16,7
5229,3,home,16,24,8
5229,4,<ENDS>,24,24,0
5230,0,<START>,0,0,0
5230,1,home,0,6,6
5230,2,work,6,8,2
5230,3,home,8,9,1
5230,4,work,9,10,1
5230,5,home,10,13,3
5230,6,work,13,15,2
5230,7,home,15,22,7
5230,8,work,22,23,1
5230,9,home,23,24,1
5230,10,<ENDS>,24,24,0
5231,0,<START>,0,0,0
5231,1,home,0,7,7
5231,2,work,7,13,6
5231,3,home,13,18,5
5231,4,shop,18,19,1
5231,5,home,19,24,5
5231,6,<ENDS>,24,24,0
5232,0,<START>,0,0,0
5232,1,home,0,6,6
5232,2,shop,6,7,1
5232,3,home,7,13,6
5232,4,education,13,16,3
5232,5,home,16,24,8
5232,6,<ENDS>,24,24,0
5233,0,<START>,0,0,0
5233,1,home,0,7,7
5233,2,shop,7,8,1
5233,3,education,8,11,3
5233,4,home,11,18,7
5233,5,shop,18,20,2
5233,6,home,20,24,4
5233,7,<ENDS>,24,24,0
5234,0,<START>,0,0,0
5234,1,home,0,6,6
5234,2,work,6,8,2
5234,3,home,8,14,6
5234,4,shop,14,15,1
5234,5,home,15,22,7
5234,6,work,22,23,1
5234,7,home,23,24,1
5234,8,<ENDS>,24,24,0
5235,0,<START>,0,0,0
5235,1,home,0,6,6
5235,2,shop,6,7,1
5235,3,home,7,13,6
5235,4,education,13,16,3
5235,5,home,16,24,8
5235,6,<ENDS>,24,24,0
5236,0,<START>,0,0,0
5236,1,home,0,6,6
5236,2,work,6,7,1
5236,3,home,7,9,2
5236,4,work,9,11,2
5236,5,home,11,14,3
5236,6,work,14,17,3
5236,7,home,17,21,4
5236,8,work,21,22,1
5236,9,home,22,24,2
5236,10,<ENDS>,24,24,0
5237,0,<START>,0,0,0
5237,1,home,0,6,6
5237,2,work,6,8,2
5237,3,home,8,9,1
5237,4,work,9,10,1
5237,5,home,10,16,6
5237,6,work,16,19,3
5237,7,home,19,24,5
5237,8,<ENDS>,24,24,0
5238,0,<START>,0,0,0
5238,1,home,0,8,8
5238,2,work,8,14,6
5238,3,home,14,18,4
5238,4,work,18,20,2
5238,5,home,20,24,4
5238,6,<ENDS>,24,24,0
5239,0,<START>,0,0,0
5239,1,home,0,8,8
5239,2,work,8,15,7
5239,3,home,15,21,6
5239,4,shop,21,22,1
5239,5,home,22,24,2
5239,6,<ENDS>,24,24,0
5240,0,<START>,0,0,0
5240,1,home,0,8,8
5240,2,work,8,15,7
5240,3,home,15,24,9
5240,4,<ENDS>,24,24,0
5241,0,<START>,0,0,0
5241,1,home,0,8,8
5241,2,work,8,15,7
5241,3,home,15,24,9
5241,4,<ENDS>,24,24,0
5242,0,<START>,0,0,0
5242,1,home,0,6,6
5242,2,shop,6,7,1
5242,3,home,7,9,2
5242,4,education,9,12,3
5242,5,shop,12,14,2
5242,6,home,14,24,10
5242,7,<ENDS>,24,24,0
5243,0,<START>,0,0,0
5243,1,home,0,8,8
5243,2,work,8,15,7
5243,3,home,15,24,9
5243,4,<ENDS>,24,24,0
5244,0,<START>,0,0,0
5244,1,home,0,6,6
5244,2,work,6,13,7
5244,3,shop,13,15,2
5244,4,work,15,19,4
5244,5,home,19,24,5
5244,6,<ENDS>,24,24,0
5245,0,<START>,0,0,0
5245,1,home,0,7,7
5245,2,work,7,13,6
5245,3,home,13,15,2
5245,4,work,15,20,5
5245,5,home,20,24,4
5245,6,<ENDS>,24,24,0
5246,0,<START>,0,0,0
5246,1,home,0,7,7
5246,2,work,7,13,6
5246,3,shop,13,14,1
5246,4,work,14,19,5
5246,5,home,19,24,5
5246,6,<ENDS>,24,24,0
5247,0,<START>,0,0,0
5247,1,home,0,6,6
5247,2,shop,6,7,1
5247,3,home,7,13,6
5247,4,work,13,19,6
5247,5,home,19,24,5
5247,6,<ENDS>,24,24,0
5248,0,<START>,0,0,0
5248,1,home,0,7,7
5248,2,work,7,14,7
5248,3,home,14,22,8
5248,4,work,22,23,1
5248,5,home,23,24,1
5248,6,<ENDS>,24,24,0
5249,0,<START>,0,0,0
5249,1,home,0,6,6
5249,2,work,6,12,6
5249,3,shop,12,13,1
5249,4,education,13,16,3
5249,5,home,16,21,5
5249,6,work,21,22,1
5249,7,home,22,24,2
5249,8,<ENDS>,24,24,0
5250,0,<START>,0,0,0
5250,1,home,0,6,6
5250,2,work,6,13,7
5250,3,shop,13,14,1
5250,4,work,14,19,5
5250,5,home,19,24,5
5250,6,<ENDS>,24,24,0
5251,0,<START>,0,0,0
5251,1,home,0,6,6
5251,2,work,6,13,7
5251,3,home,13,24,11
5251,4,<ENDS>,24,24,0
5252,0,<START>,0,0,0
5252,1,home,0,6,6
5252,2,work,6,12,6
5252,3,shop,12,13,1
5252,4,work,13,19,6
5252,5,home,19,24,5
5252,6,<ENDS>,24,24,0
5253,0,<START>,0,0,0
5253,1,home,0,8,8
5253,2,work,8,15,7
5253,3,shop,15,16,1
5253,4,work,16,20,4
5253,5,home,20,24,4
5253,6,<ENDS>,24,24,0
5254,0,<START>,0,0,0
5254,1,home,0,8,8
5254,2,work,8,15,7
5254,3,home,15,17,2
5254,4,work,17,20,3
5254,5,home,20,24,4
5254,6,<ENDS>,24,24,0
5255,0,<START>,0,0,0
5255,1,home,0,6,6
5255,2,work,6,13,7
5255,3,home,13,17,4
5255,4,work,17,19,2
5255,5,education,19,20,1
5255,6,home,20,24,4
5255,7,<ENDS>,24,24,0
5256,0,<START>,0,0,0
5256,1,home,0,7,7
5256,2,work,7,13,6
5256,3,shop,13,14,1
5256,4,work,14,19,5
5256,5,home,19,24,5
5256,6,<ENDS>,24,24,0
5257,0,<START>,0,0,0
5257,1,home,0,7,7
5257,2,work,7,14,7
5257,3,home,14,24,10
5257,4,<ENDS>,24,24,0
5258,0,<START>,0,0,0
5258,1,home,0,7,7
5258,2,work,7,14,7
5258,3,home,14,21,7
5258,4,shop,21,22,1
5258,5,home,22,24,2
5258,6,<ENDS>,24,24,0
5259,0,<START>,0,0,0
5259,1,work,0,7,7
5259,2,shop,7,8,1
5259,3,work,8,14,6
5259,4,home,14,24,10
5259,5,<ENDS>,24,24,0
5260,0,<START>,0,0,0
5260,1,home,0,7,7
5260,2,work,7,14,7
5260,3,shop,14,15,1
5260,4,home,15,23,8
5260,5,work,23,24,1
5260,6,<ENDS>,24,24,0
5261,0,<START>,0,0,0
5261,1,home,0,6,6
5261,2,work,6,8,2
5261,3,home,8,14,6
5261,4,work,14,16,2
5261,5,home,16,22,6
5261,6,work,22,23,1
5261,7,home,23,24,1
5261,8,<ENDS>,24,24,0
5262,0,<START>,0,0,0
5262,1,home,0,6,6
5262,2,work,6,13,7
5262,3,home,13,24,11
5262,4,<ENDS>,24,24,0
5263,0,<START>,0,0,0
5263,1,home,0,8,8
5263,2,work,8,15,7
5263,3,home,15,24,9
5263,4,<ENDS>,24,24,0
5264,0,<START>,0,0,0
5264,1,home,0,6,6
5264,2,work,6,13,7
5264,3,home,13,19,6
5264,4,shop,19,20,1
5264,5,home,20,24,4
5264,6,<ENDS>,24,24,0
5265,0,<START>,0,0,0
5265,1,home,0,7,7
5265,2,work,7,14,7
5265,3,home,14,19,5
5265,4,shop,19,20,1
5265,5,home,20,24,4
5265,6,<ENDS>,24,24,0
5266,0,<START>,0,0,0
5266,1,home,0,8,8
5266,2,work,8,15,7
5266,3,home,15,24,9
5266,4,<ENDS>,24,24,0
5267,0,<START>,0,0,0
5267,1,home,0,9,9
5267,2,education,9,15,6
5267,3,shop,15,16,1
5267,4,home,16,24,8
5267,5,<ENDS>,24,24,0
5268,0,<START>,0,0,0
5268,1,home,0,6,6
5268,2,work,6,13,7
5268,3,home,13,24,11
5268,4,<ENDS>,24,24,0
5269,0,<START>,0,0,0
5269,1,home,0,6,6
5269,2,shop,6,7,1
5269,3,home,7,9,2
5269,4,education,9,12,3
5269,5,home,12,20,8
5269,6,shop,20,21,1
5269,7,home,21,24,3
5269,8,<ENDS>,24,24,0
5270,0,<START>,0,0,0
5270,1,home,0,6,6
5270,2,work,6,13,7
5270,3,home,13,17,4
5270,4,shop,17,18,1
5270,5,home,18,24,6
5270,6,<ENDS>,24,24,0
5271,0,<START>,0,0,0
5271,1,home,0,7,7
5271,2,work,7,13,6
5271,3,shop,13,14,1
5271,4,work,14,19,5
5271,5,home,19,24,5
5271,6,<ENDS>,24,24,0
5272,0,<START>,0,0,0
5272,1,home,0,7,7
5272,2,shop,7,8,1
5272,3,education,8,11,3
5272,4,home,11,19,8
5272,5,shop,19,21,2
5272,6,home,21,24,3
5272,7,<ENDS>,24,24,0
5273,0,<START>,0,0,0
5273,1,home,0,8,8
5273,2,work,8,15,7
5273,3,shop,15,16,1
5273,4,home,16,24,8
5273,5,<ENDS>,24,24,0
5274,0,<START>,0,0,0
5274,1,home,0,8,8
5274,2,work,8,12,4
5274,3,shop,12,14,2
5274,4,work,14,20,6
5274,5,home,20,24,4
5274,6,<ENDS>,24,24,0
5275,0,<START>,0,0,0
5275,1,home,0,8,8
5275,2,work,8,17,9
5275,3,home,17,21,4
5275,4,work,21,22,1
5275,5,home,22,24,2
5275,6,<ENDS>,24,24,0
5276,0,<START>,0,0,0
5276,1,home,0,7,7
5276,2,shop,7,8,1
5276,3,home,8,21,13
5276,4,work,21,22,1
5276,5,home,22,24,2
5276,6,<ENDS>,24,24,0
5277,0,<START>,0,0,0
5277,1,home,0,6,6
5277,2,shop,6,7,1
5277,3,home,7,11,4
5277,4,work,11,18,7
5277,5,home,18,24,6
5277,6,<ENDS>,24,24,0
5278,0,<START>,0,0,0
5278,1,home,0,7,7
5278,2,education,7,11,4
5278,3,home,11,14,3
5278,4,education,14,16,2
5278,5,shop,16,18,2
5278,6,home,18,24,6
5278,7,<ENDS>,24,24,0
5279,0,<START>,0,0,0
5279,1,home,0,7,7
5279,2,work,7,9,2
5279,3,home,9,15,6
5279,4,work,15,17,2
5279,5,home,17,23,6
5279,6,work,23,24,1
5279,7,<ENDS>,24,24,0
5280,0,<START>,0,0,0
5280,1,home,0,7,7
5280,2,work,7,13,6
5280,3,home,13,24,11
5280,4,<ENDS>,24,24,0
5281,0,<START>,0,0,0
5281,1,home,0,8,8
5281,2,education,8,11,3
5281,3,home,11,18,7
5281,4,work,18,20,2
5281,5,home,20,24,4
5281,6,<ENDS>,24,24,0
5282,0,<START>,0,0,0
5282,1,home,0,6,6
5282,2,work,6,13,7
5282,3,home,13,21,8
5282,4,work,21,22,1
5282,5,home,22,24,2
5282,6,<ENDS>,24,24,0
5283,0,<START>,0,0,0
5283,1,home,0,7,7
5283,2,education,7,12,5
5283,3,shop,12,13,1
5283,4,education,13,16,3
5283,5,home,16,24,8
5283,6,<ENDS>,24,24,0
5284,0,<START>,0,0,0
5284,1,home,0,8,8
5284,2,work,8,15,7
5284,3,shop,15,16,1
5284,4,work,16,20,4
5284,5,home,20,24,4
5284,6,<ENDS>,24,24,0
5285,0,<START>,0,0,0
5285,1,home,0,8,8
5285,2,work,8,14,6
5285,3,shop,14,15,1
5285,4,home,15,24,9
5285,5,<ENDS>,24,24,0
5286,0,<START>,0,0,0
5286,1,home,0,7,7
5286,2,work,7,13,6
5286,3,shop,13,14,1
5286,4,home,14,24,10
5286,5,<ENDS>,24,24,0
5287,0,<START>,0,0,0
5287,1,home,0,8,8
5287,2,education,8,12,4
5287,3,home,12,14,2
5287,4,work,14,19,5
5287,5,home,19,23,4
5287,6,work,23,24,1
5287,7,<ENDS>,24,24,0
5288,0,<START>,0,0,0
5288,1,home,0,8,8
5288,2,shop,8,9,1
5288,3,home,9,15,6
5288,4,work,15,20,5
5288,5,home,20,24,4
5288,6,<ENDS>,24,24,0
5289,0,<START>,0,0,0
5289,1,home,0,8,8
5289,2,education,8,12,4
5289,3,home,12,18,6
5289,4,shop,18,19,1
5289,5,home,19,24,5
5289,6,<ENDS>,24,24,0
5290,0,<START>,0,0,0
5290,1,home,0,6,6
5290,2,work,6,8,2
5290,3,home,8,13,5
5290,4,work,13,15,2
5290,5,home,15,21,6
5290,6,work,21,22,1
5290,7,home,22,24,2
5290,8,<ENDS>,24,24,0
5291,0,<START>,0,0,0
5291,1,home,0,6,6
5291,2,work,6,13,7
5291,3,shop,13,14,1
5291,4,home,14,18,4
5291,5,work,18,20,2
5291,6,home,20,24,4
5291,7,<ENDS>,24,24,0
5292,0,<START>,0,0,0
5292,1,home,0,8,8
5292,2,work,8,14,6
5292,3,home,14,24,10
5292,4,<ENDS>,24,24,0
5293,0,<START>,0,0,0
5293,1,home,0,8,8
5293,2,work,8,10,2
5293,3,home,10,16,6
5293,4,work,16,18,2
5293,5,home,18,24,6
5293,6,<ENDS>,24,24,0
5294,0,<START>,0,0,0
5294,1,home,0,7,7
5294,2,work,7,14,7
5294,3,shop,14,16,2
5294,4,home,16,24,8
5294,5,<ENDS>,24,24,0
5295,0,<START>,0,0,0
5295,1,home,0,6,6
5295,2,shop,6,7,1
5295,3,home,7,10,3
5295,4,education,10,12,2
5295,5,home,12,20,8
5295,6,shop,20,21,1
5295,7,home,21,24,3
5295,8,<ENDS>,24,24,0
5296,0,<START>,0,0,0
5296,1,home,0,6,6
5296,2,shop,6,7,1
5296,3,home,7,13,6
5296,4,education,13,16,3
5296,5,shop,16,17,1
5296,6,home,17,24,7
5296,7,<ENDS>,24,24,0
5297,0,<START>,0,0,0
5297,1,work,0,9,9
5297,2,shop,9,10,1
5297,3,work,10,15,5
5297,4,home,15,23,8
5297,5,work,23,24,1
5297,6,<ENDS>,24,24,0
5298,0,<START>,0,0,0
5298,1,home,0,7,7
5298,2,work,7,14,7
5298,3,shop,14,15,1
5298,4,home,15,24,9
5298,5,<ENDS>,24,24,0
5299,0,<START>,0,0,0
5299,1,home,0,9,9
5299,2,education,9,15,6
5299,3,shop,15,16,1
5299,4,home,16,24,8
5299,5,<ENDS>,24,24,0
5300,0,<START>,0,0,0
5300,1,home,0,8,8
5300,2,work,8,14,6
5300,3,home,14,24,10
5300,4,<ENDS>,24,24,0
5301,0,<START>,0,0,0
5301,1,home,0,7,7
5301,2,work,7,10,3
5301,3,home,10,16,6
5301,4,work,16,18,2
5301,5,home,18,24,6
5301,6,<ENDS>,24,24,0
5302,0,<START>,0,0,0
5302,1,home,0,6,6
5302,2,work,6,13,7
5302,3,shop,13,14,1
5302,4,home,14,16,2
5302,5,work,16,19,3
5302,6,home,19,24,5
5302,7,<ENDS>,24,24,0
5303,0,<START>,0,0,0
5303,1,home,0,8,8
5303,2,work,8,15,7
5303,3,home,15,22,7
5303,4,work,22,23,1
5303,5,home,23,24,1
5303,6,<ENDS>,24,24,0
5304,0,<START>,0,0,0
5304,1,home,0,7,7
5304,2,shop,7,8,1
5304,3,work,8,15,7
5304,4,home,15,21,6
5304,5,work,21,22,1
5304,6,home,22,24,2
5304,7,<ENDS>,24,24,0
5305,0,<START>,0,0,0
5305,1,home,0,6,6
5305,2,work,6,13,7
5305,3,home,13,23,10
5305,4,work,23,24,1
5305,5,<ENDS>,24,24,0
5306,0,<START>,0,0,0
5306,1,home,0,8,8
5306,2,work,8,13,5
5306,3,shop,13,14,1
5306,4,home,14,23,9
5306,5,work,23,24,1
5306,6,<ENDS>,24,24,0
5307,0,<START>,0,0,0
5307,1,home,0,8,8
5307,2,work,8,14,6
5307,3,shop,14,15,1
5307,4,home,15,22,7
5307,5,work,22,23,1
5307,6,home,23,24,1
5307,7,<ENDS>,24,24,0
5308,0,<START>,0,0,0
5308,1,home,0,6,6
5308,2,shop,6,7,1
5308,3,home,7,8,1
5308,4,work,8,15,7
5308,5,shop,15,16,1
5308,6,home,16,24,8
5308,7,<ENDS>,24,24,0
5309,0,<START>,0,0,0
5309,1,home,0,7,7
5309,2,education,7,12,5
5309,3,home,12,20,8
5309,4,shop,20,21,1
5309,5,home,21,24,3
5309,6,<ENDS>,24,24,0
5310,0,<START>,0,0,0
5310,1,home,0,7,7
5310,2,education,7,12,5
5310,3,home,12,19,7
5310,4,shop,19,21,2
5310,5,home,21,24,3
5310,6,<ENDS>,24,24,0
5311,0,<START>,0,0,0
5311,1,home,0,8,8
5311,2,work,8,15,7
5311,3,home,15,24,9
5311,4,<ENDS>,24,24,0
5312,0,<START>,0,0,0
5312,1,home,0,6,6
5312,2,work,6,13,7
5312,3,shop,13,14,1
5312,4,education,14,17,3
5312,5,home,17,24,7
5312,6,<ENDS>,24,24,0
5313,0,<START>,0,0,0
5313,1,home,0,8,8
5313,2,work,8,16,8
5313,3,home,16,24,8
5313,4,<ENDS>,24,24,0
5314,0,<START>,0,0,0
5314,1,home,0,8,8
5314,2,work,8,15,7
5314,3,home,15,21,6
5314,4,work,21,22,1
5314,5,home,22,24,2
5314,6,<ENDS>,24,24,0
5315,0,<START>,0,0,0
5315,1,home,0,7,7
5315,2,work,7,13,6
5315,3,home,13,18,5
5315,4,work,18,20,2
5315,5,home,20,24,4
5315,6,<ENDS>,24,24,0
5316,0,<START>,0,0,0
5316,1,home,0,7,7
5316,2,work,7,13,6
5316,3,home,13,18,5
5316,4,work,18,20,2
5316,5,home,20,24,4
5316,6,<ENDS>,24,24,0
5317,0,<START>,0,0,0
5317,1,home,0,8,8
5317,2,work,8,15,7
5317,3,shop,15,16,1
5317,4,work,16,20,4
5317,5,home,20,24,4
5317,6,<ENDS>,24,24,0
5318,0,<START>,0,0,0
5318,1,home,0,7,7
5318,2,work,7,13,6
5318,3,shop,13,14,1
5318,4,home,14,24,10
5318,5,<ENDS>,24,24,0
5319,0,<START>,0,0,0
5319,1,home,0,7,7
5319,2,shop,7,8,1
5319,3,work,8,15,7
5319,4,home,15,24,9
5319,5,<ENDS>,24,24,0
5320,0,<START>,0,0,0
5320,1,home,0,8,8
5320,2,work,8,13,5
5320,3,shop,13,14,1
5320,4,home,14,24,10
5320,5,<ENDS>,24,24,0
5321,0,<START>,0,0,0
5321,1,home,0,8,8
5321,2,work,8,15,7
5321,3,home,15,24,9
5321,4,<ENDS>,24,24,0
5322,0,<START>,0,0,0
5322,1,home,0,6,6
5322,2,work,6,13,7
5322,3,home,13,17,4
5322,4,work,17,20,3
5322,5,home,20,24,4
5322,6,<ENDS>,24,24,0
5323,0,<START>,0,0,0
5323,1,home,0,7,7
5323,2,work,7,13,6
5323,3,shop,13,14,1
5323,4,work,14,18,4
5323,5,home,18,24,6
5323,6,<ENDS>,24,24,0
5324,0,<START>,0,0,0
5324,1,home,0,7,7
5324,2,work,7,13,6
5324,3,home,13,20,7
5324,4,shop,20,21,1
5324,5,home,21,24,3
5324,6,<ENDS>,24,24,0
5325,0,<START>,0,0,0
5325,1,home,0,7,7
5325,2,work,7,13,6
5325,3,home,13,24,11
5325,4,<ENDS>,24,24,0
5326,0,<START>,0,0,0
5326,1,home,0,7,7
5326,2,work,7,14,7
5326,3,home,14,24,10
5326,4,<ENDS>,24,24,0
5327,0,<START>,0,0,0
5327,1,home,0,6,6
5327,2,work,6,13,7
5327,3,home,13,24,11
5327,4,<ENDS>,24,24,0
5328,0,<START>,0,0,0
5328,1,home,0,8,8
5328,2,education,8,12,4
5328,3,work,12,19,7
5328,4,home,19,24,5
5328,5,<ENDS>,24,24,0
5329,0,<START>,0,0,0
5329,1,home,0,8,8
5329,2,work,8,15,7
5329,3,home,15,22,7
5329,4,work,22,23,1
5329,5,home,23,24,1
5329,6,<ENDS>,24,24,0
5330,0,<START>,0,0,0
5330,1,home,0,7,7
5330,2,shop,7,8,1
5330,3,education,8,11,3
5330,4,home,11,17,6
5330,5,shop,17,18,1
5330,6,home,18,24,6
5330,7,<ENDS>,24,24,0
5331,0,<START>,0,0,0
5331,1,home,0,8,8
5331,2,work,8,15,7
5331,3,home,15,22,7
5331,4,work,22,23,1
5331,5,home,23,24,1
5331,6,<ENDS>,24,24,0
5332,0,<START>,0,0,0
5332,1,home,0,7,7
5332,2,work,7,14,7
5332,3,home,14,22,8
5332,4,work,22,23,1
5332,5,home,23,24,1
5332,6,<ENDS>,24,24,0
5333,0,<START>,0,0,0
5333,1,home,0,8,8
5333,2,work,8,14,6
5333,3,home,14,18,4
5333,4,work,18,20,2
5333,5,home,20,24,4
5333,6,<ENDS>,24,24,0
5334,0,<START>,0,0,0
5334,1,home,0,7,7
5334,2,work,7,13,6
5334,3,home,13,18,5
5334,4,work,18,20,2
5334,5,home,20,24,4
5334,6,<ENDS>,24,24,0
5335,0,<START>,0,0,0
5335,1,home,0,7,7
5335,2,shop,7,8,1
5335,3,work,8,15,7
5335,4,home,15,24,9
5335,5,<ENDS>,24,24,0
5336,0,<START>,0,0,0
5336,1,home,0,7,7
5336,2,shop,7,8,1
5336,3,work,8,13,5
5336,4,home,13,18,5
5336,5,work,18,20,2
5336,6,home,20,24,4
5336,7,<ENDS>,24,24,0
5337,0,<START>,0,0,0
5337,1,home,0,6,6
5337,2,work,6,8,2
5337,3,home,8,12,4
5337,4,work,12,14,2
5337,5,home,14,21,7
5337,6,work,21,22,1
5337,7,home,22,24,2
5337,8,<ENDS>,24,24,0
5338,0,<START>,0,0,0
5338,1,home,0,7,7
5338,2,education,7,11,4
5338,3,home,11,24,13
5338,4,<ENDS>,24,24,0
5339,0,<START>,0,0,0
5339,1,home,0,7,7
5339,2,education,7,12,5
5339,3,home,12,20,8
5339,4,shop,20,21,1
5339,5,home,21,24,3
5339,6,<ENDS>,24,24,0
5340,0,<START>,0,0,0
5340,1,home,0,7,7
5340,2,work,7,13,6
5340,3,shop,13,14,1
5340,4,work,14,19,5
5340,5,home,19,24,5
5340,6,<ENDS>,24,24,0
5341,0,<START>,0,0,0
5341,1,home,0,6,6
5341,2,shop,6,7,1
5341,3,home,7,13,6
5341,4,education,13,15,2
5341,5,home,15,22,7
5341,6,work,22,23,1
5341,7,home,23,24,1
5341,8,<ENDS>,24,24,0
5342,0,<START>,0,0,0
5342,1,home,0,7,7
5342,2,education,7,11,4
5342,3,home,11,14,3
5342,4,education,14,16,2
5342,5,shop,16,18,2
5342,6,home,18,24,6
5342,7,<ENDS>,24,24,0
5343,0,<START>,0,0,0
5343,1,home,0,8,8
5343,2,work,8,16,8
5343,3,home,16,21,5
5343,4,work,21,22,1
5343,5,home,22,24,2
5343,6,<ENDS>,24,24,0
5344,0,<START>,0,0,0
5344,1,home,0,7,7
5344,2,work,7,13,6
5344,3,home,13,22,9
5344,4,work,22,23,1
5344,5,home,23,24,1
5344,6,<ENDS>,24,24,0
5345,0,<START>,0,0,0
5345,1,home,0,7,7
5345,2,education,7,12,5
5345,3,shop,12,14,2
5345,4,home,14,18,4
5345,5,shop,18,19,1
5345,6,home,19,24,5
5345,7,<ENDS>,24,24,0
5346,0,<START>,0,0,0
5346,1,home,0,6,6
5346,2,shop,6,7,1
5346,3,home,7,11,4
5346,4,work,11,18,7
5346,5,home,18,22,4
5346,6,work,22,23,1
5346,7,home,23,24,1
5346,8,<ENDS>,24,24,0
5347,0,<START>,0,0,0
5347,1,home,0,7,7
5347,2,work,7,14,7
5347,3,home,14,24,10
5347,4,<ENDS>,24,24,0
5348,0,<START>,0,0,0
5348,1,home,0,8,8
5348,2,work,8,14,6
5348,3,shop,14,15,1
5348,4,home,15,24,9
5348,5,<ENDS>,24,24,0
5349,0,<START>,0,0,0
5349,1,home,0,8,8
5349,2,education,8,12,4
5349,3,work,12,19,7
5349,4,home,19,24,5
5349,5,<ENDS>,24,24,0
5350,0,<START>,0,0,0
5350,1,home,0,7,7
5350,2,work,7,13,6
5350,3,shop,13,14,1
5350,4,home,14,21,7
5350,5,work,21,22,1
5350,6,home,22,24,2
5350,7,<ENDS>,24,24,0
5351,0,<START>,0,0,0
5351,1,home,0,7,7
5351,2,work,7,14,7
5351,3,shop,14,15,1
5351,4,work,15,19,4
5351,5,home,19,24,5
5351,6,<ENDS>,24,24,0
5352,0,<START>,0,0,0
5352,1,home,0,7,7
5352,2,work,7,14,7
5352,3,shop,14,15,1
5352,4,home,15,16,1
5352,5,work,16,19,3
5352,6,home,19,24,5
5352,7,<ENDS>,24,24,0
5353,0,<START>,0,0,0
5353,1,home,0,6,6
5353,2,work,6,13,7
5353,3,home,13,24,11
5353,4,<ENDS>,24,24,0
5354,0,<START>,0,0,0
5354,1,home,0,6,6
5354,2,work,6,13,7
5354,3,home,13,18,5
5354,4,shop,18,19,1
5354,5,home,19,24,5
5354,6,<ENDS>,24,24,0
5355,0,<START>,0,0,0
5355,1,home,0,7,7
5355,2,work,7,14,7
5355,3,home,14,24,10
5355,4,<ENDS>,24,24,0
5356,0,<START>,0,0,0
5356,1,home,0,7,7
5356,2,work,7,13,6
5356,3,home,13,17,4
5356,4,work,17,20,3
5356,5,home,20,24,4
5356,6,<ENDS>,24,24,0
5357,0,<START>,0,0,0
5357,1,home,0,7,7
5357,2,work,7,14,7
5357,3,home,14,24,10
5357,4,<ENDS>,24,24,0
5358,0,<START>,0,0,0
5358,1,home,0,7,7
5358,2,shop,7,8,1
5358,3,work,8,15,7
5358,4,home,15,23,8
5358,5,work,23,24,1
5358,6,<ENDS>,24,24,0
5359,0,<START>,0,0,0
5359,1,home,0,8,8
5359,2,work,8,15,7
5359,3,home,15,18,3
5359,4,shop,18,19,1
5359,5,home,19,24,5
5359,6,<ENDS>,24,24,0
5360,0,<START>,0,0,0
5360,1,home,0,7,7
5360,2,work,7,14,7
5360,3,home,14,23,9
5360,4,work,23,24,1
5360,5,<ENDS>,24,24,0
5361,0,<START>,0,0,0
5361,1,home,0,8,8
5361,2,shop,8,10,2
5361,3,work,10,17,7
5361,4,home,17,24,7
5361,5,<ENDS>,24,24,0
5362,0,<START>,0,0,0
5362,1,home,0,8,8
5362,2,shop,8,9,1
5362,3,work,9,16,7
5362,4,home,16,24,8
5362,5,<ENDS>,24,24,0
5363,0,<START>,0,0,0
5363,1,home,0,8,8
5363,2,work,8,14,6
5363,3,home,14,24,10
5363,4,<ENDS>,24,24,0
5364,0,<START>,0,0,0
5364,1,home,0,8,8
5364,2,work,8,15,7
5364,3,shop,15,16,1
5364,4,work,16,18,2
5364,5,home,18,24,6
5364,6,<ENDS>,24,24,0
5365,0,<START>,0,0,0
5365,1,home,0,7,7
5365,2,work,7,14,7
5365,3,home,14,18,4
5365,4,shop,18,19,1
5365,5,home,19,24,5
5365,6,<ENDS>,24,24,0
5366,0,<START>,0,0,0
5366,1,home,0,8,8
5366,2,work,8,16,8
5366,3,home,16,24,8
5366,4,<ENDS>,24,24,0
5367,0,<START>,0,0,0
5367,1,home,0,8,8
5367,2,work,8,15,7
5367,3,home,15,24,9
5367,4,<ENDS>,24,24,0
5368,0,<START>,0,0,0
5368,1,home,0,7,7
5368,2,shop,7,8,1
5368,3,education,8,11,3
5368,4,home,11,18,7
5368,5,shop,18,19,1
5368,6,home,19,24,5
5368,7,<ENDS>,24,24,0
5369,0,<START>,0,0,0
5369,1,home,0,8,8
5369,2,education,8,11,3
5369,3,home,11,14,3
5369,4,education,14,16,2
5369,5,shop,16,18,2
5369,6,home,18,24,6
5369,7,<ENDS>,24,24,0
5370,0,<START>,0,0,0
5370,1,home,0,8,8
5370,2,work,8,15,7
5370,3,home,15,24,9
5370,4,<ENDS>,24,24,0
5371,0,<START>,0,0,0
5371,1,home,0,7,7
5371,2,work,7,13,6
5371,3,home,13,21,8
5371,4,shop,21,22,1
5371,5,home,22,24,2
5371,6,<ENDS>,24,24,0
5372,0,<START>,0,0,0
5372,1,home,0,7,7
5372,2,work,7,13,6
5372,3,home,13,24,11
5372,4,<ENDS>,24,24,0
5373,0,<START>,0,0,0
5373,1,home,0,6,6
5373,2,shop,6,7,1
5373,3,home,7,12,5
5373,4,work,12,19,7
5373,5,home,19,24,5
5373,6,<ENDS>,24,24,0
5374,0,<START>,0,0,0
5374,1,home,0,8,8
5374,2,work,8,15,7
5374,3,home,15,20,5
5374,4,shop,20,21,1
5374,5,home,21,24,3
5374,6,<ENDS>,24,24,0
5375,0,<START>,0,0,0
5375,1,home,0,6,6
5375,2,work,6,13,7
5375,3,shop,13,14,1
5375,4,work,14,18,4
5375,5,education,18,20,2
5375,6,work,20,21,1
5375,7,home,21,24,3
5375,8,<ENDS>,24,24,0
5376,0,<START>,0,0,0
5376,1,home,0,8,8
5376,2,work,8,15,7
5376,3,home,15,24,9
5376,4,<ENDS>,24,24,0
5377,0,<START>,0,0,0
5377,1,home,0,7,7
5377,2,work,7,14,7
5377,3,home,14,18,4
5377,4,work,18,20,2
5377,5,home,20,24,4
5377,6,<ENDS>,24,24,0
5378,0,<START>,0,0,0
5378,1,home,0,7,7
5378,2,work,7,14,7
5378,3,home,14,21,7
5378,4,shop,21,22,1
5378,5,home,22,24,2
5378,6,<ENDS>,24,24,0
5379,0,<START>,0,0,0
5379,1,home,0,8,8
5379,2,work,8,16,8
5379,3,shop,16,17,1
5379,4,home,17,24,7
5379,5,<ENDS>,24,24,0
5380,0,<START>,0,0,0
5380,1,home,0,8,8
5380,2,work,8,15,7
5380,3,home,15,21,6
5380,4,work,21,22,1
5380,5,home,22,24,2
5380,6,<ENDS>,24,24,0
5381,0,<START>,0,0,0
5381,1,home,0,6,6
5381,2,shop,6,7,1
5381,3,work,7,9,2
5381,4,home,9,13,4
5381,5,work,13,15,2
5381,6,home,15,23,8
5381,7,work,23,24,1
5381,8,<ENDS>,24,24,0
5382,0,<START>,0,0,0
5382,1,home,0,6,6
5382,2,work,6,7,1
5382,3,home,7,12,5
5382,4,work,12,14,2
5382,5,shop,14,15,1
5382,6,home,15,22,7
5382,7,work,22,23,1
5382,8,home,23,24,1
5382,9,<ENDS>,24,24,0
5383,0,<START>,0,0,0
5383,1,home,0,7,7
5383,2,work,7,13,6
5383,3,shop,13,14,1
5383,4,work,14,19,5
5383,5,home,19,24,5
5383,6,<ENDS>,24,24,0
5384,0,<START>,0,0,0
5384,1,home,0,6,6
5384,2,shop,6,7,1
5384,3,home,7,9,2
5384,4,education,9,12,3
5384,5,shop,12,14,2
5384,6,home,14,24,10
5384,7,<ENDS>,24,24,0
5385,0,<START>,0,0,0
5385,1,home,0,8,8
5385,2,shop,8,9,1
5385,3,work,9,16,7
5385,4,shop,16,18,2
5385,5,home,18,24,6
5385,6,<ENDS>,24,24,0
5386,0,<START>,0,0,0
5386,1,home,0,6,6
5386,2,work,6,14,8
5386,3,shop,14,16,2
5386,4,home,16,23,7
5386,5,work,23,24,1
5386,6,<ENDS>,24,24,0
5387,0,<START>,0,0,0
5387,1,home,0,8,8
5387,2,shop,8,9,1
5387,3,home,9,13,4
5387,4,work,13,20,7
5387,5,home,20,24,4
5387,6,<ENDS>,24,24,0
5388,0,<START>,0,0,0
5388,1,home,0,7,7
5388,2,work,7,14,7
5388,3,home,14,21,7
5388,4,shop,21,22,1
5388,5,home,22,24,2
5388,6,<ENDS>,24,24,0
5389,0,<START>,0,0,0
5389,1,home,0,7,7
5389,2,work,7,13,6
5389,3,home,13,23,10
5389,4,work,23,24,1
5389,5,<ENDS>,24,24,0
5390,0,<START>,0,0,0
5390,1,home,0,7,7
5390,2,shop,7,9,2
5390,3,work,9,16,7
5390,4,home,16,24,8
5390,5,<ENDS>,24,24,0
5391,0,<START>,0,0,0
5391,1,home,0,8,8
5391,2,work,8,16,8
5391,3,home,16,24,8
5391,4,<ENDS>,24,24,0
5392,0,<START>,0,0,0
5392,1,home,0,7,7
5392,2,shop,7,8,1
5392,3,home,8,13,5
5392,4,education,13,17,4
5392,5,home,17,21,4
5392,6,work,21,22,1
5392,7,home,22,24,2
5392,8,<ENDS>,24,24,0
5393,0,<START>,0,0,0
5393,1,home,0,8,8
5393,2,work,8,15,7
5393,3,home,15,24,9
5393,4,<ENDS>,24,24,0
5394,0,<START>,0,0,0
5394,1,home,0,6,6
5394,2,shop,6,7,1
5394,3,home,7,10,3
5394,4,work,10,17,7
5394,5,home,17,24,7
5394,6,<ENDS>,24,24,0
5395,0,<START>,0,0,0
5395,1,home,0,8,8
5395,2,work,8,15,7
5395,3,home,15,24,9
5395,4,<ENDS>,24,24,0
5396,0,<START>,0,0,0
5396,1,home,0,7,7
5396,2,shop,7,8,1
5396,3,home,8,12,4
5396,4,work,12,19,7
5396,5,home,19,24,5
5396,6,<ENDS>,24,24,0
5397,0,<START>,0,0,0
5397,1,home,0,8,8
5397,2,work,8,15,7
5397,3,home,15,24,9
5397,4,<ENDS>,24,24,0
5398,0,<START>,0,0,0
5398,1,home,0,8,8
5398,2,education,8,12,4
5398,3,home,12,20,8
5398,4,shop,20,21,1
5398,5,home,21,24,3
5398,6,<ENDS>,24,24,0
5399,0,<START>,0,0,0
5399,1,home,0,7,7
5399,2,work,7,13,6
5399,3,shop,13,14,1
5399,4,work,14,20,6
5399,5,home,20,24,4
5399,6,<ENDS>,24,24,0
5400,0,<START>,0,0,0
5400,1,home,0,8,8
5400,2,work,8,15,7
5400,3,home,15,22,7
5400,4,work,22,23,1
5400,5,home,23,24,1
5400,6,<ENDS>,24,24,0
5401,0,<START>,0,0,0
5401,1,home,0,6,6
5401,2,shop,6,7,1
5401,3,home,7,10,3
5401,4,education,10,12,2
5401,5,shop,12,14,2
5401,6,education,14,16,2
5401,7,home,16,24,8
5401,8,<ENDS>,24,24,0
5402,0,<START>,0,0,0
5402,1,home,0,7,7
5402,2,education,7,11,4
5402,3,home,11,14,3
5402,4,education,14,15,1
5402,5,shop,15,17,2
5402,6,home,17,24,7
5402,7,<ENDS>,24,24,0
5403,0,<START>,0,0,0
5403,1,home,0,8,8
5403,2,work,8,14,6
5403,3,shop,14,15,1
5403,4,home,15,22,7
5403,5,work,22,23,1
5403,6,home,23,24,1
5403,7,<ENDS>,24,24,0
5404,0,<START>,0,0,0
5404,1,home,0,8,8
5404,2,work,8,13,5
5404,3,home,13,18,5
5404,4,shop,18,19,1
5404,5,home,19,24,5
5404,6,<ENDS>,24,24,0
5405,0,<START>,0,0,0
5405,1,home,0,8,8
5405,2,work,8,15,7
5405,3,shop,15,16,1
5405,4,home,16,24,8
5405,5,<ENDS>,24,24,0
5406,0,<START>,0,0,0
5406,1,home,0,6,6
5406,2,work,6,12,6
5406,3,shop,12,13,1
5406,4,work,13,19,6
5406,5,home,19,24,5
5406,6,<ENDS>,24,24,0
5407,0,<START>,0,0,0
5407,1,home,0,6,6
5407,2,work,6,8,2
5407,3,home,8,9,1
5407,4,work,9,11,2
5407,5,home,11,16,5
5407,6,work,16,18,2
5407,7,home,18,24,6
5407,8,<ENDS>,24,24,0
5408,0,<START>,0,0,0
5408,1,home,0,7,7
5408,2,work,7,13,6
5408,3,shop,13,14,1
5408,4,work,14,19,5
5408,5,education,19,20,1
5408,6,home,20,24,4
5408,7,<ENDS>,24,24,0
5409,0,<START>,0,0,0
5409,1,home,0,6,6
5409,2,work,6,8,2
5409,3,home,8,11,3
5409,4,work,11,13,2
5409,5,home,13,17,4
5409,6,work,17,19,2
5409,7,home,19,24,5
5409,8,<ENDS>,24,24,0
5410,0,<START>,0,0,0
5410,1,home,0,8,8
5410,2,education,8,11,3
5410,3,home,11,18,7
5410,4,shop,18,19,1
5410,5,home,19,24,5
5410,6,<ENDS>,24,24,0
5411,0,<START>,0,0,0
5411,1,home,0,8,8
5411,2,work,8,16,8
5411,3,home,16,24,8
5411,4,<ENDS>,24,24,0
5412,0,<START>,0,0,0
5412,1,home,0,6,6
5412,2,work,6,13,7
5412,3,shop,13,14,1
5412,4,work,14,19,5
5412,5,education,19,20,1
5412,6,home,20,24,4
5412,7,<ENDS>,24,24,0
5413,0,<START>,0,0,0
5413,1,home,0,7,7
5413,2,work,7,13,6
5413,3,shop,13,14,1
5413,4,work,14,19,5
5413,5,home,19,24,5
5413,6,<ENDS>,24,24,0
5414,0,<START>,0,0,0
5414,1,home,0,7,7
5414,2,shop,7,8,1
5414,3,education,8,11,3
5414,4,home,11,20,9
5414,5,shop,20,21,1
5414,6,home,21,24,3
5414,7,<ENDS>,24,24,0
5415,0,<START>,0,0,0
5415,1,home,0,6,6
5415,2,work,6,13,7
5415,3,home,13,24,11
5415,4,<ENDS>,24,24,0
5416,0,<START>,0,0,0
5416,1,home,0,7,7
5416,2,work,7,14,7
5416,3,home,14,19,5
5416,4,shop,19,20,1
5416,5,home,20,24,4
5416,6,<ENDS>,24,24,0
5417,0,<START>,0,0,0
5417,1,home,0,7,7
5417,2,work,7,13,6
5417,3,home,13,24,11
5417,4,<ENDS>,24,24,0
5418,0,<START>,0,0,0
5418,1,home,0,6,6
5418,2,shop,6,7,1
5418,3,home,7,9,2
5418,4,work,9,16,7
5418,5,home,16,24,8
5418,6,<ENDS>,24,24,0
5419,0,<START>,0,0,0
5419,1,home,0,9,9
5419,2,education,9,11,2
5419,3,home,11,15,4
5419,4,work,15,20,5
5419,5,home,20,24,4
5419,6,<ENDS>,24,24,0
5420,0,<START>,0,0,0
5420,1,home,0,6,6
5420,2,work,6,13,7
5420,3,home,13,16,3
5420,4,shop,16,17,1
5420,5,home,17,24,7
5420,6,<ENDS>,24,24,0
5421,0,<START>,0,0,0
5421,1,home,0,7,7
5421,2,shop,7,8,1
5421,3,work,8,14,6
5421,4,shop,14,15,1
5421,5,home,15,24,9
5421,6,<ENDS>,24,24,0
5422,0,<START>,0,0,0
5422,1,home,0,7,7
5422,2,work,7,14,7
5422,3,home,14,18,4
5422,4,work,18,20,2
5422,5,home,20,24,4
5422,6,<ENDS>,24,24,0
5423,0,<START>,0,0,0
5423,1,home,0,9,9
5423,2,work,9,15,6
5423,3,home,15,24,9
5423,4,<ENDS>,24,24,0
5424,0,<START>,0,0,0
5424,1,home,0,7,7
5424,2,education,7,11,4
5424,3,home,11,14,3
5424,4,education,14,15,1
5424,5,shop,15,16,1
5424,6,home,16,24,8
5424,7,<ENDS>,24,24,0
5425,0,<START>,0,0,0
5425,1,home,0,6,6
5425,2,work,6,13,7
5425,3,shop,13,14,1
5425,4,home,14,23,9
5425,5,work,23,24,1
5425,6,<ENDS>,24,24,0
5426,0,<START>,0,0,0
5426,1,home,0,7,7
5426,2,work,7,13,6
5426,3,shop,13,14,1
5426,4,work,14,19,5
5426,5,home,19,24,5
5426,6,<ENDS>,24,24,0
5427,0,<START>,0,0,0
5427,1,home,0,7,7
5427,2,shop,7,8,1
5427,3,home,8,9,1
5427,4,work,9,16,7
5427,5,home,16,24,8
5427,6,<ENDS>,24,24,0
5428,0,<START>,0,0,0
5428,1,home,0,7,7
5428,2,work,7,13,6
5428,3,home,13,24,11
5428,4,<ENDS>,24,24,0
5429,0,<START>,0,0,0
5429,1,home,0,7,7
5429,2,work,7,13,6
5429,3,shop,13,14,1
5429,4,home,14,24,10
5429,5,<ENDS>,24,24,0
5430,0,<START>,0,0,0
5430,1,home,0,6,6
5430,2,shop,6,8,2
5430,3,work,8,14,6
5430,4,shop,14,15,1
5430,5,home,15,22,7
5430,6,work,22,23,1
5430,7,home,23,24,1
5430,8,<ENDS>,24,24,0
5431,0,<START>,0,0,0
5431,1,home,0,7,7
5431,2,work,7,14,7
5431,3,home,14,24,10
5431,4,<ENDS>,24,24,0
5432,0,<START>,0,0,0
5432,1,home,0,6,6
5432,2,work,6,7,1
5432,3,home,7,14,7
5432,4,work,14,16,2
5432,5,home,16,23,7
5432,6,work,23,24,1
5432,7,<ENDS>,24,24,0
5433,0,<START>,0,0,0
5433,1,home,0,8,8
5433,2,work,8,15,7
5433,3,shop,15,16,1
5433,4,home,16,23,7
5433,5,work,23,24,1
5433,6,<ENDS>,24,24,0
5434,0,<START>,0,0,0
5434,1,home,0,7,7
5434,2,education,7,11,4
5434,3,home,11,14,3
5434,4,education,14,16,2
5434,5,home,16,24,8
5434,6,<ENDS>,24,24,0
5435,0,<START>,0,0,0
5435,1,home,0,7,7
5435,2,work,7,9,2
5435,3,home,9,13,4
5435,4,work,13,15,2
5435,5,home,15,22,7
5435,6,work,22,23,1
5435,7,home,23,24,1
5435,8,<ENDS>,24,24,0
5436,0,<START>,0,0,0
5436,1,home,0,6,6
5436,2,work,6,8,2
5436,3,home,8,11,3
5436,4,work,11,13,2
5436,5,home,13,16,3
5436,6,work,16,18,2
5436,7,home,18,24,6
5436,8,<ENDS>,24,24,0
5437,0,<START>,0,0,0
5437,1,home,0,6,6
5437,2,work,6,8,2
5437,3,home,8,14,6
5437,4,work,14,17,3
5437,5,home,17,21,4
5437,6,work,21,22,1
5437,7,home,22,24,2
5437,8,<ENDS>,24,24,0
5438,0,<START>,0,0,0
5438,1,home,0,6,6
5438,2,work,6,8,2
5438,3,home,8,13,5
5438,4,work,13,15,2
5438,5,home,15,21,6
5438,6,work,21,22,1
5438,7,home,22,24,2
5438,8,<ENDS>,24,24,0
5439,0,<START>,0,0,0
5439,1,home,0,6,6
5439,2,shop,6,7,1
5439,3,home,7,13,6
5439,4,education,13,16,3
5439,5,home,16,24,8
5439,6,<ENDS>,24,24,0
5440,0,<START>,0,0,0
5440,1,home,0,7,7
5440,2,education,7,12,5
5440,3,home,12,19,7
5440,4,shop,19,20,1
5440,5,home,20,24,4
5440,6,<ENDS>,24,24,0
5441,0,<START>,0,0,0
5441,1,home,0,8,8
5441,2,work,8,15,7
5441,3,home,15,24,9
5441,4,<ENDS>,24,24,0
5442,0,<START>,0,0,0
5442,1,home,0,6,6
5442,2,work,6,13,7
5442,3,shop,13,14,1
5442,4,home,14,24,10
5442,5,<ENDS>,24,24,0
5443,0,<START>,0,0,0
5443,1,home,0,8,8
5443,2,work,8,15,7
5443,3,home,15,24,9
5443,4,<ENDS>,24,24,0
5444,0,<START>,0,0,0
5444,1,home,0,8,8
5444,2,work,8,15,7
5444,3,home,15,24,9
5444,4,<ENDS>,24,24,0
5445,0,<START>,0,0,0
5445,1,home,0,7,7
5445,2,work,7,13,6
5445,3,shop,13,14,1
5445,4,work,14,19,5
5445,5,education,19,20,1
5445,6,home,20,24,4
5445,7,<ENDS>,24,24,0
5446,0,<START>,0,0,0
5446,1,home,0,6,6
5446,2,work,6,13,7
5446,3,shop,13,14,1
5446,4,work,14,20,6
5446,5,home,20,24,4
5446,6,<ENDS>,24,24,0
5447,0,<START>,0,0,0
5447,1,home,0,7,7
5447,2,work,7,13,6
5447,3,shop,13,14,1
5447,4,home,14,24,10
5447,5,<ENDS>,24,24,0
5448,0,<START>,0,0,0
5448,1,home,0,8,8
5448,2,work,8,15,7
5448,3,home,15,24,9
5448,4,<ENDS>,24,24,0
5449,0,<START>,0,0,0
5449,1,home,0,7,7
5449,2,shop,7,8,1
5449,3,home,8,9,1
5449,4,work,9,17,8
5449,5,home,17,24,7
5449,6,<ENDS>,24,24,0
5450,0,<START>,0,0,0
5450,1,home,0,6,6
5450,2,work,6,13,7
5450,3,home,13,17,4
5450,4,work,17,19,2
5450,5,home,19,24,5
5450,6,<ENDS>,24,24,0
5451,0,<START>,0,0,0
5451,1,home,0,6,6
5451,2,work,6,8,2
5451,3,home,8,12,4
5451,4,work,12,13,1
5451,5,home,13,21,8
5451,6,work,21,22,1
5451,7,home,22,24,2
5451,8,<ENDS>,24,24,0
5452,0,<START>,0,0,0
5452,1,home,0,7,7
5452,2,work,7,14,7
5452,3,home,14,23,9
5452,4,work,23,24,1
5452,5,<ENDS>,24,24,0
5453,0,<START>,0,0,0
5453,1,home,0,9,9
5453,2,education,9,12,3
5453,3,home,12,21,9
5453,4,work,21,22,1
5453,5,home,22,24,2
5453,6,<ENDS>,24,24,0
5454,0,<START>,0,0,0
5454,1,home,0,8,8
5454,2,education,8,11,3
5454,3,home,11,23,12
5454,4,work,23,24,1
5454,5,<ENDS>,24,24,0
5455,0,<START>,0,0,0
5455,1,home,0,7,7
5455,2,education,7,12,5
5455,3,home,12,20,8
5455,4,shop,20,21,1
5455,5,home,21,24,3
5455,6,<ENDS>,24,24,0
5456,0,<START>,0,0,0
5456,1,home,0,6,6
5456,2,work,6,8,2
5456,3,home,8,12,4
5456,4,work,12,14,2
5456,5,home,14,21,7
5456,6,work,21,22,1
5456,7,home,22,24,2
5456,8,<ENDS>,24,24,0
5457,0,<START>,0,0,0
5457,1,home,0,8,8
5457,2,work,8,14,6
5457,3,shop,14,16,2
5457,4,home,16,24,8
5457,5,<ENDS>,24,24,0
5458,0,<START>,0,0,0
5458,1,home,0,8,8
5458,2,shop,8,9,1
5458,3,home,9,14,5
5458,4,work,14,20,6
5458,5,home,20,24,4
5458,6,<ENDS>,24,24,0
5459,0,<START>,0,0,0
5459,1,home,0,7,7
5459,2,shop,7,8,1
5459,3,work,8,15,7
5459,4,home,15,24,9
5459,5,<ENDS>,24,24,0
5460,0,<START>,0,0,0
5460,1,home,0,7,7
5460,2,work,7,13,6
5460,3,home,13,17,4
5460,4,work,17,19,2
5460,5,home,19,24,5
5460,6,<ENDS>,24,24,0
5461,0,<START>,0,0,0
5461,1,home,0,7,7
5461,2,shop,7,8,1
5461,3,work,8,17,9
5461,4,home,17,24,7
5461,5,<ENDS>,24,24,0
5462,0,<START>,0,0,0
5462,1,home,0,8,8
5462,2,work,8,14,6
5462,3,home,14,24,10
5462,4,<ENDS>,24,24,0
5463,0,<START>,0,0,0
5463,1,home,0,6,6
5463,2,shop,6,7,1
5463,3,home,7,13,6
5463,4,education,13,16,3
5463,5,shop,16,17,1
5463,6,home,17,21,4
5463,7,shop,21,22,1
5463,8,home,22,24,2
5463,9,<ENDS>,24,24,0
5464,0,<START>,0,0,0
5464,1,home,0,6,6
5464,2,work,6,13,7
5464,3,home,13,17,4
5464,4,work,17,20,3
5464,5,home,20,24,4
5464,6,<ENDS>,24,24,0
5465,0,<START>,0,0,0
5465,1,home,0,8,8
5465,2,education,8,11,3
5465,3,home,11,21,10
5465,4,work,21,22,1
5465,5,home,22,24,2
5465,6,<ENDS>,24,24,0
5466,0,<START>,0,0,0
5466,1,home,0,7,7
5466,2,work,7,13,6
5466,3,home,13,18,5
5466,4,work,18,20,2
5466,5,home,20,24,4
5466,6,<ENDS>,24,24,0
5467,0,<START>,0,0,0
5467,1,home,0,6,6
5467,2,shop,6,7,1
5467,3,home,7,9,2
5467,4,education,9,12,3
5467,5,home,12,16,4
5467,6,shop,16,18,2
5467,7,home,18,24,6
5467,8,<ENDS>,24,24,0
5468,0,<START>,0,0,0
5468,1,home,0,7,7
5468,2,shop,7,8,1
5468,3,education,8,11,3
5468,4,home,11,18,7
5468,5,shop,18,20,2
5468,6,home,20,24,4
5468,7,<ENDS>,24,24,0
5469,0,<START>,0,0,0
5469,1,home,0,7,7
5469,2,work,7,13,6
5469,3,home,13,17,4
5469,4,work,17,20,3
5469,5,home,20,24,4
5469,6,<ENDS>,24,24,0
5470,0,<START>,0,0,0
5470,1,home,0,7,7
5470,2,work,7,14,7
5470,3,home,14,24,10
5470,4,<ENDS>,24,24,0
5471,0,<START>,0,0,0
5471,1,home,0,9,9
5471,2,work,9,17,8
5471,3,home,17,24,7
5471,4,<ENDS>,24,24,0
5472,0,<START>,0,0,0
5472,1,home,0,7,7
5472,2,education,7,11,4
5472,3,home,11,17,6
5472,4,shop,17,18,1
5472,5,home,18,24,6
5472,6,<ENDS>,24,24,0
5473,0,<START>,0,0,0
5473,1,home,0,8,8
5473,2,work,8,15,7
5473,3,shop,15,16,1
5473,4,home,16,23,7
5473,5,work,23,24,1
5473,6,<ENDS>,24,24,0
5474,0,<START>,0,0,0
5474,1,home,0,7,7
5474,2,work,7,13,6
5474,3,shop,13,14,1
5474,4,home,14,21,7
5474,5,work,21,22,1
5474,6,home,22,24,2
5474,7,<ENDS>,24,24,0
5475,0,<START>,0,0,0
5475,1,home,0,6,6
5475,2,shop,6,7,1
5475,3,home,7,13,6
5475,4,education,13,16,3
5475,5,home,16,24,8
5475,6,<ENDS>,24,24,0
5476,0,<START>,0,0,0
5476,1,home,0,6,6
5476,2,work,6,13,7
5476,3,home,13,24,11
5476,4,<ENDS>,24,24,0
5477,0,<START>,0,0,0
5477,1,home,0,7,7
5477,2,education,7,11,4
5477,3,home,11,13,2
5477,4,education,13,16,3
5477,5,home,16,24,8
5477,6,<ENDS>,24,24,0
5478,0,<START>,0,0,0
5478,1,home,0,7,7
5478,2,work,7,14,7
5478,3,home,14,24,10
5478,4,<ENDS>,24,24,0
5479,0,<START>,0,0,0
5479,1,home,0,8,8
5479,2,work,8,11,3
5479,3,home,11,15,4
5479,4,work,15,18,3
5479,5,home,18,24,6
5479,6,<ENDS>,24,24,0
5480,0,<START>,0,0,0
5480,1,home,0,7,7
5480,2,work,7,13,6
5480,3,shop,13,14,1
5480,4,home,14,23,9
5480,5,work,23,24,1
5480,6,<ENDS>,24,24,0
5481,0,<START>,0,0,0
5481,1,home,0,6,6
5481,2,work,6,13,7
5481,3,home,13,21,8
5481,4,work,21,22,1
5481,5,home,22,24,2
5481,6,<ENDS>,24,24,0
5482,0,<START>,0,0,0
5482,1,home,0,7,7
5482,2,education,7,11,4
5482,3,home,11,18,7
5482,4,shop,18,19,1
5482,5,home,19,24,5
5482,6,<ENDS>,24,24,0
5483,0,<START>,0,0,0
5483,1,home,0,6,6
5483,2,shop,6,7,1
5483,3,home,7,9,2
5483,4,work,9,12,3
5483,5,home,12,16,4
5483,6,work,16,18,2
5483,7,home,18,24,6
5483,8,<ENDS>,24,24,0
5484,0,<START>,0,0,0
5484,1,home,0,7,7
5484,2,education,7,11,4
5484,3,home,11,18,7
5484,4,shop,18,20,2
5484,5,home,20,24,4
5484,6,<ENDS>,24,24,0
5485,0,<START>,0,0,0
5485,1,home,0,6,6
5485,2,work,6,12,6
5485,3,shop,12,13,1
5485,4,work,13,19,6
5485,5,home,19,24,5
5485,6,<ENDS>,24,24,0
5486,0,<START>,0,0,0
5486,1,home,0,8,8
5486,2,education,8,13,5
5486,3,shop,13,14,1
5486,4,home,14,24,10
5486,5,<ENDS>,24,24,0
5487,0,<START>,0,0,0
5487,1,home,0,6,6
5487,2,work,6,13,7
5487,3,home,13,24,11
5487,4,<ENDS>,24,24,0
5488,0,<START>,0,0,0
5488,1,home,0,8,8
5488,2,work,8,15,7
5488,3,home,15,24,9
5488,4,<ENDS>,24,24,0
5489,0,<START>,0,0,0
5489,1,home,0,8,8
5489,2,education,8,12,4
5489,3,shop,12,13,1
5489,4,home,13,21,8
5489,5,shop,21,22,1
5489,6,home,22,24,2
5489,7,<ENDS>,24,24,0
5490,0,<START>,0,0,0
5490,1,home,0,9,9
5490,2,work,9,16,7
5490,3,home,16,22,6
5490,4,work,22,23,1
5490,5,home,23,24,1
5490,6,<ENDS>,24,24,0
5491,0,<START>,0,0,0
5491,1,home,0,6,6
5491,2,work,6,13,7
5491,3,shop,13,14,1
5491,4,home,14,22,8
5491,5,work,22,23,1
5491,6,home,23,24,1
5491,7,<ENDS>,24,24,0
5492,0,<START>,0,0,0
5492,1,home,0,7,7
5492,2,education,7,13,6
5492,3,shop,13,14,1
5492,4,education,14,17,3
5492,5,shop,17,19,2
5492,6,home,19,24,5
5492,7,<ENDS>,24,24,0
5493,0,<START>,0,0,0
5493,1,home,0,7,7
5493,2,shop,7,8,1
5493,3,home,8,9,1
5493,4,education,9,15,6
5493,5,shop,15,16,1
5493,6,work,16,20,4
5493,7,home,20,24,4
5493,8,<ENDS>,24,24,0
5494,0,<START>,0,0,0
5494,1,home,0,6,6
5494,2,work,6,9,3
5494,3,home,9,15,6
5494,4,work,15,17,2
5494,5,home,17,23,6
5494,6,work,23,24,1
5494,7,<ENDS>,24,24,0
5495,0,<START>,0,0,0
5495,1,home,0,7,7
5495,2,work,7,13,6
5495,3,home,13,20,7
5495,4,shop,20,21,1
5495,5,home,21,24,3
5495,6,<ENDS>,24,24,0
5496,0,<START>,0,0,0
5496,1,home,0,7,7
5496,2,shop,7,8,1
5496,3,education,8,12,4
5496,4,home,12,20,8
5496,5,shop,20,21,1
5496,6,home,21,24,3
5496,7,<ENDS>,24,24,0
5497,0,<START>,0,0,0
5497,1,home,0,7,7
5497,2,education,7,11,4
5497,3,home,11,17,6
5497,4,shop,17,18,1
5497,5,home,18,24,6
5497,6,<ENDS>,24,24,0
5498,0,<START>,0,0,0
5498,1,home,0,8,8
5498,2,work,8,15,7
5498,3,home,15,24,9
5498,4,<ENDS>,24,24,0
5499,0,<START>,0,0,0
5499,1,home,0,7,7
5499,2,work,7,14,7
5499,3,shop,14,15,1
5499,4,home,15,18,3
5499,5,work,18,20,2
5499,6,home,20,24,4
5499,7,<ENDS>,24,24,0
5500,0,<START>,0,0,0
5500,1,home,0,6,6
5500,2,work,6,13,7
5500,3,home,13,24,11
5500,4,<ENDS>,24,24,0
5501,0,<START>,0,0,0
5501,1,home,0,6,6
5501,2,work,6,13,7
5501,3,shop,13,14,1
5501,4,home,14,23,9
5501,5,work,23,24,1
5501,6,<ENDS>,24,24,0
5502,0,<START>,0,0,0
5502,1,home,0,7,7
5502,2,work,7,14,7
5502,3,shop,14,15,1
5502,4,home,15,23,8
5502,5,work,23,24,1
5502,6,<ENDS>,24,24,0
5503,0,<START>,0,0,0
5503,1,home,0,7,7
5503,2,work,7,14,7
5503,3,home,14,16,2
5503,4,work,16,20,4
5503,5,home,20,24,4
5503,6,<ENDS>,24,24,0
5504,0,<START>,0,0,0
5504,1,home,0,8,8
5504,2,work,8,13,5
5504,3,shop,13,14,1
5504,4,home,14,18,4
5504,5,work,18,20,2
5504,6,home,20,24,4
5504,7,<ENDS>,24,24,0
5505,0,<START>,0,0,0
5505,1,home,0,7,7
5505,2,work,7,14,7
5505,3,home,14,24,10
5505,4,<ENDS>,24,24,0
5506,0,<START>,0,0,0
5506,1,home,0,6,6
5506,2,work,6,8,2
5506,3,home,8,12,4
5506,4,work,12,14,2
5506,5,home,14,21,7
5506,6,work,21,22,1
5506,7,home,22,24,2
5506,8,<ENDS>,24,24,0
5507,0,<START>,0,0,0
5507,1,home,0,8,8
5507,2,education,8,11,3
5507,3,home,11,17,6
5507,4,work,17,20,3
5507,5,home,20,24,4
5507,6,<ENDS>,24,24,0
5508,0,<START>,0,0,0
5508,1,home,0,8,8
5508,2,education,8,11,3
5508,3,home,11,20,9
5508,4,shop,20,21,1
5508,5,home,21,24,3
5508,6,<ENDS>,24,24,0
5509,0,<START>,0,0,0
5509,1,home,0,6,6
5509,2,work,6,13,7
5509,3,home,13,24,11
5509,4,<ENDS>,24,24,0
5510,0,<START>,0,0,0
5510,1,home,0,6,6
5510,2,work,6,13,7
5510,3,home,13,19,6
5510,4,shop,19,21,2
5510,5,home,21,24,3
5510,6,<ENDS>,24,24,0
5511,0,<START>,0,0,0
5511,1,home,0,7,7
5511,2,work,7,13,6
5511,3,home,13,24,11
5511,4,<ENDS>,24,24,0
5512,0,<START>,0,0,0
5512,1,home,0,6,6
5512,2,work,6,8,2
5512,3,home,8,9,1
5512,4,work,9,10,1
5512,5,home,10,14,4
5512,6,work,14,16,2
5512,7,shop,16,17,1
5512,8,home,17,23,6
5512,9,work,23,24,1
5512,10,<ENDS>,24,24,0
5513,0,<START>,0,0,0
5513,1,home,0,7,7
5513,2,work,7,13,6
5513,3,home,13,18,5
5513,4,shop,18,19,1
5513,5,home,19,24,5
5513,6,<ENDS>,24,24,0
5514,0,<START>,0,0,0
5514,1,home,0,8,8
5514,2,work,8,14,6
5514,3,shop,14,15,1
5514,4,work,15,20,5
5514,5,home,20,24,4
5514,6,<ENDS>,24,24,0
5515,0,<START>,0,0,0
5515,1,home,0,7,7
5515,2,work,7,13,6
5515,3,shop,13,14,1
5515,4,home,14,24,10
5515,5,<ENDS>,24,24,0
5516,0,<START>,0,0,0
5516,1,home,0,7,7
5516,2,work,7,13,6
5516,3,home,13,20,7
5516,4,shop,20,21,1
5516,5,home,21,24,3
5516,6,<ENDS>,24,24,0
5517,0,<START>,0,0,0
5517,1,home,0,9,9
5517,2,work,9,16,7
5517,3,shop,16,17,1
5517,4,work,17,20,3
5517,5,home,20,24,4
5517,6,<ENDS>,24,24,0
5518,0,<START>,0,0,0
5518,1,home,0,8,8
5518,2,work,8,15,7
5518,3,home,15,24,9
5518,4,<ENDS>,24,24,0
5519,0,<START>,0,0,0
5519,1,home,0,7,7
5519,2,education,7,12,5
5519,3,home,12,13,1
5519,4,education,13,16,3
5519,5,shop,16,17,1
5519,6,home,17,24,7
5519,7,<ENDS>,24,24,0
5520,0,<START>,0,0,0
5520,1,home,0,7,7
5520,2,work,7,14,7
5520,3,shop,14,15,1
5520,4,work,15,19,4
5520,5,home,19,24,5
5520,6,<ENDS>,24,24,0
5521,0,<START>,0,0,0
5521,1,home,0,6,6
5521,2,work,6,8,2
5521,3,home,8,14,6
5521,4,work,14,16,2
5521,5,home,16,22,6
5521,6,work,22,23,1
5521,7,home,23,24,1
5521,8,<ENDS>,24,24,0
5522,0,<START>,0,0,0
5522,1,home,0,6,6
5522,2,shop,6,7,1
5522,3,work,7,14,7
5522,4,home,14,24,10
5522,5,<ENDS>,24,24,0
5523,0,<START>,0,0,0
5523,1,home,0,7,7
5523,2,shop,7,9,2
5523,3,education,9,11,2
5523,4,home,11,16,5
5523,5,shop,16,17,1
5523,6,home,17,24,7
5523,7,<ENDS>,24,24,0
5524,0,<START>,0,0,0
5524,1,home,0,8,8
5524,2,work,8,15,7
5524,3,home,15,17,2
5524,4,work,17,20,3
5524,5,home,20,24,4
5524,6,<ENDS>,24,24,0
5525,0,<START>,0,0,0
5525,1,home,0,6,6
5525,2,work,6,13,7
5525,3,shop,13,15,2
5525,4,work,15,20,5
5525,5,home,20,24,4
5525,6,<ENDS>,24,24,0
5526,0,<START>,0,0,0
5526,1,home,0,6,6
5526,2,shop,6,7,1
5526,3,home,7,10,3
5526,4,education,10,11,1
5526,5,home,11,19,8
5526,6,shop,19,21,2
5526,7,home,21,24,3
5526,8,<ENDS>,24,24,0
5527,0,<START>,0,0,0
5527,1,home,0,7,7
5527,2,shop,7,9,2
5527,3,education,9,12,3
5527,4,home,12,19,7
5527,5,shop,19,20,1
5527,6,home,20,24,4
5527,7,<ENDS>,24,24,0
5528,0,<START>,0,0,0
5528,1,home,0,6,6
5528,2,work,6,13,7
5528,3,home,13,17,4
5528,4,work,17,20,3
5528,5,home,20,24,4
5528,6,<ENDS>,24,24,0
5529,0,<START>,0,0,0
5529,1,home,0,7,7
5529,2,work,7,13,6
5529,3,home,13,24,11
5529,4,<ENDS>,24,24,0
5530,0,<START>,0,0,0
5530,1,home,0,6,6
5530,2,work,6,13,7
5530,3,shop,13,14,1
5530,4,work,14,19,5
5530,5,home,19,24,5
5530,6,<ENDS>,24,24,0
5531,0,<START>,0,0,0
5531,1,home,0,6,6
5531,2,work,6,8,2
5531,3,home,8,13,5
5531,4,education,13,14,1
5531,5,work,14,17,3
5531,6,home,17,23,6
5531,7,work,23,24,1
5531,8,<ENDS>,24,24,0
5532,0,<START>,0,0,0
5532,1,home,0,8,8
5532,2,shop,8,9,1
5532,3,home,9,13,4
5532,4,work,13,19,6
5532,5,home,19,24,5
5532,6,<ENDS>,24,24,0
5533,0,<START>,0,0,0
5533,1,home,0,8,8
5533,2,work,8,15,7
5533,3,home,15,24,9
5533,4,<ENDS>,24,24,0
5534,0,<START>,0,0,0
5534,1,home,0,7,7
5534,2,shop,7,8,1
5534,3,home,8,14,6
5534,4,work,14,20,6
5534,5,home,20,24,4
5534,6,<ENDS>,24,24,0
5535,0,<START>,0,0,0
5535,1,home,0,7,7
5535,2,shop,7,8,1
5535,3,home,8,9,1
5535,4,work,9,17,8
5535,5,home,17,21,4
5535,6,work,21,22,1
5535,7,home,22,24,2
5535,8,<ENDS>,24,24,0
5536,0,<START>,0,0,0
5536,1,home,0,8,8
5536,2,education,8,12,4
5536,3,shop,12,14,2
5536,4,education,14,16,2
5536,5,home,16,24,8
5536,6,<ENDS>,24,24,0
5537,0,<START>,0,0,0
5537,1,home,0,8,8
5537,2,work,8,15,7
5537,3,shop,15,16,1
5537,4,work,16,20,4
5537,5,home,20,24,4
5537,6,<ENDS>,24,24,0
5538,0,<START>,0,0,0
5538,1,home,0,7,7
5538,2,work,7,14,7
5538,3,shop,14,15,1
5538,4,home,15,24,9
5538,5,<ENDS>,24,24,0
5539,0,<START>,0,0,0
5539,1,home,0,8,8
5539,2,work,8,13,5
5539,3,home,13,21,8
5539,4,work,21,22,1
5539,5,home,22,24,2
5539,6,<ENDS>,24,24,0
5540,0,<START>,0,0,0
5540,1,home,0,6,6
5540,2,shop,6,7,1
5540,3,home,7,9,2
5540,4,work,9,17,8
5540,5,home,17,23,6
5540,6,work,23,24,1
5540,7,<ENDS>,24,24,0
5541,0,<START>,0,0,0
5541,1,home,0,6,6
5541,2,shop,6,7,1
5541,3,home,7,11,4
5541,4,work,11,17,6
5541,5,home,17,22,5
5541,6,work,22,23,1
5541,7,home,23,24,1
5541,8,<ENDS>,24,24,0
5542,0,<START>,0,0,0
5542,1,home,0,6,6
5542,2,shop,6,7,1
5542,3,home,7,10,3
5542,4,education,10,12,2
5542,5,shop,12,14,2
5542,6,education,14,16,2
5542,7,home,16,20,4
5542,8,shop,20,21,1
5542,9,home,21,24,3
5542,10,<ENDS>,24,24,0
5543,0,<START>,0,0,0
5543,1,home,0,8,8
5543,2,work,8,14,6
5543,3,home,14,24,10
5543,4,<ENDS>,24,24,0
5544,0,<START>,0,0,0
5544,1,home,0,6,6
5544,2,work,6,13,7
5544,3,home,13,24,11
5544,4,<ENDS>,24,24,0
5545,0,<START>,0,0,0
5545,1,home,0,6,6
5545,2,shop,6,7,1
5545,3,work,7,13,6
5545,4,home,13,24,11
5545,5,<ENDS>,24,24,0
5546,0,<START>,0,0,0
5546,1,home,0,7,7
5546,2,work,7,13,6
5546,3,shop,13,14,1
5546,4,work,14,19,5
5546,5,education,19,20,1
5546,6,work,20,21,1
5546,7,home,21,24,3
5546,8,<ENDS>,24,24,0
5547,0,<START>,0,0,0
5547,1,home,0,6,6
5547,2,work,6,8,2
5547,3,home,8,13,5
5547,4,work,13,15,2
5547,5,home,15,21,6
5547,6,work,21,22,1
5547,7,home,22,24,2
5547,8,<ENDS>,24,24,0
5548,0,<START>,0,0,0
5548,1,home,0,9,9
5548,2,work,9,16,7
5548,3,home,16,24,8
5548,4,<ENDS>,24,24,0
5549,0,<START>,0,0,0
5549,1,home,0,7,7
5549,2,work,7,13,6
5549,3,home,13,18,5
5549,4,work,18,20,2
5549,5,home,20,24,4
5549,6,<ENDS>,24,24,0
5550,0,<START>,0,0,0
5550,1,home,0,6,6
5550,2,shop,6,7,1
5550,3,work,7,14,7
5550,4,home,14,21,7
5550,5,work,21,22,1
5550,6,home,22,24,2
5550,7,<ENDS>,24,24,0
5551,0,<START>,0,0,0
5551,1,home,0,6,6
5551,2,work,6,8,2
5551,3,home,8,9,1
5551,4,work,9,10,1
5551,5,shop,10,11,1
5551,6,work,11,13,2
5551,7,home,13,21,8
5551,8,work,21,22,1
5551,9,home,22,24,2
5551,10,<ENDS>,24,24,0
5552,0,<START>,0,0,0
5552,1,home,0,6,6
5552,2,shop,6,7,1
5552,3,home,7,16,9
5552,4,work,16,20,4
5552,5,home,20,24,4
5552,6,<ENDS>,24,24,0
5553,0,<START>,0,0,0
5553,1,home,0,6,6
5553,2,work,6,8,2
5553,3,home,8,12,4
5553,4,work,12,14,2
5553,5,home,14,16,2
5553,6,work,16,19,3
5553,7,home,19,23,4
5553,8,work,23,24,1
5553,9,<ENDS>,24,24,0
5554,0,<START>,0,0,0
5554,1,home,0,8,8
5554,2,work,8,16,8
5554,3,shop,16,17,1
5554,4,home,17,22,5
5554,5,work,22,23,1
5554,6,home,23,24,1
5554,7,<ENDS>,24,24,0
5555,0,<START>,0,0,0
5555,1,home,0,7,7
5555,2,education,7,12,5
5555,3,shop,12,14,2
5555,4,education,14,16,2
5555,5,shop,16,17,1
5555,6,home,17,24,7
5555,7,<ENDS>,24,24,0
5556,0,<START>,0,0,0
5556,1,home,0,7,7
5556,2,work,7,13,6
5556,3,home,13,21,8
5556,4,work,21,22,1
5556,5,home,22,24,2
5556,6,<ENDS>,24,24,0
5557,0,<START>,0,0,0
5557,1,home,0,7,7
5557,2,education,7,11,4
5557,3,home,11,17,6
5557,4,shop,17,19,2
5557,5,home,19,24,5
5557,6,<ENDS>,24,24,0
5558,0,<START>,0,0,0
5558,1,home,0,7,7
5558,2,education,7,11,4
5558,3,home,11,19,8
5558,4,shop,19,20,1
5558,5,home,20,24,4
5558,6,<ENDS>,24,24,0
5559,0,<START>,0,0,0
5559,1,home,0,7,7
5559,2,work,7,14,7
5559,3,home,14,20,6
5559,4,shop,20,21,1
5559,5,home,21,24,3
5559,6,<ENDS>,24,24,0
5560,0,<START>,0,0,0
5560,1,home,0,8,8
5560,2,work,8,14,6
5560,3,home,14,24,10
5560,4,<ENDS>,24,24,0
5561,0,<START>,0,0,0
5561,1,home,0,8,8
5561,2,work,8,14,6
5561,3,home,14,17,3
5561,4,work,17,19,2
5561,5,home,19,24,5
5561,6,<ENDS>,24,24,0
5562,0,<START>,0,0,0
5562,1,home,0,7,7
5562,2,shop,7,8,1
5562,3,education,8,11,3
5562,4,home,11,19,8
5562,5,shop,19,20,1
5562,6,home,20,24,4
5562,7,<ENDS>,24,24,0
5563,0,<START>,0,0,0
5563,1,home,0,7,7
5563,2,shop,7,8,1
5563,3,education,8,12,4
5563,4,home,12,18,6
5563,5,shop,18,19,1
5563,6,home,19,24,5
5563,7,<ENDS>,24,24,0
5564,0,<START>,0,0,0
5564,1,home,0,6,6
5564,2,work,6,8,2
5564,3,shop,8,9,1
5564,4,home,9,16,7
5564,5,work,16,18,2
5564,6,home,18,24,6
5564,7,<ENDS>,24,24,0
5565,0,<START>,0,0,0
5565,1,home,0,8,8
5565,2,work,8,14,6
5565,3,shop,14,15,1
5565,4,work,15,20,5
5565,5,home,20,24,4
5565,6,<ENDS>,24,24,0
5566,0,<START>,0,0,0
5566,1,home,0,8,8
5566,2,education,8,12,4
5566,3,home,12,21,9
5566,4,shop,21,22,1
5566,5,home,22,24,2
5566,6,<ENDS>,24,24,0
5567,0,<START>,0,0,0
5567,1,home,0,7,7
5567,2,shop,7,8,1
5567,3,home,8,16,8
5567,4,work,16,20,4
5567,5,home,20,24,4
5567,6,<ENDS>,24,24,0
5568,0,<START>,0,0,0
5568,1,home,0,7,7
5568,2,work,7,13,6
5568,3,home,13,17,4
5568,4,work,17,20,3
5568,5,home,20,24,4
5568,6,<ENDS>,24,24,0
5569,0,<START>,0,0,0
5569,1,home,0,6,6
5569,2,work,6,8,2
5569,3,home,8,12,4
5569,4,work,12,14,2
5569,5,shop,14,15,1
5569,6,work,15,17,2
5569,7,home,17,23,6
5569,8,work,23,24,1
5569,9,<ENDS>,24,24,0
5570,0,<START>,0,0,0
5570,1,home,0,6,6
5570,2,shop,6,7,1
5570,3,home,7,13,6
5570,4,education,13,16,3
5570,5,home,16,24,8
5570,6,<ENDS>,24,24,0
5571,0,<START>,0,0,0
5571,1,home,0,6,6
5571,2,work,6,13,7
5571,3,home,13,17,4
5571,4,work,17,20,3
5571,5,home,20,24,4
5571,6,<ENDS>,24,24,0
5572,0,<START>,0,0,0
5572,1,home,0,7,7
5572,2,work,7,13,6
5572,3,home,13,17,4
5572,4,work,17,20,3
5572,5,home,20,24,4
5572,6,<ENDS>,24,24,0
5573,0,<START>,0,0,0
5573,1,home,0,7,7
5573,2,work,7,14,7
5573,3,home,14,24,10
5573,4,<ENDS>,24,24,0
5574,0,<START>,0,0,0
5574,1,home,0,7,7
5574,2,work,7,13,6
5574,3,shop,13,14,1
5574,4,work,14,19,5
5574,5,home,19,24,5
5574,6,<ENDS>,24,24,0
5575,0,<START>,0,0,0
5575,1,home,0,6,6
5575,2,shop,6,7,1
5575,3,work,7,13,6
5575,4,home,13,24,11
5575,5,<ENDS>,24,24,0
5576,0,<START>,0,0,0
5576,1,home,0,6,6
5576,2,work,6,13,7
5576,3,shop,13,14,1
5576,4,home,14,24,10
5576,5,<ENDS>,24,24,0
5577,0,<START>,0,0,0
5577,1,home,0,7,7
5577,2,education,7,12,5
5577,3,shop,12,14,2
5577,4,education,14,16,2
5577,5,home,16,24,8
5577,6,<ENDS>,24,24,0
5578,0,<START>,0,0,0
5578,1,home,0,8,8
5578,2,education,8,12,4
5578,3,home,12,19,7
5578,4,shop,19,20,1
5578,5,home,20,24,4
5578,6,<ENDS>,24,24,0
5579,0,<START>,0,0,0
5579,1,home,0,7,7
5579,2,work,7,9,2
5579,3,home,9,15,6
5579,4,work,15,18,3
5579,5,home,18,24,6
5579,6,<ENDS>,24,24,0
5580,0,<START>,0,0,0
5580,1,home,0,7,7
5580,2,education,7,10,3
5580,3,home,10,19,9
5580,4,shop,19,20,1
5580,5,home,20,24,4
5580,6,<ENDS>,24,24,0
5581,0,<START>,0,0,0
5581,1,home,0,6,6
5581,2,work,6,15,9
5581,3,home,15,24,9
5581,4,<ENDS>,24,24,0
5582,0,<START>,0,0,0
5582,1,home,0,6,6
5582,2,work,6,13,7
5582,3,home,13,24,11
5582,4,<ENDS>,24,24,0
5583,0,<START>,0,0,0
5583,1,home,0,8,8
5583,2,education,8,14,6
5583,3,shop,14,15,1
5583,4,home,15,24,9
5583,5,<ENDS>,24,24,0
5584,0,<START>,0,0,0
5584,1,home,0,7,7
5584,2,work,7,13,6
5584,3,home,13,15,2
5584,4,work,15,20,5
5584,5,home,20,24,4
5584,6,<ENDS>,24,24,0
5585,0,<START>,0,0,0
5585,1,home,0,7,7
5585,2,work,7,13,6
5585,3,home,13,24,11
5585,4,<ENDS>,24,24,0
5586,0,<START>,0,0,0
5586,1,home,0,6,6
5586,2,work,6,13,7
5586,3,home,13,24,11
5586,4,<ENDS>,24,24,0
5587,0,<START>,0,0,0
5587,1,home,0,7,7
5587,2,work,7,13,6
5587,3,shop,13,14,1
5587,4,work,14,19,5
5587,5,home,19,24,5
5587,6,<ENDS>,24,24,0
5588,0,<START>,0,0,0
5588,1,home,0,6,6
5588,2,work,6,13,7
5588,3,home,13,15,2
5588,4,work,15,20,5
5588,5,home,20,24,4
5588,6,<ENDS>,24,24,0
5589,0,<START>,0,0,0
5589,1,home,0,6,6
5589,2,shop,6,7,1
5589,3,home,7,10,3
5589,4,education,10,12,2
5589,5,home,12,17,5
5589,6,shop,17,19,2
5589,7,home,19,24,5
5589,8,<ENDS>,24,24,0
5590,0,<START>,0,0,0
5590,1,home,0,6,6
5590,2,shop,6,7,1
5590,3,home,7,13,6
5590,4,education,13,16,3
5590,5,home,16,24,8
5590,6,<ENDS>,24,24,0
5591,0,<START>,0,0,0
5591,1,home,0,6,6
5591,2,shop,6,7,1
5591,3,home,7,9,2
5591,4,work,9,15,6
5591,5,home,15,22,7
5591,6,work,22,23,1
5591,7,home,23,24,1
5591,8,<ENDS>,24,24,0
5592,0,<START>,0,0,0
5592,1,home,0,6,6
5592,2,work,6,8,2
5592,3,home,8,12,4
5592,4,work,12,14,2
5592,5,home,14,22,8
5592,6,work,22,23,1
5592,7,home,23,24,1
5592,8,<ENDS>,24,24,0
5593,0,<START>,0,0,0
5593,1,home,0,7,7
5593,2,work,7,13,6
5593,3,home,13,20,7
5593,4,shop,20,21,1
5593,5,home,21,24,3
5593,6,<ENDS>,24,24,0
5594,0,<START>,0,0,0
5594,1,home,0,7,7
5594,2,shop,7,8,1
5594,3,education,8,12,4
5594,4,shop,12,14,2
5594,5,education,14,16,2
5594,6,shop,16,18,2
5594,7,home,18,24,6
5594,8,<ENDS>,24,24,0
5595,0,<START>,0,0,0
5595,1,home,0,6,6
5595,2,work,6,13,7
5595,3,shop,13,14,1
5595,4,home,14,24,10
5595,5,<ENDS>,24,24,0
5596,0,<START>,0,0,0
5596,1,home,0,6,6
5596,2,work,6,13,7
5596,3,shop,13,14,1
5596,4,home,14,24,10
5596,5,<ENDS>,24,24,0
5597,0,<START>,0,0,0
5597,1,home,0,6,6
5597,2,work,6,8,2
5597,3,home,8,14,6
5597,4,work,14,17,3
5597,5,home,17,24,7
5597,6,<ENDS>,24,24,0
5598,0,<START>,0,0,0
5598,1,home,0,8,8
5598,2,education,8,11,3
5598,3,home,11,17,6
5598,4,work,17,20,3
5598,5,home,20,24,4
5598,6,<ENDS>,24,24,0
5599,0,<START>,0,0,0
5599,1,home,0,7,7
5599,2,work,7,14,7
5599,3,home,14,16,2
5599,4,work,16,20,4
5599,5,home,20,24,4
5599,6,<ENDS>,24,24,0
5600,0,<START>,0,0,0
5600,1,home,0,8,8
5600,2,work,8,14,6
5600,3,home,14,21,7
5600,4,work,21,22,1
5600,5,home,22,24,2
5600,6,<ENDS>,24,24,0
5601,0,<START>,0,0,0
5601,1,home,0,6,6
5601,2,work,6,13,7
5601,3,home,13,17,4
5601,4,work,17,20,3
5601,5,home,20,24,4
5601,6,<ENDS>,24,24,0
5602,0,<START>,0,0,0
5602,1,home,0,7,7
5602,2,work,7,14,7
5602,3,home,14,24,10
5602,4,<ENDS>,24,24,0
5603,0,<START>,0,0,0
5603,1,home,0,8,8
5603,2,work,8,15,7
5603,3,home,15,24,9
5603,4,<ENDS>,24,24,0
5604,0,<START>,0,0,0
5604,1,home,0,7,7
5604,2,education,7,12,5
5604,3,shop,12,14,2
5604,4,education,14,17,3
5604,5,shop,17,18,1
5604,6,home,18,24,6
5604,7,<ENDS>,24,24,0
5605,0,<START>,0,0,0
5605,1,home,0,7,7
5605,2,education,7,10,3
5605,3,home,10,16,6
5605,4,shop,16,17,1
5605,5,home,17,24,7
5605,6,<ENDS>,24,24,0
5606,0,<START>,0,0,0
5606,1,home,0,6,6
5606,2,work,6,12,6
5606,3,shop,12,13,1
5606,4,work,13,18,5
5606,5,home,18,24,6
5606,6,<ENDS>,24,24,0
5607,0,<START>,0,0,0
5607,1,home,0,6,6
5607,2,shop,6,7,1
5607,3,home,7,12,5
5607,4,work,12,18,6
5607,5,home,18,24,6
5607,6,<ENDS>,24,24,0
5608,0,<START>,0,0,0
5608,1,home,0,6,6
5608,2,shop,6,7,1
5608,3,work,7,14,7
5608,4,home,14,24,10
5608,5,<ENDS>,24,24,0
5609,0,<START>,0,0,0
5609,1,home,0,7,7
5609,2,work,7,13,6
5609,3,home,13,24,11
5609,4,<ENDS>,24,24,0
5610,0,<START>,0,0,0
5610,1,home,0,8,8
5610,2,work,8,15,7
5610,3,home,15,19,4
5610,4,shop,19,20,1
5610,5,home,20,24,4
5610,6,<ENDS>,24,24,0
5611,0,<START>,0,0,0
5611,1,home,0,8,8
5611,2,education,8,11,3
5611,3,home,11,15,4
5611,4,work,15,20,5
5611,5,home,20,24,4
5611,6,<ENDS>,24,24,0
5612,0,<START>,0,0,0
5612,1,home,0,7,7
5612,2,work,7,14,7
5612,3,shop,14,15,1
5612,4,work,15,20,5
5612,5,home,20,24,4
5612,6,<ENDS>,24,24,0
5613,0,<START>,0,0,0
5613,1,home,0,7,7
5613,2,work,7,13,6
5613,3,shop,13,14,1
5613,4,home,14,24,10
5613,5,<ENDS>,24,24,0
5614,0,<START>,0,0,0
5614,1,home,0,8,8
5614,2,work,8,15,7
5614,3,home,15,24,9
5614,4,<ENDS>,24,24,0
5615,0,<START>,0,0,0
5615,1,home,0,7,7
5615,2,work,7,13,6
5615,3,shop,13,14,1
5615,4,work,14,19,5
5615,5,home,19,24,5
5615,6,<ENDS>,24,24,0
5616,0,<START>,0,0,0
5616,1,home,0,7,7
5616,2,education,7,12,5
5616,3,home,12,14,2
5616,4,education,14,16,2
5616,5,home,16,24,8
5616,6,<ENDS>,24,24,0
5617,0,<START>,0,0,0
5617,1,home,0,6,6
5617,2,work,6,12,6
5617,3,shop,12,13,1
5617,4,work,13,19,6
5617,5,home,19,24,5
5617,6,<ENDS>,24,24,0
5618,0,<START>,0,0,0
5618,1,home,0,6,6
5618,2,shop,6,7,1
5618,3,home,7,8,1
5618,4,shop,8,9,1
5618,5,work,9,16,7
5618,6,home,16,24,8
5618,7,<ENDS>,24,24,0
5619,0,<START>,0,0,0
5619,1,home,0,6,6
5619,2,shop,6,7,1
5619,3,home,7,9,2
5619,4,education,9,12,3
5619,5,shop,12,13,1
5619,6,education,13,16,3
5619,7,home,16,24,8
5619,8,<ENDS>,24,24,0
5620,0,<START>,0,0,0
5620,1,home,0,6,6
5620,2,work,6,13,7
5620,3,shop,13,14,1
5620,4,work,14,19,5
5620,5,home,19,24,5
5620,6,<ENDS>,24,24,0
5621,0,<START>,0,0,0
5621,1,home,0,8,8
5621,2,work,8,15,7
5621,3,shop,15,16,1
5621,4,work,16,20,4
5621,5,home,20,24,4
5621,6,<ENDS>,24,24,0
5622,0,<START>,0,0,0
5622,1,home,0,8,8
5622,2,education,8,12,4
5622,3,shop,12,13,1
5622,4,work,13,19,6
5622,5,home,19,23,4
5622,6,work,23,24,1
5622,7,<ENDS>,24,24,0
5623,0,<START>,0,0,0
5623,1,home,0,7,7
5623,2,work,7,13,6
5623,3,home,13,17,4
5623,4,work,17,20,3
5623,5,home,20,24,4
5623,6,<ENDS>,24,24,0
5624,0,<START>,0,0,0
5624,1,home,0,7,7
5624,2,work,7,14,7
5624,3,shop,14,15,1
5624,4,home,15,24,9
5624,5,<ENDS>,24,24,0
5625,0,<START>,0,0,0
5625,1,home,0,6,6
5625,2,work,6,13,7
5625,3,shop,13,14,1
5625,4,home,14,24,10
5625,5,<ENDS>,24,24,0
5626,0,<START>,0,0,0
5626,1,home,0,7,7
5626,2,work,7,13,6
5626,3,home,13,24,11
5626,4,<ENDS>,24,24,0
5627,0,<START>,0,0,0
5627,1,home,0,8,8
5627,2,education,8,11,3
5627,3,home,11,19,8
5627,4,shop,19,21,2
5627,5,home,21,24,3
5627,6,<ENDS>,24,24,0
5628,0,<START>,0,0,0
5628,1,home,0,8,8
5628,2,education,8,11,3
5628,3,home,11,19,8
5628,4,shop,19,20,1
5628,5,home,20,24,4
5628,6,<ENDS>,24,24,0
5629,0,<START>,0,0,0
5629,1,home,0,7,7
5629,2,work,7,13,6
5629,3,shop,13,14,1
5629,4,work,14,19,5
5629,5,home,19,24,5
5629,6,<ENDS>,24,24,0
5630,0,<START>,0,0,0
5630,1,home,0,7,7
5630,2,work,7,13,6
5630,3,shop,13,14,1
5630,4,work,14,20,6
5630,5,home,20,24,4
5630,6,<ENDS>,24,24,0
5631,0,<START>,0,0,0
5631,1,home,0,8,8
5631,2,work,8,15,7
5631,3,home,15,21,6
5631,4,shop,21,22,1
5631,5,home,22,24,2
5631,6,<ENDS>,24,24,0
5632,0,<START>,0,0,0
5632,1,home,0,9,9
5632,2,work,9,16,7
5632,3,home,16,24,8
5632,4,<ENDS>,24,24,0
5633,0,<START>,0,0,0
5633,1,home,0,6,6
5633,2,work,6,13,7
5633,3,shop,13,14,1
5633,4,work,14,19,5
5633,5,home,19,22,3
5633,6,work,22,23,1
5633,7,home,23,24,1
5633,8,<ENDS>,24,24,0
5634,0,<START>,0,0,0
5634,1,home,0,8,8
5634,2,work,8,17,9
5634,3,home,17,21,4
5634,4,shop,21,22,1
5634,5,home,22,24,2
5634,6,<ENDS>,24,24,0
5635,0,<START>,0,0,0
5635,1,home,0,8,8
5635,2,education,8,11,3
5635,3,home,11,24,13
5635,4,<ENDS>,24,24,0
5636,0,<START>,0,0,0
5636,1,home,0,8,8
5636,2,work,8,15,7
5636,3,home,15,24,9
5636,4,<ENDS>,24,24,0
5637,0,<START>,0,0,0
5637,1,home,0,8,8
5637,2,work,8,15,7
5637,3,home,15,24,9
5637,4,<ENDS>,24,24,0
5638,0,<START>,0,0,0
5638,1,home,0,7,7
5638,2,work,7,13,6
5638,3,shop,13,14,1
5638,4,home,14,24,10
5638,5,<ENDS>,24,24,0
5639,0,<START>,0,0,0
5639,1,home,0,8,8
5639,2,work,8,14,6
5639,3,home,14,17,3
5639,4,shop,17,18,1
5639,5,home,18,24,6
5639,6,<ENDS>,24,24,0
5640,0,<START>,0,0,0
5640,1,home,0,6,6
5640,2,shop,6,7,1
5640,3,work,7,13,6
5640,4,home,13,17,4
5640,5,work,17,20,3
5640,6,home,20,24,4
5640,7,<ENDS>,24,24,0
5641,0,<START>,0,0,0
5641,1,home,0,7,7
5641,2,work,7,14,7
5641,3,home,14,24,10
5641,4,<ENDS>,24,24,0
5642,0,<START>,0,0,0
5642,1,home,0,9,9
5642,2,work,9,17,8
5642,3,home,17,24,7
5642,4,<ENDS>,24,24,0
5643,0,<START>,0,0,0
5643,1,home,0,7,7
5643,2,work,7,9,2
5643,3,home,9,15,6
5643,4,work,15,17,2
5643,5,home,17,24,7
5643,6,<ENDS>,24,24,0
5644,0,<START>,0,0,0
5644,1,home,0,6,6
5644,2,work,6,13,7
5644,3,home,13,18,5
5644,4,shop,18,19,1
5644,5,home,19,23,4
5644,6,work,23,24,1
5644,7,<ENDS>,24,24,0
5645,0,<START>,0,0,0
5645,1,home,0,8,8
5645,2,work,8,14,6
5645,3,home,14,24,10
5645,4,<ENDS>,24,24,0
5646,0,<START>,0,0,0
5646,1,home,0,7,7
5646,2,work,7,8,1
5646,3,home,8,13,5
5646,4,work,13,15,2
5646,5,home,15,21,6
5646,6,work,21,22,1
5646,7,home,22,24,2
5646,8,<ENDS>,24,24,0
5647,0,<START>,0,0,0
5647,1,home,0,7,7
5647,2,work,7,14,7
5647,3,home,14,24,10
5647,4,<ENDS>,24,24,0
5648,0,<START>,0,0,0
5648,1,home,0,8,8
5648,2,work,8,14,6
5648,3,shop,14,15,1
5648,4,home,15,24,9
5648,5,<ENDS>,24,24,0
5649,0,<START>,0,0,0
5649,1,home,0,7,7
5649,2,work,7,13,6
5649,3,home,13,24,11
5649,4,<ENDS>,24,24,0
5650,0,<START>,0,0,0
5650,1,home,0,7,7
5650,2,education,7,13,6
5650,3,shop,13,15,2
5650,4,home,15,24,9
5650,5,<ENDS>,24,24,0
5651,0,<START>,0,0,0
5651,1,home,0,7,7
5651,2,education,7,11,4
5651,3,home,11,20,9
5651,4,shop,20,21,1
5651,5,home,21,24,3
5651,6,<ENDS>,24,24,0
5652,0,<START>,0,0,0
5652,1,home,0,8,8
5652,2,education,8,11,3
5652,3,home,11,19,8
5652,4,shop,19,21,2
5652,5,home,21,24,3
5652,6,<ENDS>,24,24,0
5653,0,<START>,0,0,0
5653,1,home,0,8,8
5653,2,work,8,13,5
5653,3,shop,13,14,1
5653,4,home,14,24,10
5653,5,<ENDS>,24,24,0
5654,0,<START>,0,0,0
5654,1,home,0,7,7
5654,2,work,7,14,7
5654,3,home,14,22,8
5654,4,work,22,23,1
5654,5,home,23,24,1
5654,6,<ENDS>,24,24,0
5655,0,<START>,0,0,0
5655,1,home,0,6,6
5655,2,work,6,13,7
5655,3,shop,13,14,1
5655,4,work,14,19,5
5655,5,home,19,24,5
5655,6,<ENDS>,24,24,0
5656,0,<START>,0,0,0
5656,1,home,0,7,7
5656,2,education,7,11,4
5656,3,home,11,19,8
5656,4,shop,19,20,1
5656,5,home,20,24,4
5656,6,<ENDS>,24,24,0
5657,0,<START>,0,0,0
5657,1,home,0,8,8
5657,2,shop,8,10,2
5657,3,work,10,17,7
5657,4,home,17,24,7
5657,5,<ENDS>,24,24,0
5658,0,<START>,0,0,0
5658,1,home,0,6,6
5658,2,shop,6,7,1
5658,3,home,7,9,2
5658,4,education,9,11,2
5658,5,home,11,16,5
5658,6,shop,16,18,2
5658,7,home,18,24,6
5658,8,<ENDS>,24,24,0
5659,0,<START>,0,0,0
5659,1,home,0,7,7
5659,2,work,7,14,7
5659,3,shop,14,15,1
5659,4,work,15,20,5
5659,5,home,20,24,4
5659,6,<ENDS>,24,24,0
5660,0,<START>,0,0,0
5660,1,home,0,7,7
5660,2,work,7,16,9
5660,3,home,16,24,8
5660,4,<ENDS>,24,24,0
5661,0,<START>,0,0,0
5661,1,home,0,6,6
5661,2,shop,6,7,1
5661,3,home,7,8,1
5661,4,education,8,12,4
5661,5,home,12,20,8
5661,6,shop,20,21,1
5661,7,home,21,24,3
5661,8,<ENDS>,24,24,0
5662,0,<START>,0,0,0
5662,1,home,0,6,6
5662,2,work,6,8,2
5662,3,home,8,11,3
5662,4,work,11,12,1
5662,5,home,12,15,3
5662,6,work,15,17,2
5662,7,home,17,21,4
5662,8,work,21,22,1
5662,9,home,22,24,2
5662,10,<ENDS>,24,24,0
5663,0,<START>,0,0,0
5663,1,home,0,7,7
5663,2,work,7,14,7
5663,3,shop,14,15,1
5663,4,home,15,24,9
5663,5,<ENDS>,24,24,0
5664,0,<START>,0,0,0
5664,1,home,0,7,7
5664,2,education,7,12,5
5664,3,shop,12,14,2
5664,4,education,14,16,2
5664,5,home,16,24,8
5664,6,<ENDS>,24,24,0
5665,0,<START>,0,0,0
5665,1,home,0,6,6
5665,2,work,6,13,7
5665,3,home,13,22,9
5665,4,work,22,23,1
5665,5,home,23,24,1
5665,6,<ENDS>,24,24,0
5666,0,<START>,0,0,0
5666,1,home,0,8,8
5666,2,work,8,15,7
5666,3,home,15,24,9
5666,4,<ENDS>,24,24,0
5667,0,<START>,0,0,0
5667,1,home,0,6,6
5667,2,work,6,13,7
5667,3,home,13,20,7
5667,4,shop,20,21,1
5667,5,home,21,24,3
5667,6,<ENDS>,24,24,0
5668,0,<START>,0,0,0
5668,1,home,0,6,6
5668,2,shop,6,7,1
5668,3,work,7,13,6
5668,4,home,13,24,11
5668,5,<ENDS>,24,24,0
5669,0,<START>,0,0,0
5669,1,home,0,8,8
5669,2,work,8,13,5
5669,3,home,13,15,2
5669,4,work,15,19,4
5669,5,home,19,24,5
5669,6,<ENDS>,24,24,0
5670,0,<START>,0,0,0
5670,1,home,0,7,7
5670,2,work,7,13,6
5670,3,home,13,18,5
5670,4,work,18,20,2
5670,5,home,20,24,4
5670,6,<ENDS>,24,24,0
5671,0,<START>,0,0,0
5671,1,home,0,7,7
5671,2,work,7,9,2
5671,3,home,9,13,4
5671,4,work,13,15,2
5671,5,home,15,23,8
5671,6,work,23,24,1
5671,7,<ENDS>,24,24,0
5672,0,<START>,0,0,0
5672,1,home,0,9,9
5672,2,work,9,16,7
5672,3,home,16,24,8
5672,4,<ENDS>,24,24,0
5673,0,<START>,0,0,0
5673,1,home,0,6,6
5673,2,work,6,13,7
5673,3,shop,13,14,1
5673,4,work,14,20,6
5673,5,home,20,24,4
5673,6,<ENDS>,24,24,0
5674,0,<START>,0,0,0
5674,1,home,0,8,8
5674,2,work,8,15,7
5674,3,home,15,24,9
5674,4,<ENDS>,24,24,0
5675,0,<START>,0,0,0
5675,1,home,0,6,6
5675,2,work,6,13,7
5675,3,home,13,24,11
5675,4,<ENDS>,24,24,0
5676,0,<START>,0,0,0
5676,1,home,0,7,7
5676,2,shop,7,8,1
5676,3,education,8,11,3
5676,4,home,11,18,7
5676,5,shop,18,20,2
5676,6,home,20,24,4
5676,7,<ENDS>,24,24,0
5677,0,<START>,0,0,0
5677,1,home,0,6,6
5677,2,work,6,13,7
5677,3,shop,13,14,1
5677,4,work,14,19,5
5677,5,home,19,24,5
5677,6,<ENDS>,24,24,0
5678,0,<START>,0,0,0
5678,1,home,0,6,6
5678,2,work,6,13,7
5678,3,home,13,24,11
5678,4,<ENDS>,24,24,0
5679,0,<START>,0,0,0
5679,1,home,0,7,7
5679,2,education,7,10,3
5679,3,home,10,18,8
5679,4,shop,18,20,2
5679,5,home,20,24,4
5679,6,<ENDS>,24,24,0
5680,0,<START>,0,0,0
5680,1,home,0,6,6
5680,2,work,6,13,7
5680,3,home,13,24,11
5680,4,<ENDS>,24,24,0
5681,0,<START>,0,0,0
5681,1,home,0,7,7
5681,2,work,7,13,6
5681,3,home,13,24,11
5681,4,<ENDS>,24,24,0
5682,0,<START>,0,0,0
5682,1,home,0,8,8
5682,2,education,8,12,4
5682,3,shop,12,13,1
5682,4,work,13,19,6
5682,5,home,19,24,5
5682,6,<ENDS>,24,24,0
5683,0,<START>,0,0,0
5683,1,home,0,7,7
5683,2,work,7,13,6
5683,3,shop,13,14,1
5683,4,work,14,20,6
5683,5,home,20,24,4
5683,6,<ENDS>,24,24,0
5684,0,<START>,0,0,0
5684,1,home,0,8,8
5684,2,education,8,12,4
5684,3,shop,12,13,1
5684,4,work,13,19,6
5684,5,home,19,24,5
5684,6,<ENDS>,24,24,0
5685,0,<START>,0,0,0
5685,1,home,0,9,9
5685,2,work,9,15,6
5685,3,home,15,22,7
5685,4,work,22,23,1
5685,5,home,23,24,1
5685,6,<ENDS>,24,24,0
5686,0,<START>,0,0,0
5686,1,home,0,9,9
5686,2,work,9,15,6
5686,3,home,15,24,9
5686,4,<ENDS>,24,24,0
5687,0,<START>,0,0,0
5687,1,home,0,8,8
5687,2,work,8,15,7
5687,3,home,15,24,9
5687,4,<ENDS>,24,24,0
5688,0,<START>,0,0,0
5688,1,home,0,6,6
5688,2,work,6,13,7
5688,3,shop,13,14,1
5688,4,work,14,19,5
5688,5,home,19,24,5
5688,6,<ENDS>,24,24,0
5689,0,<START>,0,0,0
5689,1,home,0,7,7
5689,2,education,7,11,4
5689,3,home,11,15,4
5689,4,shop,15,17,2
5689,5,home,17,24,7
5689,6,<ENDS>,24,24,0
5690,0,<START>,0,0,0
5690,1,home,0,7,7
5690,2,work,7,14,7
5690,3,shop,14,15,1
5690,4,home,15,24,9
5690,5,<ENDS>,24,24,0
5691,0,<START>,0,0,0
5691,1,home,0,7,7
5691,2,work,7,13,6
5691,3,home,13,24,11
5691,4,<ENDS>,24,24,0
5692,0,<START>,0,0,0
5692,1,home,0,7,7
5692,2,work,7,13,6
5692,3,home,13,17,4
5692,4,work,17,20,3
5692,5,home,20,24,4
5692,6,<ENDS>,24,24,0
5693,0,<START>,0,0,0
5693,1,home,0,6,6
5693,2,work,6,14,8
5693,3,home,14,24,10
5693,4,<ENDS>,24,24,0
5694,0,<START>,0,0,0
5694,1,home,0,7,7
5694,2,work,7,14,7
5694,3,shop,14,15,1
5694,4,home,15,24,9
5694,5,<ENDS>,24,24,0
5695,0,<START>,0,0,0
5695,1,home,0,7,7
5695,2,education,7,12,5
5695,3,shop,12,14,2
5695,4,education,14,16,2
5695,5,shop,16,18,2
5695,6,home,18,24,6
5695,7,<ENDS>,24,24,0
5696,0,<START>,0,0,0
5696,1,home,0,7,7
5696,2,work,7,14,7
5696,3,home,14,24,10
5696,4,<ENDS>,24,24,0
5697,0,<START>,0,0,0
5697,1,home,0,7,7
5697,2,work,7,14,7
5697,3,home,14,17,3
5697,4,work,17,20,3
5697,5,home,20,24,4
5697,6,<ENDS>,24,24,0
5698,0,<START>,0,0,0
5698,1,home,0,8,8
5698,2,work,8,15,7
5698,3,home,15,24,9
5698,4,<ENDS>,24,24,0
5699,0,<START>,0,0,0
5699,1,home,0,7,7
5699,2,work,7,14,7
5699,3,home,14,24,10
5699,4,<ENDS>,24,24,0
5700,0,<START>,0,0,0
5700,1,home,0,7,7
5700,2,work,7,14,7
5700,3,home,14,19,5
5700,4,shop,19,20,1
5700,5,home,20,24,4
5700,6,<ENDS>,24,24,0
5701,0,<START>,0,0,0
5701,1,home,0,8,8
5701,2,work,8,14,6
5701,3,home,14,17,3
5701,4,work,17,20,3
5701,5,home,20,22,2
5701,6,work,22,23,1
5701,7,home,23,24,1
5701,8,<ENDS>,24,24,0
5702,0,<START>,0,0,0
5702,1,home,0,6,6
5702,2,shop,6,7,1
5702,3,home,7,13,6
5702,4,education,13,18,5
5702,5,home,18,24,6
5702,6,<ENDS>,24,24,0
5703,0,<START>,0,0,0
5703,1,home,0,7,7
5703,2,education,7,11,4
5703,3,home,11,17,6
5703,4,shop,17,18,1
5703,5,home,18,24,6
5703,6,<ENDS>,24,24,0
5704,0,<START>,0,0,0
5704,1,home,0,6,6
5704,2,shop,6,7,1
5704,3,home,7,13,6
5704,4,education,13,16,3
5704,5,home,16,24,8
5704,6,<ENDS>,24,24,0
5705,0,<START>,0,0,0
5705,1,home,0,6,6
5705,2,shop,6,7,1
5705,3,work,7,14,7
5705,4,home,14,24,10
5705,5,<ENDS>,24,24,0
5706,0,<START>,0,0,0
5706,1,home,0,6,6
5706,2,shop,6,7,1
5706,3,home,7,10,3
5706,4,education,10,13,3
5706,5,shop,13,15,2
5706,6,home,15,24,9
5706,7,<ENDS>,24,24,0
5707,0,<START>,0,0,0
5707,1,home,0,8,8
5707,2,education,8,12,4
5707,3,shop,12,13,1
5707,4,work,13,19,6
5707,5,home,19,24,5
5707,6,<ENDS>,24,24,0
5708,0,<START>,0,0,0
5708,1,home,0,6,6
5708,2,shop,6,7,1
5708,3,home,7,13,6
5708,4,education,13,16,3
5708,5,home,16,20,4
5708,6,shop,20,21,1
5708,7,home,21,24,3
5708,8,<ENDS>,24,24,0
5709,0,<START>,0,0,0
5709,1,home,0,9,9
5709,2,work,9,17,8
5709,3,home,17,24,7
5709,4,<ENDS>,24,24,0
5710,0,<START>,0,0,0
5710,1,home,0,7,7
5710,2,education,7,11,4
5710,3,home,11,17,6
5710,4,shop,17,19,2
5710,5,home,19,24,5
5710,6,<ENDS>,24,24,0
5711,0,<START>,0,0,0
5711,1,home,0,7,7
5711,2,work,7,13,6
5711,3,shop,13,14,1
5711,4,home,14,22,8
5711,5,work,22,23,1
5711,6,home,23,24,1
5711,7,<ENDS>,24,24,0
5712,0,<START>,0,0,0
5712,1,home,0,9,9
5712,2,work,9,17,8
5712,3,home,17,21,4
5712,4,work,21,22,1
5712,5,home,22,24,2
5712,6,<ENDS>,24,24,0
5713,0,<START>,0,0,0
5713,1,home,0,6,6
5713,2,shop,6,7,1
5713,3,home,7,13,6
5713,4,education,13,16,3
5713,5,home,16,24,8
5713,6,<ENDS>,24,24,0
5714,0,<START>,0,0,0
5714,1,home,0,7,7
5714,2,shop,7,8,1
5714,3,work,8,14,6
5714,4,home,14,24,10
5714,5,<ENDS>,24,24,0
5715,0,<START>,0,0,0
5715,1,home,0,8,8
5715,2,work,8,15,7
5715,3,home,15,24,9
5715,4,<ENDS>,24,24,0
5716,0,<START>,0,0,0
5716,1,home,0,7,7
5716,2,work,7,14,7
5716,3,home,14,24,10
5716,4,<ENDS>,24,24,0
5717,0,<START>,0,0,0
5717,1,home,0,8,8
5717,2,shop,8,9,1
5717,3,home,9,13,4
5717,4,work,13,19,6
5717,5,home,19,24,5
5717,6,<ENDS>,24,24,0
5718,0,<START>,0,0,0
5718,1,home,0,7,7
5718,2,work,7,14,7
5718,3,shop,14,15,1
5718,4,work,15,19,4
5718,5,home,19,24,5
5718,6,<ENDS>,24,24,0
5719,0,<START>,0,0,0
5719,1,home,0,8,8
5719,2,work,8,16,8
5719,3,home,16,24,8
5719,4,<ENDS>,24,24,0
5720,0,<START>,0,0,0
5720,1,home,0,8,8
5720,2,work,8,15,7
5720,3,home,15,24,9
5720,4,<ENDS>,24,24,0
5721,0,<START>,0,0,0
5721,1,home,0,7,7
5721,2,work,7,13,6
5721,3,home,13,24,11
5721,4,<ENDS>,24,24,0
5722,0,<START>,0,0,0
5722,1,home,0,7,7
5722,2,work,7,14,7
5722,3,home,14,24,10
5722,4,<ENDS>,24,24,0
5723,0,<START>,0,0,0
5723,1,home,0,7,7
5723,2,work,7,14,7
5723,3,home,14,21,7
5723,4,shop,21,22,1
5723,5,home,22,24,2
5723,6,<ENDS>,24,24,0
5724,0,<START>,0,0,0
5724,1,home,0,8,8
5724,2,work,8,15,7
5724,3,home,15,24,9
5724,4,<ENDS>,24,24,0
5725,0,<START>,0,0,0
5725,1,home,0,8,8
5725,2,work,8,15,7
5725,3,home,15,24,9
5725,4,<ENDS>,24,24,0
5726,0,<START>,0,0,0
5726,1,home,0,7,7
5726,2,work,7,13,6
5726,3,home,13,17,4
5726,4,work,17,18,1
5726,5,education,18,19,1
5726,6,home,19,24,5
5726,7,<ENDS>,24,24,0
5727,0,<START>,0,0,0
5727,1,home,0,7,7
5727,2,work,7,14,7
5727,3,shop,14,15,1
5727,4,home,15,24,9
5727,5,<ENDS>,24,24,0
5728,0,<START>,0,0,0
5728,1,home,0,8,8
5728,2,work,8,15,7
5728,3,home,15,24,9
5728,4,<ENDS>,24,24,0
5729,0,<START>,0,0,0
5729,1,home,0,6,6
5729,2,work,6,13,7
5729,3,shop,13,15,2
5729,4,work,15,19,4
5729,5,home,19,24,5
5729,6,<ENDS>,24,24,0
5730,0,<START>,0,0,0
5730,1,home,0,8,8
5730,2,shop,8,9,1
5730,3,home,9,11,2
5730,4,work,11,17,6
5730,5,home,17,24,7
5730,6,<ENDS>,24,24,0
5731,0,<START>,0,0,0
5731,1,home,0,7,7
5731,2,education,7,11,4
5731,3,home,11,17,6
5731,4,shop,17,18,1
5731,5,home,18,24,6
5731,6,<ENDS>,24,24,0
5732,0,<START>,0,0,0
5732,1,home,0,6,6
5732,2,work,6,13,7
5732,3,shop,13,14,1
5732,4,work,14,17,3
5732,5,home,17,24,7
5732,6,<ENDS>,24,24,0
5733,0,<START>,0,0,0
5733,1,home,0,7,7
5733,2,work,7,13,6
5733,3,shop,13,14,1
5733,4,home,14,17,3
5733,5,work,17,20,3
5733,6,home,20,24,4
5733,7,<ENDS>,24,24,0
5734,0,<START>,0,0,0
5734,1,home,0,7,7
5734,2,work,7,13,6
5734,3,home,13,16,3
5734,4,work,16,20,4
5734,5,home,20,24,4
5734,6,<ENDS>,24,24,0
5735,0,<START>,0,0,0
5735,1,home,0,6,6
5735,2,shop,6,7,1
5735,3,work,7,13,6
5735,4,shop,13,14,1
5735,5,education,14,17,3
5735,6,home,17,24,7
5735,7,<ENDS>,24,24,0
5736,0,<START>,0,0,0
5736,1,home,0,8,8
5736,2,work,8,15,7
5736,3,home,15,24,9
5736,4,<ENDS>,24,24,0
5737,0,<START>,0,0,0
5737,1,home,0,8,8
5737,2,work,8,16,8
5737,3,home,16,21,5
5737,4,work,21,22,1
5737,5,home,22,24,2
5737,6,<ENDS>,24,24,0
5738,0,<START>,0,0,0
5738,1,home,0,9,9
5738,2,shop,9,10,1
5738,3,home,10,14,4
5738,4,education,14,17,3
5738,5,home,17,21,4
5738,6,work,21,22,1
5738,7,home,22,24,2
5738,8,<ENDS>,24,24,0
5739,0,<START>,0,0,0
5739,1,home,0,8,8
5739,2,work,8,15,7
5739,3,home,15,24,9
5739,4,<ENDS>,24,24,0
5740,0,<START>,0,0,0
5740,1,home,0,6,6
5740,2,shop,6,7,1
5740,3,home,7,8,1
5740,4,education,8,12,4
5740,5,shop,12,13,1
5740,6,education,13,16,3
5740,7,home,16,21,5
5740,8,shop,21,22,1
5740,9,home,22,24,2
5740,10,<ENDS>,24,24,0
5741,0,<START>,0,0,0
5741,1,home,0,9,9
5741,2,work,9,16,7
5741,3,home,16,24,8
5741,4,<ENDS>,24,24,0
5742,0,<START>,0,0,0
5742,1,home,0,7,7
5742,2,work,7,13,6
5742,3,shop,13,14,1
5742,4,work,14,19,5
5742,5,home,19,23,4
5742,6,work,23,24,1
5742,7,<ENDS>,24,24,0
5743,0,<START>,0,0,0
5743,1,home,0,7,7
5743,2,work,7,13,6
5743,3,home,13,16,3
5743,4,work,16,20,4
5743,5,home,20,24,4
5743,6,<ENDS>,24,24,0
5744,0,<START>,0,0,0
5744,1,home,0,6,6
5744,2,work,6,13,7
5744,3,shop,13,14,1
5744,4,home,14,17,3
5744,5,work,17,20,3
5744,6,home,20,24,4
5744,7,<ENDS>,24,24,0
5745,0,<START>,0,0,0
5745,1,home,0,6,6
5745,2,work,6,13,7
5745,3,home,13,20,7
5745,4,shop,20,21,1
5745,5,home,21,24,3
5745,6,<ENDS>,24,24,0
5746,0,<START>,0,0,0
5746,1,home,0,6,6
5746,2,work,6,8,2
5746,3,home,8,14,6
5746,4,work,14,16,2
5746,5,home,16,23,7
5746,6,work,23,24,1
5746,7,<ENDS>,24,24,0
5747,0,<START>,0,0,0
5747,1,home,0,6,6
5747,2,shop,6,7,1
5747,3,home,7,10,3
5747,4,education,10,14,4
5747,5,shop,14,15,1
5747,6,home,15,24,9
5747,7,<ENDS>,24,24,0
5748,0,<START>,0,0,0
5748,1,home,0,7,7
5748,2,work,7,14,7
5748,3,home,14,24,10
5748,4,<ENDS>,24,24,0
5749,0,<START>,0,0,0
5749,1,home,0,6,6
5749,2,work,6,13,7
5749,3,shop,13,14,1
5749,4,home,14,17,3
5749,5,work,17,20,3
5749,6,home,20,24,4
5749,7,<ENDS>,24,24,0
5750,0,<START>,0,0,0
5750,1,home,0,6,6
5750,2,shop,6,7,1
5750,3,work,7,15,8
5750,4,home,15,24,9
5750,5,<ENDS>,24,24,0
5751,0,<START>,0,0,0
5751,1,home,0,6,6
5751,2,work,6,8,2
5751,3,home,8,14,6
5751,4,work,14,16,2
5751,5,home,16,23,7
5751,6,work,23,24,1
5751,7,<ENDS>,24,24,0
5752,0,<START>,0,0,0
5752,1,home,0,7,7
5752,2,work,7,12,5
5752,3,shop,12,13,1
5752,4,work,13,19,6
5752,5,home,19,24,5
5752,6,<ENDS>,24,24,0
5753,0,<START>,0,0,0
5753,1,home,0,6,6
5753,2,shop,6,7,1
5753,3,work,7,13,6
5753,4,home,13,22,9
5753,5,work,22,23,1
5753,6,home,23,24,1
5753,7,<ENDS>,24,24,0
5754,0,<START>,0,0,0
5754,1,home,0,6,6
5754,2,work,6,8,2
5754,3,home,8,14,6
5754,4,work,14,16,2
5754,5,home,16,23,7
5754,6,work,23,24,1
5754,7,<ENDS>,24,24,0
5755,0,<START>,0,0,0
5755,1,home,0,7,7
5755,2,education,7,11,4
5755,3,home,11,16,5
5755,4,shop,16,17,1
5755,5,home,17,24,7
5755,6,<ENDS>,24,24,0
5756,0,<START>,0,0,0
5756,1,home,0,6,6
5756,2,shop,6,7,1
5756,3,work,7,13,6
5756,4,home,13,17,4
5756,5,work,17,20,3
5756,6,home,20,24,4
5756,7,<ENDS>,24,24,0
5757,0,<START>,0,0,0
5757,1,home,0,7,7
5757,2,work,7,13,6
5757,3,shop,13,14,1
5757,4,work,14,19,5
5757,5,home,19,24,5
5757,6,<ENDS>,24,24,0
5758,0,<START>,0,0,0
5758,1,home,0,9,9
5758,2,education,9,12,3
5758,3,work,12,19,7
5758,4,home,19,24,5
5758,5,<ENDS>,24,24,0
5759,0,<START>,0,0,0
5759,1,home,0,8,8
5759,2,work,8,15,7
5759,3,home,15,22,7
5759,4,work,22,23,1
5759,5,home,23,24,1
5759,6,<ENDS>,24,24,0
5760,0,<START>,0,0,0
5760,1,home,0,7,7
5760,2,shop,7,8,1
5760,3,education,8,12,4
5760,4,home,12,19,7
5760,5,shop,19,21,2
5760,6,home,21,24,3
5760,7,<ENDS>,24,24,0
5761,0,<START>,0,0,0
5761,1,home,0,8,8
5761,2,work,8,14,6
5761,3,home,14,18,4
5761,4,work,18,20,2
5761,5,home,20,24,4
5761,6,<ENDS>,24,24,0
5762,0,<START>,0,0,0
5762,1,home,0,7,7
5762,2,work,7,14,7
5762,3,shop,14,15,1
5762,4,home,15,24,9
5762,5,<ENDS>,24,24,0
5763,0,<START>,0,0,0
5763,1,home,0,7,7
5763,2,work,7,8,1
5763,3,home,8,14,6
5763,4,work,14,16,2
5763,5,home,16,21,5
5763,6,work,21,22,1
5763,7,home,22,24,2
5763,8,<ENDS>,24,24,0
5764,0,<START>,0,0,0
5764,1,home,0,7,7
5764,2,education,7,13,6
5764,3,home,13,21,8
5764,4,shop,21,22,1
5764,5,home,22,24,2
5764,6,<ENDS>,24,24,0
5765,0,<START>,0,0,0
5765,1,home,0,6,6
5765,2,work,6,13,7
5765,3,shop,13,14,1
5765,4,work,14,19,5
5765,5,home,19,24,5
5765,6,<ENDS>,24,24,0
5766,0,<START>,0,0,0
5766,1,home,0,8,8
5766,2,education,8,11,3
5766,3,home,11,18,7
5766,4,work,18,20,2
5766,5,home,20,24,4
5766,6,<ENDS>,24,24,0
5767,0,<START>,0,0,0
5767,1,home,0,7,7
5767,2,work,7,14,7
5767,3,home,14,21,7
5767,4,shop,21,22,1
5767,5,home,22,24,2
5767,6,<ENDS>,24,24,0
5768,0,<START>,0,0,0
5768,1,home,0,7,7
5768,2,work,7,14,7
5768,3,home,14,24,10
5768,4,<ENDS>,24,24,0
5769,0,<START>,0,0,0
5769,1,home,0,6,6
5769,2,shop,6,7,1
5769,3,home,7,13,6
5769,4,education,13,16,3
5769,5,home,16,24,8
5769,6,<ENDS>,24,24,0
5770,0,<START>,0,0,0
5770,1,home,0,7,7
5770,2,work,7,14,7
5770,3,home,14,24,10
5770,4,<ENDS>,24,24,0
5771,0,<START>,0,0,0
5771,1,home,0,7,7
5771,2,work,7,13,6
5771,3,home,13,21,8
5771,4,work,21,22,1
5771,5,home,22,24,2
5771,6,<ENDS>,24,24,0
5772,0,<START>,0,0,0
5772,1,home,0,6,6
5772,2,work,6,13,7
5772,3,shop,13,14,1
5772,4,home,14,19,5
5772,5,shop,19,20,1
5772,6,home,20,24,4
5772,7,<ENDS>,24,24,0
5773,0,<START>,0,0,0
5773,1,home,0,8,8
5773,2,work,8,14,6
5773,3,home,14,24,10
5773,4,<ENDS>,24,24,0
5774,0,<START>,0,0,0
5774,1,home,0,7,7
5774,2,work,7,13,6
5774,3,home,13,21,8
5774,4,shop,21,22,1
5774,5,home,22,24,2
5774,6,<ENDS>,24,24,0
5775,0,<START>,0,0,0
5775,1,home,0,7,7
5775,2,education,7,9,2
5775,3,home,9,16,7
5775,4,shop,16,18,2
5775,5,home,18,24,6
5775,6,<ENDS>,24,24,0
5776,0,<START>,0,0,0
5776,1,home,0,9,9
5776,2,work,9,15,6
5776,3,home,15,24,9
5776,4,<ENDS>,24,24,0
5777,0,<START>,0,0,0
5777,1,home,0,7,7
5777,2,work,7,14,7
5777,3,home,14,24,10
5777,4,<ENDS>,24,24,0
5778,0,<START>,0,0,0
5778,1,home,0,7,7
5778,2,work,7,13,6
5778,3,shop,13,15,2
5778,4,home,15,24,9
5778,5,<ENDS>,24,24,0
5779,0,<START>,0,0,0
5779,1,home,0,7,7
5779,2,work,7,13,6
5779,3,home,13,19,6
5779,4,shop,19,20,1
5779,5,home,20,24,4
5779,6,<ENDS>,24,24,0
5780,0,<START>,0,0,0
5780,1,home,0,7,7
5780,2,work,7,14,7
5780,3,home,14,18,4
5780,4,work,18,20,2
5780,5,home,20,24,4
5780,6,<ENDS>,24,24,0
5781,0,<START>,0,0,0
5781,1,home,0,7,7
5781,2,shop,7,8,1
5781,3,work,8,14,6
5781,4,home,14,22,8
5781,5,work,22,23,1
5781,6,home,23,24,1
5781,7,<ENDS>,24,24,0
5782,0,<START>,0,0,0
5782,1,home,0,6,6
5782,2,shop,6,7,1
5782,3,home,7,10,3
5782,4,work,10,18,8
5782,5,education,18,20,2
5782,6,home,20,24,4
5782,7,<ENDS>,24,24,0
5783,0,<START>,0,0,0
5783,1,home,0,6,6
5783,2,shop,6,7,1
5783,3,home,7,13,6
5783,4,education,13,16,3
5783,5,home,16,24,8
5783,6,<ENDS>,24,24,0
5784,0,<START>,0,0,0
5784,1,home,0,9,9
5784,2,work,9,15,6
5784,3,shop,15,17,2
5784,4,home,17,24,7
5784,5,<ENDS>,24,24,0
5785,0,<START>,0,0,0
5785,1,home,0,7,7
5785,2,work,7,14,7
5785,3,home,14,15,1
5785,4,work,15,20,5
5785,5,home,20,24,4
5785,6,<ENDS>,24,24,0
5786,0,<START>,0,0,0
5786,1,home,0,9,9
5786,2,work,9,16,7
5786,3,home,16,24,8
5786,4,<ENDS>,24,24,0
5787,0,<START>,0,0,0
5787,1,home,0,7,7
5787,2,education,7,12,5
5787,3,home,12,19,7
5787,4,shop,19,20,1
5787,5,home,20,24,4
5787,6,<ENDS>,24,24,0
5788,0,<START>,0,0,0
5788,1,home,0,6,6
5788,2,work,6,13,7
5788,3,home,13,15,2
5788,4,shop,15,16,1
5788,5,home,16,24,8
5788,6,<ENDS>,24,24,0
5789,0,<START>,0,0,0
5789,1,home,0,6,6
5789,2,work,6,13,7
5789,3,home,13,20,7
5789,4,shop,20,21,1
5789,5,home,21,24,3
5789,6,<ENDS>,24,24,0
5790,0,<START>,0,0,0
5790,1,home,0,7,7
5790,2,education,7,12,5
5790,3,shop,12,14,2
5790,4,education,14,16,2
5790,5,home,16,24,8
5790,6,<ENDS>,24,24,0
5791,0,<START>,0,0,0
5791,1,home,0,7,7
5791,2,work,7,14,7
5791,3,shop,14,15,1
5791,4,home,15,24,9
5791,5,<ENDS>,24,24,0
5792,0,<START>,0,0,0
5792,1,home,0,7,7
5792,2,work,7,13,6
5792,3,home,13,17,4
5792,4,work,17,20,3
5792,5,home,20,24,4
5792,6,<ENDS>,24,24,0
5793,0,<START>,0,0,0
5793,1,home,0,8,8
5793,2,work,8,15,7
5793,3,home,15,24,9
5793,4,<ENDS>,24,24,0
5794,0,<START>,0,0,0
5794,1,home,0,7,7
5794,2,work,7,13,6
5794,3,shop,13,14,1
5794,4,home,14,24,10
5794,5,<ENDS>,24,24,0
5795,0,<START>,0,0,0
5795,1,home,0,7,7
5795,2,work,7,13,6
5795,3,shop,13,14,1
5795,4,home,14,24,10
5795,5,<ENDS>,24,24,0
5796,0,<START>,0,0,0
5796,1,home,0,7,7
5796,2,work,7,9,2
5796,3,home,9,15,6
5796,4,work,15,17,2
5796,5,home,17,22,5
5796,6,work,22,23,1
5796,7,home,23,24,1
5796,8,<ENDS>,24,24,0
5797,0,<START>,0,0,0
5797,1,home,0,6,6
5797,2,work,6,8,2
5797,3,home,8,9,1
5797,4,work,9,10,1
5797,5,home,10,18,8
5797,6,work,18,20,2
5797,7,home,20,24,4
5797,8,<ENDS>,24,24,0
5798,0,<START>,0,0,0
5798,1,home,0,8,8
5798,2,education,8,12,4
5798,3,shop,12,13,1
5798,4,work,13,19,6
5798,5,home,19,24,5
5798,6,<ENDS>,24,24,0
5799,0,<START>,0,0,0
5799,1,home,0,7,7
5799,2,work,7,13,6
5799,3,home,13,16,3
5799,4,work,16,20,4
5799,5,home,20,24,4
5799,6,<ENDS>,24,24,0
5800,0,<START>,0,0,0
5800,1,home,0,7,7
5800,2,work,7,15,8
5800,3,home,15,23,8
5800,4,work,23,24,1
5800,5,<ENDS>,24,24,0
5801,0,<START>,0,0,0
5801,1,home,0,8,8
5801,2,work,8,15,7
5801,3,home,15,24,9
5801,4,<ENDS>,24,24,0
5802,0,<START>,0,0,0
5802,1,home,0,7,7
5802,2,work,7,14,7
5802,3,home,14,24,10
5802,4,<ENDS>,24,24,0
5803,0,<START>,0,0,0
5803,1,home,0,8,8
5803,2,work,8,15,7
5803,3,home,15,19,4
5803,4,shop,19,20,1
5803,5,home,20,24,4
5803,6,<ENDS>,24,24,0
5804,0,<START>,0,0,0
5804,1,home,0,6,6
5804,2,work,6,13,7
5804,3,home,13,21,8
5804,4,work,21,22,1
5804,5,home,22,24,2
5804,6,<ENDS>,24,24,0
5805,0,<START>,0,0,0
5805,1,home,0,8,8
5805,2,work,8,15,7
5805,3,home,15,24,9
5805,4,<ENDS>,24,24,0
5806,0,<START>,0,0,0
5806,1,home,0,8,8
5806,2,work,8,14,6
5806,3,home,14,20,6
5806,4,shop,20,21,1
5806,5,home,21,24,3
5806,6,<ENDS>,24,24,0
5807,0,<START>,0,0,0
5807,1,home,0,7,7
5807,2,work,7,10,3
5807,3,home,10,16,6
5807,4,work,16,18,2
5807,5,home,18,24,6
5807,6,<ENDS>,24,24,0
5808,0,<START>,0,0,0
5808,1,home,0,7,7
5808,2,work,7,13,6
5808,3,shop,13,14,1
5808,4,home,14,23,9
5808,5,work,23,24,1
5808,6,<ENDS>,24,24,0
5809,0,<START>,0,0,0
5809,1,home,0,7,7
5809,2,work,7,14,7
5809,3,home,14,21,7
5809,4,work,21,22,1
5809,5,home,22,24,2
5809,6,<ENDS>,24,24,0
5810,0,<START>,0,0,0
5810,1,home,0,7,7
5810,2,work,7,15,8
5810,3,home,15,24,9
5810,4,<ENDS>,24,24,0
5811,0,<START>,0,0,0
5811,1,home,0,8,8
5811,2,work,8,16,8
5811,3,home,16,23,7
5811,4,work,23,24,1
5811,5,<ENDS>,24,24,0
5812,0,<START>,0,0,0
5812,1,home,0,7,7
5812,2,work,7,9,2
5812,3,home,9,16,7
5812,4,work,16,19,3
5812,5,home,19,24,5
5812,6,<ENDS>,24,24,0
5813,0,<START>,0,0,0
5813,1,home,0,8,8
5813,2,work,8,14,6
5813,3,shop,14,15,1
5813,4,work,15,20,5
5813,5,home,20,24,4
5813,6,<ENDS>,24,24,0
5814,0,<START>,0,0,0
5814,1,home,0,7,7
5814,2,work,7,9,2
5814,3,home,9,14,5
5814,4,work,14,17,3
5814,5,home,17,23,6
5814,6,work,23,24,1
5814,7,<ENDS>,24,24,0
5815,0,<START>,0,0,0
5815,1,home,0,7,7
5815,2,work,7,13,6
5815,3,home,13,17,4
5815,4,work,17,20,3
5815,5,home,20,24,4
5815,6,<ENDS>,24,24,0
5816,0,<START>,0,0,0
5816,1,home,0,8,8
5816,2,work,8,14,6
5816,3,home,14,20,6
5816,4,shop,20,21,1
5816,5,home,21,24,3
5816,6,<ENDS>,24,24,0
5817,0,<START>,0,0,0
5817,1,home,0,6,6
5817,2,shop,6,7,1
5817,3,home,7,11,4
5817,4,shop,11,12,1
5817,5,work,12,19,7
5817,6,home,19,24,5
5817,7,<ENDS>,24,24,0
5818,0,<START>,0,0,0
5818,1,home,0,8,8
5818,2,work,8,15,7
5818,3,home,15,18,3
5818,4,work,18,20,2
5818,5,home,20,24,4
5818,6,<ENDS>,24,24,0
5819,0,<START>,0,0,0
5819,1,home,0,7,7
5819,2,work,7,9,2
5819,3,home,9,14,5
5819,4,work,14,16,2
5819,5,home,16,21,5
5819,6,work,21,22,1
5819,7,home,22,24,2
5819,8,<ENDS>,24,24,0
5820,0,<START>,0,0,0
5820,1,home,0,7,7
5820,2,work,7,15,8
5820,3,home,15,20,5
5820,4,shop,20,21,1
5820,5,home,21,24,3
5820,6,<ENDS>,24,24,0
5821,0,<START>,0,0,0
5821,1,home,0,8,8
5821,2,work,8,15,7
5821,3,home,15,22,7
5821,4,work,22,23,1
5821,5,home,23,24,1
5821,6,<ENDS>,24,24,0
5822,0,<START>,0,0,0
5822,1,home,0,7,7
5822,2,work,7,9,2
5822,3,home,9,14,5
5822,4,work,14,16,2
5822,5,home,16,24,8
5822,6,<ENDS>,24,24,0
5823,0,<START>,0,0,0
5823,1,home,0,7,7
5823,2,work,7,13,6
5823,3,home,13,23,10
5823,4,work,23,24,1
5823,5,<ENDS>,24,24,0
5824,0,<START>,0,0,0
5824,1,home,0,7,7
5824,2,work,7,13,6
5824,3,home,13,22,9
5824,4,work,22,23,1
5824,5,home,23,24,1
5824,6,<ENDS>,24,24,0
5825,0,<START>,0,0,0
5825,1,home,0,7,7
5825,2,work,7,9,2
5825,3,home,9,15,6
5825,4,work,15,17,2
5825,5,home,17,24,7
5825,6,<ENDS>,24,24,0
5826,0,<START>,0,0,0
5826,1,home,0,8,8
5826,2,work,8,15,7
5826,3,home,15,24,9
5826,4,<ENDS>,24,24,0
5827,0,<START>,0,0,0
5827,1,home,0,6,6
5827,2,shop,6,7,1
5827,3,home,7,9,2
5827,4,education,9,12,3
5827,5,shop,12,14,2
5827,6,home,14,20,6
5827,7,shop,20,21,1
5827,8,home,21,24,3
5827,9,<ENDS>,24,24,0
5828,0,<START>,0,0,0
5828,1,home,0,7,7
5828,2,work,7,14,7
5828,3,home,14,24,10
5828,4,<ENDS>,24,24,0
5829,0,<START>,0,0,0
5829,1,home,0,6,6
5829,2,work,6,14,8
5829,3,home,14,17,3
5829,4,work,17,20,3
5829,5,home,20,24,4
5829,6,<ENDS>,24,24,0
5830,0,<START>,0,0,0
5830,1,home,0,6,6
5830,2,work,6,13,7
5830,3,home,13,18,5
5830,4,work,18,20,2
5830,5,home,20,24,4
5830,6,<ENDS>,24,24,0
5831,0,<START>,0,0,0
5831,1,home,0,6,6
5831,2,work,6,13,7
5831,3,shop,13,14,1
5831,4,work,14,18,4
5831,5,home,18,24,6
5831,6,<ENDS>,24,24,0
5832,0,<START>,0,0,0
5832,1,home,0,6,6
5832,2,work,6,13,7
5832,3,home,13,24,11
5832,4,<ENDS>,24,24,0
5833,0,<START>,0,0,0
5833,1,home,0,6,6
5833,2,shop,6,7,1
5833,3,home,7,9,2
5833,4,education,9,12,3
5833,5,shop,12,14,2
5833,6,home,14,24,10
5833,7,<ENDS>,24,24,0
5834,0,<START>,0,0,0
5834,1,home,0,7,7
5834,2,work,7,14,7
5834,3,home,14,23,9
5834,4,work,23,24,1
5834,5,<ENDS>,24,24,0
5835,0,<START>,0,0,0
5835,1,home,0,7,7
5835,2,work,7,14,7
5835,3,shop,14,15,1
5835,4,home,15,24,9
5835,5,<ENDS>,24,24,0
5836,0,<START>,0,0,0
5836,1,home,0,7,7
5836,2,education,7,10,3
5836,3,home,10,18,8
5836,4,shop,18,20,2
5836,5,home,20,24,4
5836,6,<ENDS>,24,24,0
5837,0,<START>,0,0,0
5837,1,home,0,6,6
5837,2,shop,6,7,1
5837,3,home,7,9,2
5837,4,work,9,16,7
5837,5,home,16,24,8
5837,6,<ENDS>,24,24,0
5838,0,<START>,0,0,0
5838,1,home,0,7,7
5838,2,education,7,11,4
5838,3,home,11,18,7
5838,4,shop,18,19,1
5838,5,home,19,24,5
5838,6,<ENDS>,24,24,0
5839,0,<START>,0,0,0
5839,1,home,0,8,8
5839,2,education,8,12,4
5839,3,home,12,24,12
5839,4,<ENDS>,24,24,0
5840,0,<START>,0,0,0
5840,1,home,0,6,6
5840,2,shop,6,7,1
5840,3,home,7,13,6
5840,4,work,13,19,6
5840,5,home,19,24,5
5840,6,<ENDS>,24,24,0
5841,0,<START>,0,0,0
5841,1,home,0,8,8
5841,2,work,8,13,5
5841,3,shop,13,14,1
5841,4,work,14,19,5
5841,5,home,19,24,5
5841,6,<ENDS>,24,24,0
5842,0,<START>,0,0,0
5842,1,home,0,7,7
5842,2,work,7,14,7
5842,3,home,14,24,10
5842,4,<ENDS>,24,24,0
5843,0,<START>,0,0,0
5843,1,home,0,6,6
5843,2,shop,6,7,1
5843,3,work,7,13,6
5843,4,shop,13,14,1
5843,5,home,14,24,10
5843,6,<ENDS>,24,24,0
5844,0,<START>,0,0,0
5844,1,home,0,8,8
5844,2,work,8,15,7
5844,3,home,15,24,9
5844,4,<ENDS>,24,24,0
5845,0,<START>,0,0,0
5845,1,home,0,7,7
5845,2,work,7,14,7
5845,3,shop,14,15,1
5845,4,work,15,19,4
5845,5,home,19,24,5
5845,6,<ENDS>,24,24,0
5846,0,<START>,0,0,0
5846,1,home,0,8,8
5846,2,work,8,14,6
5846,3,home,14,20,6
5846,4,shop,20,21,1
5846,5,home,21,24,3
5846,6,<ENDS>,24,24,0
5847,0,<START>,0,0,0
5847,1,work,0,7,7
5847,2,shop,7,8,1
5847,3,home,8,15,7
5847,4,work,15,20,5
5847,5,home,20,24,4
5847,6,<ENDS>,24,24,0
5848,0,<START>,0,0,0
5848,1,home,0,7,7
5848,2,education,7,12,5
5848,3,shop,12,14,2
5848,4,education,14,16,2
5848,5,shop,16,17,1
5848,6,home,17,24,7
5848,7,<ENDS>,24,24,0
5849,0,<START>,0,0,0
5849,1,home,0,7,7
5849,2,work,7,13,6
5849,3,home,13,17,4
5849,4,work,17,20,3
5849,5,home,20,24,4
5849,6,<ENDS>,24,24,0
5850,0,<START>,0,0,0
5850,1,home,0,6,6
5850,2,work,6,14,8
5850,3,home,14,18,4
5850,4,shop,18,19,1
5850,5,home,19,24,5
5850,6,<ENDS>,24,24,0
5851,0,<START>,0,0,0
5851,1,home,0,8,8
5851,2,work,8,14,6
5851,3,shop,14,15,1
5851,4,home,15,21,6
5851,5,work,21,22,1
5851,6,home,22,24,2
5851,7,<ENDS>,24,24,0
5852,0,<START>,0,0,0
5852,1,home,0,7,7
5852,2,education,7,12,5
5852,3,shop,12,14,2
5852,4,home,14,24,10
5852,5,<ENDS>,24,24,0
5853,0,<START>,0,0,0
5853,1,home,0,7,7
5853,2,work,7,14,7
5853,3,shop,14,15,1
5853,4,home,15,24,9
5853,5,<ENDS>,24,24,0
5854,0,<START>,0,0,0
5854,1,work,0,1,1
5854,2,home,1,8,7
5854,3,education,8,12,4
5854,4,shop,12,14,2
5854,5,home,14,20,6
5854,6,shop,20,21,1
5854,7,home,21,24,3
5854,8,<ENDS>,24,24,0
5855,0,<START>,0,0,0
5855,1,home,0,6,6
5855,2,work,6,13,7
5855,3,shop,13,14,1
5855,4,education,14,16,2
5855,5,shop,16,17,1
5855,6,home,17,24,7
5855,7,<ENDS>,24,24,0
5856,0,<START>,0,0,0
5856,1,home,0,8,8
5856,2,work,8,14,6
5856,3,shop,14,16,2
5856,4,work,16,20,4
5856,5,home,20,24,4
5856,6,<ENDS>,24,24,0
5857,0,<START>,0,0,0
5857,1,home,0,6,6
5857,2,work,6,12,6
5857,3,shop,12,13,1
5857,4,work,13,19,6
5857,5,home,19,24,5
5857,6,<ENDS>,24,24,0
5858,0,<START>,0,0,0
5858,1,home,0,6,6
5858,2,shop,6,7,1
5858,3,home,7,10,3
5858,4,education,10,11,1
5858,5,home,11,14,3
5858,6,education,14,16,2
5858,7,shop,16,17,1
5858,8,home,17,24,7
5858,9,<ENDS>,24,24,0
5859,0,<START>,0,0,0
5859,1,home,0,8,8
5859,2,education,8,12,4
5859,3,shop,12,14,2
5859,4,home,14,21,7
5859,5,shop,21,22,1
5859,6,home,22,24,2
5859,7,<ENDS>,24,24,0
5860,0,<START>,0,0,0
5860,1,home,0,9,9
5860,2,education,9,12,3
5860,3,shop,12,13,1
5860,4,work,13,19,6
5860,5,home,19,24,5
5860,6,<ENDS>,24,24,0
5861,0,<START>,0,0,0
5861,1,home,0,7,7
5861,2,education,7,11,4
5861,3,home,11,14,3
5861,4,education,14,16,2
5861,5,home,16,24,8
5861,6,<ENDS>,24,24,0
5862,0,<START>,0,0,0
5862,1,home,0,8,8
5862,2,work,8,16,8
5862,3,home,16,24,8
5862,4,<ENDS>,24,24,0
5863,0,<START>,0,0,0
5863,1,home,0,6,6
5863,2,shop,6,7,1
5863,3,home,7,9,2
5863,4,education,9,12,3
5863,5,home,12,19,7
5863,6,shop,19,20,1
5863,7,home,20,24,4
5863,8,<ENDS>,24,24,0
5864,0,<START>,0,0,0
5864,1,home,0,8,8
5864,2,work,8,15,7
5864,3,home,15,22,7
5864,4,work,22,23,1
5864,5,home,23,24,1
5864,6,<ENDS>,24,24,0
5865,0,<START>,0,0,0
5865,1,home,0,7,7
5865,2,work,7,14,7
5865,3,home,14,19,5
5865,4,shop,19,20,1
5865,5,home,20,24,4
5865,6,<ENDS>,24,24,0
5866,0,<START>,0,0,0
5866,1,home,0,8,8
5866,2,work,8,10,2
5866,3,home,10,15,5
5866,4,work,15,19,4
5866,5,home,19,24,5
5866,6,<ENDS>,24,24,0
5867,0,<START>,0,0,0
5867,1,home,0,6,6
5867,2,work,6,13,7
5867,3,home,13,24,11
5867,4,<ENDS>,24,24,0
5868,0,<START>,0,0,0
5868,1,home,0,7,7
5868,2,work,7,14,7
5868,3,shop,14,15,1
5868,4,home,15,24,9
5868,5,<ENDS>,24,24,0
5869,0,<START>,0,0,0
5869,1,home,0,7,7
5869,2,education,7,11,4
5869,3,home,11,14,3
5869,4,education,14,16,2
5869,5,home,16,24,8
5869,6,<ENDS>,24,24,0
5870,0,<START>,0,0,0
5870,1,home,0,8,8
5870,2,work,8,13,5
5870,3,shop,13,14,1
5870,4,education,14,17,3
5870,5,shop,17,18,1
5870,6,home,18,24,6
5870,7,<ENDS>,24,24,0
5871,0,<START>,0,0,0
5871,1,home,0,7,7
5871,2,work,7,9,2
5871,3,home,9,13,4
5871,4,work,13,15,2
5871,5,home,15,21,6
5871,6,work,21,22,1
5871,7,home,22,24,2
5871,8,<ENDS>,24,24,0
5872,0,<START>,0,0,0
5872,1,home,0,7,7
5872,2,education,7,12,5
5872,3,shop,12,13,1
5872,4,education,13,16,3
5872,5,home,16,24,8
5872,6,<ENDS>,24,24,0
5873,0,<START>,0,0,0
5873,1,home,0,6,6
5873,2,shop,6,7,1
5873,3,home,7,10,3
5873,4,education,10,12,2
5873,5,home,12,18,6
5873,6,shop,18,19,1
5873,7,home,19,24,5
5873,8,<ENDS>,24,24,0
5874,0,<START>,0,0,0
5874,1,home,0,8,8
5874,2,education,8,11,3
5874,3,home,11,17,6
5874,4,shop,17,19,2
5874,5,home,19,24,5
5874,6,<ENDS>,24,24,0
5875,0,<START>,0,0,0
5875,1,home,0,6,6
5875,2,shop,6,7,1
5875,3,home,7,10,3
5875,4,education,10,13,3
5875,5,shop,13,15,2
5875,6,home,15,24,9
5875,7,<ENDS>,24,24,0
5876,0,<START>,0,0,0
5876,1,home,0,6,6
5876,2,work,6,13,7
5876,3,home,13,24,11
5876,4,<ENDS>,24,24,0
5877,0,<START>,0,0,0
5877,1,home,0,7,7
5877,2,work,7,14,7
5877,3,home,14,24,10
5877,4,<ENDS>,24,24,0
5878,0,<START>,0,0,0
5878,1,home,0,6,6
5878,2,shop,6,7,1
5878,3,home,7,9,2
5878,4,education,9,11,2
5878,5,home,11,19,8
5878,6,shop,19,20,1
5878,7,home,20,24,4
5878,8,<ENDS>,24,24,0
5879,0,<START>,0,0,0
5879,1,home,0,6,6
5879,2,shop,6,7,1
5879,3,work,7,13,6
5879,4,shop,13,14,1
5879,5,home,14,24,10
5879,6,<ENDS>,24,24,0
5880,0,<START>,0,0,0
5880,1,home,0,7,7
5880,2,work,7,13,6
5880,3,home,13,19,6
5880,4,shop,19,20,1
5880,5,home,20,24,4
5880,6,<ENDS>,24,24,0
5881,0,<START>,0,0,0
5881,1,home,0,7,7
5881,2,work,7,14,7
5881,3,home,14,18,4
5881,4,work,18,20,2
5881,5,home,20,24,4
5881,6,<ENDS>,24,24,0
5882,0,<START>,0,0,0
5882,1,home,0,7,7
5882,2,education,7,9,2
5882,3,home,9,15,6
5882,4,shop,15,17,2
5882,5,home,17,21,4
5882,6,shop,21,22,1
5882,7,home,22,24,2
5882,8,<ENDS>,24,24,0
5883,0,<START>,0,0,0
5883,1,home,0,6,6
5883,2,shop,6,7,1
5883,3,home,7,9,2
5883,4,education,9,12,3
5883,5,home,12,20,8
5883,6,shop,20,21,1
5883,7,home,21,24,3
5883,8,<ENDS>,24,24,0
5884,0,<START>,0,0,0
5884,1,home,0,6,6
5884,2,shop,6,7,1
5884,3,home,7,10,3
5884,4,education,10,13,3
5884,5,shop,13,15,2
5884,6,home,15,21,6
5884,7,shop,21,22,1
5884,8,home,22,24,2
5884,9,<ENDS>,24,24,0
5885,0,<START>,0,0,0
5885,1,home,0,9,9
5885,2,work,9,17,8
5885,3,home,17,23,6
5885,4,work,23,24,1
5885,5,<ENDS>,24,24,0
5886,0,<START>,0,0,0
5886,1,home,0,6,6
5886,2,work,6,13,7
5886,3,shop,13,14,1
5886,4,work,14,20,6
5886,5,home,20,24,4
5886,6,<ENDS>,24,24,0
5887,0,<START>,0,0,0
5887,1,home,0,6,6
5887,2,work,6,8,2
5887,3,home,8,12,4
5887,4,work,12,14,2
5887,5,home,14,21,7
5887,6,work,21,22,1
5887,7,home,22,24,2
5887,8,<ENDS>,24,24,0
5888,0,<START>,0,0,0
5888,1,home,0,7,7
5888,2,shop,7,8,1
5888,3,education,8,12,4
5888,4,shop,12,14,2
5888,5,education,14,16,2
5888,6,home,16,24,8
5888,7,<ENDS>,24,24,0
5889,0,<START>,0,0,0
5889,1,home,0,6,6
5889,2,shop,6,7,1
5889,3,home,7,9,2
5889,4,education,9,12,3
5889,5,home,12,13,1
5889,6,education,13,15,2
5889,7,shop,15,16,1
5889,8,home,16,24,8
5889,9,<ENDS>,24,24,0
5890,0,<START>,0,0,0
5890,1,home,0,7,7
5890,2,shop,7,8,1
5890,3,home,8,13,5
5890,4,education,13,16,3
5890,5,home,16,24,8
5890,6,<ENDS>,24,24,0
5891,0,<START>,0,0,0
5891,1,home,0,7,7
5891,2,shop,7,8,1
5891,3,work,8,15,7
5891,4,home,15,24,9
5891,5,<ENDS>,24,24,0
5892,0,<START>,0,0,0
5892,1,home,0,8,8
5892,2,education,8,12,4
5892,3,home,12,19,7
5892,4,shop,19,21,2
5892,5,home,21,24,3
5892,6,<ENDS>,24,24,0
5893,0,<START>,0,0,0
5893,1,home,0,7,7
5893,2,education,7,11,4
5893,3,home,11,19,8
5893,4,shop,19,21,2
5893,5,home,21,24,3
5893,6,<ENDS>,24,24,0
5894,0,<START>,0,0,0
5894,1,home,0,8,8
5894,2,work,8,14,6
5894,3,shop,14,15,1
5894,4,home,15,24,9
5894,5,<ENDS>,24,24,0
5895,0,<START>,0,0,0
5895,1,home,0,6,6
5895,2,work,6,7,1
5895,3,home,7,9,2
5895,4,work,9,11,2
5895,5,home,11,16,5
5895,6,work,16,19,3
5895,7,home,19,24,5
5895,8,<ENDS>,24,24,0
5896,0,<START>,0,0,0
5896,1,home,0,8,8
5896,2,work,8,15,7
5896,3,home,15,24,9
5896,4,<ENDS>,24,24,0
5897,0,<START>,0,0,0
5897,1,home,0,7,7
5897,2,education,7,12,5
5897,3,shop,12,14,2
5897,4,education,14,16,2
5897,5,shop,16,17,1
5897,6,home,17,24,7
5897,7,<ENDS>,24,24,0
5898,0,<START>,0,0,0
5898,1,home,0,8,8
5898,2,work,8,15,7
5898,3,shop,15,16,1
5898,4,work,16,20,4
5898,5,home,20,24,4
5898,6,<ENDS>,24,24,0
5899,0,<START>,0,0,0
5899,1,home,0,6,6
5899,2,work,6,13,7
5899,3,home,13,17,4
5899,4,work,17,19,2
5899,5,home,19,24,5
5899,6,<ENDS>,24,24,0
5900,0,<START>,0,0,0
5900,1,home,0,6,6
5900,2,work,6,13,7
5900,3,shop,13,14,1
5900,4,home,14,23,9
5900,5,work,23,24,1
5900,6,<ENDS>,24,24,0
5901,0,<START>,0,0,0
5901,1,home,0,7,7
5901,2,work,7,14,7
5901,3,shop,14,15,1
5901,4,home,15,23,8
5901,5,work,23,24,1
5901,6,<ENDS>,24,24,0
5902,0,<START>,0,0,0
5902,1,home,0,7,7
5902,2,education,7,11,4
5902,3,home,11,19,8
5902,4,shop,19,21,2
5902,5,home,21,24,3
5902,6,<ENDS>,24,24,0
5903,0,<START>,0,0,0
5903,1,home,0,8,8
5903,2,work,8,14,6
5903,3,shop,14,15,1
5903,4,home,15,23,8
5903,5,work,23,24,1
5903,6,<ENDS>,24,24,0
5904,0,<START>,0,0,0
5904,1,home,0,7,7
5904,2,work,7,13,6
5904,3,shop,13,14,1
5904,4,work,14,19,5
5904,5,home,19,24,5
5904,6,<ENDS>,24,24,0
5905,0,<START>,0,0,0
5905,1,home,0,7,7
5905,2,work,7,14,7
5905,3,home,14,21,7
5905,4,work,21,22,1
5905,5,home,22,24,2
5905,6,<ENDS>,24,24,0
5906,0,<START>,0,0,0
5906,1,home,0,6,6
5906,2,work,6,13,7
5906,3,shop,13,14,1
5906,4,home,14,23,9
5906,5,work,23,24,1
5906,6,<ENDS>,24,24,0
5907,0,<START>,0,0,0
5907,1,home,0,7,7
5907,2,work,7,14,7
5907,3,shop,14,15,1
5907,4,work,15,20,5
5907,5,home,20,24,4
5907,6,<ENDS>,24,24,0
5908,0,<START>,0,0,0
5908,1,home,0,7,7
5908,2,work,7,13,6
5908,3,shop,13,14,1
5908,4,home,14,24,10
5908,5,<ENDS>,24,24,0
5909,0,<START>,0,0,0
5909,1,home,0,7,7
5909,2,work,7,13,6
5909,3,home,13,18,5
5909,4,work,18,20,2
5909,5,home,20,24,4
5909,6,<ENDS>,24,24,0
5910,0,<START>,0,0,0
5910,1,home,0,8,8
5910,2,work,8,16,8
5910,3,home,16,21,5
5910,4,work,21,22,1
5910,5,home,22,24,2
5910,6,<ENDS>,24,24,0
5911,0,<START>,0,0,0
5911,1,home,0,6,6
5911,2,work,6,13,7
5911,3,home,13,18,5
5911,4,shop,18,19,1
5911,5,home,19,24,5
5911,6,<ENDS>,24,24,0
5912,0,<START>,0,0,0
5912,1,home,0,7,7
5912,2,education,7,11,4
5912,3,home,11,15,4
5912,4,shop,15,17,2
5912,5,home,17,24,7
5912,6,<ENDS>,24,24,0
5913,0,<START>,0,0,0
5913,1,home,0,7,7
5913,2,work,7,14,7
5913,3,shop,14,15,1
5913,4,work,15,20,5
5913,5,home,20,24,4
5913,6,<ENDS>,24,24,0
5914,0,<START>,0,0,0
5914,1,home,0,6,6
5914,2,work,6,13,7
5914,3,home,13,24,11
5914,4,<ENDS>,24,24,0
5915,0,<START>,0,0,0
5915,1,home,0,6,6
5915,2,shop,6,7,1
5915,3,work,7,13,6
5915,4,home,13,24,11
5915,5,<ENDS>,24,24,0
5916,0,<START>,0,0,0
5916,1,home,0,7,7
5916,2,work,7,13,6
5916,3,home,13,17,4
5916,4,work,17,20,3
5916,5,home,20,24,4
5916,6,<ENDS>,24,24,0
5917,0,<START>,0,0,0
5917,1,home,0,8,8
5917,2,education,8,11,3
5917,3,shop,11,12,1
5917,4,home,12,23,11
5917,5,work,23,24,1
5917,6,<ENDS>,24,24,0
5918,0,<START>,0,0,0
5918,1,home,0,6,6
5918,2,work,6,8,2
5918,3,home,8,14,6
5918,4,work,14,17,3
5918,5,home,17,24,7
5918,6,<ENDS>,24,24,0
5919,0,<START>,0,0,0
5919,1,home,0,7,7
5919,2,work,7,9,2
5919,3,home,9,15,6
5919,4,work,15,17,2
5919,5,home,17,24,7
5919,6,<ENDS>,24,24,0
5920,0,<START>,0,0,0
5920,1,home,0,7,7
5920,2,education,7,11,4
5920,3,home,11,18,7
5920,4,shop,18,19,1
5920,5,home,19,24,5
5920,6,<ENDS>,24,24,0
5921,0,<START>,0,0,0
5921,1,home,0,7,7
5921,2,shop,7,8,1
5921,3,education,8,11,3
5921,4,home,11,19,8
5921,5,shop,19,21,2
5921,6,home,21,24,3
5921,7,<ENDS>,24,24,0
5922,0,<START>,0,0,0
5922,1,home,0,8,8
5922,2,work,8,15,7
5922,3,home,15,24,9
5922,4,<ENDS>,24,24,0
5923,0,<START>,0,0,0
5923,1,home,0,8,8
5923,2,work,8,15,7
5923,3,home,15,19,4
5923,4,shop,19,20,1
5923,5,home,20,24,4
5923,6,<ENDS>,24,24,0
5924,0,<START>,0,0,0
5924,1,home,0,6,6
5924,2,work,6,13,7
5924,3,home,13,17,4
5924,4,work,17,20,3
5924,5,home,20,24,4
5924,6,<ENDS>,24,24,0
5925,0,<START>,0,0,0
5925,1,home,0,9,9
5925,2,work,9,16,7
5925,3,home,16,24,8
5925,4,<ENDS>,24,24,0
5926,0,<START>,0,0,0
5926,1,home,0,7,7
5926,2,work,7,14,7
5926,3,shop,14,15,1
5926,4,work,15,20,5
5926,5,home,20,24,4
5926,6,<ENDS>,24,24,0
5927,0,<START>,0,0,0
5927,1,home,0,8,8
5927,2,work,8,15,7
5927,3,home,15,19,4
5927,4,shop,19,20,1
5927,5,home,20,24,4
5927,6,<ENDS>,24,24,0
5928,0,<START>,0,0,0
5928,1,home,0,7,7
5928,2,work,7,11,4
5928,3,shop,11,12,1
5928,4,work,12,18,6
5928,5,home,18,24,6
5928,6,<ENDS>,24,24,0
5929,0,<START>,0,0,0
5929,1,home,0,8,8
5929,2,work,8,15,7
5929,3,home,15,24,9
5929,4,<ENDS>,24,24,0
5930,0,<START>,0,0,0
5930,1,home,0,7,7
5930,2,shop,7,8,1
5930,3,education,8,11,3
5930,4,home,11,17,6
5930,5,shop,17,19,2
5930,6,home,19,24,5
5930,7,<ENDS>,24,24,0
5931,0,<START>,0,0,0
5931,1,home,0,7,7
5931,2,education,7,11,4
5931,3,home,11,18,7
5931,4,shop,18,19,1
5931,5,home,19,24,5
5931,6,<ENDS>,24,24,0
5932,0,<START>,0,0,0
5932,1,home,0,8,8
5932,2,work,8,13,5
5932,3,home,13,17,4
5932,4,work,17,20,3
5932,5,home,20,24,4
5932,6,<ENDS>,24,24,0
5933,0,<START>,0,0,0
5933,1,home,0,6,6
5933,2,work,6,13,7
5933,3,home,13,24,11
5933,4,<ENDS>,24,24,0
5934,0,<START>,0,0,0
5934,1,home,0,7,7
5934,2,work,7,14,7
5934,3,home,14,24,10
5934,4,<ENDS>,24,24,0
5935,0,<START>,0,0,0
5935,1,home,0,8,8
5935,2,work,8,13,5
5935,3,home,13,18,5
5935,4,work,18,19,1
5935,5,home,19,24,5
5935,6,<ENDS>,24,24,0
5936,0,<START>,0,0,0
5936,1,home,0,9,9
5936,2,work,9,17,8
5936,3,home,17,24,7
5936,4,<ENDS>,24,24,0
5937,0,<START>,0,0,0
5937,1,home,0,7,7
5937,2,work,7,13,6
5937,3,home,13,24,11
5937,4,<ENDS>,24,24,0
5938,0,<START>,0,0,0
5938,1,home,0,9,9
5938,2,work,9,16,7
5938,3,shop,16,17,1
5938,4,work,17,20,3
5938,5,home,20,24,4
5938,6,<ENDS>,24,24,0
5939,0,<START>,0,0,0
5939,1,home,0,9,9
5939,2,work,9,15,6
5939,3,home,15,22,7
5939,4,work,22,23,1
5939,5,home,23,24,1
5939,6,<ENDS>,24,24,0
5940,0,<START>,0,0,0
5940,1,home,0,6,6
5940,2,work,6,13,7
5940,3,home,13,24,11
5940,4,<ENDS>,24,24,0
5941,0,<START>,0,0,0
5941,1,home,0,8,8
5941,2,education,8,14,6
5941,3,shop,14,15,1
5941,4,home,15,24,9
5941,5,<ENDS>,24,24,0
5942,0,<START>,0,0,0
5942,1,home,0,7,7
5942,2,education,7,11,4
5942,3,home,11,18,7
5942,4,shop,18,19,1
5942,5,home,19,24,5
5942,6,<ENDS>,24,24,0
5943,0,<START>,0,0,0
5943,1,home,0,8,8
5943,2,work,8,14,6
5943,3,shop,14,15,1
5943,4,home,15,18,3
5943,5,work,18,20,2
5943,6,home,20,24,4
5943,7,<ENDS>,24,24,0
5944,0,<START>,0,0,0
5944,1,home,0,9,9
5944,2,work,9,15,6
5944,3,home,15,23,8
5944,4,work,23,24,1
5944,5,<ENDS>,24,24,0
5945,0,<START>,0,0,0
5945,1,home,0,8,8
5945,2,education,8,11,3
5945,3,home,11,24,13
5945,4,<ENDS>,24,24,0
5946,0,<START>,0,0,0
5946,1,home,0,9,9
5946,2,work,9,14,5
5946,3,home,14,21,7
5946,4,work,21,22,1
5946,5,home,22,24,2
5946,6,<ENDS>,24,24,0
5947,0,<START>,0,0,0
5947,1,home,0,6,6
5947,2,shop,6,7,1
5947,3,work,7,13,6
5947,4,home,13,24,11
5947,5,<ENDS>,24,24,0
5948,0,<START>,0,0,0
5948,1,home,0,7,7
5948,2,education,7,12,5
5948,3,shop,12,14,2
5948,4,education,14,16,2
5948,5,shop,16,17,1
5948,6,home,17,24,7
5948,7,<ENDS>,24,24,0
5949,0,<START>,0,0,0
5949,1,home,0,6,6
5949,2,work,6,13,7
5949,3,home,13,24,11
5949,4,<ENDS>,24,24,0
5950,0,<START>,0,0,0
5950,1,home,0,6,6
5950,2,shop,6,7,1
5950,3,home,7,9,2
5950,4,education,9,12,3
5950,5,shop,12,14,2
5950,6,education,14,16,2
5950,7,home,16,20,4
5950,8,shop,20,21,1
5950,9,home,21,24,3
5950,10,<ENDS>,24,24,0
5951,0,<START>,0,0,0
5951,1,home,0,8,8
5951,2,work,8,13,5
5951,3,shop,13,14,1
5951,4,work,14,20,6
5951,5,home,20,24,4
5951,6,<ENDS>,24,24,0
5952,0,<START>,0,0,0
5952,1,home,0,7,7
5952,2,education,7,12,5
5952,3,home,12,19,7
5952,4,shop,19,20,1
5952,5,home,20,24,4
5952,6,<ENDS>,24,24,0
5953,0,<START>,0,0,0
5953,1,work,0,7,7
5953,2,shop,7,8,1
5953,3,home,8,13,5
5953,4,work,13,17,4
5953,5,home,17,24,7
5953,6,<ENDS>,24,24,0
5954,0,<START>,0,0,0
5954,1,home,0,7,7
5954,2,shop,7,9,2
5954,3,education,9,12,3
5954,4,home,12,20,8
5954,5,shop,20,21,1
5954,6,home,21,24,3
5954,7,<ENDS>,24,24,0
5955,0,<START>,0,0,0
5955,1,home,0,7,7
5955,2,education,7,11,4
5955,3,home,11,15,4
5955,4,shop,15,16,1
5955,5,home,16,24,8
5955,6,<ENDS>,24,24,0
5956,0,<START>,0,0,0
5956,1,home,0,6,6
5956,2,work,6,13,7
5956,3,home,13,24,11
5956,4,<ENDS>,24,24,0
5957,0,<START>,0,0,0
5957,1,home,0,7,7
5957,2,work,7,13,6
5957,3,home,13,24,11
5957,4,<ENDS>,24,24,0
5958,0,<START>,0,0,0
5958,1,home,0,8,8
5958,2,work,8,15,7
5958,3,home,15,21,6
5958,4,work,21,22,1
5958,5,home,22,24,2
5958,6,<ENDS>,24,24,0
5959,0,<START>,0,0,0
5959,1,home,0,8,8
5959,2,work,8,13,5
5959,3,home,13,24,11
5959,4,<ENDS>,24,24,0
5960,0,<START>,0,0,0
5960,1,home,0,7,7
5960,2,work,7,13,6
5960,3,shop,13,15,2
5960,4,work,15,20,5
5960,5,home,20,24,4
5960,6,<ENDS>,24,24,0
5961,0,<START>,0,0,0
5961,1,home,0,6,6
5961,2,work,6,13,7
5961,3,home,13,18,5
5961,4,shop,18,19,1
5961,5,home,19,24,5
5961,6,<ENDS>,24,24,0
5962,0,<START>,0,0,0
5962,1,home,0,8,8
5962,2,work,8,16,8
5962,3,home,16,24,8
5962,4,<ENDS>,24,24,0
5963,0,<START>,0,0,0
5963,1,home,0,7,7
5963,2,shop,7,8,1
5963,3,education,8,11,3
5963,4,home,11,16,5
5963,5,shop,16,17,1
5963,6,home,17,24,7
5963,7,<ENDS>,24,24,0
5964,0,<START>,0,0,0
5964,1,home,0,7,7
5964,2,work,7,13,6
5964,3,home,13,19,6
5964,4,shop,19,20,1
5964,5,home,20,24,4
5964,6,<ENDS>,24,24,0
5965,0,<START>,0,0,0
5965,1,home,0,7,7
5965,2,work,7,14,7
5965,3,home,14,21,7
5965,4,work,21,22,1
5965,5,home,22,24,2
5965,6,<ENDS>,24,24,0
5966,0,<START>,0,0,0
5966,1,home,0,8,8
5966,2,work,8,13,5
5966,3,home,13,16,3
5966,4,work,16,20,4
5966,5,home,20,24,4
5966,6,<ENDS>,24,24,0
5967,0,<START>,0,0,0
5967,1,home,0,8,8
5967,2,shop,8,9,1
5967,3,home,9,14,5
5967,4,shop,14,15,1
5967,5,home,15,22,7
5967,6,work,22,23,1
5967,7,home,23,24,1
5967,8,<ENDS>,24,24,0
5968,0,<START>,0,0,0
5968,1,home,0,7,7
5968,2,work,7,13,6
5968,3,home,13,24,11
5968,4,<ENDS>,24,24,0
5969,0,<START>,0,0,0
5969,1,home,0,6,6
5969,2,shop,6,7,1
5969,3,home,7,10,3
5969,4,education,10,16,6
5969,5,home,16,24,8
5969,6,<ENDS>,24,24,0
5970,0,<START>,0,0,0
5970,1,home,0,7,7
5970,2,shop,7,8,1
5970,3,education,8,11,3
5970,4,home,11,18,7
5970,5,shop,18,19,1
5970,6,home,19,24,5
5970,7,<ENDS>,24,24,0
5971,0,<START>,0,0,0
5971,1,home,0,6,6
5971,2,work,6,13,7
5971,3,shop,13,14,1
5971,4,work,14,20,6
5971,5,home,20,24,4
5971,6,<ENDS>,24,24,0
5972,0,<START>,0,0,0
5972,1,home,0,7,7
5972,2,shop,7,8,1
5972,3,home,8,9,1
5972,4,education,9,12,3
5972,5,home,12,24,12
5972,6,<ENDS>,24,24,0
5973,0,<START>,0,0,0
5973,1,home,0,6,6
5973,2,shop,6,7,1
5973,3,home,7,13,6
5973,4,education,13,17,4
5973,5,shop,17,18,1
5973,6,home,18,24,6
5973,7,<ENDS>,24,24,0
5974,0,<START>,0,0,0
5974,1,home,0,6,6
5974,2,work,6,13,7
5974,3,home,13,24,11
5974,4,<ENDS>,24,24,0
5975,0,<START>,0,0,0
5975,1,home,0,6,6
5975,2,work,6,13,7
5975,3,home,13,24,11
5975,4,<ENDS>,24,24,0
5976,0,<START>,0,0,0
5976,1,home,0,8,8
5976,2,education,8,12,4
5976,3,home,12,18,6
5976,4,work,18,20,2
5976,5,home,20,24,4
5976,6,<ENDS>,24,24,0
5977,0,<START>,0,0,0
5977,1,home,0,7,7
5977,2,work,7,14,7
5977,3,shop,14,15,1
5977,4,work,15,19,4
5977,5,home,19,24,5
5977,6,<ENDS>,24,24,0
5978,0,<START>,0,0,0
5978,1,home,0,6,6
5978,2,work,6,7,1
5978,3,home,7,9,2
5978,4,work,9,11,2
5978,5,home,11,17,6
5978,6,work,17,19,2
5978,7,home,19,24,5
5978,8,<ENDS>,24,24,0
5979,0,<START>,0,0,0
5979,1,home,0,7,7
5979,2,work,7,13,6
5979,3,shop,13,14,1
5979,4,home,14,23,9
5979,5,work,23,24,1
5979,6,<ENDS>,24,24,0
5980,0,<START>,0,0,0
5980,1,home,0,7,7
5980,2,work,7,13,6
5980,3,home,13,24,11
5980,4,<ENDS>,24,24,0
5981,0,<START>,0,0,0
5981,1,home,0,7,7
5981,2,shop,7,8,1
5981,3,work,8,15,7
5981,4,home,15,24,9
5981,5,<ENDS>,24,24,0
5982,0,<START>,0,0,0
5982,1,home,0,6,6
5982,2,work,6,13,7
5982,3,home,13,17,4
5982,4,work,17,20,3
5982,5,home,20,24,4
5982,6,<ENDS>,24,24,0
5983,0,<START>,0,0,0
5983,1,home,0,6,6
5983,2,work,6,13,7
5983,3,home,13,21,8
5983,4,work,21,22,1
5983,5,home,22,24,2
5983,6,<ENDS>,24,24,0
5984,0,<START>,0,0,0
5984,1,home,0,7,7
5984,2,work,7,8,1
5984,3,home,8,14,6
5984,4,work,14,16,2
5984,5,home,16,21,5
5984,6,work,21,22,1
5984,7,home,22,24,2
5984,8,<ENDS>,24,24,0
5985,0,<START>,0,0,0
5985,1,home,0,7,7
5985,2,shop,7,8,1
5985,3,home,8,13,5
5985,4,education,13,15,2
5985,5,work,15,20,5
5985,6,home,20,24,4
5985,7,<ENDS>,24,24,0
5986,0,<START>,0,0,0
5986,1,home,0,7,7
5986,2,work,7,14,7
5986,3,home,14,18,4
5986,4,shop,18,19,1
5986,5,home,19,24,5
5986,6,<ENDS>,24,24,0
5987,0,<START>,0,0,0
5987,1,home,0,6,6
5987,2,work,6,13,7
5987,3,home,13,17,4
5987,4,work,17,20,3
5987,5,home,20,24,4
5987,6,<ENDS>,24,24,0
5988,0,<START>,0,0,0
5988,1,home,0,7,7
5988,2,work,7,14,7
5988,3,shop,14,15,1
5988,4,work,15,20,5
5988,5,home,20,24,4
5988,6,<ENDS>,24,24,0
5989,0,<START>,0,0,0
5989,1,home,0,6,6
5989,2,shop,6,7,1
5989,3,home,7,16,9
5989,4,work,16,20,4
5989,5,home,20,24,4
5989,6,<ENDS>,24,24,0
5990,0,<START>,0,0,0
5990,1,home,0,6,6
5990,2,shop,6,7,1
5990,3,home,7,10,3
5990,4,education,10,13,3
5990,5,shop,13,15,2
5990,6,home,15,21,6
5990,7,shop,21,22,1
5990,8,home,22,24,2
5990,9,<ENDS>,24,24,0
5991,0,<START>,0,0,0
5991,1,home,0,8,8
5991,2,shop,8,9,1
5991,3,home,9,14,5
5991,4,shop,14,15,1
5991,5,work,15,20,5
5991,6,home,20,24,4
5991,7,<ENDS>,24,24,0
5992,0,<START>,0,0,0
5992,1,home,0,8,8
5992,2,shop,8,9,1
5992,3,work,9,15,6
5992,4,home,15,24,9
5992,5,<ENDS>,24,24,0
5993,0,<START>,0,0,0
5993,1,home,0,7,7
5993,2,work,7,13,6
5993,3,home,13,23,10
5993,4,work,23,24,1
5993,5,<ENDS>,24,24,0
5994,0,<START>,0,0,0
5994,1,home,0,8,8
5994,2,education,8,12,4
5994,3,shop,12,13,1
5994,4,work,13,19,6
5994,5,home,19,24,5
5994,6,<ENDS>,24,24,0
5995,0,<START>,0,0,0
5995,1,home,0,7,7
5995,2,shop,7,8,1
5995,3,education,8,11,3
5995,4,home,11,14,3
5995,5,education,14,16,2
5995,6,home,16,21,5
5995,7,shop,21,22,1
5995,8,home,22,24,2
5995,9,<ENDS>,24,24,0
5996,0,<START>,0,0,0
5996,1,home,0,7,7
5996,2,work,7,14,7
5996,3,shop,14,15,1
5996,4,home,15,23,8
5996,5,work,23,24,1
5996,6,<ENDS>,24,24,0
5997,0,<START>,0,0,0
5997,1,home,0,8,8
5997,2,work,8,14,6
5997,3,home,14,24,10
5997,4,<ENDS>,24,24,0
5998,0,<START>,0,0,0
5998,1,home,0,7,7
5998,2,work,7,13,6
5998,3,shop,13,14,1
5998,4,work,14,19,5
5998,5,home,19,24,5
5998,6,<ENDS>,24,24,0
5999,0,<START>,0,0,0
5999,1,home,0,7,7
5999,2,work,7,13,6
5999,3,home,13,24,11
5999,4,<ENDS>,24,24,0
6000,0,<START>,0,0,0
6000,1,home,0,6,6
6000,2,work,6,8,2
6000,3,home,8,15,7
6000,4,work,15,17,2
6000,5,home,17,24,7
6000,6,<ENDS>,24,24,0
6001,0,<START>,0,0,0
6001,1,home,0,7,7
6001,2,work,7,14,7
6001,3,home,14,24,10
6001,4,<ENDS>,24,24,0
6002,0,<START>,0,0,0
6002,1,home,0,7,7
6002,2,shop,7,8,1
6002,3,home,8,9,1
6002,4,work,9,17,8
6002,5,home,17,24,7
6002,6,<ENDS>,24,24,0
6003,0,<START>,0,0,0
6003,1,home,0,6,6
6003,2,work,6,8,2
6003,3,home,8,13,5
6003,4,work,13,15,2
6003,5,home,15,21,6
6003,6,work,21,22,1
6003,7,home,22,24,2
6003,8,<ENDS>,24,24,0
6004,0,<START>,0,0,0
6004,1,home,0,7,7
6004,2,work,7,13,6
6004,3,shop,13,14,1
6004,4,home,14,21,7
6004,5,shop,21,22,1
6004,6,home,22,24,2
6004,7,<ENDS>,24,24,0
6005,0,<START>,0,0,0
6005,1,home,0,6,6
6005,2,work,6,13,7
6005,3,home,13,24,11
6005,4,<ENDS>,24,24,0
6006,0,<START>,0,0,0
6006,1,home,0,6,6
6006,2,work,6,12,6
6006,3,shop,12,13,1
6006,4,work,13,17,4
6006,5,home,17,24,7
6006,6,<ENDS>,24,24,0
6007,0,<START>,0,0,0
6007,1,home,0,7,7
6007,2,work,7,13,6
6007,3,shop,13,14,1
6007,4,work,14,19,5
6007,5,home,19,24,5
6007,6,<ENDS>,24,24,0
6008,0,<START>,0,0,0
6008,1,home,0,7,7
6008,2,work,7,14,7
6008,3,home,14,19,5
6008,4,shop,19,20,1
6008,5,home,20,24,4
6008,6,<ENDS>,24,24,0
6009,0,<START>,0,0,0
6009,1,home,0,6,6
6009,2,work,6,13,7
6009,3,home,13,21,8
6009,4,shop,21,22,1
6009,5,home,22,24,2
6009,6,<ENDS>,24,24,0
6010,0,<START>,0,0,0
6010,1,home,0,7,7
6010,2,work,7,13,6
6010,3,shop,13,14,1
6010,4,work,14,19,5
6010,5,home,19,24,5
6010,6,<ENDS>,24,24,0
6011,0,<START>,0,0,0
6011,1,home,0,6,6
6011,2,shop,6,7,1
6011,3,work,7,13,6
6011,4,home,13,23,10
6011,5,work,23,24,1
6011,6,<ENDS>,24,24,0
6012,0,<START>,0,0,0
6012,1,home,0,8,8
6012,2,education,8,11,3
6012,3,home,11,24,13
6012,4,<ENDS>,24,24,0
6013,0,<START>,0,0,0
6013,1,home,0,7,7
6013,2,work,7,13,6
6013,3,home,13,17,4
6013,4,work,17,20,3
6013,5,home,20,24,4
6013,6,<ENDS>,24,24,0
6014,0,<START>,0,0,0
6014,1,home,0,7,7
6014,2,work,7,13,6
6014,3,home,13,14,1
6014,4,work,14,20,6
6014,5,home,20,24,4
6014,6,<ENDS>,24,24,0
6015,0,<START>,0,0,0
6015,1,home,0,6,6
6015,2,shop,6,7,1
6015,3,home,7,10,3
6015,4,education,10,12,2
6015,5,home,12,19,7
6015,6,shop,19,20,1
6015,7,home,20,24,4
6015,8,<ENDS>,24,24,0
6016,0,<START>,0,0,0
6016,1,home,0,7,7
6016,2,shop,7,8,1
6016,3,education,8,11,3
6016,4,home,11,18,7
6016,5,shop,18,19,1
6016,6,home,19,24,5
6016,7,<ENDS>,24,24,0
6017,0,<START>,0,0,0
6017,1,home,0,7,7
6017,2,work,7,14,7
6017,3,shop,14,15,1
6017,4,home,15,19,4
6017,5,shop,19,20,1
6017,6,home,20,24,4
6017,7,<ENDS>,24,24,0
6018,0,<START>,0,0,0
6018,1,home,0,7,7
6018,2,education,7,11,4
6018,3,home,11,17,6
6018,4,shop,17,18,1
6018,5,home,18,24,6
6018,6,<ENDS>,24,24,0
6019,0,<START>,0,0,0
6019,1,home,0,7,7
6019,2,shop,7,8,1
6019,3,work,8,15,7
6019,4,home,15,24,9
6019,5,<ENDS>,24,24,0
6020,0,<START>,0,0,0
6020,1,home,0,7,7
6020,2,shop,7,9,2
6020,3,education,9,11,2
6020,4,home,11,18,7
6020,5,shop,18,19,1
6020,6,home,19,24,5
6020,7,<ENDS>,24,24,0
6021,0,<START>,0,0,0
6021,1,home,0,7,7
6021,2,work,7,13,6
6021,3,home,13,24,11
6021,4,<ENDS>,24,24,0
6022,0,<START>,0,0,0
6022,1,home,0,7,7
6022,2,work,7,14,7
6022,3,home,14,24,10
6022,4,<ENDS>,24,24,0
6023,0,<START>,0,0,0
6023,1,home,0,7,7
6023,2,work,7,14,7
6023,3,home,14,24,10
6023,4,<ENDS>,24,24,0
6024,0,<START>,0,0,0
6024,1,home,0,6,6
6024,2,work,6,8,2
6024,3,home,8,11,3
6024,4,work,11,13,2
6024,5,home,13,18,5
6024,6,shop,18,19,1
6024,7,home,19,24,5
6024,8,<ENDS>,24,24,0
6025,0,<START>,0,0,0
6025,1,home,0,7,7
6025,2,work,7,16,9
6025,3,home,16,23,7
6025,4,work,23,24,1
6025,5,<ENDS>,24,24,0
6026,0,<START>,0,0,0
6026,1,home,0,6,6
6026,2,shop,6,7,1
6026,3,home,7,11,4
6026,4,work,11,19,8
6026,5,education,19,20,1
6026,6,work,20,21,1
6026,7,home,21,24,3
6026,8,<ENDS>,24,24,0
6027,0,<START>,0,0,0
6027,1,home,0,7,7
6027,2,work,7,14,7
6027,3,home,14,19,5
6027,4,shop,19,20,1
6027,5,home,20,24,4
6027,6,<ENDS>,24,24,0
6028,0,<START>,0,0,0
6028,1,home,0,6,6
6028,2,shop,6,7,1
6028,3,home,7,10,3
6028,4,education,10,11,1
6028,5,home,11,18,7
6028,6,shop,18,20,2
6028,7,home,20,24,4
6028,8,<ENDS>,24,24,0
6029,0,<START>,0,0,0
6029,1,home,0,6,6
6029,2,work,6,13,7
6029,3,home,13,17,4
6029,4,shop,17,18,1
6029,5,home,18,23,5
6029,6,work,23,24,1
6029,7,<ENDS>,24,24,0
6030,0,<START>,0,0,0
6030,1,home,0,6,6
6030,2,work,6,8,2
6030,3,home,8,14,6
6030,4,work,14,17,3
6030,5,home,17,24,7
6030,6,<ENDS>,24,24,0
6031,0,<START>,0,0,0
6031,1,home,0,7,7
6031,2,shop,7,8,1
6031,3,home,8,9,1
6031,4,work,9,15,6
6031,5,home,15,24,9
6031,6,<ENDS>,24,24,0
6032,0,<START>,0,0,0
6032,1,home,0,7,7
6032,2,work,7,13,6
6032,3,shop,13,14,1
6032,4,work,14,20,6
6032,5,home,20,24,4
6032,6,<ENDS>,24,24,0
6033,0,<START>,0,0,0
6033,1,home,0,8,8
6033,2,work,8,14,6
6033,3,home,14,20,6
6033,4,shop,20,21,1
6033,5,home,21,24,3
6033,6,<ENDS>,24,24,0
6034,0,<START>,0,0,0
6034,1,home,0,7,7
6034,2,work,7,14,7
6034,3,shop,14,15,1
6034,4,home,15,24,9
6034,5,<ENDS>,24,24,0
6035,0,<START>,0,0,0
6035,1,home,0,7,7
6035,2,work,7,14,7
6035,3,home,14,24,10
6035,4,<ENDS>,24,24,0
6036,0,<START>,0,0,0
6036,1,home,0,7,7
6036,2,education,7,12,5
6036,3,shop,12,14,2
6036,4,education,14,16,2
6036,5,home,16,24,8
6036,6,<ENDS>,24,24,0
6037,0,<START>,0,0,0
6037,1,home,0,7,7
6037,2,work,7,13,6
6037,3,home,13,17,4
6037,4,work,17,20,3
6037,5,home,20,24,4
6037,6,<ENDS>,24,24,0
6038,0,<START>,0,0,0
6038,1,home,0,7,7
6038,2,education,7,11,4
6038,3,home,11,17,6
6038,4,shop,17,18,1
6038,5,home,18,24,6
6038,6,<ENDS>,24,24,0
6039,0,<START>,0,0,0
6039,1,home,0,7,7
6039,2,work,7,13,6
6039,3,shop,13,14,1
6039,4,home,14,16,2
6039,5,work,16,19,3
6039,6,home,19,24,5
6039,7,<ENDS>,24,24,0
6040,0,<START>,0,0,0
6040,1,home,0,9,9
6040,2,work,9,17,8
6040,3,home,17,21,4
6040,4,shop,21,22,1
6040,5,home,22,24,2
6040,6,<ENDS>,24,24,0
6041,0,<START>,0,0,0
6041,1,home,0,6,6
6041,2,shop,6,7,1
6041,3,home,7,13,6
6041,4,education,13,16,3
6041,5,shop,16,17,1
6041,6,home,17,24,7
6041,7,<ENDS>,24,24,0
6042,0,<START>,0,0,0
6042,1,home,0,6,6
6042,2,shop,6,7,1
6042,3,home,7,12,5
6042,4,education,12,16,4
6042,5,shop,16,18,2
6042,6,home,18,24,6
6042,7,<ENDS>,24,24,0
6043,0,<START>,0,0,0
6043,1,home,0,7,7
6043,2,shop,7,8,1
6043,3,education,8,11,3
6043,4,home,11,17,6
6043,5,shop,17,19,2
6043,6,home,19,24,5
6043,7,<ENDS>,24,24,0
6044,0,<START>,0,0,0
6044,1,home,0,6,6
6044,2,work,6,8,2
6044,3,home,8,15,7
6044,4,work,15,18,3
6044,5,home,18,22,4
6044,6,work,22,23,1
6044,7,home,23,24,1
6044,8,<ENDS>,24,24,0
6045,0,<START>,0,0,0
6045,1,home,0,6,6
6045,2,work,6,13,7
6045,3,shop,13,15,2
6045,4,work,15,20,5
6045,5,home,20,24,4
6045,6,<ENDS>,24,24,0
6046,0,<START>,0,0,0
6046,1,home,0,6,6
6046,2,shop,6,7,1
6046,3,home,7,13,6
6046,4,work,13,15,2
6046,5,home,15,21,6
6046,6,work,21,22,1
6046,7,home,22,24,2
6046,8,<ENDS>,24,24,0
6047,0,<START>,0,0,0
6047,1,home,0,7,7
6047,2,work,7,13,6
6047,3,shop,13,14,1
6047,4,home,14,24,10
6047,5,<ENDS>,24,24,0
6048,0,<START>,0,0,0
6048,1,home,0,7,7
6048,2,work,7,14,7
6048,3,home,14,23,9
6048,4,work,23,24,1
6048,5,<ENDS>,24,24,0
6049,0,<START>,0,0,0
6049,1,home,0,8,8
6049,2,work,8,14,6
6049,3,home,14,24,10
6049,4,<ENDS>,24,24,0
6050,0,<START>,0,0,0
6050,1,home,0,8,8
6050,2,work,8,14,6
6050,3,home,14,24,10
6050,4,<ENDS>,24,24,0
6051,0,<START>,0,0,0
6051,1,home,0,7,7
6051,2,shop,7,8,1
6051,3,education,8,12,4
6051,4,home,12,14,2
6051,5,education,14,16,2
6051,6,home,16,24,8
6051,7,<ENDS>,24,24,0
6052,0,<START>,0,0,0
6052,1,home,0,7,7
6052,2,work,7,13,6
6052,3,home,13,24,11
6052,4,<ENDS>,24,24,0
6053,0,<START>,0,0,0
6053,1,home,0,8,8
6053,2,education,8,12,4
6053,3,shop,12,13,1
6053,4,work,13,19,6
6053,5,home,19,24,5
6053,6,<ENDS>,24,24,0
6054,0,<START>,0,0,0
6054,1,home,0,9,9
6054,2,work,9,16,7
6054,3,home,16,24,8
6054,4,<ENDS>,24,24,0
6055,0,<START>,0,0,0
6055,1,home,0,8,8
6055,2,education,8,11,3
6055,3,home,11,19,8
6055,4,shop,19,20,1
6055,5,home,20,24,4
6055,6,<ENDS>,24,24,0
6056,0,<START>,0,0,0
6056,1,home,0,9,9
6056,2,education,9,13,4
6056,3,shop,13,14,1
6056,4,work,14,19,5
6056,5,home,19,24,5
6056,6,<ENDS>,24,24,0
6057,0,<START>,0,0,0
6057,1,home,0,8,8
6057,2,work,8,15,7
6057,3,home,15,24,9
6057,4,<ENDS>,24,24,0
6058,0,<START>,0,0,0
6058,1,home,0,6,6
6058,2,shop,6,7,1
6058,3,home,7,10,3
6058,4,education,10,16,6
6058,5,home,16,24,8
6058,6,<ENDS>,24,24,0
6059,0,<START>,0,0,0
6059,1,home,0,9,9
6059,2,work,9,17,8
6059,3,home,17,24,7
6059,4,<ENDS>,24,24,0
6060,0,<START>,0,0,0
6060,1,home,0,8,8
6060,2,education,8,12,4
6060,3,shop,12,13,1
6060,4,home,13,19,6
6060,5,shop,19,20,1
6060,6,home,20,24,4
6060,7,<ENDS>,24,24,0
6061,0,<START>,0,0,0
6061,1,home,0,6,6
6061,2,work,6,9,3
6061,3,home,9,15,6
6061,4,work,15,17,2
6061,5,home,17,22,5
6061,6,work,22,23,1
6061,7,home,23,24,1
6061,8,<ENDS>,24,24,0
6062,0,<START>,0,0,0
6062,1,home,0,6,6
6062,2,work,6,7,1
6062,3,home,7,8,1
6062,4,work,8,9,1
6062,5,home,9,15,6
6062,6,work,15,17,2
6062,7,home,17,24,7
6062,8,<ENDS>,24,24,0
6063,0,<START>,0,0,0
6063,1,home,0,8,8
6063,2,education,8,12,4
6063,3,home,12,19,7
6063,4,shop,19,20,1
6063,5,home,20,24,4
6063,6,<ENDS>,24,24,0
6064,0,<START>,0,0,0
6064,1,home,0,8,8
6064,2,work,8,15,7
6064,3,home,15,21,6
6064,4,work,21,22,1
6064,5,home,22,24,2
6064,6,<ENDS>,24,24,0
6065,0,<START>,0,0,0
6065,1,home,0,6,6
6065,2,work,6,8,2
6065,3,home,8,14,6
6065,4,work,14,16,2
6065,5,home,16,23,7
6065,6,work,23,24,1
6065,7,<ENDS>,24,24,0
6066,0,<START>,0,0,0
6066,1,home,0,6,6
6066,2,shop,6,7,1
6066,3,home,7,9,2
6066,4,work,9,18,9
6066,5,home,18,24,6
6066,6,<ENDS>,24,24,0
6067,0,<START>,0,0,0
6067,1,home,0,8,8
6067,2,work,8,15,7
6067,3,home,15,24,9
6067,4,<ENDS>,24,24,0
6068,0,<START>,0,0,0
6068,1,home,0,6,6
6068,2,work,6,13,7
6068,3,home,13,24,11
6068,4,<ENDS>,24,24,0
6069,0,<START>,0,0,0
6069,1,home,0,8,8
6069,2,work,8,14,6
6069,3,home,14,18,4
6069,4,shop,18,19,1
6069,5,home,19,24,5
6069,6,<ENDS>,24,24,0
6070,0,<START>,0,0,0
6070,1,home,0,6,6
6070,2,shop,6,8,2
6070,3,work,8,15,7
6070,4,home,15,24,9
6070,5,<ENDS>,24,24,0
6071,0,<START>,0,0,0
6071,1,home,0,7,7
6071,2,work,7,13,6
6071,3,home,13,15,2
6071,4,work,15,19,4
6071,5,home,19,24,5
6071,6,<ENDS>,24,24,0
6072,0,<START>,0,0,0
6072,1,home,0,7,7
6072,2,work,7,13,6
6072,3,home,13,16,3
6072,4,work,16,19,3
6072,5,home,19,24,5
6072,6,<ENDS>,24,24,0
6073,0,<START>,0,0,0
6073,1,home,0,7,7
6073,2,shop,7,8,1
6073,3,home,8,12,4
6073,4,work,12,18,6
6073,5,home,18,24,6
6073,6,<ENDS>,24,24,0
6074,0,<START>,0,0,0
6074,1,home,0,7,7
6074,2,work,7,13,6
6074,3,home,13,14,1
6074,4,shop,14,15,1
6074,5,home,15,24,9
6074,6,<ENDS>,24,24,0
6075,0,<START>,0,0,0
6075,1,home,0,7,7
6075,2,work,7,14,7
6075,3,home,14,21,7
6075,4,shop,21,22,1
6075,5,home,22,24,2
6075,6,<ENDS>,24,24,0
6076,0,<START>,0,0,0
6076,1,home,0,8,8
6076,2,work,8,14,6
6076,3,home,14,21,7
6076,4,shop,21,22,1
6076,5,home,22,24,2
6076,6,<ENDS>,24,24,0
6077,0,<START>,0,0,0
6077,1,home,0,7,7
6077,2,education,7,11,4
6077,3,home,11,19,8
6077,4,shop,19,21,2
6077,5,home,21,24,3
6077,6,<ENDS>,24,24,0
6078,0,<START>,0,0,0
6078,1,home,0,7,7
6078,2,work,7,14,7
6078,3,shop,14,15,1
6078,4,home,15,24,9
6078,5,<ENDS>,24,24,0
6079,0,<START>,0,0,0
6079,1,home,0,7,7
6079,2,education,7,11,4
6079,3,home,11,18,7
6079,4,shop,18,20,2
6079,5,home,20,24,4
6079,6,<ENDS>,24,24,0
6080,0,<START>,0,0,0
6080,1,home,0,6,6
6080,2,work,6,13,7
6080,3,shop,13,14,1
6080,4,home,14,22,8
6080,5,work,22,23,1
6080,6,home,23,24,1
6080,7,<ENDS>,24,24,0
6081,0,<START>,0,0,0
6081,1,home,0,7,7
6081,2,work,7,13,6
6081,3,home,13,24,11
6081,4,<ENDS>,24,24,0
6082,0,<START>,0,0,0
6082,1,home,0,8,8
6082,2,work,8,14,6
6082,3,shop,14,15,1
6082,4,home,15,21,6
6082,5,work,21,22,1
6082,6,home,22,24,2
6082,7,<ENDS>,24,24,0
6083,0,<START>,0,0,0
6083,1,work,0,7,7
6083,2,shop,7,8,1
6083,3,work,8,15,7
6083,4,home,15,19,4
6083,5,shop,19,20,1
6083,6,home,20,24,4
6083,7,<ENDS>,24,24,0
6084,0,<START>,0,0,0
6084,1,home,0,6,6
6084,2,work,6,8,2
6084,3,home,8,12,4
6084,4,work,12,14,2
6084,5,home,14,22,8
6084,6,work,22,23,1
6084,7,home,23,24,1
6084,8,<ENDS>,24,24,0
6085,0,<START>,0,0,0
6085,1,home,0,6,6
6085,2,work,6,8,2
6085,3,home,8,14,6
6085,4,work,14,16,2
6085,5,home,16,24,8
6085,6,<ENDS>,24,24,0
6086,0,<START>,0,0,0
6086,1,home,0,7,7
6086,2,work,7,14,7
6086,3,home,14,24,10
6086,4,<ENDS>,24,24,0
6087,0,<START>,0,0,0
6087,1,home,0,6,6
6087,2,work,6,12,6
6087,3,shop,12,13,1
6087,4,work,13,19,6
6087,5,home,19,24,5
6087,6,<ENDS>,24,24,0
6088,0,<START>,0,0,0
6088,1,home,0,7,7
6088,2,work,7,14,7
6088,3,home,14,24,10
6088,4,<ENDS>,24,24,0
6089,0,<START>,0,0,0
6089,1,home,0,6,6
6089,2,work,6,7,1
6089,3,home,7,13,6
6089,4,work,13,14,1
6089,5,home,14,21,7
6089,6,work,21,22,1
6089,7,home,22,24,2
6089,8,<ENDS>,24,24,0
6090,0,<START>,0,0,0
6090,1,home,0,6,6
6090,2,work,6,13,7
6090,3,shop,13,14,1
6090,4,work,14,19,5
6090,5,home,19,24,5
6090,6,<ENDS>,24,24,0
6091,0,<START>,0,0,0
6091,1,home,0,7,7
6091,2,work,7,13,6
6091,3,shop,13,14,1
6091,4,home,14,24,10
6091,5,<ENDS>,24,24,0
6092,0,<START>,0,0,0
6092,1,home,0,6,6
6092,2,work,6,13,7
6092,3,home,13,17,4
6092,4,shop,17,18,1
6092,5,home,18,24,6
6092,6,<ENDS>,24,24,0
6093,0,<START>,0,0,0
6093,1,home,0,6,6
6093,2,work,6,8,2
6093,3,home,8,12,4
6093,4,work,12,14,2
6093,5,home,14,21,7
6093,6,work,21,22,1
6093,7,home,22,24,2
6093,8,<ENDS>,24,24,0
6094,0,<START>,0,0,0
6094,1,home,0,7,7
6094,2,work,7,13,6
6094,3,home,13,20,7
6094,4,shop,20,21,1
6094,5,home,21,24,3
6094,6,<ENDS>,24,24,0
6095,0,<START>,0,0,0
6095,1,home,0,6,6
6095,2,shop,6,7,1
6095,3,home,7,10,3
6095,4,education,10,15,5
6095,5,shop,15,16,1
6095,6,home,16,21,5
6095,7,shop,21,22,1
6095,8,home,22,24,2
6095,9,<ENDS>,24,24,0
6096,0,<START>,0,0,0
6096,1,home,0,6,6
6096,2,shop,6,7,1
6096,3,home,7,9,2
6096,4,education,9,12,3
6096,5,shop,12,14,2
6096,6,home,14,21,7
6096,7,shop,21,22,1
6096,8,home,22,24,2
6096,9,<ENDS>,24,24,0
6097,0,<START>,0,0,0
6097,1,home,0,6,6
6097,2,work,6,8,2
6097,3,home,8,12,4
6097,4,work,12,13,1
6097,5,home,13,21,8
6097,6,work,21,22,1
6097,7,home,22,24,2
6097,8,<ENDS>,24,24,0
6098,0,<START>,0,0,0
6098,1,home,0,8,8
6098,2,work,8,15,7
6098,3,home,15,24,9
6098,4,<ENDS>,24,24,0
6099,0,<START>,0,0,0
6099,1,home,0,7,7
6099,2,work,7,13,6
6099,3,home,13,15,2
6099,4,work,15,19,4
6099,5,home,19,24,5
6099,6,<ENDS>,24,24,0
6100,0,<START>,0,0,0
6100,1,home,0,8,8
6100,2,work,8,14,6
6100,3,home,14,24,10
6100,4,<ENDS>,24,24,0
6101,0,<START>,0,0,0
6101,1,home,0,8,8
6101,2,education,8,11,3
6101,3,home,11,14,3
6101,4,education,14,16,2
6101,5,shop,16,18,2
6101,6,home,18,24,6
6101,7,<ENDS>,24,24,0
6102,0,<START>,0,0,0
6102,1,home,0,6,6
6102,2,work,6,13,7
6102,3,shop,13,14,1
6102,4,work,14,20,6
6102,5,home,20,24,4
6102,6,<ENDS>,24,24,0
6103,0,<START>,0,0,0
6103,1,home,0,6,6
6103,2,work,6,8,2
6103,3,home,8,14,6
6103,4,work,14,18,4
6103,5,home,18,24,6
6103,6,<ENDS>,24,24,0
6104,0,<START>,0,0,0
6104,1,home,0,8,8
6104,2,work,8,15,7
6104,3,home,15,20,5
6104,4,shop,20,21,1
6104,5,home,21,24,3
6104,6,<ENDS>,24,24,0
6105,0,<START>,0,0,0
6105,1,home,0,6,6
6105,2,work,6,8,2
6105,3,home,8,12,4
6105,4,work,12,14,2
6105,5,home,14,21,7
6105,6,work,21,22,1
6105,7,home,22,24,2
6105,8,<ENDS>,24,24,0
6106,0,<START>,0,0,0
6106,1,home,0,7,7
6106,2,work,7,13,6
6106,3,home,13,23,10
6106,4,work,23,24,1
6106,5,<ENDS>,24,24,0
6107,0,<START>,0,0,0
6107,1,home,0,6,6
6107,2,work,6,13,7
6107,3,home,13,21,8
6107,4,work,21,22,1
6107,5,home,22,24,2
6107,6,<ENDS>,24,24,0
6108,0,<START>,0,0,0
6108,1,home,0,7,7
6108,2,education,7,12,5
6108,3,home,12,18,6
6108,4,shop,18,20,2
6108,5,home,20,24,4
6108,6,<ENDS>,24,24,0
6109,0,<START>,0,0,0
6109,1,home,0,7,7
6109,2,education,7,12,5
6109,3,shop,12,14,2
6109,4,education,14,16,2
6109,5,shop,16,17,1
6109,6,home,17,24,7
6109,7,<ENDS>,24,24,0
6110,0,<START>,0,0,0
6110,1,home,0,6,6
6110,2,work,6,8,2
6110,3,home,8,15,7
6110,4,work,15,17,2
6110,5,home,17,24,7
6110,6,<ENDS>,24,24,0
6111,0,<START>,0,0,0
6111,1,home,0,7,7
6111,2,education,7,12,5
6111,3,home,12,18,6
6111,4,shop,18,19,1
6111,5,home,19,24,5
6111,6,<ENDS>,24,24,0
6112,0,<START>,0,0,0
6112,1,home,0,6,6
6112,2,shop,6,7,1
6112,3,work,7,14,7
6112,4,home,14,20,6
6112,5,shop,20,21,1
6112,6,home,21,24,3
6112,7,<ENDS>,24,24,0
6113,0,<START>,0,0,0
6113,1,home,0,6,6
6113,2,work,6,8,2
6113,3,home,8,9,1
6113,4,work,9,11,2
6113,5,home,11,17,6
6113,6,work,17,19,2
6113,7,home,19,24,5
6113,8,<ENDS>,24,24,0
6114,0,<START>,0,0,0
6114,1,home,0,6,6
6114,2,work,6,13,7
6114,3,shop,13,14,1
6114,4,work,14,19,5
6114,5,home,19,24,5
6114,6,<ENDS>,24,24,0
6115,0,<START>,0,0,0
6115,1,home,0,7,7
6115,2,work,7,13,6
6115,3,shop,13,14,1
6115,4,work,14,19,5
6115,5,home,19,24,5
6115,6,<ENDS>,24,24,0
6116,0,<START>,0,0,0
6116,1,home,0,7,7
6116,2,work,7,14,7
6116,3,home,14,21,7
6116,4,work,21,22,1
6116,5,home,22,24,2
6116,6,<ENDS>,24,24,0
6117,0,<START>,0,0,0
6117,1,home,0,7,7
6117,2,work,7,15,8
6117,3,home,15,24,9
6117,4,<ENDS>,24,24,0
6118,0,<START>,0,0,0
6118,1,home,0,7,7
6118,2,work,7,13,6
6118,3,shop,13,14,1
6118,4,home,14,18,4
6118,5,work,18,20,2
6118,6,home,20,24,4
6118,7,<ENDS>,24,24,0
6119,0,<START>,0,0,0
6119,1,home,0,6,6
6119,2,work,6,13,7
6119,3,shop,13,14,1
6119,4,home,14,24,10
6119,5,<ENDS>,24,24,0
6120,0,<START>,0,0,0
6120,1,home,0,9,9
6120,2,work,9,17,8
6120,3,home,17,22,5
6120,4,work,22,23,1
6120,5,home,23,24,1
6120,6,<ENDS>,24,24,0
6121,0,<START>,0,0,0
6121,1,home,0,6,6
6121,2,work,6,13,7
6121,3,home,13,24,11
6121,4,<ENDS>,24,24,0
6122,0,<START>,0,0,0
6122,1,home,0,7,7
6122,2,work,7,13,6
6122,3,home,13,17,4
6122,4,work,17,19,2
6122,5,home,19,24,5
6122,6,<ENDS>,24,24,0
6123,0,<START>,0,0,0
6123,1,home,0,6,6
6123,2,shop,6,7,1
6123,3,home,7,10,3
6123,4,education,10,12,2
6123,5,shop,12,13,1
6123,6,education,13,16,3
6123,7,home,16,24,8
6123,8,<ENDS>,24,24,0
6124,0,<START>,0,0,0
6124,1,home,0,7,7
6124,2,work,7,13,6
6124,3,home,13,18,5
6124,4,work,18,20,2
6124,5,home,20,24,4
6124,6,<ENDS>,24,24,0
6125,0,<START>,0,0,0
6125,1,home,0,8,8
6125,2,work,8,16,8
6125,3,home,16,24,8
6125,4,<ENDS>,24,24,0
6126,0,<START>,0,0,0
6126,1,home,0,7,7
6126,2,education,7,11,4
6126,3,home,11,15,4
6126,4,shop,15,16,1
6126,5,home,16,24,8
6126,6,<ENDS>,24,24,0
6127,0,<START>,0,0,0
6127,1,home,0,6,6
6127,2,work,6,8,2
6127,3,home,8,14,6
6127,4,work,14,17,3
6127,5,home,17,23,6
6127,6,work,23,24,1
6127,7,<ENDS>,24,24,0
6128,0,<START>,0,0,0
6128,1,home,0,6,6
6128,2,shop,6,7,1
6128,3,home,7,10,3
6128,4,education,10,12,2
6128,5,shop,12,14,2
6128,6,education,14,16,2
6128,7,home,16,24,8
6128,8,<ENDS>,24,24,0
6129,0,<START>,0,0,0
6129,1,home,0,6,6
6129,2,work,6,7,1
6129,3,home,7,12,5
6129,4,work,12,14,2
6129,5,home,14,21,7
6129,6,work,21,22,1
6129,7,home,22,24,2
6129,8,<ENDS>,24,24,0
6130,0,<START>,0,0,0
6130,1,home,0,7,7
6130,2,work,7,13,6
6130,3,home,13,18,5
6130,4,work,18,20,2
6130,5,home,20,24,4
6130,6,<ENDS>,24,24,0
6131,0,<START>,0,0,0
6131,1,home,0,7,7
6131,2,education,7,10,3
6131,3,home,10,14,4
6131,4,education,14,16,2
6131,5,home,16,20,4
6131,6,shop,20,21,1
6131,7,home,21,24,3
6131,8,<ENDS>,24,24,0
6132,0,<START>,0,0,0
6132,1,home,0,7,7
6132,2,work,7,14,7
6132,3,shop,14,15,1
6132,4,home,15,24,9
6132,5,<ENDS>,24,24,0
6133,0,<START>,0,0,0
6133,1,home,0,7,7
6133,2,work,7,13,6
6133,3,home,13,17,4
6133,4,work,17,20,3
6133,5,home,20,24,4
6133,6,<ENDS>,24,24,0
6134,0,<START>,0,0,0
6134,1,home,0,7,7
6134,2,education,7,11,4
6134,3,home,11,18,7
6134,4,shop,18,20,2
6134,5,home,20,24,4
6134,6,<ENDS>,24,24,0
6135,0,<START>,0,0,0
6135,1,home,0,8,8
6135,2,work,8,15,7
6135,3,shop,15,16,1
6135,4,home,16,22,6
6135,5,work,22,23,1
6135,6,home,23,24,1
6135,7,<ENDS>,24,24,0
6136,0,<START>,0,0,0
6136,1,home,0,8,8
6136,2,work,8,15,7
6136,3,home,15,24,9
6136,4,<ENDS>,24,24,0
6137,0,<START>,0,0,0
6137,1,home,0,6,6
6137,2,work,6,13,7
6137,3,shop,13,14,1
6137,4,home,14,15,1
6137,5,work,15,19,4
6137,6,home,19,23,4
6137,7,work,23,24,1
6137,8,<ENDS>,24,24,0
6138,0,<START>,0,0,0
6138,1,home,0,7,7
6138,2,education,7,11,4
6138,3,home,11,17,6
6138,4,shop,17,19,2
6138,5,home,19,24,5
6138,6,<ENDS>,24,24,0
6139,0,<START>,0,0,0
6139,1,home,0,8,8
6139,2,education,8,13,5
6139,3,work,13,19,6
6139,4,home,19,23,4
6139,5,work,23,24,1
6139,6,<ENDS>,24,24,0
6140,0,<START>,0,0,0
6140,1,home,0,7,7
6140,2,work,7,13,6
6140,3,home,13,24,11
6140,4,<ENDS>,24,24,0
6141,0,<START>,0,0,0
6141,1,home,0,8,8
6141,2,work,8,15,7
6141,3,shop,15,16,1
6141,4,home,16,21,5
6141,5,work,21,22,1
6141,6,home,22,24,2
6141,7,<ENDS>,24,24,0
6142,0,<START>,0,0,0
6142,1,home,0,7,7
6142,2,shop,7,8,1
6142,3,education,8,12,4
6142,4,home,12,19,7
6142,5,shop,19,21,2
6142,6,home,21,24,3
6142,7,<ENDS>,24,24,0
6143,0,<START>,0,0,0
6143,1,home,0,7,7
6143,2,work,7,14,7
6143,3,home,14,18,4
6143,4,work,18,20,2
6143,5,home,20,24,4
6143,6,<ENDS>,24,24,0
6144,0,<START>,0,0,0
6144,1,home,0,6,6
6144,2,work,6,7,1
6144,3,home,7,14,7
6144,4,work,14,16,2
6144,5,home,16,24,8
6144,6,<ENDS>,24,24,0
6145,0,<START>,0,0,0
6145,1,home,0,8,8
6145,2,work,8,14,6
6145,3,home,14,24,10
6145,4,<ENDS>,24,24,0
6146,0,<START>,0,0,0
6146,1,home,0,6,6
6146,2,shop,6,7,1
6146,3,home,7,10,3
6146,4,education,10,13,3
6146,5,home,13,19,6
6146,6,shop,19,20,1
6146,7,home,20,24,4
6146,8,<ENDS>,24,24,0
6147,0,<START>,0,0,0
6147,1,home,0,7,7
6147,2,work,7,13,6
6147,3,shop,13,14,1
6147,4,home,14,24,10
6147,5,<ENDS>,24,24,0
6148,0,<START>,0,0,0
6148,1,home,0,7,7
6148,2,work,7,14,7
6148,3,shop,14,15,1
6148,4,home,15,22,7
6148,5,work,22,23,1
6148,6,home,23,24,1
6148,7,<ENDS>,24,24,0
6149,0,<START>,0,0,0
6149,1,home,0,7,7
6149,2,work,7,13,6
6149,3,shop,13,14,1
6149,4,work,14,20,6
6149,5,home,20,24,4
6149,6,<ENDS>,24,24,0
6150,0,<START>,0,0,0
6150,1,home,0,6,6
6150,2,work,6,8,2
6150,3,home,8,12,4
6150,4,work,12,14,2
6150,5,home,14,21,7
6150,6,work,21,22,1
6150,7,home,22,24,2
6150,8,<ENDS>,24,24,0
6151,0,<START>,0,0,0
6151,1,home,0,7,7
6151,2,work,7,13,6
6151,3,shop,13,14,1
6151,4,home,14,24,10
6151,5,<ENDS>,24,24,0
6152,0,<START>,0,0,0
6152,1,home,0,8,8
6152,2,education,8,12,4
6152,3,work,12,19,7
6152,4,home,19,23,4
6152,5,work,23,24,1
6152,6,<ENDS>,24,24,0
6153,0,<START>,0,0,0
6153,1,home,0,7,7
6153,2,work,7,13,6
6153,3,shop,13,14,1
6153,4,home,14,24,10
6153,5,<ENDS>,24,24,0
6154,0,<START>,0,0,0
6154,1,home,0,7,7
6154,2,education,7,11,4
6154,3,home,11,17,6
6154,4,shop,17,18,1
6154,5,home,18,24,6
6154,6,<ENDS>,24,24,0
6155,0,<START>,0,0,0
6155,1,home,0,7,7
6155,2,education,7,11,4
6155,3,home,11,14,3
6155,4,education,14,16,2
6155,5,home,16,24,8
6155,6,<ENDS>,24,24,0
6156,0,<START>,0,0,0
6156,1,home,0,6,6
6156,2,work,6,13,7
6156,3,shop,13,14,1
6156,4,home,14,24,10
6156,5,<ENDS>,24,24,0
6157,0,<START>,0,0,0
6157,1,home,0,6,6
6157,2,shop,6,7,1
6157,3,home,7,10,3
6157,4,education,10,13,3
6157,5,shop,13,15,2
6157,6,home,15,24,9
6157,7,<ENDS>,24,24,0
6158,0,<START>,0,0,0
6158,1,home,0,6,6
6158,2,work,6,13,7
6158,3,home,13,23,10
6158,4,work,23,24,1
6158,5,<ENDS>,24,24,0
6159,0,<START>,0,0,0
6159,1,home,0,6,6
6159,2,work,6,13,7
6159,3,shop,13,14,1
6159,4,home,14,24,10
6159,5,<ENDS>,24,24,0
6160,0,<START>,0,0,0
6160,1,home,0,7,7
6160,2,shop,7,8,1
6160,3,work,8,13,5
6160,4,home,13,22,9
6160,5,work,22,23,1
6160,6,home,23,24,1
6160,7,<ENDS>,24,24,0
6161,0,<START>,0,0,0
6161,1,home,0,7,7
6161,2,work,7,13,6
6161,3,shop,13,14,1
6161,4,home,14,24,10
6161,5,<ENDS>,24,24,0
6162,0,<START>,0,0,0
6162,1,home,0,7,7
6162,2,work,7,14,7
6162,3,shop,14,15,1
6162,4,home,15,22,7
6162,5,work,22,23,1
6162,6,home,23,24,1
6162,7,<ENDS>,24,24,0
6163,0,<START>,0,0,0
6163,1,home,0,8,8
6163,2,work,8,14,6
6163,3,home,14,24,10
6163,4,<ENDS>,24,24,0
6164,0,<START>,0,0,0
6164,1,home,0,7,7
6164,2,shop,7,8,1
6164,3,education,8,12,4
6164,4,home,12,21,9
6164,5,shop,21,22,1
6164,6,home,22,24,2
6164,7,<ENDS>,24,24,0
6165,0,<START>,0,0,0
6165,1,home,0,7,7
6165,2,work,7,13,6
6165,3,home,13,24,11
6165,4,<ENDS>,24,24,0
6166,0,<START>,0,0,0
6166,1,home,0,7,7
6166,2,work,7,13,6
6166,3,home,13,23,10
6166,4,work,23,24,1
6166,5,<ENDS>,24,24,0
6167,0,<START>,0,0,0
6167,1,home,0,8,8
6167,2,work,8,14,6
6167,3,home,14,24,10
6167,4,<ENDS>,24,24,0
6168,0,<START>,0,0,0
6168,1,home,0,7,7
6168,2,work,7,13,6
6168,3,home,13,24,11
6168,4,<ENDS>,24,24,0
6169,0,<START>,0,0,0
6169,1,home,0,7,7
6169,2,education,7,12,5
6169,3,home,12,18,6
6169,4,shop,18,20,2
6169,5,home,20,24,4
6169,6,<ENDS>,24,24,0
6170,0,<START>,0,0,0
6170,1,home,0,6,6
6170,2,work,6,8,2
6170,3,home,8,14,6
6170,4,work,14,17,3
6170,5,home,17,21,4
6170,6,work,21,22,1
6170,7,home,22,24,2
6170,8,<ENDS>,24,24,0
6171,0,<START>,0,0,0
6171,1,home,0,7,7
6171,2,work,7,14,7
6171,3,home,14,17,3
6171,4,work,17,19,2
6171,5,home,19,24,5
6171,6,<ENDS>,24,24,0
6172,0,<START>,0,0,0
6172,1,home,0,7,7
6172,2,work,7,13,6
6172,3,home,13,20,7
6172,4,shop,20,21,1
6172,5,home,21,24,3
6172,6,<ENDS>,24,24,0
6173,0,<START>,0,0,0
6173,1,home,0,8,8
6173,2,education,8,13,5
6173,3,home,13,20,7
6173,4,shop,20,21,1
6173,5,home,21,24,3
6173,6,<ENDS>,24,24,0
6174,0,<START>,0,0,0
6174,1,home,0,8,8
6174,2,education,8,11,3
6174,3,home,11,18,7
6174,4,shop,18,19,1
6174,5,home,19,24,5
6174,6,<ENDS>,24,24,0
6175,0,<START>,0,0,0
6175,1,home,0,6,6
6175,2,work,6,8,2
6175,3,home,8,12,4
6175,4,work,12,14,2
6175,5,home,14,21,7
6175,6,work,21,22,1
6175,7,home,22,24,2
6175,8,<ENDS>,24,24,0
6176,0,<START>,0,0,0
6176,1,home,0,6,6
6176,2,work,6,8,2
6176,3,home,8,15,7
6176,4,work,15,18,3
6176,5,home,18,24,6
6176,6,<ENDS>,24,24,0
6177,0,<START>,0,0,0
6177,1,home,0,7,7
6177,2,work,7,14,7
6177,3,home,14,24,10
6177,4,<ENDS>,24,24,0
6178,0,<START>,0,0,0
6178,1,home,0,6,6
6178,2,work,6,13,7
6178,3,shop,13,14,1
6178,4,work,14,19,5
6178,5,home,19,24,5
6178,6,<ENDS>,24,24,0
6179,0,<START>,0,0,0
6179,1,home,0,9,9
6179,2,work,9,16,7
6179,3,home,16,24,8
6179,4,<ENDS>,24,24,0
6180,0,<START>,0,0,0
6180,1,home,0,7,7
6180,2,work,7,14,7
6180,3,home,14,22,8
6180,4,work,22,23,1
6180,5,home,23,24,1
6180,6,<ENDS>,24,24,0
6181,0,<START>,0,0,0
6181,1,home,0,8,8
6181,2,work,8,15,7
6181,3,shop,15,16,1
6181,4,home,16,22,6
6181,5,work,22,23,1
6181,6,home,23,24,1
6181,7,<ENDS>,24,24,0
6182,0,<START>,0,0,0
6182,1,home,0,6,6
6182,2,work,6,13,7
6182,3,home,13,18,5
6182,4,work,18,20,2
6182,5,home,20,24,4
6182,6,<ENDS>,24,24,0
6183,0,<START>,0,0,0
6183,1,home,0,7,7
6183,2,work,7,14,7
6183,3,shop,14,15,1
6183,4,home,15,24,9
6183,5,<ENDS>,24,24,0
6184,0,<START>,0,0,0
6184,1,home,0,6,6
6184,2,work,6,13,7
6184,3,home,13,24,11
6184,4,<ENDS>,24,24,0
6185,0,<START>,0,0,0
6185,1,home,0,9,9
6185,2,shop,9,10,1
6185,3,home,10,15,5
6185,4,work,15,20,5
6185,5,home,20,24,4
6185,6,<ENDS>,24,24,0
6186,0,<START>,0,0,0
6186,1,home,0,7,7
6186,2,work,7,9,2
6186,3,home,9,13,4
6186,4,work,13,16,3
6186,5,home,16,23,7
6186,6,work,23,24,1
6186,7,<ENDS>,24,24,0
6187,0,<START>,0,0,0
6187,1,home,0,7,7
6187,2,education,7,11,4
6187,3,home,11,18,7
6187,4,shop,18,19,1
6187,5,home,19,24,5
6187,6,<ENDS>,24,24,0
6188,0,<START>,0,0,0
6188,1,home,0,7,7
6188,2,shop,7,8,1
6188,3,education,8,11,3
6188,4,home,11,15,4
6188,5,shop,15,16,1
6188,6,home,16,24,8
6188,7,<ENDS>,24,24,0
6189,0,<START>,0,0,0
6189,1,home,0,7,7
6189,2,shop,7,8,1
6189,3,work,8,15,7
6189,4,home,15,24,9
6189,5,<ENDS>,24,24,0
6190,0,<START>,0,0,0
6190,1,home,0,7,7
6190,2,work,7,13,6
6190,3,home,13,19,6
6190,4,shop,19,20,1
6190,5,home,20,24,4
6190,6,<ENDS>,24,24,0
6191,0,<START>,0,0,0
6191,1,home,0,8,8
6191,2,shop,8,9,1
6191,3,education,9,12,3
6191,4,home,12,19,7
6191,5,shop,19,20,1
6191,6,home,20,24,4
6191,7,<ENDS>,24,24,0
6192,0,<START>,0,0,0
6192,1,home,0,7,7
6192,2,work,7,14,7
6192,3,home,14,24,10
6192,4,<ENDS>,24,24,0
6193,0,<START>,0,0,0
6193,1,home,0,7,7
6193,2,shop,7,8,1
6193,3,education,8,11,3
6193,4,home,11,18,7
6193,5,shop,18,19,1
6193,6,home,19,24,5
6193,7,<ENDS>,24,24,0
6194,0,<START>,0,0,0
6194,1,home,0,7,7
6194,2,work,7,14,7
6194,3,home,14,21,7
6194,4,work,21,22,1
6194,5,home,22,24,2
6194,6,<ENDS>,24,24,0
6195,0,<START>,0,0,0
6195,1,home,0,6,6
6195,2,work,6,8,2
6195,3,home,8,14,6
6195,4,work,14,16,2
6195,5,home,16,23,7
6195,6,work,23,24,1
6195,7,<ENDS>,24,24,0
6196,0,<START>,0,0,0
6196,1,home,0,7,7
6196,2,education,7,12,5
6196,3,shop,12,14,2
6196,4,education,14,16,2
6196,5,home,16,24,8
6196,6,<ENDS>,24,24,0
6197,0,<START>,0,0,0
6197,1,home,0,6,6
6197,2,shop,6,7,1
6197,3,home,7,11,4
6197,4,education,11,14,3
6197,5,shop,14,16,2
6197,6,home,16,24,8
6197,7,<ENDS>,24,24,0
6198,0,<START>,0,0,0
6198,1,home,0,8,8
6198,2,work,8,14,6
6198,3,shop,14,15,1
6198,4,home,15,24,9
6198,5,<ENDS>,24,24,0
6199,0,<START>,0,0,0
6199,1,home,0,6,6
6199,2,shop,6,7,1
6199,3,home,7,13,6
6199,4,education,13,16,3
6199,5,home,16,24,8
6199,6,<ENDS>,24,24,0
6200,0,<START>,0,0,0
6200,1,home,0,8,8
6200,2,work,8,15,7
6200,3,home,15,24,9
6200,4,<ENDS>,24,24,0
6201,0,<START>,0,0,0
6201,1,home,0,6,6
6201,2,shop,6,7,1
6201,3,home,7,10,3
6201,4,education,10,13,3
6201,5,shop,13,15,2
6201,6,home,15,24,9
6201,7,<ENDS>,24,24,0
6202,0,<START>,0,0,0
6202,1,home,0,6,6
6202,2,work,6,13,7
6202,3,home,13,17,4
6202,4,shop,17,18,1
6202,5,work,18,20,2
6202,6,home,20,24,4
6202,7,<ENDS>,24,24,0
6203,0,<START>,0,0,0
6203,1,home,0,7,7
6203,2,shop,7,8,1
6203,3,work,8,15,7
6203,4,home,15,20,5
6203,5,shop,20,21,1
6203,6,home,21,24,3
6203,7,<ENDS>,24,24,0
6204,0,<START>,0,0,0
6204,1,home,0,8,8
6204,2,work,8,14,6
6204,3,home,14,22,8
6204,4,work,22,23,1
6204,5,home,23,24,1
6204,6,<ENDS>,24,24,0
6205,0,<START>,0,0,0
6205,1,home,0,7,7
6205,2,work,7,14,7
6205,3,shop,14,15,1
6205,4,home,15,24,9
6205,5,<ENDS>,24,24,0
6206,0,<START>,0,0,0
6206,1,home,0,6,6
6206,2,work,6,7,1
6206,3,shop,7,8,1
6206,4,work,8,10,2
6206,5,home,10,14,4
6206,6,work,14,17,3
6206,7,home,17,23,6
6206,8,work,23,24,1
6206,9,<ENDS>,24,24,0
6207,0,<START>,0,0,0
6207,1,home,0,7,7
6207,2,education,7,11,4
6207,3,home,11,17,6
6207,4,shop,17,19,2
6207,5,home,19,21,2
6207,6,shop,21,22,1
6207,7,home,22,24,2
6207,8,<ENDS>,24,24,0
6208,0,<START>,0,0,0
6208,1,home,0,8,8
6208,2,work,8,16,8
6208,3,home,16,23,7
6208,4,work,23,24,1
6208,5,<ENDS>,24,24,0
6209,0,<START>,0,0,0
6209,1,home,0,7,7
6209,2,education,7,11,4
6209,3,home,11,14,3
6209,4,education,14,16,2
6209,5,home,16,24,8
6209,6,<ENDS>,24,24,0
6210,0,<START>,0,0,0
6210,1,home,0,6,6
6210,2,work,6,13,7
6210,3,shop,13,14,1
6210,4,home,14,24,10
6210,5,<ENDS>,24,24,0
6211,0,<START>,0,0,0
6211,1,home,0,7,7
6211,2,work,7,14,7
6211,3,shop,14,15,1
6211,4,home,15,22,7
6211,5,work,22,23,1
6211,6,home,23,24,1
6211,7,<ENDS>,24,24,0
6212,0,<START>,0,0,0
6212,1,home,0,8,8
6212,2,work,8,15,7
6212,3,home,15,24,9
6212,4,<ENDS>,24,24,0
6213,0,<START>,0,0,0
6213,1,home,0,8,8
6213,2,work,8,15,7
6213,3,home,15,23,8
6213,4,work,23,24,1
6213,5,<ENDS>,24,24,0
6214,0,<START>,0,0,0
6214,1,home,0,8,8
6214,2,education,8,11,3
6214,3,shop,11,12,1
6214,4,work,12,19,7
6214,5,home,19,24,5
6214,6,<ENDS>,24,24,0
6215,0,<START>,0,0,0
6215,1,home,0,8,8
6215,2,work,8,15,7
6215,3,shop,15,16,1
6215,4,home,16,24,8
6215,5,<ENDS>,24,24,0
6216,0,<START>,0,0,0
6216,1,home,0,8,8
6216,2,work,8,13,5
6216,3,shop,13,14,1
6216,4,work,14,20,6
6216,5,home,20,24,4
6216,6,<ENDS>,24,24,0
6217,0,<START>,0,0,0
6217,1,home,0,7,7
6217,2,work,7,13,6
6217,3,shop,13,14,1
6217,4,work,14,19,5
6217,5,home,19,24,5
6217,6,<ENDS>,24,24,0
6218,0,<START>,0,0,0
6218,1,home,0,8,8
6218,2,work,8,14,6
6218,3,home,14,24,10
6218,4,<ENDS>,24,24,0
6219,0,<START>,0,0,0
6219,1,home,0,7,7
6219,2,work,7,13,6
6219,3,shop,13,14,1
6219,4,work,14,20,6
6219,5,home,20,24,4
6219,6,<ENDS>,24,24,0
6220,0,<START>,0,0,0
6220,1,home,0,7,7
6220,2,work,7,8,1
6220,3,home,8,11,3
6220,4,work,11,13,2
6220,5,home,13,21,8
6220,6,work,21,22,1
6220,7,home,22,24,2
6220,8,<ENDS>,24,24,0
6221,0,<START>,0,0,0
6221,1,home,0,7,7
6221,2,work,7,13,6
6221,3,home,13,18,5
6221,4,work,18,20,2
6221,5,home,20,24,4
6221,6,<ENDS>,24,24,0
6222,0,<START>,0,0,0
6222,1,home,0,6,6
6222,2,shop,6,7,1
6222,3,home,7,13,6
6222,4,education,13,16,3
6222,5,home,16,24,8
6222,6,<ENDS>,24,24,0
6223,0,<START>,0,0,0
6223,1,home,0,7,7
6223,2,education,7,11,4
6223,3,home,11,18,7
6223,4,shop,18,19,1
6223,5,home,19,24,5
6223,6,<ENDS>,24,24,0
6224,0,<START>,0,0,0
6224,1,home,0,7,7
6224,2,shop,7,8,1
6224,3,work,8,15,7
6224,4,home,15,24,9
6224,5,<ENDS>,24,24,0
6225,0,<START>,0,0,0
6225,1,home,0,7,7
6225,2,work,7,13,6
6225,3,shop,13,15,2
6225,4,home,15,24,9
6225,5,<ENDS>,24,24,0
6226,0,<START>,0,0,0
6226,1,home,0,7,7
6226,2,work,7,13,6
6226,3,home,13,24,11
6226,4,<ENDS>,24,24,0
6227,0,<START>,0,0,0
6227,1,home,0,6,6
6227,2,work,6,13,7
6227,3,home,13,16,3
6227,4,work,16,20,4
6227,5,home,20,24,4
6227,6,<ENDS>,24,24,0
6228,0,<START>,0,0,0
6228,1,home,0,7,7
6228,2,work,7,13,6
6228,3,home,13,17,4
6228,4,shop,17,18,1
6228,5,home,18,24,6
6228,6,<ENDS>,24,24,0
6229,0,<START>,0,0,0
6229,1,home,0,6,6
6229,2,work,6,13,7
6229,3,home,13,19,6
6229,4,shop,19,20,1
6229,5,home,20,24,4
6229,6,<ENDS>,24,24,0
6230,0,<START>,0,0,0
6230,1,home,0,7,7
6230,2,shop,7,9,2
6230,3,home,9,13,4
6230,4,work,13,19,6
6230,5,home,19,24,5
6230,6,<ENDS>,24,24,0
6231,0,<START>,0,0,0
6231,1,home,0,6,6
6231,2,work,6,12,6
6231,3,shop,12,13,1
6231,4,work,13,19,6
6231,5,home,19,24,5
6231,6,<ENDS>,24,24,0
6232,0,<START>,0,0,0
6232,1,home,0,7,7
6232,2,work,7,13,6
6232,3,shop,13,14,1
6232,4,home,14,24,10
6232,5,<ENDS>,24,24,0
6233,0,<START>,0,0,0
6233,1,home,0,7,7
6233,2,work,7,16,9
6233,3,home,16,24,8
6233,4,<ENDS>,24,24,0
6234,0,<START>,0,0,0
6234,1,home,0,7,7
6234,2,work,7,13,6
6234,3,shop,13,14,1
6234,4,work,14,19,5
6234,5,home,19,24,5
6234,6,<ENDS>,24,24,0
6235,0,<START>,0,0,0
6235,1,home,0,7,7
6235,2,shop,7,8,1
6235,3,work,8,10,2
6235,4,home,10,17,7
6235,5,work,17,19,2
6235,6,home,19,24,5
6235,7,<ENDS>,24,24,0
6236,0,<START>,0,0,0
6236,1,home,0,6,6
6236,2,shop,6,7,1
6236,3,home,7,13,6
6236,4,education,13,16,3
6236,5,home,16,24,8
6236,6,<ENDS>,24,24,0
6237,0,<START>,0,0,0
6237,1,home,0,7,7
6237,2,shop,7,8,1
6237,3,work,8,15,7
6237,4,home,15,22,7
6237,5,work,22,23,1
6237,6,home,23,24,1
6237,7,<ENDS>,24,24,0
6238,0,<START>,0,0,0
6238,1,home,0,7,7
6238,2,shop,7,8,1
6238,3,work,8,16,8
6238,4,home,16,21,5
6238,5,work,21,22,1
6238,6,home,22,24,2
6238,7,<ENDS>,24,24,0
6239,0,<START>,0,0,0
6239,1,home,0,6,6
6239,2,work,6,13,7
6239,3,home,13,24,11
6239,4,<ENDS>,24,24,0
6240,0,<START>,0,0,0
6240,1,home,0,8,8
6240,2,education,8,13,5
6240,3,home,13,17,4
6240,4,work,17,20,3
6240,5,home,20,24,4
6240,6,<ENDS>,24,24,0
6241,0,<START>,0,0,0
6241,1,home,0,7,7
6241,2,education,7,11,4
6241,3,home,11,19,8
6241,4,shop,19,20,1
6241,5,home,20,24,4
6241,6,<ENDS>,24,24,0
6242,0,<START>,0,0,0
6242,1,home,0,6,6
6242,2,work,6,7,1
6242,3,home,7,13,6
6242,4,work,13,15,2
6242,5,home,15,21,6
6242,6,work,21,22,1
6242,7,home,22,24,2
6242,8,<ENDS>,24,24,0
6243,0,<START>,0,0,0
6243,1,home,0,6,6
6243,2,work,6,13,7
6243,3,home,13,24,11
6243,4,<ENDS>,24,24,0
6244,0,<START>,0,0,0
6244,1,home,0,7,7
6244,2,work,7,14,7
6244,3,home,14,21,7
6244,4,shop,21,22,1
6244,5,home,22,24,2
6244,6,<ENDS>,24,24,0
6245,0,<START>,0,0,0
6245,1,home,0,6,6
6245,2,shop,6,8,2
6245,3,work,8,15,7
6245,4,home,15,24,9
6245,5,<ENDS>,24,24,0
6246,0,<START>,0,0,0
6246,1,home,0,7,7
6246,2,education,7,11,4
6246,3,home,11,17,6
6246,4,shop,17,18,1
6246,5,home,18,24,6
6246,6,<ENDS>,24,24,0
6247,0,<START>,0,0,0
6247,1,home,0,7,7
6247,2,education,7,11,4
6247,3,home,11,19,8
6247,4,shop,19,21,2
6247,5,home,21,24,3
6247,6,<ENDS>,24,24,0
6248,0,<START>,0,0,0
6248,1,home,0,8,8
6248,2,work,8,13,5
6248,3,home,13,17,4
6248,4,work,17,20,3
6248,5,home,20,24,4
6248,6,<ENDS>,24,24,0
6249,0,<START>,0,0,0
6249,1,home,0,7,7
6249,2,work,7,13,6
6249,3,shop,13,14,1
6249,4,home,14,24,10
6249,5,<ENDS>,24,24,0
6250,0,<START>,0,0,0
6250,1,home,0,8,8
6250,2,work,8,15,7
6250,3,home,15,24,9
6250,4,<ENDS>,24,24,0
6251,0,<START>,0,0,0
6251,1,home,0,7,7
6251,2,work,7,14,7
6251,3,home,14,24,10
6251,4,<ENDS>,24,24,0
6252,0,<START>,0,0,0
6252,1,home,0,6,6
6252,2,work,6,12,6
6252,3,shop,12,13,1
6252,4,work,13,19,6
6252,5,education,19,20,1
6252,6,home,20,24,4
6252,7,<ENDS>,24,24,0
6253,0,<START>,0,0,0
6253,1,home,0,7,7
6253,2,work,7,13,6
6253,3,shop,13,14,1
6253,4,work,14,20,6
6253,5,home,20,24,4
6253,6,<ENDS>,24,24,0
6254,0,<START>,0,0,0
6254,1,home,0,7,7
6254,2,work,7,14,7
6254,3,home,14,24,10
6254,4,<ENDS>,24,24,0
6255,0,<START>,0,0,0
6255,1,home,0,7,7
6255,2,work,7,14,7
6255,3,home,14,24,10
6255,4,<ENDS>,24,24,0
6256,0,<START>,0,0,0
6256,1,home,0,7,7
6256,2,work,7,14,7
6256,3,home,14,24,10
6256,4,<ENDS>,24,24,0
6257,0,<START>,0,0,0
6257,1,home,0,7,7
6257,2,education,7,11,4
6257,3,home,11,17,6
6257,4,shop,17,18,1
6257,5,home,18,24,6
6257,6,<ENDS>,24,24,0
6258,0,<START>,0,0,0
6258,1,home,0,7,7
6258,2,shop,7,8,1
6258,3,education,8,11,3
6258,4,home,11,14,3
6258,5,education,14,16,2
6258,6,home,16,24,8
6258,7,<ENDS>,24,24,0
6259,0,<START>,0,0,0
6259,1,home,0,6,6
6259,2,work,6,13,7
6259,3,home,13,24,11
6259,4,<ENDS>,24,24,0
6260,0,<START>,0,0,0
6260,1,home,0,7,7
6260,2,education,7,11,4
6260,3,home,11,19,8
6260,4,shop,19,20,1
6260,5,home,20,24,4
6260,6,<ENDS>,24,24,0
6261,0,<START>,0,0,0
6261,1,home,0,6,6
6261,2,work,6,13,7
6261,3,shop,13,14,1
6261,4,home,14,15,1
6261,5,work,15,19,4
6261,6,home,19,24,5
6261,7,<ENDS>,24,24,0
6262,0,<START>,0,0,0
6262,1,home,0,6,6
6262,2,shop,6,7,1
6262,3,home,7,9,2
6262,4,education,9,12,3
6262,5,home,12,18,6
6262,6,shop,18,19,1
6262,7,home,19,24,5
6262,8,<ENDS>,24,24,0
6263,0,<START>,0,0,0
6263,1,home,0,7,7
6263,2,work,7,13,6
6263,3,shop,13,14,1
6263,4,home,14,21,7
6263,5,work,21,22,1
6263,6,home,22,24,2
6263,7,<ENDS>,24,24,0
6264,0,<START>,0,0,0
6264,1,home,0,6,6
6264,2,work,6,13,7
6264,3,home,13,15,2
6264,4,shop,15,16,1
6264,5,home,16,24,8
6264,6,<ENDS>,24,24,0
6265,0,<START>,0,0,0
6265,1,home,0,8,8
6265,2,work,8,13,5
6265,3,home,13,18,5
6265,4,work,18,20,2
6265,5,home,20,24,4
6265,6,<ENDS>,24,24,0
6266,0,<START>,0,0,0
6266,1,home,0,7,7
6266,2,education,7,12,5
6266,3,home,12,18,6
6266,4,shop,18,19,1
6266,5,home,19,24,5
6266,6,<ENDS>,24,24,0
6267,0,<START>,0,0,0
6267,1,home,0,7,7
6267,2,work,7,14,7
6267,3,home,14,23,9
6267,4,work,23,24,1
6267,5,<ENDS>,24,24,0
6268,0,<START>,0,0,0
6268,1,home,0,9,9
6268,2,work,9,15,6
6268,3,shop,15,16,1
6268,4,work,16,20,4
6268,5,home,20,24,4
6268,6,<ENDS>,24,24,0
6269,0,<START>,0,0,0
6269,1,home,0,8,8
6269,2,work,8,15,7
6269,3,home,15,24,9
6269,4,<ENDS>,24,24,0
6270,0,<START>,0,0,0
6270,1,home,0,8,8
6270,2,work,8,14,6
6270,3,home,14,18,4
6270,4,work,18,19,1
6270,5,home,19,24,5
6270,6,<ENDS>,24,24,0
6271,0,<START>,0,0,0
6271,1,home,0,7,7
6271,2,work,7,14,7
6271,3,shop,14,15,1
6271,4,work,15,20,5
6271,5,home,20,24,4
6271,6,<ENDS>,24,24,0
6272,0,<START>,0,0,0
6272,1,home,0,9,9
6272,2,education,9,12,3
6272,3,shop,12,13,1
6272,4,work,13,19,6
6272,5,home,19,24,5
6272,6,<ENDS>,24,24,0
6273,0,<START>,0,0,0
6273,1,home,0,7,7
6273,2,work,7,13,6
6273,3,shop,13,14,1
6273,4,home,14,24,10
6273,5,<ENDS>,24,24,0
6274,0,<START>,0,0,0
6274,1,home,0,7,7
6274,2,education,7,11,4
6274,3,home,11,13,2
6274,4,education,13,16,3
6274,5,shop,16,17,1
6274,6,home,17,24,7
6274,7,<ENDS>,24,24,0
6275,0,<START>,0,0,0
6275,1,home,0,8,8
6275,2,work,8,14,6
6275,3,shop,14,15,1
6275,4,home,15,24,9
6275,5,<ENDS>,24,24,0
6276,0,<START>,0,0,0
6276,1,home,0,6,6
6276,2,shop,6,7,1
6276,3,home,7,10,3
6276,4,education,10,13,3
6276,5,home,13,20,7
6276,6,shop,20,21,1
6276,7,home,21,24,3
6276,8,<ENDS>,24,24,0
6277,0,<START>,0,0,0
6277,1,home,0,7,7
6277,2,education,7,11,4
6277,3,home,11,18,7
6277,4,shop,18,19,1
6277,5,home,19,24,5
6277,6,<ENDS>,24,24,0
6278,0,<START>,0,0,0
6278,1,home,0,6,6
6278,2,work,6,13,7
6278,3,home,13,17,4
6278,4,work,17,20,3
6278,5,home,20,24,4
6278,6,<ENDS>,24,24,0
6279,0,<START>,0,0,0
6279,1,home,0,6,6
6279,2,shop,6,7,1
6279,3,home,7,12,5
6279,4,education,12,16,4
6279,5,home,16,24,8
6279,6,<ENDS>,24,24,0
6280,0,<START>,0,0,0
6280,1,home,0,7,7
6280,2,work,7,15,8
6280,3,home,15,20,5
6280,4,shop,20,21,1
6280,5,home,21,24,3
6280,6,<ENDS>,24,24,0
6281,0,<START>,0,0,0
6281,1,home,0,6,6
6281,2,work,6,7,1
6281,3,home,7,9,2
6281,4,work,9,11,2
6281,5,home,11,16,5
6281,6,work,16,18,2
6281,7,home,18,24,6
6281,8,<ENDS>,24,24,0
6282,0,<START>,0,0,0
6282,1,home,0,8,8
6282,2,work,8,15,7
6282,3,home,15,24,9
6282,4,<ENDS>,24,24,0
6283,0,<START>,0,0,0
6283,1,home,0,8,8
6283,2,work,8,14,6
6283,3,shop,14,15,1
6283,4,work,15,20,5
6283,5,home,20,24,4
6283,6,<ENDS>,24,24,0
6284,0,<START>,0,0,0
6284,1,home,0,7,7
6284,2,education,7,11,4
6284,3,home,11,19,8
6284,4,shop,19,20,1
6284,5,home,20,24,4
6284,6,<ENDS>,24,24,0
6285,0,<START>,0,0,0
6285,1,home,0,9,9
6285,2,work,9,15,6
6285,3,home,15,21,6
6285,4,shop,21,22,1
6285,5,home,22,24,2
6285,6,<ENDS>,24,24,0
6286,0,<START>,0,0,0
6286,1,home,0,9,9
6286,2,education,9,12,3
6286,3,shop,12,13,1
6286,4,work,13,19,6
6286,5,home,19,24,5
6286,6,<ENDS>,24,24,0
6287,0,<START>,0,0,0
6287,1,home,0,7,7
6287,2,shop,7,8,1
6287,3,work,8,13,5
6287,4,home,13,24,11
6287,5,<ENDS>,24,24,0
6288,0,<START>,0,0,0
6288,1,home,0,7,7
6288,2,work,7,14,7
6288,3,home,14,24,10
6288,4,<ENDS>,24,24,0
6289,0,<START>,0,0,0
6289,1,home,0,7,7
6289,2,work,7,14,7
6289,3,shop,14,15,1
6289,4,home,15,24,9
6289,5,<ENDS>,24,24,0
6290,0,<START>,0,0,0
6290,1,home,0,8,8
6290,2,work,8,14,6
6290,3,home,14,18,4
6290,4,work,18,20,2
6290,5,home,20,24,4
6290,6,<ENDS>,24,24,0
6291,0,<START>,0,0,0
6291,1,home,0,6,6
6291,2,work,6,13,7
6291,3,shop,13,14,1
6291,4,work,14,19,5
6291,5,education,19,20,1
6291,6,home,20,24,4
6291,7,<ENDS>,24,24,0
6292,0,<START>,0,0,0
6292,1,home,0,8,8
6292,2,work,8,16,8
6292,3,shop,16,18,2
6292,4,work,18,20,2
6292,5,home,20,24,4
6292,6,<ENDS>,24,24,0
6293,0,<START>,0,0,0
6293,1,home,0,8,8
6293,2,work,8,15,7
6293,3,home,15,22,7
6293,4,work,22,23,1
6293,5,home,23,24,1
6293,6,<ENDS>,24,24,0
6294,0,<START>,0,0,0
6294,1,home,0,7,7
6294,2,shop,7,8,1
6294,3,work,8,15,7
6294,4,home,15,22,7
6294,5,work,22,23,1
6294,6,home,23,24,1
6294,7,<ENDS>,24,24,0
6295,0,<START>,0,0,0
6295,1,home,0,7,7
6295,2,work,7,9,2
6295,3,home,9,13,4
6295,4,work,13,15,2
6295,5,home,15,21,6
6295,6,shop,21,22,1
6295,7,home,22,24,2
6295,8,<ENDS>,24,24,0
6296,0,<START>,0,0,0
6296,1,home,0,8,8
6296,2,work,8,17,9
6296,3,home,17,24,7
6296,4,<ENDS>,24,24,0
6297,0,<START>,0,0,0
6297,1,home,0,6,6
6297,2,shop,6,7,1
6297,3,home,7,13,6
6297,4,education,13,17,4
6297,5,home,17,24,7
6297,6,<ENDS>,24,24,0
6298,0,<START>,0,0,0
6298,1,home,0,6,6
6298,2,work,6,7,1
6298,3,home,7,9,2
6298,4,work,9,10,1
6298,5,home,10,16,6
6298,6,work,16,19,3
6298,7,home,19,24,5
6298,8,<ENDS>,24,24,0
6299,0,<START>,0,0,0
6299,1,home,0,8,8
6299,2,work,8,15,7
6299,3,shop,15,16,1
6299,4,home,16,24,8
6299,5,<ENDS>,24,24,0
6300,0,<START>,0,0,0
6300,1,home,0,6,6
6300,2,shop,6,7,1
6300,3,home,7,9,2
6300,4,education,9,12,3
6300,5,shop,12,15,3
6300,6,home,15,24,9
6300,7,<ENDS>,24,24,0
6301,0,<START>,0,0,0
6301,1,home,0,6,6
6301,2,work,6,13,7
6301,3,home,13,17,4
6301,4,work,17,20,3
6301,5,home,20,24,4
6301,6,<ENDS>,24,24,0
6302,0,<START>,0,0,0
6302,1,home,0,7,7
6302,2,work,7,13,6
6302,3,home,13,17,4
6302,4,work,17,20,3
6302,5,home,20,24,4
6302,6,<ENDS>,24,24,0
6303,0,<START>,0,0,0
6303,1,home,0,7,7
6303,2,work,7,14,7
6303,3,home,14,24,10
6303,4,<ENDS>,24,24,0
6304,0,<START>,0,0,0
6304,1,home,0,6,6
6304,2,work,6,8,2
6304,3,home,8,12,4
6304,4,work,12,14,2
6304,5,home,14,21,7
6304,6,work,21,22,1
6304,7,home,22,24,2
6304,8,<ENDS>,24,24,0
6305,0,<START>,0,0,0
6305,1,home,0,6,6
6305,2,work,6,8,2
6305,3,home,8,14,6
6305,4,work,14,15,1
6305,5,home,15,21,6
6305,6,work,21,22,1
6305,7,home,22,24,2
6305,8,<ENDS>,24,24,0
6306,0,<START>,0,0,0
6306,1,home,0,6,6
6306,2,shop,6,7,1
6306,3,home,7,10,3
6306,4,education,10,12,2
6306,5,home,12,20,8
6306,6,shop,20,21,1
6306,7,home,21,24,3
6306,8,<ENDS>,24,24,0
6307,0,<START>,0,0,0
6307,1,home,0,6,6
6307,2,work,6,13,7
6307,3,home,13,21,8
6307,4,work,21,22,1
6307,5,home,22,24,2
6307,6,<ENDS>,24,24,0
6308,0,<START>,0,0,0
6308,1,home,0,7,7
6308,2,education,7,12,5
6308,3,shop,12,13,1
6308,4,education,13,16,3
6308,5,home,16,24,8
6308,6,<ENDS>,24,24,0
6309,0,<START>,0,0,0
6309,1,home,0,7,7
6309,2,work,7,13,6
6309,3,home,13,24,11
6309,4,<ENDS>,24,24,0
6310,0,<START>,0,0,0
6310,1,home,0,7,7
6310,2,education,7,11,4
6310,3,home,11,18,7
6310,4,shop,18,20,2
6310,5,home,20,24,4
6310,6,<ENDS>,24,24,0
6311,0,<START>,0,0,0
6311,1,home,0,6,6
6311,2,work,6,8,2
6311,3,home,8,12,4
6311,4,work,12,14,2
6311,5,home,14,21,7
6311,6,work,21,22,1
6311,7,home,22,24,2
6311,8,<ENDS>,24,24,0
6312,0,<START>,0,0,0
6312,1,home,0,7,7
6312,2,education,7,11,4
6312,3,home,11,18,7
6312,4,shop,18,20,2
6312,5,home,20,24,4
6312,6,<ENDS>,24,24,0
6313,0,<START>,0,0,0
6313,1,home,0,7,7
6313,2,work,7,14,7
6313,3,home,14,24,10
6313,4,<ENDS>,24,24,0
6314,0,<START>,0,0,0
6314,1,home,0,7,7
6314,2,work,7,14,7
6314,3,home,14,17,3
6314,4,work,17,19,2
6314,5,home,19,24,5
6314,6,<ENDS>,24,24,0
6315,0,<START>,0,0,0
6315,1,home,0,9,9
6315,2,education,9,13,4
6315,3,work,13,19,6
6315,4,home,19,24,5
6315,5,<ENDS>,24,24,0
6316,0,<START>,0,0,0
6316,1,home,0,7,7
6316,2,shop,7,8,1
6316,3,home,8,12,4
6316,4,work,12,19,7
6316,5,home,19,24,5
6316,6,<ENDS>,24,24,0
6317,0,<START>,0,0,0
6317,1,home,0,8,8
6317,2,work,8,14,6
6317,3,shop,14,15,1
6317,4,home,15,20,5
6317,5,shop,20,21,1
6317,6,home,21,24,3
6317,7,<ENDS>,24,24,0
6318,0,<START>,0,0,0
6318,1,home,0,7,7
6318,2,work,7,14,7
6318,3,home,14,21,7
6318,4,work,21,22,1
6318,5,home,22,24,2
6318,6,<ENDS>,24,24,0
6319,0,<START>,0,0,0
6319,1,home,0,7,7
6319,2,work,7,9,2
6319,3,home,9,13,4
6319,4,work,13,14,1
6319,5,home,14,21,7
6319,6,work,21,22,1
6319,7,home,22,24,2
6319,8,<ENDS>,24,24,0
6320,0,<START>,0,0,0
6320,1,home,0,7,7
6320,2,work,7,13,6
6320,3,shop,13,14,1
6320,4,work,14,20,6
6320,5,home,20,24,4
6320,6,<ENDS>,24,24,0
6321,0,<START>,0,0,0
6321,1,home,0,7,7
6321,2,work,7,14,7
6321,3,shop,14,15,1
6321,4,home,15,24,9
6321,5,<ENDS>,24,24,0
6322,0,<START>,0,0,0
6322,1,home,0,7,7
6322,2,work,7,14,7
6322,3,shop,14,15,1
6322,4,home,15,24,9
6322,5,<ENDS>,24,24,0
6323,0,<START>,0,0,0
6323,1,home,0,6,6
6323,2,work,6,13,7
6323,3,home,13,24,11
6323,4,<ENDS>,24,24,0
6324,0,<START>,0,0,0
6324,1,home,0,7,7
6324,2,work,7,14,7
6324,3,shop,14,16,2
6324,4,work,16,20,4
6324,5,home,20,24,4
6324,6,<ENDS>,24,24,0
6325,0,<START>,0,0,0
6325,1,home,0,8,8
6325,2,work,8,15,7
6325,3,home,15,24,9
6325,4,<ENDS>,24,24,0
6326,0,<START>,0,0,0
6326,1,home,0,6,6
6326,2,work,6,14,8
6326,3,shop,14,15,1
6326,4,home,15,24,9
6326,5,<ENDS>,24,24,0
6327,0,<START>,0,0,0
6327,1,home,0,7,7
6327,2,education,7,11,4
6327,3,home,11,19,8
6327,4,shop,19,20,1
6327,5,home,20,24,4
6327,6,<ENDS>,24,24,0
6328,0,<START>,0,0,0
6328,1,home,0,8,8
6328,2,shop,8,9,1
6328,3,work,9,15,6
6328,4,home,15,24,9
6328,5,<ENDS>,24,24,0
6329,0,<START>,0,0,0
6329,1,home,0,7,7
6329,2,shop,7,8,1
6329,3,education,8,11,3
6329,4,home,11,18,7
6329,5,shop,18,19,1
6329,6,home,19,24,5
6329,7,<ENDS>,24,24,0
6330,0,<START>,0,0,0
6330,1,home,0,7,7
6330,2,work,7,13,6
6330,3,shop,13,14,1
6330,4,work,14,19,5
6330,5,home,19,24,5
6330,6,<ENDS>,24,24,0
6331,0,<START>,0,0,0
6331,1,home,0,8,8
6331,2,education,8,11,3
6331,3,home,11,15,4
6331,4,work,15,20,5
6331,5,home,20,24,4
6331,6,<ENDS>,24,24,0
6332,0,<START>,0,0,0
6332,1,home,0,8,8
6332,2,work,8,14,6
6332,3,shop,14,15,1
6332,4,home,15,24,9
6332,5,<ENDS>,24,24,0
6333,0,<START>,0,0,0
6333,1,home,0,7,7
6333,2,work,7,9,2
6333,3,home,9,13,4
6333,4,work,13,16,3
6333,5,home,16,23,7
6333,6,work,23,24,1
6333,7,<ENDS>,24,24,0
6334,0,<START>,0,0,0
6334,1,home,0,7,7
6334,2,work,7,14,7
6334,3,home,14,22,8
6334,4,work,22,23,1
6334,5,home,23,24,1
6334,6,<ENDS>,24,24,0
6335,0,<START>,0,0,0
6335,1,home,0,7,7
6335,2,work,7,13,6
6335,3,home,13,21,8
6335,4,work,21,22,1
6335,5,home,22,24,2
6335,6,<ENDS>,24,24,0
6336,0,<START>,0,0,0
6336,1,home,0,8,8
6336,2,work,8,16,8
6336,3,home,16,24,8
6336,4,<ENDS>,24,24,0
6337,0,<START>,0,0,0
6337,1,home,0,6,6
6337,2,shop,6,7,1
6337,3,work,7,13,6
6337,4,home,13,24,11
6337,5,<ENDS>,24,24,0
6338,0,<START>,0,0,0
6338,1,home,0,7,7
6338,2,work,7,14,7
6338,3,shop,14,15,1
6338,4,home,15,24,9
6338,5,<ENDS>,24,24,0
6339,0,<START>,0,0,0
6339,1,home,0,6,6
6339,2,work,6,13,7
6339,3,home,13,16,3
6339,4,work,16,20,4
6339,5,home,20,24,4
6339,6,<ENDS>,24,24,0
6340,0,<START>,0,0,0
6340,1,home,0,6,6
6340,2,shop,6,7,1
6340,3,home,7,13,6
6340,4,education,13,16,3
6340,5,home,16,24,8
6340,6,<ENDS>,24,24,0
6341,0,<START>,0,0,0
6341,1,home,0,6,6
6341,2,work,6,8,2
6341,3,home,8,14,6
6341,4,work,14,16,2
6341,5,home,16,21,5
6341,6,work,21,22,1
6341,7,home,22,24,2
6341,8,<ENDS>,24,24,0
6342,0,<START>,0,0,0
6342,1,home,0,6,6
6342,2,work,6,13,7
6342,3,home,13,24,11
6342,4,<ENDS>,24,24,0
6343,0,<START>,0,0,0
6343,1,home,0,8,8
6343,2,work,8,13,5
6343,3,shop,13,14,1
6343,4,education,14,16,2
6343,5,home,16,24,8
6343,6,<ENDS>,24,24,0
6344,0,<START>,0,0,0
6344,1,home,0,7,7
6344,2,shop,7,8,1
6344,3,education,8,11,3
6344,4,home,11,20,9
6344,5,shop,20,21,1
6344,6,home,21,24,3
6344,7,<ENDS>,24,24,0
6345,0,<START>,0,0,0
6345,1,home,0,8,8
6345,2,work,8,14,6
6345,3,shop,14,15,1
6345,4,home,15,24,9
6345,5,<ENDS>,24,24,0
6346,0,<START>,0,0,0
6346,1,home,0,8,8
6346,2,work,8,15,7
6346,3,home,15,24,9
6346,4,<ENDS>,24,24,0
6347,0,<START>,0,0,0
6347,1,home,0,6,6
6347,2,shop,6,7,1
6347,3,home,7,10,3
6347,4,education,10,16,6
6347,5,home,16,24,8
6347,6,<ENDS>,24,24,0
6348,0,<START>,0,0,0
6348,1,home,0,6,6
6348,2,shop,6,7,1
6348,3,work,7,13,6
6348,4,home,13,21,8
6348,5,work,21,22,1
6348,6,home,22,24,2
6348,7,<ENDS>,24,24,0
6349,0,<START>,0,0,0
6349,1,home,0,7,7
6349,2,work,7,9,2
6349,3,shop,9,10,1
6349,4,home,10,15,5
6349,5,work,15,17,2
6349,6,home,17,24,7
6349,7,<ENDS>,24,24,0
6350,0,<START>,0,0,0
6350,1,home,0,6,6
6350,2,shop,6,7,1
6350,3,home,7,9,2
6350,4,work,9,15,6
6350,5,home,15,24,9
6350,6,<ENDS>,24,24,0
6351,0,<START>,0,0,0
6351,1,home,0,7,7
6351,2,work,7,13,6
6351,3,home,13,21,8
6351,4,work,21,22,1
6351,5,home,22,24,2
6351,6,<ENDS>,24,24,0
6352,0,<START>,0,0,0
6352,1,home,0,6,6
6352,2,work,6,13,7
6352,3,home,13,23,10
6352,4,work,23,24,1
6352,5,<ENDS>,24,24,0
6353,0,<START>,0,0,0
6353,1,home,0,7,7
6353,2,work,7,14,7
6353,3,shop,14,15,1
6353,4,work,15,20,5
6353,5,home,20,24,4
6353,6,<ENDS>,24,24,0
6354,0,<START>,0,0,0
6354,1,home,0,8,8
6354,2,work,8,15,7
6354,3,home,15,24,9
6354,4,<ENDS>,24,24,0
6355,0,<START>,0,0,0
6355,1,home,0,6,6
6355,2,work,6,13,7
6355,3,home,13,21,8
6355,4,work,21,22,1
6355,5,home,22,24,2
6355,6,<ENDS>,24,24,0
6356,0,<START>,0,0,0
6356,1,home,0,6,6
6356,2,work,6,8,2
6356,3,home,8,9,1
6356,4,work,9,11,2
6356,5,home,11,15,4
6356,6,work,15,17,2
6356,7,home,17,24,7
6356,8,<ENDS>,24,24,0
6357,0,<START>,0,0,0
6357,1,home,0,6,6
6357,2,work,6,13,7
6357,3,home,13,19,6
6357,4,shop,19,20,1
6357,5,home,20,24,4
6357,6,<ENDS>,24,24,0
6358,0,<START>,0,0,0
6358,1,home,0,8,8
6358,2,work,8,15,7
6358,3,home,15,24,9
6358,4,<ENDS>,24,24,0
6359,0,<START>,0,0,0
6359,1,home,0,7,7
6359,2,education,7,11,4
6359,3,home,11,17,6
6359,4,shop,17,19,2
6359,5,home,19,24,5
6359,6,<ENDS>,24,24,0
6360,0,<START>,0,0,0
6360,1,home,0,7,7
6360,2,work,7,14,7
6360,3,shop,14,15,1
6360,4,work,15,20,5
6360,5,home,20,24,4
6360,6,<ENDS>,24,24,0
6361,0,<START>,0,0,0
6361,1,home,0,8,8
6361,2,work,8,15,7
6361,3,shop,15,17,2
6361,4,home,17,22,5
6361,5,work,22,23,1
6361,6,home,23,24,1
6361,7,<ENDS>,24,24,0
6362,0,<START>,0,0,0
6362,1,home,0,7,7
6362,2,work,7,9,2
6362,3,home,9,13,4
6362,4,work,13,16,3
6362,5,shop,16,17,1
6362,6,home,17,24,7
6362,7,<ENDS>,24,24,0
6363,0,<START>,0,0,0
6363,1,home,0,7,7
6363,2,work,7,13,6
6363,3,shop,13,14,1
6363,4,home,14,24,10
6363,5,<ENDS>,24,24,0
6364,0,<START>,0,0,0
6364,1,home,0,8,8
6364,2,shop,8,10,2
6364,3,education,10,16,6
6364,4,home,16,24,8
6364,5,<ENDS>,24,24,0
6365,0,<START>,0,0,0
6365,1,home,0,7,7
6365,2,work,7,12,5
6365,3,shop,12,13,1
6365,4,education,13,16,3
6365,5,home,16,24,8
6365,6,<ENDS>,24,24,0
6366,0,<START>,0,0,0
6366,1,home,0,7,7
6366,2,work,7,14,7
6366,3,home,14,23,9
6366,4,work,23,24,1
6366,5,<ENDS>,24,24,0
6367,0,<START>,0,0,0
6367,1,home,0,8,8
6367,2,education,8,11,3
6367,3,home,11,23,12
6367,4,work,23,24,1
6367,5,<ENDS>,24,24,0
6368,0,<START>,0,0,0
6368,1,home,0,6,6
6368,2,work,6,13,7
6368,3,shop,13,14,1
6368,4,work,14,19,5
6368,5,home,19,24,5
6368,6,<ENDS>,24,24,0
6369,0,<START>,0,0,0
6369,1,home,0,6,6
6369,2,work,6,13,7
6369,3,home,13,17,4
6369,4,work,17,20,3
6369,5,home,20,24,4
6369,6,<ENDS>,24,24,0
6370,0,<START>,0,0,0
6370,1,home,0,7,7
6370,2,shop,7,8,1
6370,3,work,8,14,6
6370,4,home,14,18,4
6370,5,work,18,19,1
6370,6,home,19,24,5
6370,7,<ENDS>,24,24,0
6371,0,<START>,0,0,0
6371,1,home,0,8,8
6371,2,work,8,15,7
6371,3,home,15,24,9
6371,4,<ENDS>,24,24,0
6372,0,<START>,0,0,0
6372,1,home,0,6,6
6372,2,work,6,7,1
6372,3,home,7,9,2
6372,4,work,9,10,1
6372,5,home,10,14,4
6372,6,work,14,17,3
6372,7,home,17,23,6
6372,8,work,23,24,1
6372,9,<ENDS>,24,24,0
6373,0,<START>,0,0,0
6373,1,home,0,6,6
6373,2,work,6,8,2
6373,3,home,8,12,4
6373,4,work,12,14,2
6373,5,home,14,15,1
6373,6,shop,15,16,1
6373,7,home,16,23,7
6373,8,work,23,24,1
6373,9,<ENDS>,24,24,0
6374,0,<START>,0,0,0
6374,1,home,0,8,8
6374,2,work,8,15,7
6374,3,shop,15,16,1
6374,4,work,16,20,4
6374,5,home,20,24,4
6374,6,<ENDS>,24,24,0
6375,0,<START>,0,0,0
6375,1,home,0,7,7
6375,2,work,7,13,6
6375,3,shop,13,14,1
6375,4,home,14,24,10
6375,5,<ENDS>,24,24,0
6376,0,<START>,0,0,0
6376,1,home,0,6,6
6376,2,work,6,8,2
6376,3,home,8,14,6
6376,4,work,14,16,2
6376,5,home,16,23,7
6376,6,work,23,24,1
6376,7,<ENDS>,24,24,0
6377,0,<START>,0,0,0
6377,1,home,0,6,6
6377,2,shop,6,7,1
6377,3,home,7,9,2
6377,4,work,9,17,8
6377,5,home,17,24,7
6377,6,<ENDS>,24,24,0
6378,0,<START>,0,0,0
6378,1,home,0,7,7
6378,2,shop,7,9,2
6378,3,education,9,15,6
6378,4,shop,15,17,2
6378,5,home,17,24,7
6378,6,<ENDS>,24,24,0
6379,0,<START>,0,0,0
6379,1,home,0,7,7
6379,2,education,7,11,4
6379,3,home,11,18,7
6379,4,shop,18,20,2
6379,5,home,20,24,4
6379,6,<ENDS>,24,24,0
6380,0,<START>,0,0,0
6380,1,home,0,6,6
6380,2,shop,6,7,1
6380,3,home,7,9,2
6380,4,work,9,15,6
6380,5,home,15,23,8
6380,6,work,23,24,1
6380,7,<ENDS>,24,24,0
6381,0,<START>,0,0,0
6381,1,home,0,7,7
6381,2,work,7,13,6
6381,3,home,13,17,4
6381,4,shop,17,18,1
6381,5,home,18,24,6
6381,6,<ENDS>,24,24,0
6382,0,<START>,0,0,0
6382,1,home,0,7,7
6382,2,education,7,11,4
6382,3,home,11,16,5
6382,4,shop,16,17,1
6382,5,home,17,24,7
6382,6,<ENDS>,24,24,0
6383,0,<START>,0,0,0
6383,1,home,0,7,7
6383,2,work,7,14,7
6383,3,home,14,17,3
6383,4,work,17,20,3
6383,5,home,20,24,4
6383,6,<ENDS>,24,24,0
6384,0,<START>,0,0,0
6384,1,home,0,8,8
6384,2,work,8,15,7
6384,3,shop,15,16,1
6384,4,home,16,24,8
6384,5,<ENDS>,24,24,0
6385,0,<START>,0,0,0
6385,1,home,0,6,6
6385,2,work,6,8,2
6385,3,home,8,14,6
6385,4,work,14,16,2
6385,5,home,16,24,8
6385,6,<ENDS>,24,24,0
6386,0,<START>,0,0,0
6386,1,home,0,6,6
6386,2,work,6,13,7
6386,3,shop,13,15,2
6386,4,home,15,24,9
6386,5,<ENDS>,24,24,0
6387,0,<START>,0,0,0
6387,1,home,0,7,7
6387,2,work,7,14,7
6387,3,home,14,24,10
6387,4,<ENDS>,24,24,0
6388,0,<START>,0,0,0
6388,1,home,0,7,7
6388,2,education,7,11,4
6388,3,home,11,19,8
6388,4,shop,19,20,1
6388,5,home,20,24,4
6388,6,<ENDS>,24,24,0
6389,0,<START>,0,0,0
6389,1,home,0,7,7
6389,2,education,7,11,4
6389,3,home,11,17,6
6389,4,shop,17,18,1
6389,5,home,18,24,6
6389,6,<ENDS>,24,24,0
6390,0,<START>,0,0,0
6390,1,home,0,8,8
6390,2,shop,8,9,1
6390,3,education,9,12,3
6390,4,home,12,14,2
6390,5,education,14,18,4
6390,6,home,18,24,6
6390,7,<ENDS>,24,24,0
6391,0,<START>,0,0,0
6391,1,home,0,7,7
6391,2,work,7,13,6
6391,3,shop,13,14,1
6391,4,home,14,19,5
6391,5,shop,19,20,1
6391,6,home,20,24,4
6391,7,<ENDS>,24,24,0
6392,0,<START>,0,0,0
6392,1,home,0,7,7
6392,2,education,7,11,4
6392,3,home,11,19,8
6392,4,shop,19,20,1
6392,5,home,20,24,4
6392,6,<ENDS>,24,24,0
6393,0,<START>,0,0,0
6393,1,home,0,7,7
6393,2,work,7,14,7
6393,3,shop,14,15,1
6393,4,home,15,24,9
6393,5,<ENDS>,24,24,0
6394,0,<START>,0,0,0
6394,1,home,0,8,8
6394,2,work,8,15,7
6394,3,home,15,24,9
6394,4,<ENDS>,24,24,0
6395,0,<START>,0,0,0
6395,1,home,0,8,8
6395,2,education,8,12,4
6395,3,home,12,16,4
6395,4,shop,16,18,2
6395,5,home,18,24,6
6395,6,<ENDS>,24,24,0
6396,0,<START>,0,0,0
6396,1,home,0,7,7
6396,2,shop,7,9,2
6396,3,education,9,12,3
6396,4,home,12,18,6
6396,5,shop,18,20,2
6396,6,home,20,24,4
6396,7,<ENDS>,24,24,0
6397,0,<START>,0,0,0
6397,1,home,0,7,7
6397,2,education,7,12,5
6397,3,shop,12,14,2
6397,4,home,14,21,7
6397,5,shop,21,22,1
6397,6,home,22,24,2
6397,7,<ENDS>,24,24,0
6398,0,<START>,0,0,0
6398,1,home,0,8,8
6398,2,work,8,15,7
6398,3,home,15,24,9
6398,4,<ENDS>,24,24,0
6399,0,<START>,0,0,0
6399,1,home,0,7,7
6399,2,work,7,13,6
6399,3,home,13,15,2
6399,4,work,15,20,5
6399,5,home,20,24,4
6399,6,<ENDS>,24,24,0
6400,0,<START>,0,0,0
6400,1,home,0,7,7
6400,2,work,7,13,6
6400,3,home,13,17,4
6400,4,work,17,20,3
6400,5,home,20,24,4
6400,6,<ENDS>,24,24,0
6401,0,<START>,0,0,0
6401,1,home,0,7,7
6401,2,education,7,11,4
6401,3,home,11,19,8
6401,4,shop,19,21,2
6401,5,home,21,24,3
6401,6,<ENDS>,24,24,0
6402,0,<START>,0,0,0
6402,1,home,0,8,8
6402,2,work,8,13,5
6402,3,shop,13,14,1
6402,4,home,14,24,10
6402,5,<ENDS>,24,24,0
6403,0,<START>,0,0,0
6403,1,home,0,9,9
6403,2,shop,9,10,1
6403,3,home,10,22,12
6403,4,work,22,23,1
6403,5,home,23,24,1
6403,6,<ENDS>,24,24,0
6404,0,<START>,0,0,0
6404,1,home,0,6,6
6404,2,shop,6,7,1
6404,3,home,7,10,3
6404,4,education,10,13,3
6404,5,shop,13,15,2
6404,6,home,15,20,5
6404,7,shop,20,21,1
6404,8,home,21,24,3
6404,9,<ENDS>,24,24,0
6405,0,<START>,0,0,0
6405,1,home,0,7,7
6405,2,shop,7,9,2
6405,3,education,9,12,3
6405,4,shop,12,14,2
6405,5,home,14,20,6
6405,6,shop,20,21,1
6405,7,home,21,24,3
6405,8,<ENDS>,24,24,0
6406,0,<START>,0,0,0
6406,1,home,0,6,6
6406,2,shop,6,7,1
6406,3,work,7,13,6
6406,4,home,13,22,9
6406,5,work,22,23,1
6406,6,home,23,24,1
6406,7,<ENDS>,24,24,0
6407,0,<START>,0,0,0
6407,1,home,0,8,8
6407,2,work,8,14,6
6407,3,home,14,20,6
6407,4,shop,20,21,1
6407,5,home,21,24,3
6407,6,<ENDS>,24,24,0
6408,0,<START>,0,0,0
6408,1,home,0,8,8
6408,2,work,8,15,7
6408,3,home,15,23,8
6408,4,work,23,24,1
6408,5,<ENDS>,24,24,0
6409,0,<START>,0,0,0
6409,1,home,0,6,6
6409,2,shop,6,7,1
6409,3,home,7,9,2
6409,4,work,9,15,6
6409,5,home,15,24,9
6409,6,<ENDS>,24,24,0
6410,0,<START>,0,0,0
6410,1,home,0,6,6
6410,2,work,6,13,7
6410,3,home,13,17,4
6410,4,work,17,20,3
6410,5,home,20,24,4
6410,6,<ENDS>,24,24,0
6411,0,<START>,0,0,0
6411,1,home,0,7,7
6411,2,education,7,10,3
6411,3,home,10,14,4
6411,4,education,14,15,1
6411,5,shop,15,16,1
6411,6,home,16,24,8
6411,7,<ENDS>,24,24,0
6412,0,<START>,0,0,0
6412,1,home,0,7,7
6412,2,work,7,9,2
6412,3,home,9,15,6
6412,4,work,15,17,2
6412,5,home,17,24,7
6412,6,<ENDS>,24,24,0
6413,0,<START>,0,0,0
6413,1,home,0,7,7
6413,2,work,7,13,6
6413,3,home,13,24,11
6413,4,<ENDS>,24,24,0
6414,0,<START>,0,0,0
6414,1,home,0,6,6
6414,2,work,6,13,7
6414,3,home,13,16,3
6414,4,work,16,20,4
6414,5,home,20,24,4
6414,6,<ENDS>,24,24,0
6415,0,<START>,0,0,0
6415,1,home,0,9,9
6415,2,education,9,13,4
6415,3,shop,13,14,1
6415,4,home,14,19,5
6415,5,shop,19,20,1
6415,6,home,20,24,4
6415,7,<ENDS>,24,24,0
6416,0,<START>,0,0,0
6416,1,home,0,8,8
6416,2,work,8,14,6
6416,3,shop,14,15,1
6416,4,home,15,24,9
6416,5,<ENDS>,24,24,0
6417,0,<START>,0,0,0
6417,1,home,0,6,6
6417,2,shop,6,8,2
6417,3,work,8,15,7
6417,4,home,15,24,9
6417,5,<ENDS>,24,24,0
6418,0,<START>,0,0,0
6418,1,home,0,6,6
6418,2,shop,6,7,1
6418,3,home,7,13,6
6418,4,education,13,16,3
6418,5,shop,16,17,1
6418,6,home,17,24,7
6418,7,<ENDS>,24,24,0
6419,0,<START>,0,0,0
6419,1,home,0,7,7
6419,2,work,7,13,6
6419,3,home,13,17,4
6419,4,work,17,20,3
6419,5,home,20,24,4
6419,6,<ENDS>,24,24,0
6420,0,<START>,0,0,0
6420,1,home,0,8,8
6420,2,education,8,11,3
6420,3,home,11,14,3
6420,4,work,14,20,6
6420,5,home,20,24,4
6420,6,<ENDS>,24,24,0
6421,0,<START>,0,0,0
6421,1,home,0,7,7
6421,2,work,7,14,7
6421,3,shop,14,16,2
6421,4,home,16,24,8
6421,5,<ENDS>,24,24,0
6422,0,<START>,0,0,0
6422,1,home,0,8,8
6422,2,shop,8,9,1
6422,3,work,9,18,9
6422,4,home,18,24,6
6422,5,<ENDS>,24,24,0
6423,0,<START>,0,0,0
6423,1,home,0,7,7
6423,2,work,7,14,7
6423,3,shop,14,15,1
6423,4,home,15,21,6
6423,5,work,21,22,1
6423,6,home,22,24,2
6423,7,<ENDS>,24,24,0
6424,0,<START>,0,0,0
6424,1,home,0,7,7
6424,2,work,7,14,7
6424,3,shop,14,15,1
6424,4,work,15,20,5
6424,5,home,20,24,4
6424,6,<ENDS>,24,24,0
6425,0,<START>,0,0,0
6425,1,home,0,6,6
6425,2,work,6,8,2
6425,3,home,8,12,4
6425,4,work,12,13,1
6425,5,shop,13,14,1
6425,6,home,14,21,7
6425,7,work,21,22,1
6425,8,home,22,24,2
6425,9,<ENDS>,24,24,0
6426,0,<START>,0,0,0
6426,1,home,0,8,8
6426,2,work,8,14,6
6426,3,home,14,23,9
6426,4,work,23,24,1
6426,5,<ENDS>,24,24,0
6427,0,<START>,0,0,0
6427,1,home,0,7,7
6427,2,work,7,13,6
6427,3,shop,13,14,1
6427,4,home,14,23,9
6427,5,work,23,24,1
6427,6,<ENDS>,24,24,0
6428,0,<START>,0,0,0
6428,1,home,0,7,7
6428,2,work,7,13,6
6428,3,home,13,14,1
6428,4,shop,14,15,1
6428,5,work,15,20,5
6428,6,home,20,24,4
6428,7,<ENDS>,24,24,0
6429,0,<START>,0,0,0
6429,1,home,0,8,8
6429,2,work,8,15,7
6429,3,home,15,24,9
6429,4,<ENDS>,24,24,0
6430,0,<START>,0,0,0
6430,1,home,0,8,8
6430,2,work,8,15,7
6430,3,home,15,24,9
6430,4,<ENDS>,24,24,0
6431,0,<START>,0,0,0
6431,1,home,0,6,6
6431,2,work,6,13,7
6431,3,home,13,17,4
6431,4,shop,17,18,1
6431,5,home,18,24,6
6431,6,<ENDS>,24,24,0
6432,0,<START>,0,0,0
6432,1,home,0,6,6
6432,2,work,6,8,2
6432,3,home,8,14,6
6432,4,work,14,16,2
6432,5,home,16,22,6
6432,6,work,22,23,1
6432,7,home,23,24,1
6432,8,<ENDS>,24,24,0
6433,0,<START>,0,0,0
6433,1,home,0,6,6
6433,2,shop,6,7,1
6433,3,home,7,13,6
6433,4,education,13,16,3
6433,5,home,16,24,8
6433,6,<ENDS>,24,24,0
6434,0,<START>,0,0,0
6434,1,home,0,6,6
6434,2,work,6,13,7
6434,3,shop,13,14,1
6434,4,education,14,17,3
6434,5,home,17,22,5
6434,6,work,22,23,1
6434,7,home,23,24,1
6434,8,<ENDS>,24,24,0
6435,0,<START>,0,0,0
6435,1,home,0,6,6
6435,2,shop,6,7,1
6435,3,home,7,12,5
6435,4,work,12,19,7
6435,5,home,19,24,5
6435,6,<ENDS>,24,24,0
6436,0,<START>,0,0,0
6436,1,home,0,7,7
6436,2,work,7,13,6
6436,3,home,13,24,11
6436,4,<ENDS>,24,24,0
6437,0,<START>,0,0,0
6437,1,home,0,6,6
6437,2,work,6,13,7
6437,3,home,13,20,7
6437,4,shop,20,21,1
6437,5,home,21,24,3
6437,6,<ENDS>,24,24,0
6438,0,<START>,0,0,0
6438,1,home,0,6,6
6438,2,work,6,13,7
6438,3,home,13,18,5
6438,4,work,18,20,2
6438,5,home,20,24,4
6438,6,<ENDS>,24,24,0
6439,0,<START>,0,0,0
6439,1,home,0,7,7
6439,2,work,7,13,6
6439,3,shop,13,14,1
6439,4,work,14,20,6
6439,5,home,20,24,4
6439,6,<ENDS>,24,24,0
6440,0,<START>,0,0,0
6440,1,home,0,7,7
6440,2,work,7,13,6
6440,3,home,13,21,8
6440,4,work,21,22,1
6440,5,home,22,24,2
6440,6,<ENDS>,24,24,0
6441,0,<START>,0,0,0
6441,1,home,0,7,7
6441,2,work,7,15,8
6441,3,shop,15,16,1
6441,4,home,16,21,5
6441,5,work,21,22,1
6441,6,home,22,24,2
6441,7,<ENDS>,24,24,0
6442,0,<START>,0,0,0
6442,1,home,0,6,6
6442,2,work,6,8,2
6442,3,home,8,12,4
6442,4,work,12,14,2
6442,5,home,14,21,7
6442,6,work,21,22,1
6442,7,home,22,24,2
6442,8,<ENDS>,24,24,0
6443,0,<START>,0,0,0
6443,1,home,0,7,7
6443,2,work,7,14,7
6443,3,home,14,21,7
6443,4,shop,21,22,1
6443,5,home,22,24,2
6443,6,<ENDS>,24,24,0
6444,0,<START>,0,0,0
6444,1,home,0,8,8
6444,2,education,8,11,3
6444,3,home,11,17,6
6444,4,shop,17,18,1
6444,5,home,18,24,6
6444,6,<ENDS>,24,24,0
6445,0,<START>,0,0,0
6445,1,home,0,7,7
6445,2,work,7,13,6
6445,3,shop,13,14,1
6445,4,home,14,24,10
6445,5,<ENDS>,24,24,0
6446,0,<START>,0,0,0
6446,1,home,0,7,7
6446,2,work,7,14,7
6446,3,shop,14,15,1
6446,4,home,15,24,9
6446,5,<ENDS>,24,24,0
6447,0,<START>,0,0,0
6447,1,home,0,8,8
6447,2,work,8,15,7
6447,3,shop,15,16,1
6447,4,home,16,24,8
6447,5,<ENDS>,24,24,0
6448,0,<START>,0,0,0
6448,1,home,0,7,7
6448,2,work,7,13,6
6448,3,home,13,24,11
6448,4,<ENDS>,24,24,0
6449,0,<START>,0,0,0
6449,1,home,0,7,7
6449,2,work,7,13,6
6449,3,home,13,16,3
6449,4,work,16,19,3
6449,5,home,19,24,5
6449,6,<ENDS>,24,24,0
6450,0,<START>,0,0,0
6450,1,home,0,8,8
6450,2,work,8,15,7
6450,3,home,15,17,2
6450,4,work,17,20,3
6450,5,home,20,24,4
6450,6,<ENDS>,24,24,0
6451,0,<START>,0,0,0
6451,1,home,0,7,7
6451,2,work,7,13,6
6451,3,shop,13,14,1
6451,4,home,14,21,7
6451,5,work,21,22,1
6451,6,home,22,24,2
6451,7,<ENDS>,24,24,0
6452,0,<START>,0,0,0
6452,1,home,0,6,6
6452,2,work,6,13,7
6452,3,shop,13,14,1
6452,4,work,14,19,5
6452,5,home,19,24,5
6452,6,<ENDS>,24,24,0
6453,0,<START>,0,0,0
6453,1,home,0,6,6
6453,2,work,6,13,7
6453,3,shop,13,14,1
6453,4,home,14,23,9
6453,5,work,23,24,1
6453,6,<ENDS>,24,24,0
6454,0,<START>,0,0,0
6454,1,home,0,6,6
6454,2,shop,6,7,1
6454,3,home,7,11,4
6454,4,work,11,18,7
6454,5,home,18,23,5
6454,6,work,23,24,1
6454,7,<ENDS>,24,24,0
6455,0,<START>,0,0,0
6455,1,home,0,7,7
6455,2,work,7,13,6
6455,3,home,13,24,11
6455,4,<ENDS>,24,24,0
6456,0,<START>,0,0,0
6456,1,home,0,7,7
6456,2,work,7,14,7
6456,3,home,14,24,10
6456,4,<ENDS>,24,24,0
6457,0,<START>,0,0,0
6457,1,home,0,8,8
6457,2,work,8,10,2
6457,3,shop,10,11,1
6457,4,work,11,18,7
6457,5,home,18,24,6
6457,6,<ENDS>,24,24,0
6458,0,<START>,0,0,0
6458,1,home,0,8,8
6458,2,work,8,14,6
6458,3,shop,14,15,1
6458,4,home,15,24,9
6458,5,<ENDS>,24,24,0
6459,0,<START>,0,0,0
6459,1,home,0,7,7
6459,2,work,7,14,7
6459,3,home,14,24,10
6459,4,<ENDS>,24,24,0
6460,0,<START>,0,0,0
6460,1,home,0,7,7
6460,2,work,7,14,7
6460,3,home,14,18,4
6460,4,shop,18,19,1
6460,5,home,19,24,5
6460,6,<ENDS>,24,24,0
6461,0,<START>,0,0,0
6461,1,home,0,7,7
6461,2,work,7,13,6
6461,3,shop,13,14,1
6461,4,home,14,24,10
6461,5,<ENDS>,24,24,0
6462,0,<START>,0,0,0
6462,1,home,0,8,8
6462,2,work,8,15,7
6462,3,shop,15,17,2
6462,4,work,17,20,3
6462,5,home,20,24,4
6462,6,<ENDS>,24,24,0
6463,0,<START>,0,0,0
6463,1,home,0,7,7
6463,2,work,7,10,3
6463,3,home,10,13,3
6463,4,work,13,15,2
6463,5,home,15,22,7
6463,6,work,22,23,1
6463,7,home,23,24,1
6463,8,<ENDS>,24,24,0
6464,0,<START>,0,0,0
6464,1,home,0,7,7
6464,2,work,7,13,6
6464,3,home,13,24,11
6464,4,<ENDS>,24,24,0
6465,0,<START>,0,0,0
6465,1,home,0,6,6
6465,2,shop,6,7,1
6465,3,work,7,13,6
6465,4,home,13,24,11
6465,5,<ENDS>,24,24,0
6466,0,<START>,0,0,0
6466,1,home,0,6,6
6466,2,work,6,8,2
6466,3,home,8,14,6
6466,4,work,14,17,3
6466,5,home,17,24,7
6466,6,<ENDS>,24,24,0
6467,0,<START>,0,0,0
6467,1,home,0,7,7
6467,2,shop,7,9,2
6467,3,education,9,12,3
6467,4,home,12,19,7
6467,5,shop,19,20,1
6467,6,home,20,24,4
6467,7,<ENDS>,24,24,0
6468,0,<START>,0,0,0
6468,1,home,0,6,6
6468,2,work,6,13,7
6468,3,shop,13,14,1
6468,4,home,14,24,10
6468,5,<ENDS>,24,24,0
6469,0,<START>,0,0,0
6469,1,home,0,8,8
6469,2,education,8,12,4
6469,3,work,12,19,7
6469,4,home,19,24,5
6469,5,<ENDS>,24,24,0
6470,0,<START>,0,0,0
6470,1,home,0,6,6
6470,2,shop,6,7,1
6470,3,home,7,13,6
6470,4,education,13,16,3
6470,5,shop,16,17,1
6470,6,home,17,24,7
6470,7,<ENDS>,24,24,0
6471,0,<START>,0,0,0
6471,1,home,0,8,8
6471,2,education,8,11,3
6471,3,home,11,16,5
6471,4,shop,16,17,1
6471,5,home,17,24,7
6471,6,<ENDS>,24,24,0
6472,0,<START>,0,0,0
6472,1,home,0,7,7
6472,2,shop,7,8,1
6472,3,home,8,9,1
6472,4,education,9,12,3
6472,5,home,12,21,9
6472,6,shop,21,22,1
6472,7,home,22,24,2
6472,8,<ENDS>,24,24,0
6473,0,<START>,0,0,0
6473,1,home,0,7,7
6473,2,work,7,13,6
6473,3,shop,13,14,1
6473,4,work,14,19,5
6473,5,home,19,24,5
6473,6,<ENDS>,24,24,0
6474,0,<START>,0,0,0
6474,1,home,0,8,8
6474,2,work,8,15,7
6474,3,shop,15,16,1
6474,4,home,16,24,8
6474,5,<ENDS>,24,24,0
6475,0,<START>,0,0,0
6475,1,home,0,7,7
6475,2,work,7,13,6
6475,3,home,13,21,8
6475,4,shop,21,22,1
6475,5,home,22,24,2
6475,6,<ENDS>,24,24,0
6476,0,<START>,0,0,0
6476,1,home,0,7,7
6476,2,shop,7,8,1
6476,3,home,8,13,5
6476,4,work,13,19,6
6476,5,home,19,24,5
6476,6,<ENDS>,24,24,0
6477,0,<START>,0,0,0
6477,1,home,0,7,7
6477,2,education,7,11,4
6477,3,home,11,18,7
6477,4,shop,18,20,2
6477,5,home,20,24,4
6477,6,<ENDS>,24,24,0
6478,0,<START>,0,0,0
6478,1,home,0,7,7
6478,2,work,7,13,6
6478,3,home,13,16,3
6478,4,work,16,20,4
6478,5,home,20,24,4
6478,6,<ENDS>,24,24,0
6479,0,<START>,0,0,0
6479,1,home,0,7,7
6479,2,work,7,14,7
6479,3,home,14,24,10
6479,4,<ENDS>,24,24,0
6480,0,<START>,0,0,0
6480,1,home,0,7,7
6480,2,work,7,14,7
6480,3,shop,14,15,1
6480,4,home,15,24,9
6480,5,<ENDS>,24,24,0
6481,0,<START>,0,0,0
6481,1,home,0,7,7
6481,2,shop,7,8,1
6481,3,home,8,13,5
6481,4,education,13,16,3
6481,5,home,16,24,8
6481,6,<ENDS>,24,24,0
6482,0,<START>,0,0,0
6482,1,home,0,9,9
6482,2,work,9,15,6
6482,3,home,15,24,9
6482,4,<ENDS>,24,24,0
6483,0,<START>,0,0,0
6483,1,home,0,6,6
6483,2,work,6,13,7
6483,3,shop,13,14,1
6483,4,work,14,20,6
6483,5,home,20,24,4
6483,6,<ENDS>,24,24,0
6484,0,<START>,0,0,0
6484,1,home,0,7,7
6484,2,education,7,12,5
6484,3,shop,12,13,1
6484,4,education,13,16,3
6484,5,home,16,20,4
6484,6,shop,20,21,1
6484,7,home,21,24,3
6484,8,<ENDS>,24,24,0
6485,0,<START>,0,0,0
6485,1,home,0,7,7
6485,2,work,7,13,6
6485,3,shop,13,14,1
6485,4,home,14,24,10
6485,5,<ENDS>,24,24,0
6486,0,<START>,0,0,0
6486,1,home,0,8,8
6486,2,work,8,15,7
6486,3,home,15,24,9
6486,4,<ENDS>,24,24,0
6487,0,<START>,0,0,0
6487,1,home,0,6,6
6487,2,shop,6,7,1
6487,3,work,7,15,8
6487,4,home,15,24,9
6487,5,<ENDS>,24,24,0
6488,0,<START>,0,0,0
6488,1,home,0,7,7
6488,2,work,7,13,6
6488,3,home,13,21,8
6488,4,work,21,22,1
6488,5,home,22,24,2
6488,6,<ENDS>,24,24,0
6489,0,<START>,0,0,0
6489,1,home,0,6,6
6489,2,work,6,12,6
6489,3,shop,12,13,1
6489,4,work,13,19,6
6489,5,home,19,24,5
6489,6,<ENDS>,24,24,0
6490,0,<START>,0,0,0
6490,1,home,0,8,8
6490,2,work,8,16,8
6490,3,home,16,24,8
6490,4,<ENDS>,24,24,0
6491,0,<START>,0,0,0
6491,1,home,0,7,7
6491,2,work,7,13,6
6491,3,home,13,18,5
6491,4,shop,18,19,1
6491,5,home,19,24,5
6491,6,<ENDS>,24,24,0
6492,0,<START>,0,0,0
6492,1,home,0,8,8
6492,2,education,8,11,3
6492,3,home,11,16,5
6492,4,work,16,20,4
6492,5,home,20,24,4
6492,6,<ENDS>,24,24,0
6493,0,<START>,0,0,0
6493,1,home,0,6,6
6493,2,work,6,13,7
6493,3,shop,13,14,1
6493,4,work,14,20,6
6493,5,home,20,24,4
6493,6,<ENDS>,24,24,0
6494,0,<START>,0,0,0
6494,1,home,0,8,8
6494,2,work,8,15,7
6494,3,home,15,21,6
6494,4,work,21,22,1
6494,5,home,22,24,2
6494,6,<ENDS>,24,24,0
6495,0,<START>,0,0,0
6495,1,home,0,8,8
6495,2,work,8,10,2
6495,3,home,10,14,4
6495,4,work,14,17,3
6495,5,home,17,21,4
6495,6,work,21,22,1
6495,7,home,22,24,2
6495,8,<ENDS>,24,24,0
6496,0,<START>,0,0,0
6496,1,home,0,7,7
6496,2,work,7,14,7
6496,3,home,14,20,6
6496,4,shop,20,21,1
6496,5,home,21,24,3
6496,6,<ENDS>,24,24,0
6497,0,<START>,0,0,0
6497,1,home,0,7,7
6497,2,work,7,14,7
6497,3,shop,14,15,1
6497,4,work,15,20,5
6497,5,home,20,24,4
6497,6,<ENDS>,24,24,0
6498,0,<START>,0,0,0
6498,1,home,0,8,8
6498,2,education,8,12,4
6498,3,home,12,18,6
6498,4,shop,18,20,2
6498,5,home,20,24,4
6498,6,<ENDS>,24,24,0
6499,0,<START>,0,0,0
6499,1,home,0,7,7
6499,2,work,7,13,6
6499,3,home,13,24,11
6499,4,<ENDS>,24,24,0
6500,0,<START>,0,0,0
6500,1,home,0,7,7
6500,2,work,7,13,6
6500,3,shop,13,14,1
6500,4,work,14,19,5
6500,5,home,19,24,5
6500,6,<ENDS>,24,24,0
6501,0,<START>,0,0,0
6501,1,home,0,6,6
6501,2,shop,6,7,1
6501,3,home,7,15,8
6501,4,work,15,20,5
6501,5,home,20,24,4
6501,6,<ENDS>,24,24,0
6502,0,<START>,0,0,0
6502,1,home,0,7,7
6502,2,work,7,13,6
6502,3,home,13,17,4
6502,4,work,17,20,3
6502,5,home,20,24,4
6502,6,<ENDS>,24,24,0
6503,0,<START>,0,0,0
6503,1,home,0,8,8
6503,2,education,8,11,3
6503,3,home,11,18,7
6503,4,shop,18,19,1
6503,5,home,19,24,5
6503,6,<ENDS>,24,24,0
6504,0,<START>,0,0,0
6504,1,home,0,8,8
6504,2,work,8,15,7
6504,3,home,15,24,9
6504,4,<ENDS>,24,24,0
6505,0,<START>,0,0,0
6505,1,home,0,6,6
6505,2,work,6,8,2
6505,3,home,8,12,4
6505,4,work,12,14,2
6505,5,home,14,20,6
6505,6,shop,20,21,1
6505,7,home,21,24,3
6505,8,<ENDS>,24,24,0
6506,0,<START>,0,0,0
6506,1,home,0,8,8
6506,2,education,8,11,3
6506,3,home,11,16,5
6506,4,work,16,20,4
6506,5,home,20,24,4
6506,6,<ENDS>,24,24,0
6507,0,<START>,0,0,0
6507,1,home,0,6,6
6507,2,work,6,7,1
6507,3,home,7,13,6
6507,4,work,13,14,1
6507,5,home,14,21,7
6507,6,work,21,22,1
6507,7,home,22,24,2
6507,8,<ENDS>,24,24,0
6508,0,<START>,0,0,0
6508,1,home,0,7,7
6508,2,work,7,14,7
6508,3,home,14,24,10
6508,4,<ENDS>,24,24,0
6509,0,<START>,0,0,0
6509,1,home,0,6,6
6509,2,work,6,13,7
6509,3,shop,13,14,1
6509,4,home,14,24,10
6509,5,<ENDS>,24,24,0
6510,0,<START>,0,0,0
6510,1,home,0,7,7
6510,2,education,7,11,4
6510,3,home,11,14,3
6510,4,education,14,16,2
6510,5,home,16,24,8
6510,6,<ENDS>,24,24,0
6511,0,<START>,0,0,0
6511,1,home,0,6,6
6511,2,work,6,13,7
6511,3,shop,13,15,2
6511,4,work,15,19,4
6511,5,home,19,24,5
6511,6,<ENDS>,24,24,0
6512,0,<START>,0,0,0
6512,1,home,0,6,6
6512,2,shop,6,7,1
6512,3,work,7,14,7
6512,4,home,14,22,8
6512,5,work,22,23,1
6512,6,home,23,24,1
6512,7,<ENDS>,24,24,0
6513,0,<START>,0,0,0
6513,1,home,0,8,8
6513,2,work,8,15,7
6513,3,home,15,24,9
6513,4,<ENDS>,24,24,0
6514,0,<START>,0,0,0
6514,1,home,0,6,6
6514,2,work,6,13,7
6514,3,home,13,19,6
6514,4,shop,19,20,1
6514,5,home,20,24,4
6514,6,<ENDS>,24,24,0
6515,0,<START>,0,0,0
6515,1,home,0,8,8
6515,2,work,8,17,9
6515,3,home,17,22,5
6515,4,work,22,23,1
6515,5,home,23,24,1
6515,6,<ENDS>,24,24,0
6516,0,<START>,0,0,0
6516,1,home,0,6,6
6516,2,work,6,13,7
6516,3,shop,13,14,1
6516,4,home,14,24,10
6516,5,<ENDS>,24,24,0
6517,0,<START>,0,0,0
6517,1,home,0,7,7
6517,2,work,7,13,6
6517,3,home,13,24,11
6517,4,<ENDS>,24,24,0
6518,0,<START>,0,0,0
6518,1,home,0,7,7
6518,2,work,7,9,2
6518,3,home,9,13,4
6518,4,work,13,15,2
6518,5,home,15,23,8
6518,6,work,23,24,1
6518,7,<ENDS>,24,24,0
6519,0,<START>,0,0,0
6519,1,home,0,7,7
6519,2,shop,7,8,1
6519,3,education,8,11,3
6519,4,home,11,18,7
6519,5,shop,18,19,1
6519,6,home,19,24,5
6519,7,<ENDS>,24,24,0
6520,0,<START>,0,0,0
6520,1,home,0,7,7
6520,2,education,7,11,4
6520,3,home,11,18,7
6520,4,shop,18,19,1
6520,5,home,19,24,5
6520,6,<ENDS>,24,24,0
6521,0,<START>,0,0,0
6521,1,home,0,7,7
6521,2,education,7,11,4
6521,3,home,11,17,6
6521,4,shop,17,18,1
6521,5,home,18,24,6
6521,6,<ENDS>,24,24,0
6522,0,<START>,0,0,0
6522,1,home,0,7,7
6522,2,education,7,11,4
6522,3,home,11,17,6
6522,4,shop,17,19,2
6522,5,home,19,24,5
6522,6,<ENDS>,24,24,0
6523,0,<START>,0,0,0
6523,1,home,0,7,7
6523,2,education,7,11,4
6523,3,home,11,17,6
6523,4,shop,17,19,2
6523,5,home,19,24,5
6523,6,<ENDS>,24,24,0
6524,0,<START>,0,0,0
6524,1,home,0,7,7
6524,2,work,7,14,7
6524,3,shop,14,15,1
6524,4,home,15,21,6
6524,5,work,21,22,1
6524,6,home,22,24,2
6524,7,<ENDS>,24,24,0
6525,0,<START>,0,0,0
6525,1,home,0,8,8
6525,2,work,8,14,6
6525,3,home,14,24,10
6525,4,<ENDS>,24,24,0
6526,0,<START>,0,0,0
6526,1,home,0,7,7
6526,2,work,7,14,7
6526,3,home,14,24,10
6526,4,<ENDS>,24,24,0
6527,0,<START>,0,0,0
6527,1,home,0,7,7
6527,2,work,7,14,7
6527,3,home,14,23,9
6527,4,work,23,24,1
6527,5,<ENDS>,24,24,0
6528,0,<START>,0,0,0
6528,1,home,0,8,8
6528,2,work,8,15,7
6528,3,shop,15,16,1
6528,4,home,16,24,8
6528,5,<ENDS>,24,24,0
6529,0,<START>,0,0,0
6529,1,work,0,1,1
6529,2,home,1,6,5
6529,3,shop,6,7,1
6529,4,home,7,10,3
6529,5,education,10,12,2
6529,6,shop,12,14,2
6529,7,education,14,16,2
6529,8,home,16,24,8
6529,9,<ENDS>,24,24,0
6530,0,<START>,0,0,0
6530,1,home,0,7,7
6530,2,work,7,13,6
6530,3,home,13,21,8
6530,4,work,21,22,1
6530,5,home,22,24,2
6530,6,<ENDS>,24,24,0
6531,0,<START>,0,0,0
6531,1,home,0,7,7
6531,2,work,7,14,7
6531,3,shop,14,15,1
6531,4,home,15,23,8
6531,5,work,23,24,1
6531,6,<ENDS>,24,24,0
6532,0,<START>,0,0,0
6532,1,home,0,7,7
6532,2,work,7,13,6
6532,3,home,13,16,3
6532,4,work,16,20,4
6532,5,home,20,24,4
6532,6,<ENDS>,24,24,0
6533,0,<START>,0,0,0
6533,1,home,0,6,6
6533,2,shop,6,7,1
6533,3,home,7,10,3
6533,4,education,10,13,3
6533,5,shop,13,15,2
6533,6,home,15,24,9
6533,7,<ENDS>,24,24,0
6534,0,<START>,0,0,0
6534,1,home,0,6,6
6534,2,shop,6,7,1
6534,3,home,7,10,3
6534,4,education,10,11,1
6534,5,home,11,13,2
6534,6,education,13,16,3
6534,7,shop,16,18,2
6534,8,home,18,24,6
6534,9,<ENDS>,24,24,0
6535,0,<START>,0,0,0
6535,1,home,0,6,6
6535,2,work,6,13,7
6535,3,shop,13,14,1
6535,4,work,14,20,6
6535,5,home,20,24,4
6535,6,<ENDS>,24,24,0
6536,0,<START>,0,0,0
6536,1,home,0,6,6
6536,2,shop,6,7,1
6536,3,work,7,14,7
6536,4,home,14,24,10
6536,5,<ENDS>,24,24,0
6537,0,<START>,0,0,0
6537,1,home,0,7,7
6537,2,shop,7,8,1
6537,3,education,8,11,3
6537,4,home,11,17,6
6537,5,shop,17,18,1
6537,6,home,18,24,6
6537,7,<ENDS>,24,24,0
6538,0,<START>,0,0,0
6538,1,home,0,6,6
6538,2,work,6,13,7
6538,3,home,13,16,3
6538,4,shop,16,17,1
6538,5,home,17,24,7
6538,6,<ENDS>,24,24,0
6539,0,<START>,0,0,0
6539,1,home,0,6,6
6539,2,shop,6,7,1
6539,3,work,7,13,6
6539,4,home,13,17,4
6539,5,work,17,20,3
6539,6,home,20,24,4
6539,7,<ENDS>,24,24,0
6540,0,<START>,0,0,0
6540,1,home,0,7,7
6540,2,shop,7,8,1
6540,3,home,8,13,5
6540,4,education,13,16,3
6540,5,shop,16,18,2
6540,6,home,18,24,6
6540,7,<ENDS>,24,24,0
6541,0,<START>,0,0,0
6541,1,home,0,7,7
6541,2,work,7,13,6
6541,3,home,13,24,11
6541,4,<ENDS>,24,24,0
6542,0,<START>,0,0,0
6542,1,home,0,6,6
6542,2,work,6,13,7
6542,3,home,13,22,9
6542,4,work,22,23,1
6542,5,home,23,24,1
6542,6,<ENDS>,24,24,0
6543,0,<START>,0,0,0
6543,1,home,0,7,7
6543,2,work,7,9,2
6543,3,home,9,14,5
6543,4,work,14,16,2
6543,5,home,16,22,6
6543,6,work,22,23,1
6543,7,home,23,24,1
6543,8,<ENDS>,24,24,0
6544,0,<START>,0,0,0
6544,1,home,0,7,7
6544,2,shop,7,8,1
6544,3,education,8,12,4
6544,4,home,12,18,6
6544,5,shop,18,19,1
6544,6,home,19,24,5
6544,7,<ENDS>,24,24,0
6545,0,<START>,0,0,0
6545,1,home,0,8,8
6545,2,work,8,14,6
6545,3,shop,14,15,1
6545,4,home,15,24,9
6545,5,<ENDS>,24,24,0
6546,0,<START>,0,0,0
6546,1,home,0,7,7
6546,2,work,7,13,6
6546,3,shop,13,15,2
6546,4,work,15,20,5
6546,5,home,20,24,4
6546,6,<ENDS>,24,24,0
6547,0,<START>,0,0,0
6547,1,home,0,7,7
6547,2,work,7,14,7
6547,3,home,14,23,9
6547,4,work,23,24,1
6547,5,<ENDS>,24,24,0
6548,0,<START>,0,0,0
6548,1,home,0,8,8
6548,2,work,8,15,7
6548,3,shop,15,16,1
6548,4,home,16,24,8
6548,5,<ENDS>,24,24,0
6549,0,<START>,0,0,0
6549,1,home,0,7,7
6549,2,shop,7,8,1
6549,3,education,8,11,3
6549,4,home,11,18,7
6549,5,shop,18,19,1
6549,6,home,19,24,5
6549,7,<ENDS>,24,24,0
6550,0,<START>,0,0,0
6550,1,home,0,7,7
6550,2,work,7,13,6
6550,3,home,13,24,11
6550,4,<ENDS>,24,24,0
6551,0,<START>,0,0,0
6551,1,home,0,6,6
6551,2,shop,6,7,1
6551,3,home,7,10,3
6551,4,education,10,13,3
6551,5,shop,13,15,2
6551,6,home,15,20,5
6551,7,shop,20,21,1
6551,8,home,21,24,3
6551,9,<ENDS>,24,24,0
6552,0,<START>,0,0,0
6552,1,home,0,7,7
6552,2,work,7,13,6
6552,3,shop,13,14,1
6552,4,work,14,18,4
6552,5,education,18,20,2
6552,6,home,20,24,4
6552,7,<ENDS>,24,24,0
6553,0,<START>,0,0,0
6553,1,home,0,6,6
6553,2,work,6,13,7
6553,3,home,13,16,3
6553,4,work,16,20,4
6553,5,home,20,24,4
6553,6,<ENDS>,24,24,0
6554,0,<START>,0,0,0
6554,1,home,0,6,6
6554,2,work,6,13,7
6554,3,home,13,24,11
6554,4,<ENDS>,24,24,0
6555,0,<START>,0,0,0
6555,1,home,0,6,6
6555,2,work,6,8,2
6555,3,home,8,16,8
6555,4,work,16,18,2
6555,5,home,18,24,6
6555,6,<ENDS>,24,24,0
6556,0,<START>,0,0,0
6556,1,home,0,7,7
6556,2,work,7,14,7
6556,3,shop,14,15,1
6556,4,home,15,24,9
6556,5,<ENDS>,24,24,0
6557,0,<START>,0,0,0
6557,1,home,0,8,8
6557,2,work,8,14,6
6557,3,shop,14,15,1
6557,4,home,15,24,9
6557,5,<ENDS>,24,24,0
6558,0,<START>,0,0,0
6558,1,home,0,8,8
6558,2,education,8,12,4
6558,3,home,12,24,12
6558,4,<ENDS>,24,24,0
6559,0,<START>,0,0,0
6559,1,home,0,7,7
6559,2,education,7,11,4
6559,3,home,11,20,9
6559,4,shop,20,21,1
6559,5,home,21,24,3
6559,6,<ENDS>,24,24,0
6560,0,<START>,0,0,0
6560,1,home,0,9,9
6560,2,education,9,12,3
6560,3,shop,12,13,1
6560,4,work,13,20,7
6560,5,home,20,24,4
6560,6,<ENDS>,24,24,0
6561,0,<START>,0,0,0
6561,1,home,0,7,7
6561,2,work,7,14,7
6561,3,home,14,24,10
6561,4,<ENDS>,24,24,0
6562,0,<START>,0,0,0
6562,1,work,0,7,7
6562,2,shop,7,8,1
6562,3,home,8,11,3
6562,4,work,11,18,7
6562,5,home,18,24,6
6562,6,<ENDS>,24,24,0
6563,0,<START>,0,0,0
6563,1,home,0,8,8
6563,2,work,8,15,7
6563,3,home,15,24,9
6563,4,<ENDS>,24,24,0
6564,0,<START>,0,0,0
6564,1,home,0,6,6
6564,2,work,6,13,7
6564,3,shop,13,14,1
6564,4,work,14,19,5
6564,5,home,19,24,5
6564,6,<ENDS>,24,24,0
6565,0,<START>,0,0,0
6565,1,home,0,6,6
6565,2,shop,6,7,1
6565,3,home,7,12,5
6565,4,education,12,17,5
6565,5,home,17,24,7
6565,6,<ENDS>,24,24,0
6566,0,<START>,0,0,0
6566,1,home,0,6,6
6566,2,work,6,13,7
6566,3,shop,13,15,2
6566,4,work,15,20,5
6566,5,home,20,24,4
6566,6,<ENDS>,24,24,0
6567,0,<START>,0,0,0
6567,1,home,0,6,6
6567,2,shop,6,7,1
6567,3,home,7,13,6
6567,4,education,13,16,3
6567,5,shop,16,17,1
6567,6,home,17,24,7
6567,7,<ENDS>,24,24,0
6568,0,<START>,0,0,0
6568,1,home,0,8,8
6568,2,work,8,15,7
6568,3,home,15,24,9
6568,4,<ENDS>,24,24,0
6569,0,<START>,0,0,0
6569,1,home,0,6,6
6569,2,shop,6,8,2
6569,3,home,8,13,5
6569,4,education,13,16,3
6569,5,home,16,24,8
6569,6,<ENDS>,24,24,0
6570,0,<START>,0,0,0
6570,1,home,0,7,7
6570,2,work,7,14,7
6570,3,home,14,21,7
6570,4,shop,21,22,1
6570,5,home,22,24,2
6570,6,<ENDS>,24,24,0
6571,0,<START>,0,0,0
6571,1,home,0,8,8
6571,2,work,8,15,7
6571,3,home,15,24,9
6571,4,<ENDS>,24,24,0
6572,0,<START>,0,0,0
6572,1,home,0,9,9
6572,2,education,9,12,3
6572,3,shop,12,14,2
6572,4,home,14,20,6
6572,5,shop,20,21,1
6572,6,home,21,24,3
6572,7,<ENDS>,24,24,0
6573,0,<START>,0,0,0
6573,1,home,0,7,7
6573,2,work,7,14,7
6573,3,home,14,24,10
6573,4,<ENDS>,24,24,0
6574,0,<START>,0,0,0
6574,1,home,0,7,7
6574,2,work,7,15,8
6574,3,shop,15,16,1
6574,4,home,16,24,8
6574,5,<ENDS>,24,24,0
6575,0,<START>,0,0,0
6575,1,home,0,6,6
6575,2,work,6,13,7
6575,3,shop,13,14,1
6575,4,work,14,20,6
6575,5,home,20,24,4
6575,6,<ENDS>,24,24,0
6576,0,<START>,0,0,0
6576,1,home,0,7,7
6576,2,work,7,13,6
6576,3,home,13,20,7
6576,4,shop,20,21,1
6576,5,home,21,24,3
6576,6,<ENDS>,24,24,0
6577,0,<START>,0,0,0
6577,1,home,0,7,7
6577,2,work,7,13,6
6577,3,home,13,19,6
6577,4,shop,19,20,1
6577,5,home,20,24,4
6577,6,<ENDS>,24,24,0
6578,0,<START>,0,0,0
6578,1,home,0,8,8
6578,2,work,8,13,5
6578,3,home,13,14,1
6578,4,work,14,20,6
6578,5,home,20,24,4
6578,6,<ENDS>,24,24,0
6579,0,<START>,0,0,0
6579,1,home,0,7,7
6579,2,work,7,14,7
6579,3,home,14,24,10
6579,4,<ENDS>,24,24,0
6580,0,<START>,0,0,0
6580,1,home,0,8,8
6580,2,education,8,11,3
6580,3,home,11,17,6
6580,4,shop,17,18,1
6580,5,home,18,24,6
6580,6,<ENDS>,24,24,0
6581,0,<START>,0,0,0
6581,1,home,0,7,7
6581,2,education,7,13,6
6581,3,shop,13,15,2
6581,4,home,15,24,9
6581,5,<ENDS>,24,24,0
6582,0,<START>,0,0,0
6582,1,home,0,7,7
6582,2,work,7,13,6
6582,3,shop,13,14,1
6582,4,education,14,16,2
6582,5,shop,16,17,1
6582,6,home,17,21,4
6582,7,work,21,22,1
6582,8,home,22,24,2
6582,9,<ENDS>,24,24,0
6583,0,<START>,0,0,0
6583,1,home,0,8,8
6583,2,work,8,13,5
6583,3,shop,13,14,1
6583,4,work,14,19,5
6583,5,home,19,24,5
6583,6,<ENDS>,24,24,0
6584,0,<START>,0,0,0
6584,1,home,0,7,7
6584,2,shop,7,8,1
6584,3,education,8,12,4
6584,4,shop,12,14,2
6584,5,education,14,15,1
6584,6,shop,15,16,1
6584,7,home,16,24,8
6584,8,<ENDS>,24,24,0
6585,0,<START>,0,0,0
6585,1,home,0,8,8
6585,2,work,8,15,7
6585,3,home,15,24,9
6585,4,<ENDS>,24,24,0
6586,0,<START>,0,0,0
6586,1,home,0,6,6
6586,2,work,6,8,2
6586,3,home,8,14,6
6586,4,work,14,17,3
6586,5,home,17,24,7
6586,6,<ENDS>,24,24,0
6587,0,<START>,0,0,0
6587,1,home,0,8,8
6587,2,work,8,15,7
6587,3,home,15,24,9
6587,4,<ENDS>,24,24,0
6588,0,<START>,0,0,0
6588,1,home,0,8,8
6588,2,education,8,11,3
6588,3,home,11,16,5
6588,4,shop,16,17,1
6588,5,home,17,24,7
6588,6,<ENDS>,24,24,0
6589,0,<START>,0,0,0
6589,1,home,0,7,7
6589,2,work,7,14,7
6589,3,shop,14,15,1
6589,4,home,15,24,9
6589,5,<ENDS>,24,24,0
6590,0,<START>,0,0,0
6590,1,home,0,7,7
6590,2,work,7,14,7
6590,3,home,14,24,10
6590,4,<ENDS>,24,24,0
6591,0,<START>,0,0,0
6591,1,home,0,6,6
6591,2,work,6,12,6
6591,3,shop,12,13,1
6591,4,work,13,18,5
6591,5,home,18,24,6
6591,6,<ENDS>,24,24,0
6592,0,<START>,0,0,0
6592,1,home,0,8,8
6592,2,work,8,14,6
6592,3,home,14,24,10
6592,4,<ENDS>,24,24,0
6593,0,<START>,0,0,0
6593,1,home,0,8,8
6593,2,shop,8,9,1
6593,3,home,9,14,5
6593,4,work,14,20,6
6593,5,home,20,24,4
6593,6,<ENDS>,24,24,0
6594,0,<START>,0,0,0
6594,1,home,0,6,6
6594,2,work,6,13,7
6594,3,home,13,17,4
6594,4,shop,17,18,1
6594,5,home,18,22,4
6594,6,work,22,23,1
6594,7,home,23,24,1
6594,8,<ENDS>,24,24,0
6595,0,<START>,0,0,0
6595,1,home,0,7,7
6595,2,education,7,12,5
6595,3,shop,12,14,2
6595,4,education,14,16,2
6595,5,home,16,24,8
6595,6,<ENDS>,24,24,0
6596,0,<START>,0,0,0
6596,1,home,0,8,8
6596,2,work,8,14,6
6596,3,home,14,18,4
6596,4,shop,18,19,1
6596,5,home,19,24,5
6596,6,<ENDS>,24,24,0
6597,0,<START>,0,0,0
6597,1,home,0,6,6
6597,2,work,6,8,2
6597,3,home,8,14,6
6597,4,work,14,16,2
6597,5,home,16,23,7
6597,6,work,23,24,1
6597,7,<ENDS>,24,24,0
6598,0,<START>,0,0,0
6598,1,home,0,8,8
6598,2,work,8,15,7
6598,3,shop,15,16,1
6598,4,work,16,20,4
6598,5,home,20,24,4
6598,6,<ENDS>,24,24,0
6599,0,<START>,0,0,0
6599,1,home,0,7,7
6599,2,work,7,9,2
6599,3,home,9,15,6
6599,4,work,15,17,2
6599,5,home,17,23,6
6599,6,work,23,24,1
6599,7,<ENDS>,24,24,0
6600,0,<START>,0,0,0
6600,1,home,0,7,7
6600,2,education,7,11,4
6600,3,home,11,18,7
6600,4,shop,18,20,2
6600,5,home,20,24,4
6600,6,<ENDS>,24,24,0
6601,0,<START>,0,0,0
6601,1,home,0,6,6
6601,2,work,6,13,7
6601,3,home,13,21,8
6601,4,shop,21,22,1
6601,5,home,22,24,2
6601,6,<ENDS>,24,24,0
6602,0,<START>,0,0,0
6602,1,home,0,7,7
6602,2,shop,7,8,1
6602,3,education,8,13,5
6602,4,shop,13,15,2
6602,5,home,15,21,6
6602,6,shop,21,22,1
6602,7,home,22,24,2
6602,8,<ENDS>,24,24,0
6603,0,<START>,0,0,0
6603,1,home,0,7,7
6603,2,education,7,12,5
6603,3,home,12,20,8
6603,4,shop,20,21,1
6603,5,home,21,24,3
6603,6,<ENDS>,24,24,0
6604,0,<START>,0,0,0
6604,1,home,0,7,7
6604,2,work,7,13,6
6604,3,home,13,24,11
6604,4,<ENDS>,24,24,0
6605,0,<START>,0,0,0
6605,1,home,0,9,9
6605,2,work,9,17,8
6605,3,home,17,24,7
6605,4,<ENDS>,24,24,0
6606,0,<START>,0,0,0
6606,1,home,0,7,7
6606,2,work,7,14,7
6606,3,home,14,21,7
6606,4,shop,21,22,1
6606,5,home,22,24,2
6606,6,<ENDS>,24,24,0
6607,0,<START>,0,0,0
6607,1,home,0,8,8
6607,2,work,8,15,7
6607,3,shop,15,16,1
6607,4,home,16,21,5
6607,5,shop,21,22,1
6607,6,home,22,24,2
6607,7,<ENDS>,24,24,0
6608,0,<START>,0,0,0
6608,1,home,0,8,8
6608,2,work,8,14,6
6608,3,shop,14,15,1
6608,4,work,15,19,4
6608,5,home,19,24,5
6608,6,<ENDS>,24,24,0
6609,0,<START>,0,0,0
6609,1,home,0,7,7
6609,2,work,7,13,6
6609,3,home,13,24,11
6609,4,<ENDS>,24,24,0
6610,0,<START>,0,0,0
6610,1,home,0,8,8
6610,2,work,8,14,6
6610,3,home,14,21,7
6610,4,work,21,22,1
6610,5,home,22,24,2
6610,6,<ENDS>,24,24,0
6611,0,<START>,0,0,0
6611,1,home,0,8,8
6611,2,work,8,15,7
6611,3,home,15,24,9
6611,4,<ENDS>,24,24,0
6612,0,<START>,0,0,0
6612,1,home,0,6,6
6612,2,work,6,13,7
6612,3,shop,13,14,1
6612,4,work,14,19,5
6612,5,home,19,24,5
6612,6,<ENDS>,24,24,0
6613,0,<START>,0,0,0
6613,1,home,0,7,7
6613,2,work,7,13,6
6613,3,shop,13,14,1
6613,4,home,14,24,10
6613,5,<ENDS>,24,24,0
6614,0,<START>,0,0,0
6614,1,home,0,8,8
6614,2,work,8,13,5
6614,3,shop,13,14,1
6614,4,home,14,24,10
6614,5,<ENDS>,24,24,0
6615,0,<START>,0,0,0
6615,1,home,0,8,8
6615,2,work,8,15,7
6615,3,home,15,24,9
6615,4,<ENDS>,24,24,0
6616,0,<START>,0,0,0
6616,1,home,0,8,8
6616,2,education,8,11,3
6616,3,home,11,17,6
6616,4,shop,17,19,2
6616,5,home,19,24,5
6616,6,<ENDS>,24,24,0
6617,0,<START>,0,0,0
6617,1,home,0,8,8
6617,2,work,8,13,5
6617,3,home,13,24,11
6617,4,<ENDS>,24,24,0
6618,0,<START>,0,0,0
6618,1,home,0,7,7
6618,2,work,7,9,2
6618,3,home,9,15,6
6618,4,work,15,17,2
6618,5,home,17,24,7
6618,6,<ENDS>,24,24,0
6619,0,<START>,0,0,0
6619,1,home,0,7,7
6619,2,work,7,14,7
6619,3,shop,14,15,1
6619,4,home,15,24,9
6619,5,<ENDS>,24,24,0
6620,0,<START>,0,0,0
6620,1,home,0,7,7
6620,2,work,7,13,6
6620,3,shop,13,14,1
6620,4,work,14,19,5
6620,5,home,19,24,5
6620,6,<ENDS>,24,24,0
6621,0,<START>,0,0,0
6621,1,home,0,7,7
6621,2,work,7,13,6
6621,3,home,13,16,3
6621,4,work,16,20,4
6621,5,home,20,24,4
6621,6,<ENDS>,24,24,0
6622,0,<START>,0,0,0
6622,1,home,0,8,8
6622,2,work,8,14,6
6622,3,home,14,15,1
6622,4,work,15,20,5
6622,5,home,20,24,4
6622,6,<ENDS>,24,24,0
6623,0,<START>,0,0,0
6623,1,home,0,6,6
6623,2,work,6,7,1
6623,3,home,7,13,6
6623,4,work,13,15,2
6623,5,home,15,21,6
6623,6,work,21,22,1
6623,7,home,22,24,2
6623,8,<ENDS>,24,24,0
6624,0,<START>,0,0,0
6624,1,home,0,6,6
6624,2,work,6,13,7
6624,3,home,13,24,11
6624,4,<ENDS>,24,24,0
6625,0,<START>,0,0,0
6625,1,home,0,7,7
6625,2,work,7,14,7
6625,3,shop,14,15,1
6625,4,home,15,24,9
6625,5,<ENDS>,24,24,0
6626,0,<START>,0,0,0
6626,1,home,0,6,6
6626,2,shop,6,7,1
6626,3,work,7,15,8
6626,4,home,15,22,7
6626,5,work,22,23,1
6626,6,home,23,24,1
6626,7,<ENDS>,24,24,0
6627,0,<START>,0,0,0
6627,1,home,0,7,7
6627,2,education,7,13,6
6627,3,home,13,20,7
6627,4,shop,20,21,1
6627,5,home,21,24,3
6627,6,<ENDS>,24,24,0
6628,0,<START>,0,0,0
6628,1,home,0,6,6
6628,2,work,6,13,7
6628,3,home,13,17,4
6628,4,work,17,20,3
6628,5,home,20,24,4
6628,6,<ENDS>,24,24,0
6629,0,<START>,0,0,0
6629,1,home,0,8,8
6629,2,work,8,14,6
6629,3,home,14,24,10
6629,4,<ENDS>,24,24,0
6630,0,<START>,0,0,0
6630,1,home,0,6,6
6630,2,work,6,13,7
6630,3,home,13,17,4
6630,4,shop,17,18,1
6630,5,home,18,24,6
6630,6,<ENDS>,24,24,0
6631,0,<START>,0,0,0
6631,1,home,0,7,7
6631,2,work,7,14,7
6631,3,home,14,19,5
6631,4,shop,19,20,1
6631,5,home,20,24,4
6631,6,<ENDS>,24,24,0
6632,0,<START>,0,0,0
6632,1,home,0,7,7
6632,2,shop,7,8,1
6632,3,education,8,12,4
6632,4,shop,12,14,2
6632,5,education,14,16,2
6632,6,home,16,24,8
6632,7,<ENDS>,24,24,0
6633,0,<START>,0,0,0
6633,1,home,0,7,7
6633,2,work,7,14,7
6633,3,shop,14,15,1
6633,4,home,15,20,5
6633,5,shop,20,21,1
6633,6,home,21,24,3
6633,7,<ENDS>,24,24,0
6634,0,<START>,0,0,0
6634,1,home,0,7,7
6634,2,work,7,13,6
6634,3,home,13,21,8
6634,4,work,21,22,1
6634,5,home,22,24,2
6634,6,<ENDS>,24,24,0
6635,0,<START>,0,0,0
6635,1,home,0,6,6
6635,2,work,6,7,1
6635,3,home,7,11,4
6635,4,work,11,13,2
6635,5,home,13,18,5
6635,6,work,18,19,1
6635,7,home,19,24,5
6635,8,<ENDS>,24,24,0
6636,0,<START>,0,0,0
6636,1,home,0,6,6
6636,2,shop,6,7,1
6636,3,home,7,13,6
6636,4,education,13,16,3
6636,5,home,16,24,8
6636,6,<ENDS>,24,24,0
6637,0,<START>,0,0,0
6637,1,home,0,6,6
6637,2,work,6,13,7
6637,3,shop,13,14,1
6637,4,home,14,24,10
6637,5,<ENDS>,24,24,0
6638,0,<START>,0,0,0
6638,1,home,0,7,7
6638,2,work,7,14,7
6638,3,shop,14,15,1
6638,4,work,15,20,5
6638,5,home,20,24,4
6638,6,<ENDS>,24,24,0
6639,0,<START>,0,0,0
6639,1,home,0,8,8
6639,2,work,8,15,7
6639,3,home,15,24,9
6639,4,<ENDS>,24,24,0
6640,0,<START>,0,0,0
6640,1,home,0,8,8
6640,2,work,8,14,6
6640,3,home,14,24,10
6640,4,<ENDS>,24,24,0
6641,0,<START>,0,0,0
6641,1,home,0,7,7
6641,2,education,7,11,4
6641,3,home,11,14,3
6641,4,education,14,16,2
6641,5,home,16,24,8
6641,6,<ENDS>,24,24,0
6642,0,<START>,0,0,0
6642,1,home,0,6,6
6642,2,shop,6,7,1
6642,3,home,7,10,3
6642,4,education,10,11,1
6642,5,home,11,18,7
6642,6,shop,18,19,1
6642,7,home,19,24,5
6642,8,<ENDS>,24,24,0
6643,0,<START>,0,0,0
6643,1,home,0,8,8
6643,2,work,8,15,7
6643,3,home,15,24,9
6643,4,<ENDS>,24,24,0
6644,0,<START>,0,0,0
6644,1,home,0,8,8
6644,2,work,8,16,8
6644,3,shop,16,17,1
6644,4,work,17,20,3
6644,5,home,20,24,4
6644,6,<ENDS>,24,24,0
6645,0,<START>,0,0,0
6645,1,home,0,7,7
6645,2,work,7,14,7
6645,3,home,14,20,6
6645,4,shop,20,21,1
6645,5,home,21,24,3
6645,6,<ENDS>,24,24,0
6646,0,<START>,0,0,0
6646,1,home,0,8,8
6646,2,work,8,15,7
6646,3,home,15,24,9
6646,4,<ENDS>,24,24,0
6647,0,<START>,0,0,0
6647,1,home,0,6,6
6647,2,work,6,13,7
6647,3,shop,13,14,1
6647,4,home,14,24,10
6647,5,<ENDS>,24,24,0
6648,0,<START>,0,0,0
6648,1,home,0,6,6
6648,2,work,6,13,7
6648,3,home,13,24,11
6648,4,<ENDS>,24,24,0
6649,0,<START>,0,0,0
6649,1,home,0,6,6
6649,2,work,6,14,8
6649,3,shop,14,15,1
6649,4,home,15,22,7
6649,5,work,22,23,1
6649,6,home,23,24,1
6649,7,<ENDS>,24,24,0
6650,0,<START>,0,0,0
6650,1,home,0,7,7
6650,2,work,7,13,6
6650,3,shop,13,14,1
6650,4,work,14,20,6
6650,5,home,20,24,4
6650,6,<ENDS>,24,24,0
6651,0,<START>,0,0,0
6651,1,home,0,7,7
6651,2,work,7,14,7
6651,3,home,14,21,7
6651,4,shop,21,22,1
6651,5,home,22,24,2
6651,6,<ENDS>,24,24,0
6652,0,<START>,0,0,0
6652,1,home,0,7,7
6652,2,education,7,15,8
6652,3,shop,15,17,2
6652,4,home,17,24,7
6652,5,<ENDS>,24,24,0
6653,0,<START>,0,0,0
6653,1,home,0,7,7
6653,2,work,7,13,6
6653,3,home,13,24,11
6653,4,<ENDS>,24,24,0
6654,0,<START>,0,0,0
6654,1,home,0,8,8
6654,2,work,8,15,7
6654,3,shop,15,16,1
6654,4,work,16,20,4
6654,5,home,20,24,4
6654,6,<ENDS>,24,24,0
6655,0,<START>,0,0,0
6655,1,home,0,6,6
6655,2,work,6,7,1
6655,3,home,7,11,4
6655,4,work,11,13,2
6655,5,home,13,21,8
6655,6,shop,21,22,1
6655,7,home,22,24,2
6655,8,<ENDS>,24,24,0
6656,0,<START>,0,0,0
6656,1,home,0,8,8
6656,2,education,8,12,4
6656,3,home,12,24,12
6656,4,<ENDS>,24,24,0
6657,0,<START>,0,0,0
6657,1,home,0,6,6
6657,2,work,6,7,1
6657,3,home,7,12,5
6657,4,work,12,13,1
6657,5,home,13,17,4
6657,6,work,17,19,2
6657,7,home,19,24,5
6657,8,<ENDS>,24,24,0
6658,0,<START>,0,0,0
6658,1,home,0,7,7
6658,2,shop,7,8,1
6658,3,work,8,15,7
6658,4,home,15,21,6
6658,5,work,21,22,1
6658,6,home,22,24,2
6658,7,<ENDS>,24,24,0
6659,0,<START>,0,0,0
6659,1,home,0,8,8
6659,2,work,8,15,7
6659,3,home,15,24,9
6659,4,<ENDS>,24,24,0
6660,0,<START>,0,0,0
6660,1,home,0,6,6
6660,2,work,6,13,7
6660,3,home,13,19,6
6660,4,shop,19,20,1
6660,5,home,20,24,4
6660,6,<ENDS>,24,24,0
6661,0,<START>,0,0,0
6661,1,home,0,7,7
6661,2,work,7,14,7
6661,3,home,14,24,10
6661,4,<ENDS>,24,24,0
6662,0,<START>,0,0,0
6662,1,home,0,8,8
6662,2,work,8,13,5
6662,3,home,13,24,11
6662,4,<ENDS>,24,24,0
6663,0,<START>,0,0,0
6663,1,home,0,7,7
6663,2,work,7,13,6
6663,3,home,13,16,3
6663,4,work,16,19,3
6663,5,home,19,24,5
6663,6,<ENDS>,24,24,0
6664,0,<START>,0,0,0
6664,1,home,0,8,8
6664,2,work,8,15,7
6664,3,home,15,24,9
6664,4,<ENDS>,24,24,0
6665,0,<START>,0,0,0
6665,1,home,0,7,7
6665,2,work,7,13,6
6665,3,home,13,24,11
6665,4,<ENDS>,24,24,0
6666,0,<START>,0,0,0
6666,1,home,0,7,7
6666,2,shop,7,8,1
6666,3,education,8,12,4
6666,4,home,12,18,6
6666,5,shop,18,20,2
6666,6,home,20,24,4
6666,7,<ENDS>,24,24,0
6667,0,<START>,0,0,0
6667,1,home,0,6,6
6667,2,work,6,8,2
6667,3,home,8,11,3
6667,4,work,11,13,2
6667,5,home,13,21,8
6667,6,work,21,22,1
6667,7,home,22,24,2
6667,8,<ENDS>,24,24,0
6668,0,<START>,0,0,0
6668,1,home,0,6,6
6668,2,shop,6,7,1
6668,3,home,7,8,1
6668,4,education,8,11,3
6668,5,home,11,16,5
6668,6,work,16,20,4
6668,7,home,20,24,4
6668,8,<ENDS>,24,24,0
6669,0,<START>,0,0,0
6669,1,home,0,7,7
6669,2,work,7,14,7
6669,3,home,14,24,10
6669,4,<ENDS>,24,24,0
6670,0,<START>,0,0,0
6670,1,home,0,6,6
6670,2,shop,6,7,1
6670,3,home,7,9,2
6670,4,education,9,12,3
6670,5,home,12,19,7
6670,6,shop,19,20,1
6670,7,home,20,24,4
6670,8,<ENDS>,24,24,0
6671,0,<START>,0,0,0
6671,1,home,0,7,7
6671,2,education,7,11,4
6671,3,home,11,14,3
6671,4,education,14,16,2
6671,5,shop,16,17,1
6671,6,home,17,24,7
6671,7,<ENDS>,24,24,0
6672,0,<START>,0,0,0
6672,1,home,0,6,6
6672,2,shop,6,7,1
6672,3,home,7,13,6
6672,4,education,13,16,3
6672,5,home,16,24,8
6672,6,<ENDS>,24,24,0
6673,0,<START>,0,0,0
6673,1,home,0,6,6
6673,2,shop,6,7,1
6673,3,work,7,14,7
6673,4,home,14,23,9
6673,5,work,23,24,1
6673,6,<ENDS>,24,24,0
6674,0,<START>,0,0,0
6674,1,home,0,6,6
6674,2,shop,6,7,1
6674,3,home,7,10,3
6674,4,education,10,13,3
6674,5,shop,13,15,2
6674,6,home,15,21,6
6674,7,shop,21,22,1
6674,8,home,22,24,2
6674,9,<ENDS>,24,24,0
6675,0,<START>,0,0,0
6675,1,home,0,6,6
6675,2,shop,6,7,1
6675,3,work,7,14,7
6675,4,home,14,22,8
6675,5,work,22,23,1
6675,6,home,23,24,1
6675,7,<ENDS>,24,24,0
6676,0,<START>,0,0,0
6676,1,home,0,7,7
6676,2,education,7,10,3
6676,3,home,10,16,6
6676,4,shop,16,18,2
6676,5,home,18,24,6
6676,6,<ENDS>,24,24,0
6677,0,<START>,0,0,0
6677,1,home,0,7,7
6677,2,shop,7,8,1
6677,3,education,8,15,7
6677,4,shop,15,16,1
6677,5,home,16,24,8
6677,6,<ENDS>,24,24,0
6678,0,<START>,0,0,0
6678,1,home,0,7,7
6678,2,shop,7,8,1
6678,3,home,8,14,6
6678,4,work,14,20,6
6678,5,home,20,24,4
6678,6,<ENDS>,24,24,0
6679,0,<START>,0,0,0
6679,1,home,0,6,6
6679,2,work,6,8,2
6679,3,home,8,13,5
6679,4,work,13,15,2
6679,5,home,15,22,7
6679,6,work,22,23,1
6679,7,home,23,24,1
6679,8,<ENDS>,24,24,0
6680,0,<START>,0,0,0
6680,1,home,0,6,6
6680,2,work,6,16,10
6680,3,home,16,24,8
6680,4,<ENDS>,24,24,0
6681,0,<START>,0,0,0
6681,1,home,0,7,7
6681,2,work,7,14,7
6681,3,home,14,18,4
6681,4,work,18,20,2
6681,5,home,20,24,4
6681,6,<ENDS>,24,24,0
6682,0,<START>,0,0,0
6682,1,home,0,8,8
6682,2,work,8,14,6
6682,3,home,14,18,4
6682,4,work,18,20,2
6682,5,home,20,24,4
6682,6,<ENDS>,24,24,0
6683,0,<START>,0,0,0
6683,1,home,0,7,7
6683,2,work,7,14,7
6683,3,home,14,18,4
6683,4,work,18,20,2
6683,5,home,20,24,4
6683,6,<ENDS>,24,24,0
6684,0,<START>,0,0,0
6684,1,home,0,7,7
6684,2,education,7,11,4
6684,3,home,11,14,3
6684,4,education,14,16,2
6684,5,shop,16,17,1
6684,6,home,17,24,7
6684,7,<ENDS>,24,24,0
6685,0,<START>,0,0,0
6685,1,home,0,6,6
6685,2,work,6,8,2
6685,3,home,8,9,1
6685,4,work,9,11,2
6685,5,home,11,16,5
6685,6,work,16,17,1
6685,7,home,17,22,5
6685,8,work,22,23,1
6685,9,home,23,24,1
6685,10,<ENDS>,24,24,0
6686,0,<START>,0,0,0
6686,1,home,0,8,8
6686,2,work,8,15,7
6686,3,home,15,20,5
6686,4,shop,20,21,1
6686,5,home,21,24,3
6686,6,<ENDS>,24,24,0
6687,0,<START>,0,0,0
6687,1,home,0,7,7
6687,2,shop,7,8,1
6687,3,work,8,15,7
6687,4,home,15,21,6
6687,5,work,21,22,1
6687,6,home,22,24,2
6687,7,<ENDS>,24,24,0
6688,0,<START>,0,0,0
6688,1,home,0,7,7
6688,2,education,7,11,4
6688,3,home,11,18,7
6688,4,shop,18,19,1
6688,5,home,19,24,5
6688,6,<ENDS>,24,24,0
6689,0,<START>,0,0,0
6689,1,home,0,7,7
6689,2,shop,7,8,1
6689,3,work,8,14,6
6689,4,home,14,16,2
6689,5,work,16,20,4
6689,6,home,20,24,4
6689,7,<ENDS>,24,24,0
6690,0,<START>,0,0,0
6690,1,home,0,8,8
6690,2,work,8,15,7
6690,3,shop,15,16,1
6690,4,home,16,23,7
6690,5,work,23,24,1
6690,6,<ENDS>,24,24,0
6691,0,<START>,0,0,0
6691,1,home,0,7,7
6691,2,work,7,8,1
6691,3,home,8,11,3
6691,4,work,11,13,2
6691,5,home,13,19,6
6691,6,shop,19,20,1
6691,7,home,20,24,4
6691,8,<ENDS>,24,24,0
6692,0,<START>,0,0,0
6692,1,home,0,7,7
6692,2,education,7,11,4
6692,3,home,11,19,8
6692,4,shop,19,20,1
6692,5,home,20,24,4
6692,6,<ENDS>,24,24,0
6693,0,<START>,0,0,0
6693,1,home,0,6,6
6693,2,work,6,7,1
6693,3,home,7,14,7
6693,4,work,14,16,2
6693,5,home,16,23,7
6693,6,work,23,24,1
6693,7,<ENDS>,24,24,0
6694,0,<START>,0,0,0
6694,1,home,0,7,7
6694,2,work,7,13,6
6694,3,shop,13,14,1
6694,4,work,14,19,5
6694,5,home,19,24,5
6694,6,<ENDS>,24,24,0
6695,0,<START>,0,0,0
6695,1,home,0,7,7
6695,2,work,7,14,7
6695,3,shop,14,15,1
6695,4,home,15,24,9
6695,5,<ENDS>,24,24,0
6696,0,<START>,0,0,0
6696,1,home,0,8,8
6696,2,work,8,15,7
6696,3,home,15,24,9
6696,4,<ENDS>,24,24,0
6697,0,<START>,0,0,0
6697,1,home,0,7,7
6697,2,work,7,14,7
6697,3,home,14,20,6
6697,4,shop,20,21,1
6697,5,home,21,24,3
6697,6,<ENDS>,24,24,0
6698,0,<START>,0,0,0
6698,1,home,0,6,6
6698,2,shop,6,7,1
6698,3,work,7,14,7
6698,4,home,14,24,10
6698,5,<ENDS>,24,24,0
6699,0,<START>,0,0,0
6699,1,home,0,7,7
6699,2,shop,7,9,2
6699,3,education,9,11,2
6699,4,home,11,17,6
6699,5,shop,17,18,1
6699,6,home,18,24,6
6699,7,<ENDS>,24,24,0
6700,0,<START>,0,0,0
6700,1,home,0,7,7
6700,2,work,7,13,6
6700,3,shop,13,14,1
6700,4,work,14,19,5
6700,5,home,19,24,5
6700,6,<ENDS>,24,24,0
6701,0,<START>,0,0,0
6701,1,home,0,7,7
6701,2,work,7,13,6
6701,3,home,13,24,11
6701,4,<ENDS>,24,24,0
6702,0,<START>,0,0,0
6702,1,home,0,8,8
6702,2,work,8,15,7
6702,3,home,15,24,9
6702,4,<ENDS>,24,24,0
6703,0,<START>,0,0,0
6703,1,home,0,9,9
6703,2,education,9,12,3
6703,3,home,12,19,7
6703,4,shop,19,20,1
6703,5,home,20,24,4
6703,6,<ENDS>,24,24,0
6704,0,<START>,0,0,0
6704,1,home,0,6,6
6704,2,work,6,14,8
6704,3,home,14,24,10
6704,4,<ENDS>,24,24,0
6705,0,<START>,0,0,0
6705,1,home,0,8,8
6705,2,work,8,15,7
6705,3,home,15,24,9
6705,4,<ENDS>,24,24,0
6706,0,<START>,0,0,0
6706,1,home,0,6,6
6706,2,shop,6,7,1
6706,3,home,7,10,3
6706,4,education,10,13,3
6706,5,shop,13,15,2
6706,6,home,15,21,6
6706,7,shop,21,22,1
6706,8,home,22,24,2
6706,9,<ENDS>,24,24,0
6707,0,<START>,0,0,0
6707,1,home,0,7,7
6707,2,work,7,13,6
6707,3,home,13,24,11
6707,4,<ENDS>,24,24,0
6708,0,<START>,0,0,0
6708,1,home,0,6,6
6708,2,shop,6,7,1
6708,3,work,7,13,6
6708,4,home,13,24,11
6708,5,<ENDS>,24,24,0
6709,0,<START>,0,0,0
6709,1,home,0,6,6
6709,2,work,6,13,7
6709,3,shop,13,14,1
6709,4,home,14,24,10
6709,5,<ENDS>,24,24,0
6710,0,<START>,0,0,0
6710,1,home,0,7,7
6710,2,education,7,11,4
6710,3,home,11,14,3
6710,4,education,14,15,1
6710,5,shop,15,16,1
6710,6,home,16,24,8
6710,7,<ENDS>,24,24,0
6711,0,<START>,0,0,0
6711,1,home,0,8,8
6711,2,work,8,14,6
6711,3,home,14,24,10
6711,4,<ENDS>,24,24,0
6712,0,<START>,0,0,0
6712,1,home,0,7,7
6712,2,work,7,9,2
6712,3,home,9,16,7
6712,4,work,16,18,2
6712,5,home,18,24,6
6712,6,<ENDS>,24,24,0
6713,0,<START>,0,0,0
6713,1,home,0,6,6
6713,2,work,6,8,2
6713,3,home,8,14,6
6713,4,work,14,16,2
6713,5,home,16,24,8
6713,6,<ENDS>,24,24,0
6714,0,<START>,0,0,0
6714,1,home,0,7,7
6714,2,work,7,14,7
6714,3,shop,14,15,1
6714,4,home,15,23,8
6714,5,work,23,24,1
6714,6,<ENDS>,24,24,0
6715,0,<START>,0,0,0
6715,1,home,0,8,8
6715,2,work,8,16,8
6715,3,home,16,21,5
6715,4,work,21,22,1
6715,5,home,22,24,2
6715,6,<ENDS>,24,24,0
6716,0,<START>,0,0,0
6716,1,home,0,6,6
6716,2,work,6,13,7
6716,3,home,13,15,2
6716,4,shop,15,16,1
6716,5,home,16,24,8
6716,6,<ENDS>,24,24,0
6717,0,<START>,0,0,0
6717,1,home,0,7,7
6717,2,shop,7,8,1
6717,3,work,8,15,7
6717,4,home,15,23,8
6717,5,work,23,24,1
6717,6,<ENDS>,24,24,0
6718,0,<START>,0,0,0
6718,1,home,0,7,7
6718,2,work,7,13,6
6718,3,shop,13,14,1
6718,4,work,14,20,6
6718,5,home,20,24,4
6718,6,<ENDS>,24,24,0
6719,0,<START>,0,0,0
6719,1,home,0,8,8
6719,2,work,8,14,6
6719,3,shop,14,15,1
6719,4,home,15,24,9
6719,5,<ENDS>,24,24,0
6720,0,<START>,0,0,0
6720,1,home,0,8,8
6720,2,work,8,15,7
6720,3,home,15,24,9
6720,4,<ENDS>,24,24,0
6721,0,<START>,0,0,0
6721,1,home,0,7,7
6721,2,work,7,14,7
6721,3,home,14,24,10
6721,4,<ENDS>,24,24,0
6722,0,<START>,0,0,0
6722,1,home,0,8,8
6722,2,education,8,12,4
6722,3,shop,12,14,2
6722,4,education,14,15,1
6722,5,shop,15,17,2
6722,6,home,17,24,7
6722,7,<ENDS>,24,24,0
6723,0,<START>,0,0,0
6723,1,home,0,6,6
6723,2,work,6,8,2
6723,3,home,8,12,4
6723,4,work,12,14,2
6723,5,home,14,21,7
6723,6,work,21,22,1
6723,7,home,22,24,2
6723,8,<ENDS>,24,24,0
6724,0,<START>,0,0,0
6724,1,home,0,7,7
6724,2,work,7,14,7
6724,3,shop,14,15,1
6724,4,home,15,24,9
6724,5,<ENDS>,24,24,0
6725,0,<START>,0,0,0
6725,1,home,0,7,7
6725,2,work,7,13,6
6725,3,shop,13,14,1
6725,4,work,14,18,4
6725,5,home,18,24,6
6725,6,<ENDS>,24,24,0
6726,0,<START>,0,0,0
6726,1,home,0,8,8
6726,2,work,8,17,9
6726,3,home,17,22,5
6726,4,work,22,23,1
6726,5,home,23,24,1
6726,6,<ENDS>,24,24,0
6727,0,<START>,0,0,0
6727,1,home,0,6,6
6727,2,work,6,14,8
6727,3,home,14,24,10
6727,4,<ENDS>,24,24,0
6728,0,<START>,0,0,0
6728,1,home,0,7,7
6728,2,work,7,13,6
6728,3,shop,13,14,1
6728,4,work,14,19,5
6728,5,home,19,24,5
6728,6,<ENDS>,24,24,0
6729,0,<START>,0,0,0
6729,1,home,0,7,7
6729,2,work,7,13,6
6729,3,shop,13,14,1
6729,4,home,14,17,3
6729,5,work,17,20,3
6729,6,home,20,24,4
6729,7,<ENDS>,24,24,0
6730,0,<START>,0,0,0
6730,1,home,0,7,7
6730,2,work,7,14,7
6730,3,home,14,18,4
6730,4,shop,18,19,1
6730,5,home,19,24,5
6730,6,<ENDS>,24,24,0
6731,0,<START>,0,0,0
6731,1,home,0,8,8
6731,2,education,8,13,5
6731,3,shop,13,15,2
6731,4,home,15,24,9
6731,5,<ENDS>,24,24,0
6732,0,<START>,0,0,0
6732,1,home,0,6,6
6732,2,work,6,13,7
6732,3,home,13,21,8
6732,4,work,21,22,1
6732,5,home,22,24,2
6732,6,<ENDS>,24,24,0
6733,0,<START>,0,0,0
6733,1,home,0,7,7
6733,2,education,7,11,4
6733,3,home,11,17,6
6733,4,shop,17,19,2
6733,5,home,19,24,5
6733,6,<ENDS>,24,24,0
6734,0,<START>,0,0,0
6734,1,home,0,8,8
6734,2,shop,8,9,1
6734,3,home,9,12,3
6734,4,work,12,18,6
6734,5,home,18,24,6
6734,6,<ENDS>,24,24,0
6735,0,<START>,0,0,0
6735,1,home,0,6,6
6735,2,work,6,13,7
6735,3,home,13,21,8
6735,4,work,21,22,1
6735,5,home,22,24,2
6735,6,<ENDS>,24,24,0
6736,0,<START>,0,0,0
6736,1,home,0,6,6
6736,2,work,6,13,7
6736,3,shop,13,14,1
6736,4,work,14,19,5
6736,5,home,19,24,5
6736,6,<ENDS>,24,24,0
6737,0,<START>,0,0,0
6737,1,home,0,7,7
6737,2,work,7,8,1
6737,3,home,8,9,1
6737,4,work,9,11,2
6737,5,home,11,17,6
6737,6,work,17,19,2
6737,7,home,19,24,5
6737,8,<ENDS>,24,24,0
6738,0,<START>,0,0,0
6738,1,home,0,6,6
6738,2,work,6,13,7
6738,3,shop,13,14,1
6738,4,work,14,20,6
6738,5,home,20,24,4
6738,6,<ENDS>,24,24,0
6739,0,<START>,0,0,0
6739,1,home,0,9,9
6739,2,work,9,16,7
6739,3,home,16,24,8
6739,4,<ENDS>,24,24,0
6740,0,<START>,0,0,0
6740,1,home,0,7,7
6740,2,work,7,15,8
6740,3,home,15,24,9
6740,4,<ENDS>,24,24,0
6741,0,<START>,0,0,0
6741,1,home,0,7,7
6741,2,education,7,11,4
6741,3,home,11,18,7
6741,4,shop,18,19,1
6741,5,home,19,24,5
6741,6,<ENDS>,24,24,0
6742,0,<START>,0,0,0
6742,1,home,0,6,6
6742,2,shop,6,7,1
6742,3,home,7,9,2
6742,4,work,9,16,7
6742,5,home,16,24,8
6742,6,<ENDS>,24,24,0
6743,0,<START>,0,0,0
6743,1,home,0,8,8
6743,2,work,8,15,7
6743,3,home,15,24,9
6743,4,<ENDS>,24,24,0
6744,0,<START>,0,0,0
6744,1,home,0,9,9
6744,2,work,9,16,7
6744,3,home,16,20,4
6744,4,shop,20,21,1
6744,5,home,21,24,3
6744,6,<ENDS>,24,24,0
6745,0,<START>,0,0,0
6745,1,home,0,9,9
6745,2,work,9,17,8
6745,3,home,17,21,4
6745,4,work,21,22,1
6745,5,home,22,24,2
6745,6,<ENDS>,24,24,0
6746,0,<START>,0,0,0
6746,1,home,0,7,7
6746,2,work,7,13,6
6746,3,shop,13,14,1
6746,4,work,14,20,6
6746,5,home,20,24,4
6746,6,<ENDS>,24,24,0
6747,0,<START>,0,0,0
6747,1,home,0,6,6
6747,2,work,6,8,2
6747,3,home,8,13,5
6747,4,work,13,15,2
6747,5,home,15,22,7
6747,6,work,22,23,1
6747,7,home,23,24,1
6747,8,<ENDS>,24,24,0
6748,0,<START>,0,0,0
6748,1,home,0,8,8
6748,2,work,8,15,7
6748,3,shop,15,16,1
6748,4,home,16,24,8
6748,5,<ENDS>,24,24,0
6749,0,<START>,0,0,0
6749,1,home,0,7,7
6749,2,work,7,9,2
6749,3,home,9,13,4
6749,4,work,13,15,2
6749,5,home,15,21,6
6749,6,work,21,22,1
6749,7,home,22,24,2
6749,8,<ENDS>,24,24,0
6750,0,<START>,0,0,0
6750,1,home,0,7,7
6750,2,work,7,13,6
6750,3,shop,13,14,1
6750,4,work,14,19,5
6750,5,home,19,24,5
6750,6,<ENDS>,24,24,0
6751,0,<START>,0,0,0
6751,1,home,0,7,7
6751,2,education,7,12,5
6751,3,shop,12,13,1
6751,4,education,13,16,3
6751,5,home,16,24,8
6751,6,<ENDS>,24,24,0
6752,0,<START>,0,0,0
6752,1,home,0,7,7
6752,2,work,7,13,6
6752,3,shop,13,14,1
6752,4,home,14,24,10
6752,5,<ENDS>,24,24,0
6753,0,<START>,0,0,0
6753,1,home,0,7,7
6753,2,work,7,14,7
6753,3,home,14,24,10
6753,4,<ENDS>,24,24,0
6754,0,<START>,0,0,0
6754,1,home,0,8,8
6754,2,shop,8,9,1
6754,3,work,9,16,7
6754,4,home,16,24,8
6754,5,<ENDS>,24,24,0
6755,0,<START>,0,0,0
6755,1,home,0,7,7
6755,2,education,7,11,4
6755,3,home,11,14,3
6755,4,education,14,16,2
6755,5,home,16,24,8
6755,6,<ENDS>,24,24,0
6756,0,<START>,0,0,0
6756,1,home,0,8,8
6756,2,education,8,12,4
6756,3,shop,12,14,2
6756,4,education,14,16,2
6756,5,home,16,24,8
6756,6,<ENDS>,24,24,0
6757,0,<START>,0,0,0
6757,1,home,0,8,8
6757,2,education,8,12,4
6757,3,work,12,17,5
6757,4,home,17,24,7
6757,5,<ENDS>,24,24,0
6758,0,<START>,0,0,0
6758,1,home,0,7,7
6758,2,work,7,13,6
6758,3,shop,13,14,1
6758,4,work,14,20,6
6758,5,home,20,24,4
6758,6,<ENDS>,24,24,0
6759,0,<START>,0,0,0
6759,1,home,0,7,7
6759,2,work,7,13,6
6759,3,shop,13,14,1
6759,4,home,14,24,10
6759,5,<ENDS>,24,24,0
6760,0,<START>,0,0,0
6760,1,home,0,6,6
6760,2,work,6,13,7
6760,3,home,13,21,8
6760,4,shop,21,22,1
6760,5,home,22,24,2
6760,6,<ENDS>,24,24,0
6761,0,<START>,0,0,0
6761,1,home,0,6,6
6761,2,work,6,13,7
6761,3,home,13,15,2
6761,4,work,15,20,5
6761,5,home,20,24,4
6761,6,<ENDS>,24,24,0
6762,0,<START>,0,0,0
6762,1,home,0,6,6
6762,2,work,6,13,7
6762,3,shop,13,14,1
6762,4,work,14,19,5
6762,5,home,19,24,5
6762,6,<ENDS>,24,24,0
6763,0,<START>,0,0,0
6763,1,home,0,7,7
6763,2,work,7,9,2
6763,3,home,9,13,4
6763,4,work,13,15,2
6763,5,home,15,21,6
6763,6,work,21,22,1
6763,7,home,22,24,2
6763,8,<ENDS>,24,24,0
6764,0,<START>,0,0,0
6764,1,home,0,7,7
6764,2,shop,7,8,1
6764,3,work,8,14,6
6764,4,home,14,22,8
6764,5,work,22,23,1
6764,6,home,23,24,1
6764,7,<ENDS>,24,24,0
6765,0,<START>,0,0,0
6765,1,home,0,8,8
6765,2,work,8,14,6
6765,3,home,14,24,10
6765,4,<ENDS>,24,24,0
6766,0,<START>,0,0,0
6766,1,home,0,6,6
6766,2,shop,6,7,1
6766,3,home,7,10,3
6766,4,education,10,16,6
6766,5,home,16,24,8
6766,6,<ENDS>,24,24,0
6767,0,<START>,0,0,0
6767,1,home,0,6,6
6767,2,shop,6,7,1
6767,3,work,7,13,6
6767,4,shop,13,14,1
6767,5,home,14,24,10
6767,6,<ENDS>,24,24,0
6768,0,<START>,0,0,0
6768,1,home,0,8,8
6768,2,education,8,11,3
6768,3,home,11,19,8
6768,4,shop,19,21,2
6768,5,home,21,24,3
6768,6,<ENDS>,24,24,0
6769,0,<START>,0,0,0
6769,1,home,0,8,8
6769,2,work,8,14,6
6769,3,shop,14,15,1
6769,4,home,15,21,6
6769,5,shop,21,22,1
6769,6,home,22,24,2
6769,7,<ENDS>,24,24,0
6770,0,<START>,0,0,0
6770,1,home,0,8,8
6770,2,work,8,13,5
6770,3,home,13,16,3
6770,4,work,16,19,3
6770,5,home,19,24,5
6770,6,<ENDS>,24,24,0
6771,0,<START>,0,0,0
6771,1,home,0,7,7
6771,2,work,7,13,6
6771,3,home,13,24,11
6771,4,<ENDS>,24,24,0
6772,0,<START>,0,0,0
6772,1,home,0,6,6
6772,2,work,6,12,6
6772,3,shop,12,13,1
6772,4,work,13,19,6
6772,5,home,19,24,5
6772,6,<ENDS>,24,24,0
6773,0,<START>,0,0,0
6773,1,home,0,6,6
6773,2,work,6,13,7
6773,3,shop,13,14,1
6773,4,home,14,18,4
6773,5,work,18,20,2
6773,6,home,20,24,4
6773,7,<ENDS>,24,24,0
6774,0,<START>,0,0,0
6774,1,home,0,6,6
6774,2,shop,6,7,1
6774,3,work,7,13,6
6774,4,shop,13,14,1
6774,5,home,14,24,10
6774,6,<ENDS>,24,24,0
6775,0,<START>,0,0,0
6775,1,home,0,7,7
6775,2,work,7,14,7
6775,3,shop,14,15,1
6775,4,home,15,24,9
6775,5,<ENDS>,24,24,0
6776,0,<START>,0,0,0
6776,1,home,0,7,7
6776,2,education,7,11,4
6776,3,home,11,14,3
6776,4,education,14,16,2
6776,5,home,16,20,4
6776,6,shop,20,21,1
6776,7,home,21,24,3
6776,8,<ENDS>,24,24,0
6777,0,<START>,0,0,0
6777,1,home,0,7,7
6777,2,work,7,13,6
6777,3,home,13,21,8
6777,4,work,21,22,1
6777,5,home,22,24,2
6777,6,<ENDS>,24,24,0
6778,0,<START>,0,0,0
6778,1,home,0,6,6
6778,2,work,6,13,7
6778,3,shop,13,14,1
6778,4,work,14,17,3
6778,5,home,17,24,7
6778,6,<ENDS>,24,24,0
6779,0,<START>,0,0,0
6779,1,home,0,8,8
6779,2,work,8,13,5
6779,3,shop,13,14,1
6779,4,home,14,23,9
6779,5,work,23,24,1
6779,6,<ENDS>,24,24,0
6780,0,<START>,0,0,0
6780,1,home,0,7,7
6780,2,work,7,13,6
6780,3,home,13,17,4
6780,4,shop,17,18,1
6780,5,home,18,24,6
6780,6,<ENDS>,24,24,0
6781,0,<START>,0,0,0
6781,1,home,0,7,7
6781,2,work,7,13,6
6781,3,home,13,24,11
6781,4,<ENDS>,24,24,0
6782,0,<START>,0,0,0
6782,1,home,0,6,6
6782,2,work,6,8,2
6782,3,home,8,12,4
6782,4,work,12,14,2
6782,5,home,14,18,4
6782,6,work,18,19,1
6782,7,home,19,24,5
6782,8,<ENDS>,24,24,0
6783,0,<START>,0,0,0
6783,1,home,0,8,8
6783,2,work,8,14,6
6783,3,shop,14,15,1
6783,4,home,15,24,9
6783,5,<ENDS>,24,24,0
6784,0,<START>,0,0,0
6784,1,home,0,8,8
6784,2,work,8,15,7
6784,3,shop,15,16,1
6784,4,home,16,22,6
6784,5,work,22,23,1
6784,6,home,23,24,1
6784,7,<ENDS>,24,24,0
6785,0,<START>,0,0,0
6785,1,home,0,7,7
6785,2,shop,7,8,1
6785,3,home,8,15,7
6785,4,work,15,20,5
6785,5,home,20,24,4
6785,6,<ENDS>,24,24,0
6786,0,<START>,0,0,0
6786,1,home,0,7,7
6786,2,shop,7,8,1
6786,3,work,8,14,6
6786,4,home,14,24,10
6786,5,<ENDS>,24,24,0
6787,0,<START>,0,0,0
6787,1,home,0,7,7
6787,2,shop,7,8,1
6787,3,work,8,16,8
6787,4,home,16,22,6
6787,5,work,22,23,1
6787,6,home,23,24,1
6787,7,<ENDS>,24,24,0
6788,0,<START>,0,0,0
6788,1,home,0,8,8
6788,2,work,8,15,7
6788,3,home,15,24,9
6788,4,<ENDS>,24,24,0
6789,0,<START>,0,0,0
6789,1,home,0,6,6
6789,2,shop,6,7,1
6789,3,home,7,11,4
6789,4,work,11,18,7
6789,5,home,18,24,6
6789,6,<ENDS>,24,24,0
6790,0,<START>,0,0,0
6790,1,home,0,6,6
6790,2,work,6,13,7
6790,3,home,13,23,10
6790,4,work,23,24,1
6790,5,<ENDS>,24,24,0
6791,0,<START>,0,0,0
6791,1,home,0,7,7
6791,2,work,7,13,6
6791,3,home,13,17,4
6791,4,work,17,20,3
6791,5,home,20,24,4
6791,6,<ENDS>,24,24,0
6792,0,<START>,0,0,0
6792,1,home,0,7,7
6792,2,shop,7,9,2
6792,3,education,9,11,2
6792,4,home,11,18,7
6792,5,shop,18,19,1
6792,6,home,19,24,5
6792,7,<ENDS>,24,24,0
6793,0,<START>,0,0,0
6793,1,home,0,6,6
6793,2,work,6,13,7
6793,3,home,13,24,11
6793,4,<ENDS>,24,24,0
6794,0,<START>,0,0,0
6794,1,home,0,6,6
6794,2,work,6,13,7
6794,3,home,13,16,3
6794,4,work,16,20,4
6794,5,home,20,24,4
6794,6,<ENDS>,24,24,0
6795,0,<START>,0,0,0
6795,1,home,0,6,6
6795,2,work,6,13,7
6795,3,shop,13,14,1
6795,4,work,14,19,5
6795,5,home,19,24,5
6795,6,<ENDS>,24,24,0
6796,0,<START>,0,0,0
6796,1,home,0,7,7
6796,2,work,7,13,6
6796,3,shop,13,14,1
6796,4,home,14,24,10
6796,5,<ENDS>,24,24,0
6797,0,<START>,0,0,0
6797,1,home,0,7,7
6797,2,education,7,11,4
6797,3,home,11,16,5
6797,4,shop,16,18,2
6797,5,home,18,24,6
6797,6,<ENDS>,24,24,0
6798,0,<START>,0,0,0
6798,1,home,0,6,6
6798,2,shop,6,7,1
6798,3,work,7,14,7
6798,4,home,14,24,10
6798,5,<ENDS>,24,24,0
6799,0,<START>,0,0,0
6799,1,home,0,6,6
6799,2,work,6,8,2
6799,3,home,8,9,1
6799,4,work,9,11,2
6799,5,shop,11,12,1
6799,6,work,12,14,2
6799,7,home,14,21,7
6799,8,work,21,22,1
6799,9,home,22,24,2
6799,10,<ENDS>,24,24,0
6800,0,<START>,0,0,0
6800,1,home,0,6,6
6800,2,work,6,13,7
6800,3,shop,13,14,1
6800,4,home,14,16,2
6800,5,work,16,20,4
6800,6,home,20,24,4
6800,7,<ENDS>,24,24,0
6801,0,<START>,0,0,0
6801,1,home,0,6,6
6801,2,work,6,13,7
6801,3,shop,13,14,1
6801,4,home,14,24,10
6801,5,<ENDS>,24,24,0
6802,0,<START>,0,0,0
6802,1,home,0,7,7
6802,2,work,7,15,8
6802,3,home,15,24,9
6802,4,<ENDS>,24,24,0
6803,0,<START>,0,0,0
6803,1,home,0,7,7
6803,2,education,7,11,4
6803,3,home,11,18,7
6803,4,shop,18,19,1
6803,5,home,19,24,5
6803,6,<ENDS>,24,24,0
6804,0,<START>,0,0,0
6804,1,home,0,7,7
6804,2,work,7,14,7
6804,3,home,14,24,10
6804,4,<ENDS>,24,24,0
6805,0,<START>,0,0,0
6805,1,home,0,7,7
6805,2,education,7,11,4
6805,3,home,11,18,7
6805,4,shop,18,19,1
6805,5,home,19,24,5
6805,6,<ENDS>,24,24,0
6806,0,<START>,0,0,0
6806,1,home,0,8,8
6806,2,work,8,13,5
6806,3,shop,13,14,1
6806,4,home,14,24,10
6806,5,<ENDS>,24,24,0
6807,0,<START>,0,0,0
6807,1,home,0,7,7
6807,2,work,7,14,7
6807,3,home,14,24,10
6807,4,<ENDS>,24,24,0
6808,0,<START>,0,0,0
6808,1,home,0,7,7
6808,2,work,7,13,6
6808,3,home,13,20,7
6808,4,shop,20,21,1
6808,5,home,21,24,3
6808,6,<ENDS>,24,24,0
6809,0,<START>,0,0,0
6809,1,home,0,9,9
6809,2,education,9,12,3
6809,3,shop,12,13,1
6809,4,work,13,19,6
6809,5,home,19,24,5
6809,6,<ENDS>,24,24,0
6810,0,<START>,0,0,0
6810,1,home,0,7,7
6810,2,work,7,14,7
6810,3,home,14,24,10
6810,4,<ENDS>,24,24,0
6811,0,<START>,0,0,0
6811,1,home,0,7,7
6811,2,work,7,9,2
6811,3,home,9,13,4
6811,4,work,13,15,2
6811,5,home,15,22,7
6811,6,work,22,23,1
6811,7,home,23,24,1
6811,8,<ENDS>,24,24,0
6812,0,<START>,0,0,0
6812,1,home,0,6,6
6812,2,shop,6,7,1
6812,3,home,7,13,6
6812,4,education,13,16,3
6812,5,shop,16,18,2
6812,6,home,18,24,6
6812,7,<ENDS>,24,24,0
6813,0,<START>,0,0,0
6813,1,home,0,7,7
6813,2,education,7,12,5
6813,3,shop,12,14,2
6813,4,education,14,16,2
6813,5,shop,16,18,2
6813,6,home,18,24,6
6813,7,<ENDS>,24,24,0
6814,0,<START>,0,0,0
6814,1,home,0,7,7
6814,2,work,7,13,6
6814,3,shop,13,14,1
6814,4,home,14,24,10
6814,5,<ENDS>,24,24,0
6815,0,<START>,0,0,0
6815,1,home,0,8,8
6815,2,work,8,15,7
6815,3,home,15,24,9
6815,4,<ENDS>,24,24,0
6816,0,<START>,0,0,0
6816,1,home,0,8,8
6816,2,work,8,15,7
6816,3,home,15,21,6
6816,4,shop,21,22,1
6816,5,home,22,24,2
6816,6,<ENDS>,24,24,0
6817,0,<START>,0,0,0
6817,1,home,0,7,7
6817,2,work,7,14,7
6817,3,shop,14,15,1
6817,4,home,15,21,6
6817,5,work,21,22,1
6817,6,home,22,24,2
6817,7,<ENDS>,24,24,0
6818,0,<START>,0,0,0
6818,1,home,0,8,8
6818,2,work,8,14,6
6818,3,home,14,24,10
6818,4,<ENDS>,24,24,0
6819,0,<START>,0,0,0
6819,1,home,0,8,8
6819,2,work,8,17,9
6819,3,home,17,24,7
6819,4,<ENDS>,24,24,0
6820,0,<START>,0,0,0
6820,1,home,0,6,6
6820,2,shop,6,8,2
6820,3,work,8,15,7
6820,4,home,15,23,8
6820,5,work,23,24,1
6820,6,<ENDS>,24,24,0
6821,0,<START>,0,0,0
6821,1,home,0,7,7
6821,2,work,7,14,7
6821,3,home,14,21,7
6821,4,work,21,22,1
6821,5,home,22,24,2
6821,6,<ENDS>,24,24,0
6822,0,<START>,0,0,0
6822,1,home,0,7,7
6822,2,education,7,11,4
6822,3,home,11,18,7
6822,4,shop,18,19,1
6822,5,home,19,24,5
6822,6,<ENDS>,24,24,0
6823,0,<START>,0,0,0
6823,1,home,0,7,7
6823,2,work,7,14,7
6823,3,home,14,24,10
6823,4,<ENDS>,24,24,0
6824,0,<START>,0,0,0
6824,1,home,0,6,6
6824,2,shop,6,7,1
6824,3,home,7,13,6
6824,4,education,13,16,3
6824,5,home,16,24,8
6824,6,<ENDS>,24,24,0
6825,0,<START>,0,0,0
6825,1,work,0,1,1
6825,2,home,1,8,7
6825,3,education,8,11,3
6825,4,home,11,20,9
6825,5,shop,20,21,1
6825,6,home,21,24,3
6825,7,<ENDS>,24,24,0
6826,0,<START>,0,0,0
6826,1,home,0,6,6
6826,2,work,6,13,7
6826,3,shop,13,14,1
6826,4,work,14,20,6
6826,5,home,20,24,4
6826,6,<ENDS>,24,24,0
6827,0,<START>,0,0,0
6827,1,home,0,6,6
6827,2,work,6,8,2
6827,3,home,8,9,1
6827,4,work,9,11,2
6827,5,home,11,15,4
6827,6,work,15,17,2
6827,7,home,17,22,5
6827,8,work,22,23,1
6827,9,home,23,24,1
6827,10,<ENDS>,24,24,0
6828,0,<START>,0,0,0
6828,1,home,0,6,6
6828,2,shop,6,7,1
6828,3,home,7,12,5
6828,4,education,12,15,3
6828,5,shop,15,16,1
6828,6,home,16,24,8
6828,7,<ENDS>,24,24,0
6829,0,<START>,0,0,0
6829,1,home,0,6,6
6829,2,work,6,13,7
6829,3,home,13,21,8
6829,4,work,21,22,1
6829,5,home,22,24,2
6829,6,<ENDS>,24,24,0
6830,0,<START>,0,0,0
6830,1,home,0,6,6
6830,2,shop,6,7,1
6830,3,home,7,9,2
6830,4,education,9,12,3
6830,5,home,12,14,2
6830,6,education,14,16,2
6830,7,home,16,24,8
6830,8,<ENDS>,24,24,0
6831,0,<START>,0,0,0
6831,1,home,0,7,7
6831,2,work,7,14,7
6831,3,home,14,24,10
6831,4,<ENDS>,24,24,0
6832,0,<START>,0,0,0
6832,1,home,0,7,7
6832,2,work,7,15,8
6832,3,home,15,24,9
6832,4,<ENDS>,24,24,0
6833,0,<START>,0,0,0
6833,1,home,0,6,6
6833,2,work,6,7,1
6833,3,home,7,9,2
6833,4,work,9,10,1
6833,5,home,10,14,4
6833,6,work,14,16,2
6833,7,home,16,22,6
6833,8,work,22,23,1
6833,9,home,23,24,1
6833,10,<ENDS>,24,24,0
6834,0,<START>,0,0,0
6834,1,home,0,6,6
6834,2,work,6,13,7
6834,3,shop,13,14,1
6834,4,home,14,24,10
6834,5,<ENDS>,24,24,0
6835,0,<START>,0,0,0
6835,1,home,0,8,8
6835,2,education,8,11,3
6835,3,home,11,16,5
6835,4,work,16,20,4
6835,5,home,20,24,4
6835,6,<ENDS>,24,24,0
6836,0,<START>,0,0,0
6836,1,home,0,7,7
6836,2,work,7,13,6
6836,3,shop,13,14,1
6836,4,home,14,24,10
6836,5,<ENDS>,24,24,0
6837,0,<START>,0,0,0
6837,1,home,0,8,8
6837,2,work,8,15,7
6837,3,home,15,24,9
6837,4,<ENDS>,24,24,0
6838,0,<START>,0,0,0
6838,1,home,0,7,7
6838,2,work,7,13,6
6838,3,shop,13,14,1
6838,4,work,14,19,5
6838,5,home,19,24,5
6838,6,<ENDS>,24,24,0
6839,0,<START>,0,0,0
6839,1,home,0,8,8
6839,2,work,8,14,6
6839,3,shop,14,15,1
6839,4,work,15,19,4
6839,5,home,19,24,5
6839,6,<ENDS>,24,24,0
6840,0,<START>,0,0,0
6840,1,home,0,6,6
6840,2,work,6,13,7
6840,3,home,13,21,8
6840,4,work,21,22,1
6840,5,home,22,24,2
6840,6,<ENDS>,24,24,0
6841,0,<START>,0,0,0
6841,1,home,0,6,6
6841,2,work,6,8,2
6841,3,home,8,13,5
6841,4,work,13,15,2
6841,5,home,15,21,6
6841,6,work,21,22,1
6841,7,home,22,24,2
6841,8,<ENDS>,24,24,0
6842,0,<START>,0,0,0
6842,1,home,0,6,6
6842,2,shop,6,7,1
6842,3,home,7,10,3
6842,4,education,10,12,2
6842,5,home,12,19,7
6842,6,shop,19,20,1
6842,7,home,20,24,4
6842,8,<ENDS>,24,24,0
6843,0,<START>,0,0,0
6843,1,home,0,6,6
6843,2,work,6,13,7
6843,3,home,13,17,4
6843,4,work,17,20,3
6843,5,home,20,24,4
6843,6,<ENDS>,24,24,0
6844,0,<START>,0,0,0
6844,1,home,0,6,6
6844,2,shop,6,7,1
6844,3,work,7,9,2
6844,4,home,9,16,7
6844,5,work,16,19,3
6844,6,home,19,24,5
6844,7,<ENDS>,24,24,0
6845,0,<START>,0,0,0
6845,1,home,0,9,9
6845,2,work,9,17,8
6845,3,home,17,24,7
6845,4,<ENDS>,24,24,0
6846,0,<START>,0,0,0
6846,1,home,0,7,7
6846,2,work,7,15,8
6846,3,home,15,23,8
6846,4,work,23,24,1
6846,5,<ENDS>,24,24,0
6847,0,<START>,0,0,0
6847,1,home,0,6,6
6847,2,shop,6,7,1
6847,3,home,7,12,5
6847,4,work,12,18,6
6847,5,home,18,24,6
6847,6,<ENDS>,24,24,0
6848,0,<START>,0,0,0
6848,1,home,0,7,7
6848,2,work,7,13,6
6848,3,shop,13,15,2
6848,4,work,15,19,4
6848,5,home,19,24,5
6848,6,<ENDS>,24,24,0
6849,0,<START>,0,0,0
6849,1,home,0,8,8
6849,2,work,8,13,5
6849,3,home,13,21,8
6849,4,work,21,22,1
6849,5,home,22,24,2
6849,6,<ENDS>,24,24,0
6850,0,<START>,0,0,0
6850,1,home,0,8,8
6850,2,education,8,12,4
6850,3,work,12,19,7
6850,4,home,19,24,5
6850,5,<ENDS>,24,24,0
6851,0,<START>,0,0,0
6851,1,home,0,6,6
6851,2,work,6,14,8
6851,3,shop,14,15,1
6851,4,work,15,19,4
6851,5,home,19,24,5
6851,6,<ENDS>,24,24,0
6852,0,<START>,0,0,0
6852,1,home,0,8,8
6852,2,work,8,15,7
6852,3,home,15,21,6
6852,4,shop,21,22,1
6852,5,home,22,24,2
6852,6,<ENDS>,24,24,0
6853,0,<START>,0,0,0
6853,1,home,0,8,8
6853,2,education,8,11,3
6853,3,home,11,24,13
6853,4,<ENDS>,24,24,0
6854,0,<START>,0,0,0
6854,1,home,0,7,7
6854,2,work,7,13,6
6854,3,home,13,17,4
6854,4,work,17,20,3
6854,5,home,20,24,4
6854,6,<ENDS>,24,24,0
6855,0,<START>,0,0,0
6855,1,home,0,6,6
6855,2,work,6,13,7
6855,3,home,13,24,11
6855,4,<ENDS>,24,24,0
6856,0,<START>,0,0,0
6856,1,home,0,6,6
6856,2,work,6,13,7
6856,3,home,13,23,10
6856,4,work,23,24,1
6856,5,<ENDS>,24,24,0
6857,0,<START>,0,0,0
6857,1,home,0,7,7
6857,2,work,7,14,7
6857,3,home,14,18,4
6857,4,work,18,20,2
6857,5,home,20,24,4
6857,6,<ENDS>,24,24,0
6858,0,<START>,0,0,0
6858,1,home,0,8,8
6858,2,work,8,13,5
6858,3,shop,13,14,1
6858,4,home,14,22,8
6858,5,work,22,23,1
6858,6,home,23,24,1
6858,7,<ENDS>,24,24,0
6859,0,<START>,0,0,0
6859,1,home,0,7,7
6859,2,education,7,12,5
6859,3,shop,12,13,1
6859,4,education,13,16,3
6859,5,home,16,24,8
6859,6,<ENDS>,24,24,0
6860,0,<START>,0,0,0
6860,1,home,0,6,6
6860,2,work,6,8,2
6860,3,home,8,15,7
6860,4,work,15,17,2
6860,5,home,17,21,4
6860,6,work,21,22,1
6860,7,home,22,24,2
6860,8,<ENDS>,24,24,0
6861,0,<START>,0,0,0
6861,1,home,0,7,7
6861,2,work,7,14,7
6861,3,home,14,21,7
6861,4,shop,21,22,1
6861,5,home,22,24,2
6861,6,<ENDS>,24,24,0
6862,0,<START>,0,0,0
6862,1,home,0,9,9
6862,2,education,9,13,4
6862,3,shop,13,14,1
6862,4,work,14,20,6
6862,5,home,20,24,4
6862,6,<ENDS>,24,24,0
6863,0,<START>,0,0,0
6863,1,home,0,8,8
6863,2,work,8,15,7
6863,3,home,15,24,9
6863,4,<ENDS>,24,24,0
6864,0,<START>,0,0,0
6864,1,home,0,7,7
6864,2,education,7,10,3
6864,3,home,10,13,3
6864,4,education,13,16,3
6864,5,home,16,24,8
6864,6,<ENDS>,24,24,0
6865,0,<START>,0,0,0
6865,1,home,0,6,6
6865,2,work,6,13,7
6865,3,home,13,24,11
6865,4,<ENDS>,24,24,0
6866,0,<START>,0,0,0
6866,1,home,0,6,6
6866,2,shop,6,7,1
6866,3,home,7,10,3
6866,4,education,10,13,3
6866,5,shop,13,14,1
6866,6,home,14,21,7
6866,7,shop,21,22,1
6866,8,home,22,24,2
6866,9,<ENDS>,24,24,0
6867,0,<START>,0,0,0
6867,1,home,0,6,6
6867,2,work,6,13,7
6867,3,home,13,21,8
6867,4,work,21,22,1
6867,5,home,22,24,2
6867,6,<ENDS>,24,24,0
6868,0,<START>,0,0,0
6868,1,home,0,8,8
6868,2,work,8,14,6
6868,3,shop,14,15,1
6868,4,home,15,21,6
6868,5,work,21,22,1
6868,6,home,22,24,2
6868,7,<ENDS>,24,24,0
6869,0,<START>,0,0,0
6869,1,home,0,6,6
6869,2,work,6,13,7
6869,3,home,13,14,1
6869,4,shop,14,15,1
6869,5,home,15,24,9
6869,6,<ENDS>,24,24,0
6870,0,<START>,0,0,0
6870,1,home,0,6,6
6870,2,work,6,13,7
6870,3,shop,13,14,1
6870,4,home,14,19,5
6870,5,shop,19,20,1
6870,6,home,20,24,4
6870,7,<ENDS>,24,24,0
6871,0,<START>,0,0,0
6871,1,home,0,7,7
6871,2,shop,7,8,1
6871,3,education,8,11,3
6871,4,home,11,20,9
6871,5,shop,20,21,1
6871,6,home,21,24,3
6871,7,<ENDS>,24,24,0
6872,0,<START>,0,0,0
6872,1,home,0,8,8
6872,2,work,8,13,5
6872,3,shop,13,14,1
6872,4,home,14,21,7
6872,5,work,21,22,1
6872,6,home,22,24,2
6872,7,<ENDS>,24,24,0
6873,0,<START>,0,0,0
6873,1,home,0,6,6
6873,2,shop,6,7,1
6873,3,work,7,13,6
6873,4,home,13,18,5
6873,5,work,18,20,2
6873,6,home,20,24,4
6873,7,<ENDS>,24,24,0
6874,0,<START>,0,0,0
6874,1,home,0,6,6
6874,2,work,6,12,6
6874,3,shop,12,13,1
6874,4,work,13,19,6
6874,5,home,19,24,5
6874,6,<ENDS>,24,24,0
6875,0,<START>,0,0,0
6875,1,home,0,7,7
6875,2,work,7,13,6
6875,3,home,13,17,4
6875,4,work,17,20,3
6875,5,home,20,24,4
6875,6,<ENDS>,24,24,0
6876,0,<START>,0,0,0
6876,1,home,0,6,6
6876,2,work,6,13,7
6876,3,home,13,24,11
6876,4,<ENDS>,24,24,0
6877,0,<START>,0,0,0
6877,1,home,0,8,8
6877,2,education,8,11,3
6877,3,shop,11,13,2
6877,4,work,13,19,6
6877,5,home,19,24,5
6877,6,<ENDS>,24,24,0
6878,0,<START>,0,0,0
6878,1,home,0,6,6
6878,2,work,6,8,2
6878,3,home,8,14,6
6878,4,work,14,16,2
6878,5,home,16,23,7
6878,6,work,23,24,1
6878,7,<ENDS>,24,24,0
6879,0,<START>,0,0,0
6879,1,home,0,7,7
6879,2,work,7,13,6
6879,3,home,13,24,11
6879,4,<ENDS>,24,24,0
6880,0,<START>,0,0,0
6880,1,home,0,8,8
6880,2,work,8,13,5
6880,3,home,13,17,4
6880,4,work,17,20,3
6880,5,home,20,24,4
6880,6,<ENDS>,24,24,0
6881,0,<START>,0,0,0
6881,1,home,0,6,6
6881,2,shop,6,7,1
6881,3,home,7,10,3
6881,4,education,10,13,3
6881,5,shop,13,15,2
6881,6,home,15,24,9
6881,7,<ENDS>,24,24,0
6882,0,<START>,0,0,0
6882,1,home,0,6,6
6882,2,work,6,13,7
6882,3,home,13,18,5
6882,4,shop,18,19,1
6882,5,home,19,24,5
6882,6,<ENDS>,24,24,0
6883,0,<START>,0,0,0
6883,1,home,0,6,6
6883,2,shop,6,7,1
6883,3,home,7,10,3
6883,4,education,10,13,3
6883,5,home,13,21,8
6883,6,shop,21,22,1
6883,7,home,22,24,2
6883,8,<ENDS>,24,24,0
6884,0,<START>,0,0,0
6884,1,home,0,7,7
6884,2,work,7,14,7
6884,3,home,14,20,6
6884,4,shop,20,21,1
6884,5,home,21,24,3
6884,6,<ENDS>,24,24,0
6885,0,<START>,0,0,0
6885,1,home,0,8,8
6885,2,work,8,15,7
6885,3,home,15,23,8
6885,4,work,23,24,1
6885,5,<ENDS>,24,24,0
6886,0,<START>,0,0,0
6886,1,home,0,7,7
6886,2,work,7,13,6
6886,3,shop,13,14,1
6886,4,work,14,20,6
6886,5,home,20,24,4
6886,6,<ENDS>,24,24,0
6887,0,<START>,0,0,0
6887,1,home,0,7,7
6887,2,work,7,13,6
6887,3,home,13,17,4
6887,4,work,17,19,2
6887,5,home,19,24,5
6887,6,<ENDS>,24,24,0
6888,0,<START>,0,0,0
6888,1,home,0,7,7
6888,2,work,7,13,6
6888,3,shop,13,14,1
6888,4,work,14,19,5
6888,5,home,19,24,5
6888,6,<ENDS>,24,24,0
6889,0,<START>,0,0,0
6889,1,home,0,8,8
6889,2,work,8,13,5
6889,3,shop,13,15,2
6889,4,home,15,21,6
6889,5,work,21,22,1
6889,6,home,22,24,2
6889,7,<ENDS>,24,24,0
6890,0,<START>,0,0,0
6890,1,home,0,6,6
6890,2,shop,6,7,1
6890,3,home,7,9,2
6890,4,education,9,12,3
6890,5,home,12,18,6
6890,6,shop,18,19,1
6890,7,home,19,24,5
6890,8,<ENDS>,24,24,0
6891,0,<START>,0,0,0
6891,1,home,0,6,6
6891,2,work,6,13,7
6891,3,home,13,18,5
6891,4,shop,18,20,2
6891,5,home,20,24,4
6891,6,<ENDS>,24,24,0
6892,0,<START>,0,0,0
6892,1,home,0,7,7
6892,2,work,7,13,6
6892,3,home,13,24,11
6892,4,<ENDS>,24,24,0
6893,0,<START>,0,0,0
6893,1,home,0,8,8
6893,2,work,8,15,7
6893,3,home,15,24,9
6893,4,<ENDS>,24,24,0
6894,0,<START>,0,0,0
6894,1,home,0,7,7
6894,2,work,7,14,7
6894,3,home,14,23,9
6894,4,work,23,24,1
6894,5,<ENDS>,24,24,0
6895,0,<START>,0,0,0
6895,1,home,0,8,8
6895,2,work,8,15,7
6895,3,home,15,23,8
6895,4,work,23,24,1
6895,5,<ENDS>,24,24,0
6896,0,<START>,0,0,0
6896,1,home,0,6,6
6896,2,work,6,7,1
6896,3,home,7,9,2
6896,4,work,9,11,2
6896,5,home,11,16,5
6896,6,work,16,18,2
6896,7,home,18,22,4
6896,8,work,22,23,1
6896,9,home,23,24,1
6896,10,<ENDS>,24,24,0
6897,0,<START>,0,0,0
6897,1,home,0,7,7
6897,2,work,7,14,7
6897,3,shop,14,15,1
6897,4,work,15,20,5
6897,5,home,20,24,4
6897,6,<ENDS>,24,24,0
6898,0,<START>,0,0,0
6898,1,home,0,7,7
6898,2,shop,7,9,2
6898,3,education,9,15,6
6898,4,shop,15,16,1
6898,5,home,16,24,8
6898,6,<ENDS>,24,24,0
6899,0,<START>,0,0,0
6899,1,home,0,8,8
6899,2,work,8,14,6
6899,3,home,14,24,10
6899,4,<ENDS>,24,24,0
6900,0,<START>,0,0,0
6900,1,home,0,6,6
6900,2,work,6,8,2
6900,3,home,8,14,6
6900,4,work,14,16,2
6900,5,home,16,22,6
6900,6,work,22,23,1
6900,7,home,23,24,1
6900,8,<ENDS>,24,24,0
6901,0,<START>,0,0,0
6901,1,home,0,8,8
6901,2,work,8,14,6
6901,3,home,14,24,10
6901,4,<ENDS>,24,24,0
6902,0,<START>,0,0,0
6902,1,home,0,6,6
6902,2,work,6,13,7
6902,3,shop,13,14,1
6902,4,work,14,19,5
6902,5,home,19,24,5
6902,6,<ENDS>,24,24,0
6903,0,<START>,0,0,0
6903,1,home,0,7,7
6903,2,work,7,13,6
6903,3,home,13,21,8
6903,4,shop,21,22,1
6903,5,home,22,24,2
6903,6,<ENDS>,24,24,0
6904,0,<START>,0,0,0
6904,1,home,0,7,7
6904,2,work,7,14,7
6904,3,home,14,18,4
6904,4,work,18,20,2
6904,5,home,20,24,4
6904,6,<ENDS>,24,24,0
6905,0,<START>,0,0,0
6905,1,home,0,7,7
6905,2,shop,7,8,1
6905,3,home,8,13,5
6905,4,work,13,19,6
6905,5,home,19,24,5
6905,6,<ENDS>,24,24,0
6906,0,<START>,0,0,0
6906,1,home,0,8,8
6906,2,work,8,14,6
6906,3,home,14,18,4
6906,4,shop,18,19,1
6906,5,home,19,21,2
6906,6,work,21,22,1
6906,7,home,22,24,2
6906,8,<ENDS>,24,24,0
6907,0,<START>,0,0,0
6907,1,home,0,7,7
6907,2,work,7,13,6
6907,3,home,13,24,11
6907,4,<ENDS>,24,24,0
6908,0,<START>,0,0,0
6908,1,home,0,7,7
6908,2,work,7,13,6
6908,3,home,13,24,11
6908,4,<ENDS>,24,24,0
6909,0,<START>,0,0,0
6909,1,home,0,7,7
6909,2,work,7,14,7
6909,3,shop,14,15,1
6909,4,home,15,21,6
6909,5,work,21,22,1
6909,6,home,22,24,2
6909,7,<ENDS>,24,24,0
6910,0,<START>,0,0,0
6910,1,home,0,8,8
6910,2,education,8,11,3
6910,3,home,11,18,7
6910,4,shop,18,19,1
6910,5,home,19,24,5
6910,6,<ENDS>,24,24,0
6911,0,<START>,0,0,0
6911,1,home,0,7,7
6911,2,education,7,13,6
6911,3,home,13,19,6
6911,4,shop,19,21,2
6911,5,home,21,24,3
6911,6,<ENDS>,24,24,0
6912,0,<START>,0,0,0
6912,1,home,0,6,6
6912,2,shop,6,7,1
6912,3,work,7,13,6
6912,4,home,13,24,11
6912,5,<ENDS>,24,24,0
6913,0,<START>,0,0,0
6913,1,home,0,6,6
6913,2,work,6,13,7
6913,3,home,13,24,11
6913,4,<ENDS>,24,24,0
6914,0,<START>,0,0,0
6914,1,home,0,8,8
6914,2,work,8,13,5
6914,3,home,13,24,11
6914,4,<ENDS>,24,24,0
6915,0,<START>,0,0,0
6915,1,home,0,8,8
6915,2,work,8,13,5
6915,3,shop,13,14,1
6915,4,home,14,24,10
6915,5,<ENDS>,24,24,0
6916,0,<START>,0,0,0
6916,1,home,0,6,6
6916,2,shop,6,7,1
6916,3,home,7,13,6
6916,4,education,13,16,3
6916,5,home,16,24,8
6916,6,<ENDS>,24,24,0
6917,0,<START>,0,0,0
6917,1,home,0,7,7
6917,2,shop,7,8,1
6917,3,home,8,18,10
6917,4,work,18,20,2
6917,5,home,20,24,4
6917,6,<ENDS>,24,24,0
6918,0,<START>,0,0,0
6918,1,home,0,7,7
6918,2,education,7,11,4
6918,3,home,11,19,8
6918,4,shop,19,21,2
6918,5,home,21,24,3
6918,6,<ENDS>,24,24,0
6919,0,<START>,0,0,0
6919,1,home,0,6,6
6919,2,work,6,13,7
6919,3,home,13,22,9
6919,4,work,22,23,1
6919,5,home,23,24,1
6919,6,<ENDS>,24,24,0
6920,0,<START>,0,0,0
6920,1,home,0,8,8
6920,2,work,8,15,7
6920,3,home,15,24,9
6920,4,<ENDS>,24,24,0
6921,0,<START>,0,0,0
6921,1,home,0,7,7
6921,2,education,7,11,4
6921,3,home,11,18,7
6921,4,shop,18,19,1
6921,5,home,19,24,5
6921,6,<ENDS>,24,24,0
6922,0,<START>,0,0,0
6922,1,home,0,6,6
6922,2,shop,6,7,1
6922,3,home,7,9,2
6922,4,education,9,16,7
6922,5,home,16,24,8
6922,6,<ENDS>,24,24,0
6923,0,<START>,0,0,0
6923,1,home,0,7,7
6923,2,education,7,11,4
6923,3,home,11,18,7
6923,4,shop,18,19,1
6923,5,home,19,24,5
6923,6,<ENDS>,24,24,0
6924,0,<START>,0,0,0
6924,1,home,0,6,6
6924,2,work,6,8,2
6924,3,home,8,10,2
6924,4,work,10,12,2
6924,5,home,12,16,4
6924,6,work,16,18,2
6924,7,home,18,24,6
6924,8,<ENDS>,24,24,0
6925,0,<START>,0,0,0
6925,1,home,0,6,6
6925,2,work,6,12,6
6925,3,shop,12,13,1
6925,4,work,13,19,6
6925,5,home,19,24,5
6925,6,<ENDS>,24,24,0
6926,0,<START>,0,0,0
6926,1,home,0,7,7
6926,2,work,7,14,7
6926,3,shop,14,15,1
6926,4,home,15,16,1
6926,5,work,16,19,3
6926,6,home,19,24,5
6926,7,<ENDS>,24,24,0
6927,0,<START>,0,0,0
6927,1,home,0,6,6
6927,2,shop,6,7,1
6927,3,home,7,9,2
6927,4,education,9,11,2
6927,5,home,11,18,7
6927,6,shop,18,19,1
6927,7,home,19,24,5
6927,8,<ENDS>,24,24,0
6928,0,<START>,0,0,0
6928,1,home,0,6,6
6928,2,shop,6,7,1
6928,3,home,7,8,1
6928,4,education,8,11,3
6928,5,home,11,13,2
6928,6,work,13,19,6
6928,7,home,19,23,4
6928,8,work,23,24,1
6928,9,<ENDS>,24,24,0
6929,0,<START>,0,0,0
6929,1,home,0,8,8
6929,2,education,8,11,3
6929,3,home,11,15,4
6929,4,work,15,20,5
6929,5,home,20,24,4
6929,6,<ENDS>,24,24,0
6930,0,<START>,0,0,0
6930,1,home,0,7,7
6930,2,education,7,12,5
6930,3,home,12,18,6
6930,4,shop,18,19,1
6930,5,home,19,24,5
6930,6,<ENDS>,24,24,0
6931,0,<START>,0,0,0
6931,1,home,0,7,7
6931,2,work,7,13,6
6931,3,home,13,17,4
6931,4,work,17,19,2
6931,5,home,19,24,5
6931,6,<ENDS>,24,24,0
6932,0,<START>,0,0,0
6932,1,home,0,8,8
6932,2,work,8,13,5
6932,3,shop,13,14,1
6932,4,work,14,20,6
6932,5,home,20,24,4
6932,6,<ENDS>,24,24,0
6933,0,<START>,0,0,0
6933,1,home,0,6,6
6933,2,work,6,13,7
6933,3,home,13,24,11
6933,4,<ENDS>,24,24,0
6934,0,<START>,0,0,0
6934,1,home,0,7,7
6934,2,work,7,13,6
6934,3,home,13,24,11
6934,4,<ENDS>,24,24,0
6935,0,<START>,0,0,0
6935,1,home,0,8,8
6935,2,work,8,16,8
6935,3,home,16,21,5
6935,4,work,21,22,1
6935,5,home,22,24,2
6935,6,<ENDS>,24,24,0
6936,0,<START>,0,0,0
6936,1,home,0,6,6
6936,2,work,6,13,7
6936,3,home,13,17,4
6936,4,work,17,20,3
6936,5,home,20,24,4
6936,6,<ENDS>,24,24,0
6937,0,<START>,0,0,0
6937,1,home,0,6,6
6937,2,work,6,12,6
6937,3,shop,12,14,2
6937,4,home,14,20,6
6937,5,shop,20,21,1
6937,6,home,21,24,3
6937,7,<ENDS>,24,24,0
6938,0,<START>,0,0,0
6938,1,home,0,7,7
6938,2,work,7,13,6
6938,3,home,13,14,1
6938,4,shop,14,15,1
6938,5,home,15,21,6
6938,6,work,21,22,1
6938,7,home,22,24,2
6938,8,<ENDS>,24,24,0
6939,0,<START>,0,0,0
6939,1,home,0,6,6
6939,2,work,6,13,7
6939,3,shop,13,14,1
6939,4,work,14,19,5
6939,5,home,19,24,5
6939,6,<ENDS>,24,24,0
6940,0,<START>,0,0,0
6940,1,home,0,8,8
6940,2,education,8,12,4
6940,3,home,12,21,9
6940,4,work,21,22,1
6940,5,home,22,24,2
6940,6,<ENDS>,24,24,0
6941,0,<START>,0,0,0
6941,1,home,0,6,6
6941,2,work,6,8,2
6941,3,home,8,9,1
6941,4,work,9,11,2
6941,5,home,11,16,5
6941,6,work,16,19,3
6941,7,home,19,24,5
6941,8,<ENDS>,24,24,0
6942,0,<START>,0,0,0
6942,1,home,0,6,6
6942,2,work,6,13,7
6942,3,home,13,17,4
6942,4,work,17,20,3
6942,5,home,20,24,4
6942,6,<ENDS>,24,24,0
6943,0,<START>,0,0,0
6943,1,home,0,8,8
6943,2,work,8,15,7
6943,3,home,15,21,6
6943,4,shop,21,22,1
6943,5,home,22,24,2
6943,6,<ENDS>,24,24,0
6944,0,<START>,0,0,0
6944,1,home,0,7,7
6944,2,work,7,15,8
6944,3,home,15,21,6
6944,4,shop,21,22,1
6944,5,home,22,24,2
6944,6,<ENDS>,24,24,0
6945,0,<START>,0,0,0
6945,1,home,0,8,8
6945,2,work,8,13,5
6945,3,home,13,17,4
6945,4,work,17,20,3
6945,5,home,20,24,4
6945,6,<ENDS>,24,24,0
6946,0,<START>,0,0,0
6946,1,home,0,6,6
6946,2,work,6,13,7
6946,3,home,13,21,8
6946,4,work,21,22,1
6946,5,home,22,24,2
6946,6,<ENDS>,24,24,0
6947,0,<START>,0,0,0
6947,1,home,0,6,6
6947,2,work,6,7,1
6947,3,home,7,9,2
6947,4,work,9,11,2
6947,5,home,11,15,4
6947,6,work,15,17,2
6947,7,home,17,24,7
6947,8,<ENDS>,24,24,0
6948,0,<START>,0,0,0
6948,1,home,0,8,8
6948,2,education,8,12,4
6948,3,home,12,24,12
6948,4,<ENDS>,24,24,0
6949,0,<START>,0,0,0
6949,1,home,0,6,6
6949,2,work,6,12,6
6949,3,shop,12,13,1
6949,4,work,13,19,6
6949,5,home,19,24,5
6949,6,<ENDS>,24,24,0
6950,0,<START>,0,0,0
6950,1,home,0,8,8
6950,2,work,8,15,7
6950,3,shop,15,16,1
6950,4,home,16,24,8
6950,5,<ENDS>,24,24,0
6951,0,<START>,0,0,0
6951,1,home,0,8,8
6951,2,work,8,15,7
6951,3,shop,15,16,1
6951,4,home,16,24,8
6951,5,<ENDS>,24,24,0
6952,0,<START>,0,0,0
6952,1,home,0,6,6
6952,2,work,6,13,7
6952,3,home,13,24,11
6952,4,<ENDS>,24,24,0
6953,0,<START>,0,0,0
6953,1,home,0,6,6
6953,2,work,6,13,7
6953,3,shop,13,14,1
6953,4,education,14,18,4
6953,5,home,18,24,6
6953,6,<ENDS>,24,24,0
6954,0,<START>,0,0,0
6954,1,home,0,6,6
6954,2,shop,6,7,1
6954,3,home,7,8,1
6954,4,education,8,11,3
6954,5,home,11,14,3
6954,6,work,14,20,6
6954,7,home,20,24,4
6954,8,<ENDS>,24,24,0
6955,0,<START>,0,0,0
6955,1,home,0,7,7
6955,2,shop,7,8,1
6955,3,home,8,13,5
6955,4,work,13,19,6
6955,5,home,19,24,5
6955,6,<ENDS>,24,24,0
6956,0,<START>,0,0,0
6956,1,home,0,7,7
6956,2,work,7,13,6
6956,3,shop,13,14,1
6956,4,home,14,21,7
6956,5,work,21,22,1
6956,6,home,22,24,2
6956,7,<ENDS>,24,24,0
6957,0,<START>,0,0,0
6957,1,home,0,7,7
6957,2,work,7,13,6
6957,3,shop,13,14,1
6957,4,home,14,17,3
6957,5,work,17,20,3
6957,6,home,20,24,4
6957,7,<ENDS>,24,24,0
6958,0,<START>,0,0,0
6958,1,home,0,8,8
6958,2,work,8,15,7
6958,3,shop,15,16,1
6958,4,home,16,24,8
6958,5,<ENDS>,24,24,0
6959,0,<START>,0,0,0
6959,1,home,0,7,7
6959,2,work,7,14,7
6959,3,home,14,19,5
6959,4,shop,19,20,1
6959,5,home,20,24,4
6959,6,<ENDS>,24,24,0
6960,0,<START>,0,0,0
6960,1,home,0,6,6
6960,2,shop,6,7,1
6960,3,home,7,10,3
6960,4,education,10,13,3
6960,5,shop,13,14,1
6960,6,education,14,16,2
6960,7,home,16,21,5
6960,8,shop,21,22,1
6960,9,home,22,24,2
6960,10,<ENDS>,24,24,0
6961,0,<START>,0,0,0
6961,1,home,0,7,7
6961,2,work,7,14,7
6961,3,home,14,24,10
6961,4,<ENDS>,24,24,0
6962,0,<START>,0,0,0
6962,1,home,0,7,7
6962,2,education,7,11,4
6962,3,home,11,17,6
6962,4,shop,17,19,2
6962,5,home,19,24,5
6962,6,<ENDS>,24,24,0
6963,0,<START>,0,0,0
6963,1,home,0,8,8
6963,2,work,8,12,4
6963,3,shop,12,13,1
6963,4,work,13,19,6
6963,5,home,19,24,5
6963,6,<ENDS>,24,24,0
6964,0,<START>,0,0,0
6964,1,home,0,7,7
6964,2,work,7,13,6
6964,3,shop,13,14,1
6964,4,work,14,20,6
6964,5,home,20,24,4
6964,6,<ENDS>,24,24,0
6965,0,<START>,0,0,0
6965,1,home,0,7,7
6965,2,work,7,14,7
6965,3,shop,14,15,1
6965,4,home,15,24,9
6965,5,<ENDS>,24,24,0
6966,0,<START>,0,0,0
6966,1,home,0,6,6
6966,2,work,6,13,7
6966,3,home,13,24,11
6966,4,<ENDS>,24,24,0
6967,0,<START>,0,0,0
6967,1,home,0,6,6
6967,2,work,6,7,1
6967,3,home,7,8,1
6967,4,work,8,10,2
6967,5,home,10,14,4
6967,6,work,14,16,2
6967,7,home,16,23,7
6967,8,work,23,24,1
6967,9,<ENDS>,24,24,0
6968,0,<START>,0,0,0
6968,1,home,0,6,6
6968,2,work,6,8,2
6968,3,home,8,12,4
6968,4,work,12,14,2
6968,5,shop,14,15,1
6968,6,home,15,21,6
6968,7,work,21,22,1
6968,8,home,22,24,2
6968,9,<ENDS>,24,24,0
6969,0,<START>,0,0,0
6969,1,home,0,7,7
6969,2,work,7,14,7
6969,3,home,14,23,9
6969,4,work,23,24,1
6969,5,<ENDS>,24,24,0
6970,0,<START>,0,0,0
6970,1,home,0,6,6
6970,2,shop,6,7,1
6970,3,home,7,10,3
6970,4,education,10,15,5
6970,5,home,15,24,9
6970,6,<ENDS>,24,24,0
6971,0,<START>,0,0,0
6971,1,home,0,8,8
6971,2,education,8,12,4
6971,3,shop,12,13,1
6971,4,work,13,19,6
6971,5,home,19,24,5
6971,6,<ENDS>,24,24,0
6972,0,<START>,0,0,0
6972,1,home,0,6,6
6972,2,work,6,13,7
6972,3,shop,13,14,1
6972,4,education,14,18,4
6972,5,home,18,23,5
6972,6,work,23,24,1
6972,7,<ENDS>,24,24,0
6973,0,<START>,0,0,0
6973,1,home,0,6,6
6973,2,work,6,13,7
6973,3,home,13,21,8
6973,4,work,21,22,1
6973,5,home,22,24,2
6973,6,<ENDS>,24,24,0
6974,0,<START>,0,0,0
6974,1,home,0,8,8
6974,2,work,8,14,6
6974,3,home,14,24,10
6974,4,<ENDS>,24,24,0
6975,0,<START>,0,0,0
6975,1,home,0,8,8
6975,2,education,8,11,3
6975,3,home,11,19,8
6975,4,shop,19,21,2
6975,5,home,21,24,3
6975,6,<ENDS>,24,24,0
6976,0,<START>,0,0,0
6976,1,home,0,7,7
6976,2,work,7,14,7
6976,3,shop,14,15,1
6976,4,work,15,19,4
6976,5,home,19,24,5
6976,6,<ENDS>,24,24,0
6977,0,<START>,0,0,0
6977,1,home,0,6,6
6977,2,shop,6,7,1
6977,3,home,7,10,3
6977,4,education,10,13,3
6977,5,shop,13,15,2
6977,6,home,15,24,9
6977,7,<ENDS>,24,24,0
6978,0,<START>,0,0,0
6978,1,home,0,8,8
6978,2,education,8,11,3
6978,3,shop,11,12,1
6978,4,education,12,15,3
6978,5,work,15,20,5
6978,6,home,20,24,4
6978,7,<ENDS>,24,24,0
6979,0,<START>,0,0,0
6979,1,home,0,6,6
6979,2,shop,6,7,1
6979,3,home,7,10,3
6979,4,education,10,12,2
6979,5,home,12,16,4
6979,6,shop,16,18,2
6979,7,home,18,24,6
6979,8,<ENDS>,24,24,0
6980,0,<START>,0,0,0
6980,1,home,0,7,7
6980,2,work,7,13,6
6980,3,home,13,20,7
6980,4,shop,20,21,1
6980,5,home,21,24,3
6980,6,<ENDS>,24,24,0
6981,0,<START>,0,0,0
6981,1,home,0,7,7
6981,2,work,7,14,7
6981,3,home,14,21,7
6981,4,work,21,22,1
6981,5,home,22,24,2
6981,6,<ENDS>,24,24,0
6982,0,<START>,0,0,0
6982,1,home,0,6,6
6982,2,work,6,8,2
6982,3,home,8,12,4
6982,4,work,12,14,2
6982,5,home,14,21,7
6982,6,work,21,22,1
6982,7,home,22,24,2
6982,8,<ENDS>,24,24,0
6983,0,<START>,0,0,0
6983,1,home,0,7,7
6983,2,work,7,14,7
6983,3,shop,14,15,1
6983,4,home,15,24,9
6983,5,<ENDS>,24,24,0
6984,0,<START>,0,0,0
6984,1,home,0,7,7
6984,2,shop,7,8,1
6984,3,work,8,17,9
6984,4,home,17,21,4
6984,5,work,21,22,1
6984,6,home,22,24,2
6984,7,<ENDS>,24,24,0
6985,0,<START>,0,0,0
6985,1,home,0,7,7
6985,2,work,7,13,6
6985,3,home,13,24,11
6985,4,<ENDS>,24,24,0
6986,0,<START>,0,0,0
6986,1,home,0,8,8
6986,2,education,8,14,6
6986,3,shop,14,16,2
6986,4,home,16,24,8
6986,5,<ENDS>,24,24,0
6987,0,<START>,0,0,0
6987,1,home,0,8,8
6987,2,work,8,13,5
6987,3,home,13,16,3
6987,4,work,16,20,4
6987,5,home,20,24,4
6987,6,<ENDS>,24,24,0
6988,0,<START>,0,0,0
6988,1,home,0,9,9
6988,2,work,9,17,8
6988,3,home,17,24,7
6988,4,<ENDS>,24,24,0
6989,0,<START>,0,0,0
6989,1,home,0,6,6
6989,2,shop,6,7,1
6989,3,home,7,9,2
6989,4,education,9,11,2
6989,5,home,11,20,9
6989,6,shop,20,21,1
6989,7,home,21,24,3
6989,8,<ENDS>,24,24,0
6990,0,<START>,0,0,0
6990,1,home,0,7,7
6990,2,work,7,13,6
6990,3,shop,13,14,1
6990,4,work,14,20,6
6990,5,home,20,24,4
6990,6,<ENDS>,24,24,0
6991,0,<START>,0,0,0
6991,1,home,0,7,7
6991,2,shop,7,8,1
6991,3,work,8,15,7
6991,4,home,15,21,6
6991,5,work,21,22,1
6991,6,home,22,24,2
6991,7,<ENDS>,24,24,0
6992,0,<START>,0,0,0
6992,1,home,0,6,6
6992,2,work,6,13,7
6992,3,home,13,21,8
6992,4,work,21,22,1
6992,5,home,22,24,2
6992,6,<ENDS>,24,24,0
6993,0,<START>,0,0,0
6993,1,home,0,6,6
6993,2,shop,6,7,1
6993,3,home,7,9,2
6993,4,education,9,11,2
6993,5,home,11,19,8
6993,6,shop,19,20,1
6993,7,home,20,24,4
6993,8,<ENDS>,24,24,0
6994,0,<START>,0,0,0
6994,1,home,0,7,7
6994,2,shop,7,8,1
6994,3,education,8,11,3
6994,4,home,11,15,4
6994,5,shop,15,16,1
6994,6,home,16,20,4
6994,7,shop,20,21,1
6994,8,home,21,24,3
6994,9,<ENDS>,24,24,0
6995,0,<START>,0,0,0
6995,1,home,0,7,7
6995,2,work,7,14,7
6995,3,home,14,23,9
6995,4,work,23,24,1
6995,5,<ENDS>,24,24,0
6996,0,<START>,0,0,0
6996,1,home,0,8,8
6996,2,work,8,15,7
6996,3,shop,15,16,1
6996,4,home,16,24,8
6996,5,<ENDS>,24,24,0
6997,0,<START>,0,0,0
6997,1,home,0,8,8
6997,2,education,8,11,3
6997,3,home,11,17,6
6997,4,shop,17,18,1
6997,5,home,18,24,6
6997,6,<ENDS>,24,24,0
6998,0,<START>,0,0,0
6998,1,home,0,7,7
6998,2,work,7,13,6
6998,3,home,13,17,4
6998,4,work,17,19,2
6998,5,home,19,24,5
6998,6,<ENDS>,24,24,0
6999,0,<START>,0,0,0
6999,1,home,0,9,9
6999,2,work,9,16,7
6999,3,home,16,22,6
6999,4,work,22,23,1
6999,5,home,23,24,1
6999,6,<ENDS>,24,24,0
7000,0,<START>,0,0,0
7000,1,home,0,7,7
7000,2,shop,7,8,1
7000,3,education,8,11,3
7000,4,home,11,17,6
7000,5,shop,17,18,1
7000,6,home,18,24,6
7000,7,<ENDS>,24,24,0
7001,0,<START>,0,0,0
7001,1,home,0,6,6
7001,2,work,6,8,2
7001,3,home,8,9,1
7001,4,work,9,11,2
7001,5,home,11,18,7
7001,6,work,18,19,1
7001,7,home,19,24,5
7001,8,<ENDS>,24,24,0
7002,0,<START>,0,0,0
7002,1,home,0,8,8
7002,2,work,8,14,6
7002,3,home,14,24,10
7002,4,<ENDS>,24,24,0
7003,0,<START>,0,0,0
7003,1,home,0,8,8
7003,2,education,8,12,4
7003,3,home,12,20,8
7003,4,shop,20,21,1
7003,5,home,21,24,3
7003,6,<ENDS>,24,24,0
7004,0,<START>,0,0,0
7004,1,home,0,6,6
7004,2,shop,6,7,1
7004,3,work,7,13,6
7004,4,home,13,24,11
7004,5,<ENDS>,24,24,0
7005,0,<START>,0,0,0
7005,1,home,0,6,6
7005,2,shop,6,7,1
7005,3,home,7,10,3
7005,4,education,10,13,3
7005,5,home,13,21,8
7005,6,shop,21,22,1
7005,7,home,22,24,2
7005,8,<ENDS>,24,24,0
7006,0,<START>,0,0,0
7006,1,home,0,6,6
7006,2,work,6,13,7
7006,3,home,13,19,6
7006,4,shop,19,20,1
7006,5,home,20,24,4
7006,6,<ENDS>,24,24,0
7007,0,<START>,0,0,0
7007,1,home,0,7,7
7007,2,work,7,14,7
7007,3,home,14,15,1
7007,4,work,15,19,4
7007,5,education,19,20,1
7007,6,home,20,24,4
7007,7,<ENDS>,24,24,0
7008,0,<START>,0,0,0
7008,1,home,0,6,6
7008,2,work,6,13,7
7008,3,shop,13,14,1
7008,4,home,14,17,3
7008,5,work,17,20,3
7008,6,home,20,24,4
7008,7,<ENDS>,24,24,0
7009,0,<START>,0,0,0
7009,1,home,0,7,7
7009,2,work,7,13,6
7009,3,home,13,17,4
7009,4,work,17,20,3
7009,5,home,20,24,4
7009,6,<ENDS>,24,24,0
7010,0,<START>,0,0,0
7010,1,home,0,6,6
7010,2,shop,6,7,1
7010,3,home,7,9,2
7010,4,education,9,11,2
7010,5,home,11,18,7
7010,6,shop,18,19,1
7010,7,home,19,24,5
7010,8,<ENDS>,24,24,0
7011,0,<START>,0,0,0
7011,1,home,0,6,6
7011,2,shop,6,7,1
7011,3,home,7,13,6
7011,4,education,13,16,3
7011,5,home,16,24,8
7011,6,<ENDS>,24,24,0
7012,0,<START>,0,0,0
7012,1,home,0,7,7
7012,2,work,7,13,6
7012,3,shop,13,14,1
7012,4,home,14,24,10
7012,5,<ENDS>,24,24,0
7013,0,<START>,0,0,0
7013,1,home,0,9,9
7013,2,work,9,16,7
7013,3,home,16,24,8
7013,4,<ENDS>,24,24,0
7014,0,<START>,0,0,0
7014,1,home,0,8,8
7014,2,shop,8,9,1
7014,3,work,9,16,7
7014,4,home,16,24,8
7014,5,<ENDS>,24,24,0
7015,0,<START>,0,0,0
7015,1,home,0,8,8
7015,2,work,8,16,8
7015,3,home,16,24,8
7015,4,<ENDS>,24,24,0
7016,0,<START>,0,0,0
7016,1,home,0,6,6
7016,2,work,6,13,7
7016,3,home,13,16,3
7016,4,work,16,19,3
7016,5,home,19,24,5
7016,6,<ENDS>,24,24,0
7017,0,<START>,0,0,0
7017,1,home,0,7,7
7017,2,work,7,13,6
7017,3,home,13,23,10
7017,4,work,23,24,1
7017,5,<ENDS>,24,24,0
7018,0,<START>,0,0,0
7018,1,home,0,8,8
7018,2,work,8,15,7
7018,3,home,15,22,7
7018,4,work,22,23,1
7018,5,home,23,24,1
7018,6,<ENDS>,24,24,0
7019,0,<START>,0,0,0
7019,1,home,0,7,7
7019,2,work,7,13,6
7019,3,shop,13,14,1
7019,4,home,14,18,4
7019,5,work,18,20,2
7019,6,home,20,24,4
7019,7,<ENDS>,24,24,0
7020,0,<START>,0,0,0
7020,1,home,0,8,8
7020,2,work,8,14,6
7020,3,home,14,24,10
7020,4,<ENDS>,24,24,0
7021,0,<START>,0,0,0
7021,1,home,0,6,6
7021,2,work,6,8,2
7021,3,home,8,14,6
7021,4,work,14,16,2
7021,5,home,16,24,8
7021,6,<ENDS>,24,24,0
7022,0,<START>,0,0,0
7022,1,home,0,8,8
7022,2,work,8,14,6
7022,3,shop,14,15,1
7022,4,home,15,21,6
7022,5,work,21,22,1
7022,6,home,22,24,2
7022,7,<ENDS>,24,24,0
7023,0,<START>,0,0,0
7023,1,home,0,8,8
7023,2,work,8,14,6
7023,3,shop,14,15,1
7023,4,home,15,24,9
7023,5,<ENDS>,24,24,0
7024,0,<START>,0,0,0
7024,1,home,0,7,7
7024,2,education,7,12,5
7024,3,home,12,21,9
7024,4,shop,21,22,1
7024,5,home,22,24,2
7024,6,<ENDS>,24,24,0
7025,0,<START>,0,0,0
7025,1,home,0,8,8
7025,2,work,8,14,6
7025,3,shop,14,15,1
7025,4,home,15,24,9
7025,5,<ENDS>,24,24,0
7026,0,<START>,0,0,0
7026,1,home,0,7,7
7026,2,education,7,12,5
7026,3,shop,12,13,1
7026,4,education,13,14,1
7026,5,shop,14,15,1
7026,6,home,15,24,9
7026,7,<ENDS>,24,24,0
7027,0,<START>,0,0,0
7027,1,home,0,6,6
7027,2,shop,6,7,1
7027,3,work,7,9,2
7027,4,home,9,13,4
7027,5,work,13,16,3
7027,6,home,16,22,6
7027,7,work,22,23,1
7027,8,home,23,24,1
7027,9,<ENDS>,24,24,0
7028,0,<START>,0,0,0
7028,1,home,0,7,7
7028,2,work,7,9,2
7028,3,home,9,14,5
7028,4,work,14,16,2
7028,5,home,16,23,7
7028,6,work,23,24,1
7028,7,<ENDS>,24,24,0
7029,0,<START>,0,0,0
7029,1,home,0,7,7
7029,2,work,7,13,6
7029,3,home,13,24,11
7029,4,<ENDS>,24,24,0
7030,0,<START>,0,0,0
7030,1,home,0,6,6
7030,2,work,6,13,7
7030,3,home,13,18,5
7030,4,shop,18,19,1
7030,5,home,19,24,5
7030,6,<ENDS>,24,24,0
7031,0,<START>,0,0,0
7031,1,home,0,7,7
7031,2,shop,7,8,1
7031,3,work,8,15,7
7031,4,home,15,24,9
7031,5,<ENDS>,24,24,0
7032,0,<START>,0,0,0
7032,1,home,0,7,7
7032,2,shop,7,8,1
7032,3,education,8,11,3
7032,4,home,11,15,4
7032,5,shop,15,16,1
7032,6,home,16,24,8
7032,7,<ENDS>,24,24,0
7033,0,<START>,0,0,0
7033,1,home,0,8,8
7033,2,work,8,15,7
7033,3,home,15,21,6
7033,4,work,21,22,1
7033,5,home,22,24,2
7033,6,<ENDS>,24,24,0
7034,0,<START>,0,0,0
7034,1,home,0,8,8
7034,2,work,8,16,8
7034,3,home,16,17,1
7034,4,work,17,20,3
7034,5,home,20,24,4
7034,6,<ENDS>,24,24,0
7035,0,<START>,0,0,0
7035,1,home,0,7,7
7035,2,work,7,9,2
7035,3,home,9,13,4
7035,4,shop,13,14,1
7035,5,work,14,16,2
7035,6,home,16,23,7
7035,7,work,23,24,1
7035,8,<ENDS>,24,24,0
7036,0,<START>,0,0,0
7036,1,home,0,8,8
7036,2,education,8,11,3
7036,3,home,11,19,8
7036,4,shop,19,20,1
7036,5,home,20,24,4
7036,6,<ENDS>,24,24,0
7037,0,<START>,0,0,0
7037,1,home,0,6,6
7037,2,work,6,13,7
7037,3,home,13,24,11
7037,4,<ENDS>,24,24,0
7038,0,<START>,0,0,0
7038,1,home,0,7,7
7038,2,work,7,13,6
7038,3,home,13,17,4
7038,4,work,17,18,1
7038,5,home,18,24,6
7038,6,<ENDS>,24,24,0
7039,0,<START>,0,0,0
7039,1,home,0,7,7
7039,2,work,7,13,6
7039,3,home,13,24,11
7039,4,<ENDS>,24,24,0
7040,0,<START>,0,0,0
7040,1,home,0,7,7
7040,2,work,7,13,6
7040,3,shop,13,14,1
7040,4,home,14,24,10
7040,5,<ENDS>,24,24,0
7041,0,<START>,0,0,0
7041,1,home,0,7,7
7041,2,education,7,11,4
7041,3,home,11,18,7
7041,4,shop,18,19,1
7041,5,home,19,24,5
7041,6,<ENDS>,24,24,0
7042,0,<START>,0,0,0
7042,1,home,0,8,8
7042,2,work,8,16,8
7042,3,home,16,24,8
7042,4,<ENDS>,24,24,0
7043,0,<START>,0,0,0
7043,1,home,0,7,7
7043,2,education,7,13,6
7043,3,home,13,20,7
7043,4,shop,20,21,1
7043,5,home,21,24,3
7043,6,<ENDS>,24,24,0
7044,0,<START>,0,0,0
7044,1,home,0,8,8
7044,2,work,8,15,7
7044,3,home,15,24,9
7044,4,<ENDS>,24,24,0
7045,0,<START>,0,0,0
7045,1,home,0,6,6
7045,2,shop,6,7,1
7045,3,home,7,10,3
7045,4,education,10,13,3
7045,5,shop,13,15,2
7045,6,home,15,24,9
7045,7,<ENDS>,24,24,0
7046,0,<START>,0,0,0
7046,1,home,0,7,7
7046,2,work,7,15,8
7046,3,shop,15,16,1
7046,4,home,16,24,8
7046,5,<ENDS>,24,24,0
7047,0,<START>,0,0,0
7047,1,home,0,8,8
7047,2,education,8,11,3
7047,3,home,11,21,10
7047,4,shop,21,22,1
7047,5,home,22,24,2
7047,6,<ENDS>,24,24,0
7048,0,<START>,0,0,0
7048,1,home,0,7,7
7048,2,education,7,12,5
7048,3,shop,12,14,2
7048,4,education,14,17,3
7048,5,home,17,24,7
7048,6,<ENDS>,24,24,0
7049,0,<START>,0,0,0
7049,1,home,0,6,6
7049,2,work,6,12,6
7049,3,shop,12,13,1
7049,4,work,13,19,6
7049,5,home,19,24,5
7049,6,<ENDS>,24,24,0
7050,0,<START>,0,0,0
7050,1,home,0,7,7
7050,2,work,7,13,6
7050,3,home,13,18,5
7050,4,work,18,20,2
7050,5,home,20,24,4
7050,6,<ENDS>,24,24,0
7051,0,<START>,0,0,0
7051,1,home,0,6,6
7051,2,work,6,13,7
7051,3,home,13,23,10
7051,4,work,23,24,1
7051,5,<ENDS>,24,24,0
7052,0,<START>,0,0,0
7052,1,home,0,7,7
7052,2,work,7,13,6
7052,3,home,13,24,11
7052,4,<ENDS>,24,24,0
7053,0,<START>,0,0,0
7053,1,home,0,8,8
7053,2,work,8,10,2
7053,3,home,10,16,6
7053,4,work,16,18,2
7053,5,home,18,24,6
7053,6,<ENDS>,24,24,0
7054,0,<START>,0,0,0
7054,1,home,0,7,7
7054,2,work,7,14,7
7054,3,shop,14,16,2
7054,4,home,16,24,8
7054,5,<ENDS>,24,24,0
7055,0,<START>,0,0,0
7055,1,home,0,6,6
7055,2,shop,6,7,1
7055,3,work,7,13,6
7055,4,home,13,17,4
7055,5,work,17,19,2
7055,6,education,19,20,1
7055,7,home,20,24,4
7055,8,<ENDS>,24,24,0
7056,0,<START>,0,0,0
7056,1,home,0,8,8
7056,2,work,8,15,7
7056,3,home,15,24,9
7056,4,<ENDS>,24,24,0
7057,0,<START>,0,0,0
7057,1,home,0,7,7
7057,2,education,7,13,6
7057,3,home,13,20,7
7057,4,shop,20,21,1
7057,5,home,21,24,3
7057,6,<ENDS>,24,24,0
7058,0,<START>,0,0,0
7058,1,home,0,8,8
7058,2,education,8,11,3
7058,3,home,11,18,7
7058,4,shop,18,19,1
7058,5,home,19,24,5
7058,6,<ENDS>,24,24,0
7059,0,<START>,0,0,0
7059,1,home,0,6,6
7059,2,shop,6,7,1
7059,3,work,7,14,7
7059,4,home,14,24,10
7059,5,<ENDS>,24,24,0
7060,0,<START>,0,0,0
7060,1,home,0,6,6
7060,2,work,6,13,7
7060,3,shop,13,14,1
7060,4,education,14,16,2
7060,5,home,16,24,8
7060,6,<ENDS>,24,24,0
7061,0,<START>,0,0,0
7061,1,home,0,6,6
7061,2,shop,6,7,1
7061,3,home,7,10,3
7061,4,education,10,13,3
7061,5,shop,13,15,2
7061,6,home,15,24,9
7061,7,<ENDS>,24,24,0
7062,0,<START>,0,0,0
7062,1,home,0,7,7
7062,2,education,7,11,4
7062,3,home,11,18,7
7062,4,shop,18,19,1
7062,5,home,19,24,5
7062,6,<ENDS>,24,24,0
7063,0,<START>,0,0,0
7063,1,home,0,8,8
7063,2,work,8,15,7
7063,3,home,15,24,9
7063,4,<ENDS>,24,24,0
7064,0,<START>,0,0,0
7064,1,home,0,8,8
7064,2,shop,8,9,1
7064,3,home,9,14,5
7064,4,work,14,19,5
7064,5,home,19,23,4
7064,6,work,23,24,1
7064,7,<ENDS>,24,24,0
7065,0,<START>,0,0,0
7065,1,home,0,7,7
7065,2,work,7,14,7
7065,3,shop,14,15,1
7065,4,work,15,20,5
7065,5,home,20,24,4
7065,6,<ENDS>,24,24,0
7066,0,<START>,0,0,0
7066,1,home,0,7,7
7066,2,work,7,9,2
7066,3,home,9,13,4
7066,4,work,13,15,2
7066,5,home,15,23,8
7066,6,work,23,24,1
7066,7,<ENDS>,24,24,0
7067,0,<START>,0,0,0
7067,1,home,0,7,7
7067,2,education,7,11,4
7067,3,home,11,16,5
7067,4,shop,16,17,1
7067,5,home,17,24,7
7067,6,<ENDS>,24,24,0
7068,0,<START>,0,0,0
7068,1,home,0,7,7
7068,2,education,7,12,5
7068,3,shop,12,14,2
7068,4,education,14,16,2
7068,5,shop,16,17,1
7068,6,home,17,24,7
7068,7,<ENDS>,24,24,0
7069,0,<START>,0,0,0
7069,1,home,0,8,8
7069,2,work,8,13,5
7069,3,home,13,24,11
7069,4,<ENDS>,24,24,0
7070,0,<START>,0,0,0
7070,1,home,0,9,9
7070,2,work,9,15,6
7070,3,home,15,24,9
7070,4,<ENDS>,24,24,0
7071,0,<START>,0,0,0
7071,1,home,0,6,6
7071,2,shop,6,7,1
7071,3,home,7,13,6
7071,4,education,13,16,3
7071,5,shop,16,17,1
7071,6,home,17,19,2
7071,7,shop,19,20,1
7071,8,home,20,24,4
7071,9,<ENDS>,24,24,0
7072,0,<START>,0,0,0
7072,1,work,0,8,8
7072,2,shop,8,9,1
7072,3,home,9,14,5
7072,4,work,14,19,5
7072,5,home,19,24,5
7072,6,<ENDS>,24,24,0
7073,0,<START>,0,0,0
7073,1,home,0,6,6
7073,2,shop,6,7,1
7073,3,home,7,9,2
7073,4,education,9,11,2
7073,5,home,11,17,6
7073,6,shop,17,18,1
7073,7,home,18,24,6
7073,8,<ENDS>,24,24,0
7074,0,<START>,0,0,0
7074,1,home,0,7,7
7074,2,work,7,9,2
7074,3,home,9,14,5
7074,4,work,14,17,3
7074,5,home,17,23,6
7074,6,work,23,24,1
7074,7,<ENDS>,24,24,0
7075,0,<START>,0,0,0
7075,1,home,0,7,7
7075,2,shop,7,9,2
7075,3,education,9,12,3
7075,4,shop,12,13,1
7075,5,education,13,16,3
7075,6,home,16,24,8
7075,7,<ENDS>,24,24,0
7076,0,<START>,0,0,0
7076,1,home,0,6,6
7076,2,work,6,8,2
7076,3,home,8,14,6
7076,4,work,14,16,2
7076,5,home,16,22,6
7076,6,work,22,23,1
7076,7,home,23,24,1
7076,8,<ENDS>,24,24,0
7077,0,<START>,0,0,0
7077,1,home,0,8,8
7077,2,work,8,15,7
7077,3,home,15,24,9
7077,4,<ENDS>,24,24,0
7078,0,<START>,0,0,0
7078,1,home,0,9,9
7078,2,work,9,16,7
7078,3,shop,16,17,1
7078,4,home,17,24,7
7078,5,<ENDS>,24,24,0
7079,0,<START>,0,0,0
7079,1,home,0,7,7
7079,2,education,7,12,5
7079,3,home,12,20,8
7079,4,shop,20,21,1
7079,5,home,21,24,3
7079,6,<ENDS>,24,24,0
7080,0,<START>,0,0,0
7080,1,home,0,7,7
7080,2,work,7,14,7
7080,3,shop,14,15,1
7080,4,home,15,24,9
7080,5,<ENDS>,24,24,0
7081,0,<START>,0,0,0
7081,1,home,0,7,7
7081,2,education,7,11,4
7081,3,home,11,18,7
7081,4,shop,18,19,1
7081,5,home,19,24,5
7081,6,<ENDS>,24,24,0
7082,0,<START>,0,0,0
7082,1,home,0,8,8
7082,2,work,8,17,9
7082,3,home,17,24,7
7082,4,<ENDS>,24,24,0
7083,0,<START>,0,0,0
7083,1,home,0,6,6
7083,2,work,6,8,2
7083,3,home,8,14,6
7083,4,work,14,16,2
7083,5,home,16,22,6
7083,6,work,22,23,1
7083,7,home,23,24,1
7083,8,<ENDS>,24,24,0
7084,0,<START>,0,0,0
7084,1,home,0,7,7
7084,2,education,7,11,4
7084,3,home,11,17,6
7084,4,shop,17,18,1
7084,5,home,18,24,6
7084,6,<ENDS>,24,24,0
7085,0,<START>,0,0,0
7085,1,home,0,7,7
7085,2,work,7,14,7
7085,3,shop,14,15,1
7085,4,work,15,20,5
7085,5,home,20,24,4
7085,6,<ENDS>,24,24,0
7086,0,<START>,0,0,0
7086,1,home,0,8,8
7086,2,work,8,15,7
7086,3,home,15,24,9
7086,4,<ENDS>,24,24,0
7087,0,<START>,0,0,0
7087,1,home,0,7,7
7087,2,work,7,14,7
7087,3,home,14,24,10
7087,4,<ENDS>,24,24,0
7088,0,<START>,0,0,0
7088,1,home,0,7,7
7088,2,education,7,11,4
7088,3,home,11,14,3
7088,4,education,14,16,2
7088,5,home,16,24,8
7088,6,<ENDS>,24,24,0
7089,0,<START>,0,0,0
7089,1,home,0,6,6
7089,2,work,6,13,7
7089,3,shop,13,14,1
7089,4,work,14,20,6
7089,5,home,20,24,4
7089,6,<ENDS>,24,24,0
7090,0,<START>,0,0,0
7090,1,home,0,7,7
7090,2,work,7,14,7
7090,3,home,14,24,10
7090,4,<ENDS>,24,24,0
7091,0,<START>,0,0,0
7091,1,home,0,7,7
7091,2,shop,7,8,1
7091,3,work,8,15,7
7091,4,shop,15,16,1
7091,5,work,16,20,4
7091,6,home,20,24,4
7091,7,<ENDS>,24,24,0
7092,0,<START>,0,0,0
7092,1,home,0,6,6
7092,2,shop,6,7,1
7092,3,home,7,13,6
7092,4,education,13,16,3
7092,5,home,16,24,8
7092,6,<ENDS>,24,24,0
7093,0,<START>,0,0,0
7093,1,home,0,7,7
7093,2,work,7,13,6
7093,3,home,13,17,4
7093,4,work,17,20,3
7093,5,home,20,24,4
7093,6,<ENDS>,24,24,0
7094,0,<START>,0,0,0
7094,1,home,0,7,7
7094,2,shop,7,8,1
7094,3,home,8,12,4
7094,4,work,12,19,7
7094,5,home,19,23,4
7094,6,work,23,24,1
7094,7,<ENDS>,24,24,0
7095,0,<START>,0,0,0
7095,1,home,0,8,8
7095,2,work,8,15,7
7095,3,shop,15,16,1
7095,4,work,16,20,4
7095,5,home,20,24,4
7095,6,<ENDS>,24,24,0
7096,0,<START>,0,0,0
7096,1,home,0,7,7
7096,2,work,7,15,8
7096,3,home,15,24,9
7096,4,<ENDS>,24,24,0
7097,0,<START>,0,0,0
7097,1,home,0,8,8
7097,2,work,8,15,7
7097,3,home,15,24,9
7097,4,<ENDS>,24,24,0
7098,0,<START>,0,0,0
7098,1,home,0,6,6
7098,2,shop,6,7,1
7098,3,home,7,9,2
7098,4,education,9,12,3
7098,5,home,12,18,6
7098,6,shop,18,20,2
7098,7,home,20,24,4
7098,8,<ENDS>,24,24,0
7099,0,<START>,0,0,0
7099,1,home,0,7,7
7099,2,work,7,14,7
7099,3,shop,14,15,1
7099,4,home,15,24,9
7099,5,<ENDS>,24,24,0
7100,0,<START>,0,0,0
7100,1,home,0,6,6
7100,2,shop,6,7,1
7100,3,home,7,9,2
7100,4,education,9,12,3
7100,5,shop,12,14,2
7100,6,education,14,16,2
7100,7,home,16,24,8
7100,8,<ENDS>,24,24,0
7101,0,<START>,0,0,0
7101,1,home,0,8,8
7101,2,work,8,15,7
7101,3,home,15,24,9
7101,4,<ENDS>,24,24,0
7102,0,<START>,0,0,0
7102,1,home,0,7,7
7102,2,work,7,15,8
7102,3,home,15,24,9
7102,4,<ENDS>,24,24,0
7103,0,<START>,0,0,0
7103,1,home,0,6,6
7103,2,work,6,13,7
7103,3,home,13,17,4
7103,4,shop,17,18,1
7103,5,home,18,24,6
7103,6,<ENDS>,24,24,0
7104,0,<START>,0,0,0
7104,1,home,0,8,8
7104,2,work,8,14,6
7104,3,home,14,24,10
7104,4,<ENDS>,24,24,0
7105,0,<START>,0,0,0
7105,1,home,0,6,6
7105,2,work,6,13,7
7105,3,shop,13,14,1
7105,4,home,14,23,9
7105,5,work,23,24,1
7105,6,<ENDS>,24,24,0
7106,0,<START>,0,0,0
7106,1,home,0,8,8
7106,2,work,8,14,6
7106,3,shop,14,15,1
7106,4,home,15,24,9
7106,5,<ENDS>,24,24,0
7107,0,<START>,0,0,0
7107,1,home,0,7,7
7107,2,work,7,8,1
7107,3,home,8,14,6
7107,4,work,14,16,2
7107,5,home,16,22,6
7107,6,work,22,23,1
7107,7,home,23,24,1
7107,8,<ENDS>,24,24,0
7108,0,<START>,0,0,0
7108,1,home,0,7,7
7108,2,work,7,13,6
7108,3,home,13,24,11
7108,4,<ENDS>,24,24,0
7109,0,<START>,0,0,0
7109,1,home,0,6,6
7109,2,shop,6,7,1
7109,3,home,7,11,4
7109,4,work,11,18,7
7109,5,home,18,24,6
7109,6,<ENDS>,24,24,0
7110,0,<START>,0,0,0
7110,1,home,0,9,9
7110,2,work,9,16,7
7110,3,home,16,21,5
7110,4,work,21,22,1
7110,5,home,22,24,2
7110,6,<ENDS>,24,24,0
7111,0,<START>,0,0,0
7111,1,home,0,6,6
7111,2,work,6,13,7
7111,3,shop,13,14,1
7111,4,work,14,19,5
7111,5,home,19,24,5
7111,6,<ENDS>,24,24,0
7112,0,<START>,0,0,0
7112,1,home,0,6,6
7112,2,work,6,13,7
7112,3,shop,13,14,1
7112,4,work,14,20,6
7112,5,home,20,24,4
7112,6,<ENDS>,24,24,0
7113,0,<START>,0,0,0
7113,1,home,0,8,8
7113,2,work,8,14,6
7113,3,home,14,24,10
7113,4,<ENDS>,24,24,0
7114,0,<START>,0,0,0
7114,1,home,0,7,7
7114,2,work,7,14,7
7114,3,home,14,24,10
7114,4,<ENDS>,24,24,0
7115,0,<START>,0,0,0
7115,1,home,0,6,6
7115,2,work,6,8,2
7115,3,home,8,13,5
7115,4,work,13,15,2
7115,5,home,15,22,7
7115,6,work,22,23,1
7115,7,home,23,24,1
7115,8,<ENDS>,24,24,0
7116,0,<START>,0,0,0
7116,1,home,0,6,6
7116,2,shop,6,7,1
7116,3,home,7,13,6
7116,4,education,13,16,3
7116,5,home,16,24,8
7116,6,<ENDS>,24,24,0
7117,0,<START>,0,0,0
7117,1,home,0,8,8
7117,2,work,8,14,6
7117,3,home,14,21,7
7117,4,work,21,22,1
7117,5,home,22,24,2
7117,6,<ENDS>,24,24,0
7118,0,<START>,0,0,0
7118,1,home,0,8,8
7118,2,work,8,14,6
7118,3,shop,14,15,1
7118,4,work,15,19,4
7118,5,home,19,24,5
7118,6,<ENDS>,24,24,0
7119,0,<START>,0,0,0
7119,1,home,0,6,6
7119,2,work,6,13,7
7119,3,home,13,21,8
7119,4,work,21,22,1
7119,5,home,22,24,2
7119,6,<ENDS>,24,24,0
7120,0,<START>,0,0,0
7120,1,home,0,7,7
7120,2,education,7,12,5
7120,3,shop,12,14,2
7120,4,home,14,24,10
7120,5,<ENDS>,24,24,0
7121,0,<START>,0,0,0
7121,1,home,0,8,8
7121,2,work,8,15,7
7121,3,home,15,24,9
7121,4,<ENDS>,24,24,0
7122,0,<START>,0,0,0
7122,1,home,0,8,8
7122,2,work,8,15,7
7122,3,shop,15,16,1
7122,4,home,16,24,8
7122,5,<ENDS>,24,24,0
7123,0,<START>,0,0,0
7123,1,home,0,6,6
7123,2,shop,6,7,1
7123,3,home,7,12,5
7123,4,education,12,16,4
7123,5,home,16,24,8
7123,6,<ENDS>,24,24,0
7124,0,<START>,0,0,0
7124,1,home,0,7,7
7124,2,work,7,13,6
7124,3,shop,13,14,1
7124,4,work,14,19,5
7124,5,home,19,24,5
7124,6,<ENDS>,24,24,0
7125,0,<START>,0,0,0
7125,1,home,0,7,7
7125,2,work,7,13,6
7125,3,shop,13,14,1
7125,4,work,14,17,3
7125,5,home,17,24,7
7125,6,<ENDS>,24,24,0
7126,0,<START>,0,0,0
7126,1,home,0,7,7
7126,2,work,7,13,6
7126,3,shop,13,14,1
7126,4,home,14,18,4
7126,5,work,18,20,2
7126,6,home,20,24,4
7126,7,<ENDS>,24,24,0
7127,0,<START>,0,0,0
7127,1,home,0,6,6
7127,2,work,6,13,7
7127,3,home,13,24,11
7127,4,<ENDS>,24,24,0
7128,0,<START>,0,0,0
7128,1,home,0,7,7
7128,2,work,7,14,7
7128,3,home,14,24,10
7128,4,<ENDS>,24,24,0
7129,0,<START>,0,0,0
7129,1,home,0,6,6
7129,2,work,6,8,2
7129,3,home,8,12,4
7129,4,work,12,14,2
7129,5,home,14,21,7
7129,6,work,21,22,1
7129,7,home,22,24,2
7129,8,<ENDS>,24,24,0
7130,0,<START>,0,0,0
7130,1,home,0,7,7
7130,2,work,7,14,7
7130,3,home,14,24,10
7130,4,<ENDS>,24,24,0
7131,0,<START>,0,0,0
7131,1,home,0,8,8
7131,2,work,8,14,6
7131,3,home,14,24,10
7131,4,<ENDS>,24,24,0
7132,0,<START>,0,0,0
7132,1,home,0,8,8
7132,2,shop,8,9,1
7132,3,education,9,12,3
7132,4,shop,12,13,1
7132,5,home,13,20,7
7132,6,shop,20,21,1
7132,7,home,21,24,3
7132,8,<ENDS>,24,24,0
7133,0,<START>,0,0,0
7133,1,home,0,7,7
7133,2,work,7,14,7
7133,3,home,14,24,10
7133,4,<ENDS>,24,24,0
7134,0,<START>,0,0,0
7134,1,home,0,7,7
7134,2,work,7,13,6
7134,3,home,13,16,3
7134,4,work,16,20,4
7134,5,home,20,24,4
7134,6,<ENDS>,24,24,0
7135,0,<START>,0,0,0
7135,1,home,0,6,6
7135,2,work,6,7,1
7135,3,home,7,9,2
7135,4,work,9,11,2
7135,5,home,11,18,7
7135,6,work,18,19,1
7135,7,home,19,23,4
7135,8,work,23,24,1
7135,9,<ENDS>,24,24,0
7136,0,<START>,0,0,0
7136,1,home,0,8,8
7136,2,work,8,15,7
7136,3,home,15,24,9
7136,4,<ENDS>,24,24,0
7137,0,<START>,0,0,0
7137,1,home,0,7,7
7137,2,work,7,14,7
7137,3,home,14,24,10
7137,4,<ENDS>,24,24,0
7138,0,<START>,0,0,0
7138,1,home,0,8,8
7138,2,work,8,15,7
7138,3,home,15,24,9
7138,4,<ENDS>,24,24,0
7139,0,<START>,0,0,0
7139,1,home,0,9,9
7139,2,work,9,15,6
7139,3,home,15,24,9
7139,4,<ENDS>,24,24,0
7140,0,<START>,0,0,0
7140,1,home,0,6,6
7140,2,shop,6,7,1
7140,3,home,7,13,6
7140,4,education,13,16,3
7140,5,home,16,24,8
7140,6,<ENDS>,24,24,0
7141,0,<START>,0,0,0
7141,1,home,0,7,7
7141,2,education,7,12,5
7141,3,shop,12,14,2
7141,4,education,14,16,2
7141,5,shop,16,17,1
7141,6,home,17,24,7
7141,7,<ENDS>,24,24,0
7142,0,<START>,0,0,0
7142,1,home,0,7,7
7142,2,work,7,14,7
7142,3,home,14,24,10
7142,4,<ENDS>,24,24,0
7143,0,<START>,0,0,0
7143,1,home,0,7,7
7143,2,shop,7,8,1
7143,3,home,8,9,1
7143,4,work,9,17,8
7143,5,home,17,24,7
7143,6,<ENDS>,24,24,0
7144,0,<START>,0,0,0
7144,1,home,0,6,6
7144,2,shop,6,7,1
7144,3,home,7,13,6
7144,4,education,13,16,3
7144,5,home,16,21,5
7144,6,shop,21,22,1
7144,7,home,22,24,2
7144,8,<ENDS>,24,24,0
7145,0,<START>,0,0,0
7145,1,home,0,8,8
7145,2,work,8,15,7
7145,3,home,15,24,9
7145,4,<ENDS>,24,24,0
7146,0,<START>,0,0,0
7146,1,home,0,6,6
7146,2,shop,6,7,1
7146,3,home,7,9,2
7146,4,education,9,12,3
7146,5,shop,12,14,2
7146,6,education,14,16,2
7146,7,shop,16,17,1
7146,8,home,17,24,7
7146,9,<ENDS>,24,24,0
7147,0,<START>,0,0,0
7147,1,home,0,7,7
7147,2,work,7,14,7
7147,3,shop,14,15,1
7147,4,work,15,20,5
7147,5,home,20,24,4
7147,6,<ENDS>,24,24,0
7148,0,<START>,0,0,0
7148,1,home,0,6,6
7148,2,work,6,13,7
7148,3,shop,13,14,1
7148,4,home,14,21,7
7148,5,work,21,22,1
7148,6,home,22,24,2
7148,7,<ENDS>,24,24,0
7149,0,<START>,0,0,0
7149,1,home,0,7,7
7149,2,shop,7,8,1
7149,3,home,8,9,1
7149,4,work,9,14,5
7149,5,home,14,24,10
7149,6,<ENDS>,24,24,0
7150,0,<START>,0,0,0
7150,1,home,0,9,9
7150,2,work,9,17,8
7150,3,home,17,23,6
7150,4,work,23,24,1
7150,5,<ENDS>,24,24,0
7151,0,<START>,0,0,0
7151,1,home,0,6,6
7151,2,work,6,8,2
7151,3,home,8,14,6
7151,4,work,14,16,2
7151,5,home,16,24,8
7151,6,<ENDS>,24,24,0
7152,0,<START>,0,0,0
7152,1,home,0,7,7
7152,2,work,7,14,7
7152,3,home,14,18,4
7152,4,work,18,20,2
7152,5,home,20,24,4
7152,6,<ENDS>,24,24,0
7153,0,<START>,0,0,0
7153,1,home,0,8,8
7153,2,education,8,13,5
7153,3,shop,13,14,1
7153,4,home,14,21,7
7153,5,work,21,22,1
7153,6,home,22,24,2
7153,7,<ENDS>,24,24,0
7154,0,<START>,0,0,0
7154,1,home,0,9,9
7154,2,work,9,17,8
7154,3,home,17,22,5
7154,4,work,22,23,1
7154,5,home,23,24,1
7154,6,<ENDS>,24,24,0
7155,0,<START>,0,0,0
7155,1,home,0,6,6
7155,2,work,6,8,2
7155,3,home,8,12,4
7155,4,work,12,14,2
7155,5,home,14,21,7
7155,6,work,21,22,1
7155,7,home,22,24,2
7155,8,<ENDS>,24,24,0
7156,0,<START>,0,0,0
7156,1,home,0,7,7
7156,2,work,7,14,7
7156,3,home,14,18,4
7156,4,work,18,20,2
7156,5,home,20,24,4
7156,6,<ENDS>,24,24,0
7157,0,<START>,0,0,0
7157,1,home,0,6,6
7157,2,work,6,13,7
7157,3,home,13,24,11
7157,4,<ENDS>,24,24,0
7158,0,<START>,0,0,0
7158,1,home,0,8,8
7158,2,work,8,15,7
7158,3,home,15,22,7
7158,4,work,22,23,1
7158,5,home,23,24,1
7158,6,<ENDS>,24,24,0
7159,0,<START>,0,0,0
7159,1,home,0,8,8
7159,2,education,8,11,3
7159,3,shop,11,12,1
7159,4,education,12,16,4
7159,5,shop,16,17,1
7159,6,home,17,24,7
7159,7,<ENDS>,24,24,0
7160,0,<START>,0,0,0
7160,1,home,0,6,6
7160,2,work,6,13,7
7160,3,shop,13,14,1
7160,4,work,14,20,6
7160,5,home,20,24,4
7160,6,<ENDS>,24,24,0
7161,0,<START>,0,0,0
7161,1,home,0,7,7
7161,2,education,7,11,4
7161,3,home,11,18,7
7161,4,shop,18,20,2
7161,5,home,20,24,4
7161,6,<ENDS>,24,24,0
7162,0,<START>,0,0,0
7162,1,home,0,6,6
7162,2,work,6,8,2
7162,3,home,8,12,4
7162,4,work,12,14,2
7162,5,home,14,16,2
7162,6,work,16,18,2
7162,7,home,18,23,5
7162,8,work,23,24,1
7162,9,<ENDS>,24,24,0
7163,0,<START>,0,0,0
7163,1,home,0,7,7
7163,2,work,7,14,7
7163,3,home,14,23,9
7163,4,work,23,24,1
7163,5,<ENDS>,24,24,0
7164,0,<START>,0,0,0
7164,1,home,0,6,6
7164,2,work,6,7,1
7164,3,home,7,11,4
7164,4,work,11,13,2
7164,5,home,13,21,8
7164,6,work,21,22,1
7164,7,home,22,24,2
7164,8,<ENDS>,24,24,0
7165,0,<START>,0,0,0
7165,1,home,0,6,6
7165,2,work,6,13,7
7165,3,shop,13,14,1
7165,4,work,14,19,5
7165,5,home,19,24,5
7165,6,<ENDS>,24,24,0
7166,0,<START>,0,0,0
7166,1,home,0,6,6
7166,2,work,6,13,7
7166,3,shop,13,14,1
7166,4,work,14,20,6
7166,5,home,20,24,4
7166,6,<ENDS>,24,24,0
7167,0,<START>,0,0,0
7167,1,home,0,6,6
7167,2,work,6,13,7
7167,3,shop,13,14,1
7167,4,home,14,24,10
7167,5,<ENDS>,24,24,0
7168,0,<START>,0,0,0
7168,1,home,0,7,7
7168,2,work,7,14,7
7168,3,shop,14,15,1
7168,4,work,15,19,4
7168,5,home,19,24,5
7168,6,<ENDS>,24,24,0
7169,0,<START>,0,0,0
7169,1,home,0,7,7
7169,2,education,7,11,4
7169,3,home,11,18,7
7169,4,shop,18,19,1
7169,5,home,19,24,5
7169,6,<ENDS>,24,24,0
7170,0,<START>,0,0,0
7170,1,home,0,7,7
7170,2,work,7,8,1
7170,3,home,8,9,1
7170,4,work,9,11,2
7170,5,home,11,16,5
7170,6,work,16,18,2
7170,7,home,18,24,6
7170,8,<ENDS>,24,24,0
7171,0,<START>,0,0,0
7171,1,home,0,7,7
7171,2,work,7,14,7
7171,3,shop,14,15,1
7171,4,home,15,24,9
7171,5,<ENDS>,24,24,0
7172,0,<START>,0,0,0
7172,1,home,0,8,8
7172,2,work,8,15,7
7172,3,shop,15,16,1
7172,4,home,16,23,7
7172,5,work,23,24,1
7172,6,<ENDS>,24,24,0
7173,0,<START>,0,0,0
7173,1,home,0,8,8
7173,2,work,8,16,8
7173,3,home,16,24,8
7173,4,<ENDS>,24,24,0
7174,0,<START>,0,0,0
7174,1,home,0,7,7
7174,2,shop,7,8,1
7174,3,work,8,15,7
7174,4,home,15,22,7
7174,5,work,22,23,1
7174,6,home,23,24,1
7174,7,<ENDS>,24,24,0
7175,0,<START>,0,0,0
7175,1,home,0,6,6
7175,2,shop,6,7,1
7175,3,home,7,9,2
7175,4,work,9,15,6
7175,5,home,15,24,9
7175,6,<ENDS>,24,24,0
7176,0,<START>,0,0,0
7176,1,home,0,7,7
7176,2,education,7,11,4
7176,3,home,11,18,7
7176,4,shop,18,19,1
7176,5,home,19,24,5
7176,6,<ENDS>,24,24,0
7177,0,<START>,0,0,0
7177,1,home,0,7,7
7177,2,work,7,13,6
7177,3,shop,13,14,1
7177,4,home,14,20,6
7177,5,shop,20,21,1
7177,6,home,21,24,3
7177,7,<ENDS>,24,24,0
7178,0,<START>,0,0,0
7178,1,home,0,7,7
7178,2,work,7,14,7
7178,3,shop,14,15,1
7178,4,home,15,21,6
7178,5,work,21,22,1
7178,6,home,22,24,2
7178,7,<ENDS>,24,24,0
7179,0,<START>,0,0,0
7179,1,home,0,7,7
7179,2,education,7,11,4
7179,3,home,11,18,7
7179,4,shop,18,19,1
7179,5,home,19,24,5
7179,6,<ENDS>,24,24,0
7180,0,<START>,0,0,0
7180,1,home,0,8,8
7180,2,education,8,12,4
7180,3,home,12,20,8
7180,4,shop,20,21,1
7180,5,home,21,24,3
7180,6,<ENDS>,24,24,0
7181,0,<START>,0,0,0
7181,1,home,0,7,7
7181,2,work,7,13,6
7181,3,shop,13,14,1
7181,4,home,14,24,10
7181,5,<ENDS>,24,24,0
7182,0,<START>,0,0,0
7182,1,home,0,8,8
7182,2,work,8,15,7
7182,3,home,15,23,8
7182,4,work,23,24,1
7182,5,<ENDS>,24,24,0
7183,0,<START>,0,0,0
7183,1,home,0,8,8
7183,2,shop,8,9,1
7183,3,work,9,16,7
7183,4,shop,16,17,1
7183,5,home,17,21,4
7183,6,work,21,22,1
7183,7,home,22,24,2
7183,8,<ENDS>,24,24,0
7184,0,<START>,0,0,0
7184,1,home,0,7,7
7184,2,work,7,14,7
7184,3,shop,14,15,1
7184,4,work,15,19,4
7184,5,home,19,24,5
7184,6,<ENDS>,24,24,0
7185,0,<START>,0,0,0
7185,1,home,0,6,6
7185,2,shop,6,7,1
7185,3,home,7,10,3
7185,4,education,10,12,2
7185,5,shop,12,14,2
7185,6,home,14,20,6
7185,7,shop,20,21,1
7185,8,home,21,24,3
7185,9,<ENDS>,24,24,0
7186,0,<START>,0,0,0
7186,1,home,0,6,6
7186,2,work,6,13,7
7186,3,home,13,17,4
7186,4,work,17,20,3
7186,5,home,20,24,4
7186,6,<ENDS>,24,24,0
7187,0,<START>,0,0,0
7187,1,home,0,7,7
7187,2,shop,7,8,1
7187,3,work,8,16,8
7187,4,home,16,24,8
7187,5,<ENDS>,24,24,0
7188,0,<START>,0,0,0
7188,1,home,0,7,7
7188,2,education,7,11,4
7188,3,home,11,18,7
7188,4,shop,18,19,1
7188,5,home,19,24,5
7188,6,<ENDS>,24,24,0
7189,0,<START>,0,0,0
7189,1,home,0,7,7
7189,2,work,7,13,6
7189,3,home,13,24,11
7189,4,<ENDS>,24,24,0
7190,0,<START>,0,0,0
7190,1,home,0,8,8
7190,2,work,8,15,7
7190,3,home,15,24,9
7190,4,<ENDS>,24,24,0
7191,0,<START>,0,0,0
7191,1,home,0,7,7
7191,2,work,7,13,6
7191,3,shop,13,14,1
7191,4,home,14,21,7
7191,5,work,21,22,1
7191,6,home,22,24,2
7191,7,<ENDS>,24,24,0
7192,0,<START>,0,0,0
7192,1,home,0,6,6
7192,2,shop,6,7,1
7192,3,home,7,9,2
7192,4,education,9,11,2
7192,5,home,11,19,8
7192,6,shop,19,21,2
7192,7,home,21,24,3
7192,8,<ENDS>,24,24,0
7193,0,<START>,0,0,0
7193,1,home,0,6,6
7193,2,work,6,13,7
7193,3,home,13,24,11
7193,4,<ENDS>,24,24,0
7194,0,<START>,0,0,0
7194,1,home,0,6,6
7194,2,work,6,9,3
7194,3,home,9,15,6
7194,4,work,15,17,2
7194,5,home,17,24,7
7194,6,<ENDS>,24,24,0
7195,0,<START>,0,0,0
7195,1,home,0,8,8
7195,2,education,8,14,6
7195,3,shop,14,15,1
7195,4,home,15,19,4
7195,5,shop,19,20,1
7195,6,home,20,24,4
7195,7,<ENDS>,24,24,0
7196,0,<START>,0,0,0
7196,1,home,0,7,7
7196,2,work,7,14,7
7196,3,shop,14,15,1
7196,4,home,15,23,8
7196,5,work,23,24,1
7196,6,<ENDS>,24,24,0
7197,0,<START>,0,0,0
7197,1,home,0,6,6
7197,2,work,6,14,8
7197,3,home,14,24,10
7197,4,<ENDS>,24,24,0
7198,0,<START>,0,0,0
7198,1,home,0,6,6
7198,2,work,6,13,7
7198,3,shop,13,14,1
7198,4,work,14,20,6
7198,5,home,20,24,4
7198,6,<ENDS>,24,24,0
7199,0,<START>,0,0,0
7199,1,home,0,7,7
7199,2,work,7,13,6
7199,3,home,13,21,8
7199,4,work,21,22,1
7199,5,home,22,24,2
7199,6,<ENDS>,24,24,0
7200,0,<START>,0,0,0
7200,1,home,0,7,7
7200,2,work,7,14,7
7200,3,home,14,24,10
7200,4,<ENDS>,24,24,0
7201,0,<START>,0,0,0
7201,1,home,0,7,7
7201,2,work,7,13,6
7201,3,shop,13,14,1
7201,4,work,14,19,5
7201,5,home,19,24,5
7201,6,<ENDS>,24,24,0
7202,0,<START>,0,0,0
7202,1,home,0,6,6
7202,2,shop,6,7,1
7202,3,work,7,14,7
7202,4,home,14,19,5
7202,5,shop,19,20,1
7202,6,home,20,24,4
7202,7,<ENDS>,24,24,0
7203,0,<START>,0,0,0
7203,1,home,0,8,8
7203,2,shop,8,9,1
7203,3,work,9,17,8
7203,4,home,17,24,7
7203,5,<ENDS>,24,24,0
7204,0,<START>,0,0,0
7204,1,home,0,7,7
7204,2,shop,7,8,1
7204,3,education,8,13,5
7204,4,home,13,19,6
7204,5,shop,19,21,2
7204,6,home,21,24,3
7204,7,<ENDS>,24,24,0
7205,0,<START>,0,0,0
7205,1,home,0,9,9
7205,2,education,9,11,2
7205,3,home,11,15,4
7205,4,work,15,20,5
7205,5,home,20,24,4
7205,6,<ENDS>,24,24,0
7206,0,<START>,0,0,0
7206,1,home,0,6,6
7206,2,work,6,13,7
7206,3,home,13,21,8
7206,4,shop,21,22,1
7206,5,home,22,24,2
7206,6,<ENDS>,24,24,0
7207,0,<START>,0,0,0
7207,1,home,0,6,6
7207,2,shop,6,7,1
7207,3,home,7,10,3
7207,4,education,10,13,3
7207,5,home,13,16,3
7207,6,shop,16,17,1
7207,7,home,17,24,7
7207,8,<ENDS>,24,24,0
7208,0,<START>,0,0,0
7208,1,home,0,9,9
7208,2,work,9,15,6
7208,3,shop,15,16,1
7208,4,home,16,24,8
7208,5,<ENDS>,24,24,0
7209,0,<START>,0,0,0
7209,1,home,0,8,8
7209,2,shop,8,9,1
7209,3,home,9,13,4
7209,4,education,13,17,4
7209,5,home,17,24,7
7209,6,<ENDS>,24,24,0
7210,0,<START>,0,0,0
7210,1,home,0,6,6
7210,2,shop,6,7,1
7210,3,home,7,10,3
7210,4,education,10,13,3
7210,5,shop,13,15,2
7210,6,home,15,24,9
7210,7,<ENDS>,24,24,0
7211,0,<START>,0,0,0
7211,1,home,0,7,7
7211,2,work,7,13,6
7211,3,home,13,23,10
7211,4,work,23,24,1
7211,5,<ENDS>,24,24,0
7212,0,<START>,0,0,0
7212,1,work,0,8,8
7212,2,shop,8,9,1
7212,3,work,9,16,7
7212,4,home,16,24,8
7212,5,<ENDS>,24,24,0
7213,0,<START>,0,0,0
7213,1,home,0,6,6
7213,2,work,6,13,7
7213,3,home,13,17,4
7213,4,work,17,20,3
7213,5,home,20,24,4
7213,6,<ENDS>,24,24,0
7214,0,<START>,0,0,0
7214,1,home,0,8,8
7214,2,education,8,12,4
7214,3,home,12,20,8
7214,4,shop,20,21,1
7214,5,home,21,24,3
7214,6,<ENDS>,24,24,0
7215,0,<START>,0,0,0
7215,1,home,0,6,6
7215,2,shop,6,7,1
7215,3,home,7,9,2
7215,4,work,9,17,8
7215,5,home,17,24,7
7215,6,<ENDS>,24,24,0
7216,0,<START>,0,0,0
7216,1,home,0,7,7
7216,2,work,7,9,2
7216,3,home,9,12,3
7216,4,work,12,14,2
7216,5,home,14,18,4
7216,6,work,18,19,1
7216,7,home,19,24,5
7216,8,<ENDS>,24,24,0
7217,0,<START>,0,0,0
7217,1,home,0,7,7
7217,2,shop,7,9,2
7217,3,education,9,12,3
7217,4,shop,12,13,1
7217,5,education,13,16,3
7217,6,home,16,24,8
7217,7,<ENDS>,24,24,0
7218,0,<START>,0,0,0
7218,1,home,0,6,6
7218,2,shop,6,7,1
7218,3,home,7,10,3
7218,4,education,10,16,6
7218,5,home,16,24,8
7218,6,<ENDS>,24,24,0
7219,0,<START>,0,0,0
7219,1,home,0,6,6
7219,2,work,6,8,2
7219,3,home,8,13,5
7219,4,work,13,14,1
7219,5,home,14,22,8
7219,6,work,22,23,1
7219,7,home,23,24,1
7219,8,<ENDS>,24,24,0
7220,0,<START>,0,0,0
7220,1,home,0,7,7
7220,2,work,7,13,6
7220,3,shop,13,14,1
7220,4,home,14,24,10
7220,5,<ENDS>,24,24,0
7221,0,<START>,0,0,0
7221,1,home,0,6,6
7221,2,work,6,8,2
7221,3,home,8,14,6
7221,4,work,14,17,3
7221,5,home,17,24,7
7221,6,<ENDS>,24,24,0
7222,0,<START>,0,0,0
7222,1,home,0,6,6
7222,2,shop,6,7,1
7222,3,home,7,13,6
7222,4,education,13,16,3
7222,5,home,16,24,8
7222,6,<ENDS>,24,24,0
7223,0,<START>,0,0,0
7223,1,home,0,7,7
7223,2,education,7,11,4
7223,3,home,11,17,6
7223,4,shop,17,18,1
7223,5,home,18,24,6
7223,6,<ENDS>,24,24,0
7224,0,<START>,0,0,0
7224,1,home,0,7,7
7224,2,shop,7,8,1
7224,3,education,8,11,3
7224,4,home,11,13,2
7224,5,education,13,16,3
7224,6,home,16,24,8
7224,7,<ENDS>,24,24,0
7225,0,<START>,0,0,0
7225,1,home,0,6,6
7225,2,shop,6,7,1
7225,3,home,7,10,3
7225,4,education,10,13,3
7225,5,shop,13,14,1
7225,6,home,14,21,7
7225,7,shop,21,22,1
7225,8,home,22,24,2
7225,9,<ENDS>,24,24,0
7226,0,<START>,0,0,0
7226,1,home,0,7,7
7226,2,education,7,12,5
7226,3,shop,12,14,2
7226,4,home,14,20,6
7226,5,shop,20,21,1
7226,6,home,21,24,3
7226,7,<ENDS>,24,24,0
7227,0,<START>,0,0,0
7227,1,home,0,7,7
7227,2,education,7,13,6
7227,3,home,13,19,6
7227,4,shop,19,20,1
7227,5,home,20,24,4
7227,6,<ENDS>,24,24,0
7228,0,<START>,0,0,0
7228,1,home,0,8,8
7228,2,work,8,15,7
7228,3,home,15,20,5
7228,4,shop,20,21,1
7228,5,home,21,24,3
7228,6,<ENDS>,24,24,0
7229,0,<START>,0,0,0
7229,1,home,0,8,8
7229,2,work,8,15,7
7229,3,shop,15,17,2
7229,4,home,17,24,7
7229,5,<ENDS>,24,24,0
7230,0,<START>,0,0,0
7230,1,home,0,8,8
7230,2,work,8,15,7
7230,3,shop,15,16,1
7230,4,home,16,24,8
7230,5,<ENDS>,24,24,0
7231,0,<START>,0,0,0
7231,1,home,0,7,7
7231,2,work,7,15,8
7231,3,home,15,19,4
7231,4,shop,19,20,1
7231,5,home,20,24,4
7231,6,<ENDS>,24,24,0
7232,0,<START>,0,0,0
7232,1,home,0,6,6
7232,2,work,6,8,2
7232,3,home,8,9,1
7232,4,work,9,10,1
7232,5,home,10,16,6
7232,6,work,16,18,2
7232,7,home,18,23,5
7232,8,work,23,24,1
7232,9,<ENDS>,24,24,0
7233,0,<START>,0,0,0
7233,1,home,0,7,7
7233,2,shop,7,8,1
7233,3,education,8,11,3
7233,4,home,11,18,7
7233,5,shop,18,19,1
7233,6,home,19,24,5
7233,7,<ENDS>,24,24,0
7234,0,<START>,0,0,0
7234,1,home,0,8,8
7234,2,work,8,14,6
7234,3,shop,14,15,1
7234,4,work,15,18,3
7234,5,home,18,24,6
7234,6,<ENDS>,24,24,0
7235,0,<START>,0,0,0
7235,1,home,0,7,7
7235,2,shop,7,8,1
7235,3,home,8,16,8
7235,4,shop,16,17,1
7235,5,home,17,24,7
7235,6,<ENDS>,24,24,0
7236,0,<START>,0,0,0
7236,1,home,0,7,7
7236,2,shop,7,8,1
7236,3,work,8,16,8
7236,4,home,16,24,8
7236,5,<ENDS>,24,24,0
7237,0,<START>,0,0,0
7237,1,home,0,7,7
7237,2,shop,7,8,1
7237,3,work,8,15,7
7237,4,home,15,24,9
7237,5,<ENDS>,24,24,0
7238,0,<START>,0,0,0
7238,1,home,0,8,8
7238,2,work,8,15,7
7238,3,shop,15,16,1
7238,4,home,16,23,7
7238,5,work,23,24,1
7238,6,<ENDS>,24,24,0
7239,0,<START>,0,0,0
7239,1,home,0,9,9
7239,2,work,9,17,8
7239,3,home,17,24,7
7239,4,<ENDS>,24,24,0
7240,0,<START>,0,0,0
7240,1,home,0,7,7
7240,2,shop,7,8,1
7240,3,work,8,14,6
7240,4,home,14,22,8
7240,5,work,22,23,1
7240,6,home,23,24,1
7240,7,<ENDS>,24,24,0
7241,0,<START>,0,0,0
7241,1,home,0,6,6
7241,2,work,6,13,7
7241,3,shop,13,15,2
7241,4,home,15,24,9
7241,5,<ENDS>,24,24,0
7242,0,<START>,0,0,0
7242,1,home,0,6,6
7242,2,work,6,13,7
7242,3,shop,13,14,1
7242,4,home,14,24,10
7242,5,<ENDS>,24,24,0
7243,0,<START>,0,0,0
7243,1,home,0,8,8
7243,2,work,8,15,7
7243,3,home,15,24,9
7243,4,<ENDS>,24,24,0
7244,0,<START>,0,0,0
7244,1,home,0,7,7
7244,2,education,7,10,3
7244,3,home,10,16,6
7244,4,shop,16,17,1
7244,5,home,17,24,7
7244,6,<ENDS>,24,24,0
7245,0,<START>,0,0,0
7245,1,home,0,7,7
7245,2,work,7,14,7
7245,3,home,14,24,10
7245,4,<ENDS>,24,24,0
7246,0,<START>,0,0,0
7246,1,home,0,7,7
7246,2,shop,7,8,1
7246,3,education,8,13,5
7246,4,home,13,19,6
7246,5,shop,19,21,2
7246,6,home,21,24,3
7246,7,<ENDS>,24,24,0
7247,0,<START>,0,0,0
7247,1,home,0,7,7
7247,2,work,7,14,7
7247,3,shop,14,15,1
7247,4,home,15,24,9
7247,5,<ENDS>,24,24,0
7248,0,<START>,0,0,0
7248,1,home,0,7,7
7248,2,work,7,13,6
7248,3,shop,13,14,1
7248,4,work,14,19,5
7248,5,home,19,24,5
7248,6,<ENDS>,24,24,0
7249,0,<START>,0,0,0
7249,1,home,0,7,7
7249,2,education,7,11,4
7249,3,home,11,18,7
7249,4,shop,18,19,1
7249,5,home,19,24,5
7249,6,<ENDS>,24,24,0
7250,0,<START>,0,0,0
7250,1,home,0,7,7
7250,2,education,7,10,3
7250,3,home,10,14,4
7250,4,education,14,16,2
7250,5,shop,16,17,1
7250,6,home,17,24,7
7250,7,<ENDS>,24,24,0
7251,0,<START>,0,0,0
7251,1,home,0,7,7
7251,2,work,7,13,6
7251,3,shop,13,14,1
7251,4,education,14,16,2
7251,5,home,16,22,6
7251,6,work,22,23,1
7251,7,home,23,24,1
7251,8,<ENDS>,24,24,0
7252,0,<START>,0,0,0
7252,1,home,0,6,6
7252,2,work,6,13,7
7252,3,home,13,24,11
7252,4,<ENDS>,24,24,0
7253,0,<START>,0,0,0
7253,1,home,0,7,7
7253,2,work,7,14,7
7253,3,home,14,21,7
7253,4,shop,21,22,1
7253,5,home,22,24,2
7253,6,<ENDS>,24,24,0
7254,0,<START>,0,0,0
7254,1,home,0,6,6
7254,2,work,6,13,7
7254,3,shop,13,14,1
7254,4,work,14,20,6
7254,5,home,20,24,4
7254,6,<ENDS>,24,24,0
7255,0,<START>,0,0,0
7255,1,home,0,9,9
7255,2,work,9,16,7
7255,3,shop,16,17,1
7255,4,home,17,24,7
7255,5,<ENDS>,24,24,0
7256,0,<START>,0,0,0
7256,1,home,0,7,7
7256,2,shop,7,8,1
7256,3,education,8,12,4
7256,4,home,12,19,7
7256,5,shop,19,21,2
7256,6,home,21,24,3
7256,7,<ENDS>,24,24,0
7257,0,<START>,0,0,0
7257,1,home,0,6,6
7257,2,shop,6,7,1
7257,3,home,7,9,2
7257,4,work,9,17,8
7257,5,home,17,23,6
7257,6,work,23,24,1
7257,7,<ENDS>,24,24,0
7258,0,<START>,0,0,0
7258,1,home,0,6,6
7258,2,work,6,8,2
7258,3,home,8,12,4
7258,4,work,12,13,1
7258,5,home,13,18,5
7258,6,work,18,20,2
7258,7,home,20,24,4
7258,8,<ENDS>,24,24,0
7259,0,<START>,0,0,0
7259,1,home,0,7,7
7259,2,shop,7,8,1
7259,3,education,8,11,3
7259,4,home,11,18,7
7259,5,shop,18,19,1
7259,6,home,19,24,5
7259,7,<ENDS>,24,24,0
7260,0,<START>,0,0,0
7260,1,home,0,8,8
7260,2,shop,8,9,1
7260,3,home,9,13,4
7260,4,work,13,19,6
7260,5,home,19,24,5
7260,6,<ENDS>,24,24,0
7261,0,<START>,0,0,0
7261,1,home,0,9,9
7261,2,work,9,16,7
7261,3,shop,16,17,1
7261,4,home,17,21,4
7261,5,work,21,22,1
7261,6,home,22,24,2
7261,7,<ENDS>,24,24,0
7262,0,<START>,0,0,0
7262,1,home,0,7,7
7262,2,education,7,12,5
7262,3,shop,12,14,2
7262,4,home,14,20,6
7262,5,shop,20,21,1
7262,6,home,21,24,3
7262,7,<ENDS>,24,24,0
7263,0,<START>,0,0,0
7263,1,home,0,8,8
7263,2,shop,8,9,1
7263,3,work,9,16,7
7263,4,home,16,22,6
7263,5,work,22,23,1
7263,6,home,23,24,1
7263,7,<ENDS>,24,24,0
7264,0,<START>,0,0,0
7264,1,home,0,7,7
7264,2,work,7,13,6
7264,3,shop,13,14,1
7264,4,work,14,20,6
7264,5,home,20,24,4
7264,6,<ENDS>,24,24,0
7265,0,<START>,0,0,0
7265,1,home,0,7,7
7265,2,work,7,14,7
7265,3,home,14,24,10
7265,4,<ENDS>,24,24,0
7266,0,<START>,0,0,0
7266,1,home,0,7,7
7266,2,education,7,14,7
7266,3,shop,14,15,1
7266,4,home,15,24,9
7266,5,<ENDS>,24,24,0
7267,0,<START>,0,0,0
7267,1,home,0,6,6
7267,2,work,6,7,1
7267,3,home,7,12,5
7267,4,work,12,14,2
7267,5,home,14,21,7
7267,6,work,21,22,1
7267,7,home,22,24,2
7267,8,<ENDS>,24,24,0
7268,0,<START>,0,0,0
7268,1,home,0,7,7
7268,2,education,7,11,4
7268,3,home,11,18,7
7268,4,shop,18,19,1
7268,5,home,19,24,5
7268,6,<ENDS>,24,24,0
7269,0,<START>,0,0,0
7269,1,home,0,7,7
7269,2,work,7,9,2
7269,3,home,9,13,4
7269,4,work,13,15,2
7269,5,home,15,16,1
7269,6,work,16,19,3
7269,7,home,19,24,5
7269,8,<ENDS>,24,24,0
7270,0,<START>,0,0,0
7270,1,home,0,7,7
7270,2,work,7,13,6
7270,3,shop,13,14,1
7270,4,home,14,24,10
7270,5,<ENDS>,24,24,0
7271,0,<START>,0,0,0
7271,1,home,0,7,7
7271,2,education,7,12,5
7271,3,shop,12,13,1
7271,4,home,13,20,7
7271,5,shop,20,21,1
7271,6,home,21,24,3
7271,7,<ENDS>,24,24,0
7272,0,<START>,0,0,0
7272,1,home,0,8,8
7272,2,education,8,11,3
7272,3,home,11,18,7
7272,4,shop,18,19,1
7272,5,home,19,24,5
7272,6,<ENDS>,24,24,0
7273,0,<START>,0,0,0
7273,1,home,0,7,7
7273,2,work,7,9,2
7273,3,home,9,15,6
7273,4,work,15,17,2
7273,5,home,17,23,6
7273,6,work,23,24,1
7273,7,<ENDS>,24,24,0
7274,0,<START>,0,0,0
7274,1,home,0,7,7
7274,2,work,7,13,6
7274,3,shop,13,14,1
7274,4,work,14,20,6
7274,5,home,20,24,4
7274,6,<ENDS>,24,24,0
7275,0,<START>,0,0,0
7275,1,home,0,6,6
7275,2,shop,6,7,1
7275,3,home,7,10,3
7275,4,education,10,11,1
7275,5,home,11,13,2
7275,6,education,13,16,3
7275,7,home,16,24,8
7275,8,<ENDS>,24,24,0
7276,0,<START>,0,0,0
7276,1,home,0,8,8
7276,2,work,8,16,8
7276,3,home,16,24,8
7276,4,<ENDS>,24,24,0
7277,0,<START>,0,0,0
7277,1,home,0,6,6
7277,2,work,6,13,7
7277,3,home,13,22,9
7277,4,work,22,23,1
7277,5,home,23,24,1
7277,6,<ENDS>,24,24,0
7278,0,<START>,0,0,0
7278,1,home,0,7,7
7278,2,education,7,12,5
7278,3,home,12,19,7
7278,4,shop,19,20,1
7278,5,home,20,24,4
7278,6,<ENDS>,24,24,0
7279,0,<START>,0,0,0
7279,1,home,0,7,7
7279,2,work,7,13,6
7279,3,home,13,24,11
7279,4,<ENDS>,24,24,0
7280,0,<START>,0,0,0
7280,1,home,0,8,8
7280,2,work,8,14,6
7280,3,home,14,20,6
7280,4,shop,20,21,1
7280,5,home,21,24,3
7280,6,<ENDS>,24,24,0
7281,0,<START>,0,0,0
7281,1,home,0,7,7
7281,2,shop,7,8,1
7281,3,education,8,12,4
7281,4,shop,12,13,1
7281,5,home,13,20,7
7281,6,shop,20,21,1
7281,7,home,21,24,3
7281,8,<ENDS>,24,24,0
7282,0,<START>,0,0,0
7282,1,home,0,6,6
7282,2,work,6,13,7
7282,3,home,13,24,11
7282,4,<ENDS>,24,24,0
7283,0,<START>,0,0,0
7283,1,home,0,7,7
7283,2,education,7,12,5
7283,3,shop,12,14,2
7283,4,home,14,20,6
7283,5,shop,20,21,1
7283,6,home,21,24,3
7283,7,<ENDS>,24,24,0
7284,0,<START>,0,0,0
7284,1,home,0,8,8
7284,2,work,8,15,7
7284,3,shop,15,16,1
7284,4,home,16,24,8
7284,5,<ENDS>,24,24,0
7285,0,<START>,0,0,0
7285,1,home,0,7,7
7285,2,work,7,9,2
7285,3,home,9,13,4
7285,4,work,13,15,2
7285,5,home,15,21,6
7285,6,work,21,22,1
7285,7,home,22,23,1
7285,8,work,23,24,1
7285,9,<ENDS>,24,24,0
7286,0,<START>,0,0,0
7286,1,home,0,8,8
7286,2,work,8,15,7
7286,3,home,15,24,9
7286,4,<ENDS>,24,24,0
7287,0,<START>,0,0,0
7287,1,home,0,7,7
7287,2,work,7,14,7
7287,3,home,14,24,10
7287,4,<ENDS>,24,24,0
7288,0,<START>,0,0,0
7288,1,home,0,7,7
7288,2,education,7,11,4
7288,3,home,11,14,3
7288,4,education,14,16,2
7288,5,home,16,24,8
7288,6,<ENDS>,24,24,0
7289,0,<START>,0,0,0
7289,1,home,0,6,6
7289,2,work,6,13,7
7289,3,shop,13,14,1
7289,4,home,14,24,10
7289,5,<ENDS>,24,24,0
7290,0,<START>,0,0,0
7290,1,home,0,7,7
7290,2,work,7,13,6
7290,3,home,13,24,11
7290,4,<ENDS>,24,24,0
7291,0,<START>,0,0,0
7291,1,home,0,7,7
7291,2,work,7,8,1
7291,3,home,8,14,6
7291,4,work,14,16,2
7291,5,home,16,22,6
7291,6,work,22,23,1
7291,7,home,23,24,1
7291,8,<ENDS>,24,24,0
7292,0,<START>,0,0,0
7292,1,home,0,7,7
7292,2,work,7,9,2
7292,3,home,9,14,5
7292,4,work,14,19,5
7292,5,home,19,24,5
7292,6,<ENDS>,24,24,0
7293,0,<START>,0,0,0
7293,1,home,0,7,7
7293,2,work,7,13,6
7293,3,home,13,17,4
7293,4,shop,17,18,1
7293,5,home,18,24,6
7293,6,<ENDS>,24,24,0
7294,0,<START>,0,0,0
7294,1,home,0,8,8
7294,2,work,8,14,6
7294,3,home,14,24,10
7294,4,<ENDS>,24,24,0
7295,0,<START>,0,0,0
7295,1,home,0,6,6
7295,2,shop,6,7,1
7295,3,home,7,10,3
7295,4,education,10,12,2
7295,5,home,12,19,7
7295,6,shop,19,21,2
7295,7,home,21,24,3
7295,8,<ENDS>,24,24,0
7296,0,<START>,0,0,0
7296,1,home,0,8,8
7296,2,work,8,13,5
7296,3,home,13,22,9
7296,4,work,22,23,1
7296,5,home,23,24,1
7296,6,<ENDS>,24,24,0
7297,0,<START>,0,0,0
7297,1,home,0,6,6
7297,2,shop,6,7,1
7297,3,home,7,9,2
7297,4,education,9,12,3
7297,5,home,12,18,6
7297,6,shop,18,19,1
7297,7,home,19,24,5
7297,8,<ENDS>,24,24,0
7298,0,<START>,0,0,0
7298,1,home,0,7,7
7298,2,education,7,11,4
7298,3,home,11,18,7
7298,4,shop,18,19,1
7298,5,home,19,24,5
7298,6,<ENDS>,24,24,0
7299,0,<START>,0,0,0
7299,1,home,0,6,6
7299,2,work,6,13,7
7299,3,home,13,17,4
7299,4,work,17,19,2
7299,5,education,19,20,1
7299,6,home,20,24,4
7299,7,<ENDS>,24,24,0
7300,0,<START>,0,0,0
7300,1,home,0,8,8
7300,2,work,8,15,7
7300,3,home,15,17,2
7300,4,work,17,20,3
7300,5,home,20,24,4
7300,6,<ENDS>,24,24,0
7301,0,<START>,0,0,0
7301,1,home,0,7,7
7301,2,work,7,14,7
7301,3,home,14,24,10
7301,4,<ENDS>,24,24,0
7302,0,<START>,0,0,0
7302,1,home,0,6,6
7302,2,work,6,13,7
7302,3,home,13,14,1
7302,4,education,14,16,2
7302,5,home,16,24,8
7302,6,<ENDS>,24,24,0
7303,0,<START>,0,0,0
7303,1,home,0,6,6
7303,2,work,6,8,2
7303,3,home,8,12,4
7303,4,work,12,14,2
7303,5,home,14,18,4
7303,6,work,18,20,2
7303,7,home,20,24,4
7303,8,<ENDS>,24,24,0
7304,0,<START>,0,0,0
7304,1,home,0,6,6
7304,2,shop,6,7,1
7304,3,home,7,13,6
7304,4,education,13,16,3
7304,5,shop,16,17,1
7304,6,home,17,24,7
7304,7,<ENDS>,24,24,0
7305,0,<START>,0,0,0
7305,1,home,0,8,8
7305,2,work,8,15,7
7305,3,home,15,21,6
7305,4,shop,21,22,1
7305,5,home,22,24,2
7305,6,<ENDS>,24,24,0
7306,0,<START>,0,0,0
7306,1,home,0,8,8
7306,2,education,8,12,4
7306,3,home,12,16,4
7306,4,shop,16,17,1
7306,5,home,17,24,7
7306,6,<ENDS>,24,24,0
7307,0,<START>,0,0,0
7307,1,home,0,8,8
7307,2,work,8,14,6
7307,3,shop,14,15,1
7307,4,home,15,24,9
7307,5,<ENDS>,24,24,0
7308,0,<START>,0,0,0
7308,1,home,0,8,8
7308,2,work,8,17,9
7308,3,home,17,24,7
7308,4,<ENDS>,24,24,0
7309,0,<START>,0,0,0
7309,1,home,0,6,6
7309,2,work,6,8,2
7309,3,home,8,14,6
7309,4,work,14,16,2
7309,5,home,16,21,5
7309,6,work,21,22,1
7309,7,home,22,24,2
7309,8,<ENDS>,24,24,0
7310,0,<START>,0,0,0
7310,1,work,0,1,1
7310,2,home,1,9,8
7310,3,education,9,12,3
7310,4,home,12,20,8
7310,5,shop,20,21,1
7310,6,home,21,24,3
7310,7,<ENDS>,24,24,0
7311,0,<START>,0,0,0
7311,1,home,0,6,6
7311,2,work,6,13,7
7311,3,home,13,17,4
7311,4,shop,17,18,1
7311,5,home,18,24,6
7311,6,<ENDS>,24,24,0
7312,0,<START>,0,0,0
7312,1,home,0,7,7
7312,2,work,7,14,7
7312,3,shop,14,15,1
7312,4,home,15,21,6
7312,5,work,21,22,1
7312,6,home,22,24,2
7312,7,<ENDS>,24,24,0
7313,0,<START>,0,0,0
7313,1,home,0,7,7
7313,2,work,7,13,6
7313,3,shop,13,14,1
7313,4,work,14,20,6
7313,5,home,20,24,4
7313,6,<ENDS>,24,24,0
7314,0,<START>,0,0,0
7314,1,work,0,10,10
7314,2,shop,10,11,1
7314,3,work,11,17,6
7314,4,home,17,24,7
7314,5,<ENDS>,24,24,0
7315,0,<START>,0,0,0
7315,1,home,0,7,7
7315,2,work,7,14,7
7315,3,shop,14,15,1
7315,4,work,15,19,4
7315,5,home,19,24,5
7315,6,<ENDS>,24,24,0
7316,0,<START>,0,0,0
7316,1,home,0,7,7
7316,2,work,7,13,6
7316,3,home,13,18,5
7316,4,work,18,20,2
7316,5,home,20,24,4
7316,6,<ENDS>,24,24,0
7317,0,<START>,0,0,0
7317,1,home,0,6,6
7317,2,work,6,12,6
7317,3,shop,12,13,1
7317,4,work,13,20,7
7317,5,home,20,24,4
7317,6,<ENDS>,24,24,0
7318,0,<START>,0,0,0
7318,1,home,0,6,6
7318,2,work,6,8,2
7318,3,home,8,14,6
7318,4,work,14,16,2
7318,5,home,16,21,5
7318,6,work,21,22,1
7318,7,home,22,24,2
7318,8,<ENDS>,24,24,0
7319,0,<START>,0,0,0
7319,1,home,0,8,8
7319,2,work,8,14,6
7319,3,shop,14,16,2
7319,4,home,16,24,8
7319,5,<ENDS>,24,24,0
7320,0,<START>,0,0,0
7320,1,home,0,7,7
7320,2,work,7,13,6
7320,3,home,13,24,11
7320,4,<ENDS>,24,24,0
7321,0,<START>,0,0,0
7321,1,home,0,7,7
7321,2,work,7,14,7
7321,3,home,14,24,10
7321,4,<ENDS>,24,24,0
7322,0,<START>,0,0,0
7322,1,home,0,7,7
7322,2,work,7,13,6
7322,3,home,13,17,4
7322,4,work,17,20,3
7322,5,home,20,24,4
7322,6,<ENDS>,24,24,0
7323,0,<START>,0,0,0
7323,1,home,0,7,7
7323,2,work,7,13,6
7323,3,home,13,16,3
7323,4,work,16,20,4
7323,5,home,20,24,4
7323,6,<ENDS>,24,24,0
7324,0,<START>,0,0,0
7324,1,home,0,7,7
7324,2,work,7,13,6
7324,3,shop,13,14,1
7324,4,work,14,19,5
7324,5,home,19,24,5
7324,6,<ENDS>,24,24,0
7325,0,<START>,0,0,0
7325,1,home,0,6,6
7325,2,work,6,13,7
7325,3,home,13,18,5
7325,4,shop,18,19,1
7325,5,home,19,24,5
7325,6,<ENDS>,24,24,0
7326,0,<START>,0,0,0
7326,1,home,0,8,8
7326,2,work,8,14,6
7326,3,home,14,24,10
7326,4,<ENDS>,24,24,0
7327,0,<START>,0,0,0
7327,1,home,0,9,9
7327,2,work,9,16,7
7327,3,home,16,24,8
7327,4,<ENDS>,24,24,0
7328,0,<START>,0,0,0
7328,1,home,0,8,8
7328,2,work,8,13,5
7328,3,home,13,24,11
7328,4,<ENDS>,24,24,0
7329,0,<START>,0,0,0
7329,1,home,0,8,8
7329,2,work,8,15,7
7329,3,home,15,24,9
7329,4,<ENDS>,24,24,0
7330,0,<START>,0,0,0
7330,1,home,0,8,8
7330,2,work,8,15,7
7330,3,shop,15,16,1
7330,4,home,16,22,6
7330,5,work,22,23,1
7330,6,home,23,24,1
7330,7,<ENDS>,24,24,0
7331,0,<START>,0,0,0
7331,1,home,0,8,8
7331,2,work,8,15,7
7331,3,shop,15,16,1
7331,4,work,16,19,3
7331,5,home,19,24,5
7331,6,<ENDS>,24,24,0
7332,0,<START>,0,0,0
7332,1,home,0,7,7
7332,2,shop,7,8,1
7332,3,education,8,11,3
7332,4,home,11,19,8
7332,5,shop,19,20,1
7332,6,home,20,24,4
7332,7,<ENDS>,24,24,0
7333,0,<START>,0,0,0
7333,1,home,0,8,8
7333,2,work,8,14,6
7333,3,shop,14,15,1
7333,4,work,15,20,5
7333,5,home,20,24,4
7333,6,<ENDS>,24,24,0
7334,0,<START>,0,0,0
7334,1,home,0,8,8
7334,2,work,8,15,7
7334,3,home,15,22,7
7334,4,work,22,23,1
7334,5,home,23,24,1
7334,6,<ENDS>,24,24,0
7335,0,<START>,0,0,0
7335,1,home,0,7,7
7335,2,shop,7,8,1
7335,3,education,8,10,2
7335,4,home,10,14,4
7335,5,education,14,16,2
7335,6,home,16,24,8
7335,7,<ENDS>,24,24,0
7336,0,<START>,0,0,0
7336,1,home,0,7,7
7336,2,shop,7,8,1
7336,3,home,8,9,1
7336,4,education,9,12,3
7336,5,shop,12,13,1
7336,6,work,13,18,5
7336,7,home,18,22,4
7336,8,work,22,23,1
7336,9,home,23,24,1
7336,10,<ENDS>,24,24,0
7337,0,<START>,0,0,0
7337,1,home,0,6,6
7337,2,shop,6,7,1
7337,3,home,7,10,3
7337,4,education,10,12,2
7337,5,shop,12,13,1
7337,6,education,13,14,1
7337,7,shop,14,15,1
7337,8,home,15,24,9
7337,9,<ENDS>,24,24,0
7338,0,<START>,0,0,0
7338,1,home,0,7,7
7338,2,education,7,11,4
7338,3,home,11,17,6
7338,4,shop,17,18,1
7338,5,home,18,24,6
7338,6,<ENDS>,24,24,0
7339,0,<START>,0,0,0
7339,1,home,0,7,7
7339,2,work,7,13,6
7339,3,home,13,24,11
7339,4,<ENDS>,24,24,0
7340,0,<START>,0,0,0
7340,1,home,0,6,6
7340,2,work,6,8,2
7340,3,home,8,12,4
7340,4,work,12,14,2
7340,5,home,14,21,7
7340,6,work,21,22,1
7340,7,home,22,24,2
7340,8,<ENDS>,24,24,0
7341,0,<START>,0,0,0
7341,1,home,0,7,7
7341,2,work,7,14,7
7341,3,shop,14,16,2
7341,4,work,16,20,4
7341,5,home,20,24,4
7341,6,<ENDS>,24,24,0
7342,0,<START>,0,0,0
7342,1,home,0,7,7
7342,2,work,7,13,6
7342,3,shop,13,14,1
7342,4,home,14,21,7
7342,5,work,21,22,1
7342,6,home,22,24,2
7342,7,<ENDS>,24,24,0
7343,0,<START>,0,0,0
7343,1,home,0,7,7
7343,2,work,7,14,7
7343,3,home,14,24,10
7343,4,<ENDS>,24,24,0
7344,0,<START>,0,0,0
7344,1,home,0,8,8
7344,2,education,8,14,6
7344,3,home,14,22,8
7344,4,work,22,23,1
7344,5,home,23,24,1
7344,6,<ENDS>,24,24,0
7345,0,<START>,0,0,0
7345,1,home,0,7,7
7345,2,shop,7,8,1
7345,3,education,8,11,3
7345,4,home,11,18,7
7345,5,shop,18,19,1
7345,6,home,19,24,5
7345,7,<ENDS>,24,24,0
7346,0,<START>,0,0,0
7346,1,home,0,8,8
7346,2,education,8,14,6
7346,3,home,14,19,5
7346,4,shop,19,20,1
7346,5,home,20,24,4
7346,6,<ENDS>,24,24,0
7347,0,<START>,0,0,0
7347,1,home,0,8,8
7347,2,shop,8,9,1
7347,3,home,9,21,12
7347,4,work,21,22,1
7347,5,home,22,24,2
7347,6,<ENDS>,24,24,0
7348,0,<START>,0,0,0
7348,1,home,0,7,7
7348,2,work,7,9,2
7348,3,home,9,15,6
7348,4,work,15,17,2
7348,5,home,17,24,7
7348,6,<ENDS>,24,24,0
7349,0,<START>,0,0,0
7349,1,home,0,6,6
7349,2,work,6,13,7
7349,3,home,13,17,4
7349,4,shop,17,18,1
7349,5,home,18,24,6
7349,6,<ENDS>,24,24,0
7350,0,<START>,0,0,0
7350,1,home,0,8,8
7350,2,education,8,12,4
7350,3,shop,12,13,1
7350,4,work,13,19,6
7350,5,home,19,24,5
7350,6,<ENDS>,24,24,0
7351,0,<START>,0,0,0
7351,1,home,0,7,7
7351,2,shop,7,8,1
7351,3,work,8,13,5
7351,4,home,13,24,11
7351,5,<ENDS>,24,24,0
7352,0,<START>,0,0,0
7352,1,home,0,6,6
7352,2,shop,6,7,1
7352,3,home,7,10,3
7352,4,education,10,16,6
7352,5,home,16,24,8
7352,6,<ENDS>,24,24,0
7353,0,<START>,0,0,0
7353,1,home,0,7,7
7353,2,shop,7,9,2
7353,3,education,9,12,3
7353,4,shop,12,14,2
7353,5,home,14,20,6
7353,6,shop,20,21,1
7353,7,home,21,24,3
7353,8,<ENDS>,24,24,0
7354,0,<START>,0,0,0
7354,1,home,0,8,8
7354,2,work,8,15,7
7354,3,home,15,24,9
7354,4,<ENDS>,24,24,0
7355,0,<START>,0,0,0
7355,1,home,0,7,7
7355,2,work,7,13,6
7355,3,home,13,24,11
7355,4,<ENDS>,24,24,0
7356,0,<START>,0,0,0
7356,1,home,0,6,6
7356,2,shop,6,7,1
7356,3,work,7,13,6
7356,4,home,13,24,11
7356,5,<ENDS>,24,24,0
7357,0,<START>,0,0,0
7357,1,home,0,7,7
7357,2,work,7,14,7
7357,3,shop,14,15,1
7357,4,home,15,24,9
7357,5,<ENDS>,24,24,0
7358,0,<START>,0,0,0
7358,1,home,0,9,9
7358,2,work,9,16,7
7358,3,home,16,24,8
7358,4,<ENDS>,24,24,0
7359,0,<START>,0,0,0
7359,1,home,0,6,6
7359,2,work,6,13,7
7359,3,shop,13,14,1
7359,4,home,14,21,7
7359,5,work,21,22,1
7359,6,home,22,24,2
7359,7,<ENDS>,24,24,0
7360,0,<START>,0,0,0
7360,1,home,0,7,7
7360,2,work,7,14,7
7360,3,home,14,24,10
7360,4,<ENDS>,24,24,0
7361,0,<START>,0,0,0
7361,1,home,0,7,7
7361,2,work,7,13,6
7361,3,home,13,17,4
7361,4,work,17,20,3
7361,5,home,20,24,4
7361,6,<ENDS>,24,24,0
7362,0,<START>,0,0,0
7362,1,home,0,7,7
7362,2,work,7,14,7
7362,3,shop,14,15,1
7362,4,work,15,20,5
7362,5,home,20,24,4
7362,6,<ENDS>,24,24,0
7363,0,<START>,0,0,0
7363,1,home,0,7,7
7363,2,shop,7,8,1
7363,3,education,8,11,3
7363,4,home,11,18,7
7363,5,shop,18,20,2
7363,6,home,20,24,4
7363,7,<ENDS>,24,24,0
7364,0,<START>,0,0,0
7364,1,home,0,8,8
7364,2,work,8,15,7
7364,3,shop,15,16,1
7364,4,home,16,23,7
7364,5,work,23,24,1
7364,6,<ENDS>,24,24,0
7365,0,<START>,0,0,0
7365,1,home,0,7,7
7365,2,work,7,13,6
7365,3,home,13,24,11
7365,4,<ENDS>,24,24,0
7366,0,<START>,0,0,0
7366,1,home,0,8,8
7366,2,work,8,15,7
7366,3,shop,15,16,1
7366,4,work,16,20,4
7366,5,home,20,24,4
7366,6,<ENDS>,24,24,0
7367,0,<START>,0,0,0
7367,1,home,0,7,7
7367,2,education,7,11,4
7367,3,home,11,18,7
7367,4,shop,18,20,2
7367,5,home,20,24,4
7367,6,<ENDS>,24,24,0
7368,0,<START>,0,0,0
7368,1,home,0,7,7
7368,2,education,7,12,5
7368,3,home,12,16,4
7368,4,shop,16,17,1
7368,5,home,17,24,7
7368,6,<ENDS>,24,24,0
7369,0,<START>,0,0,0
7369,1,home,0,6,6
7369,2,work,6,13,7
7369,3,shop,13,14,1
7369,4,work,14,20,6
7369,5,home,20,24,4
7369,6,<ENDS>,24,24,0
7370,0,<START>,0,0,0
7370,1,home,0,6,6
7370,2,work,6,13,7
7370,3,home,13,21,8
7370,4,work,21,22,1
7370,5,home,22,24,2
7370,6,<ENDS>,24,24,0
7371,0,<START>,0,0,0
7371,1,home,0,7,7
7371,2,work,7,13,6
7371,3,home,13,24,11
7371,4,<ENDS>,24,24,0
7372,0,<START>,0,0,0
7372,1,home,0,7,7
7372,2,work,7,14,7
7372,3,home,14,20,6
7372,4,shop,20,21,1
7372,5,home,21,24,3
7372,6,<ENDS>,24,24,0
7373,0,<START>,0,0,0
7373,1,home,0,7,7
7373,2,work,7,15,8
7373,3,shop,15,16,1
7373,4,home,16,18,2
7373,5,work,18,20,2
7373,6,home,20,24,4
7373,7,<ENDS>,24,24,0
7374,0,<START>,0,0,0
7374,1,home,0,8,8
7374,2,work,8,15,7
7374,3,home,15,24,9
7374,4,<ENDS>,24,24,0
7375,0,<START>,0,0,0
7375,1,home,0,7,7
7375,2,work,7,8,1
7375,3,home,8,9,1
7375,4,work,9,10,1
7375,5,home,10,14,4
7375,6,work,14,16,2
7375,7,home,16,24,8
7375,8,<ENDS>,24,24,0
7376,0,<START>,0,0,0
7376,1,home,0,7,7
7376,2,education,7,13,6
7376,3,shop,13,14,1
7376,4,education,14,15,1
7376,5,shop,15,17,2
7376,6,home,17,24,7
7376,7,<ENDS>,24,24,0
7377,0,<START>,0,0,0
7377,1,home,0,6,6
7377,2,shop,6,7,1
7377,3,home,7,10,3
7377,4,education,10,11,1
7377,5,home,11,16,5
7377,6,shop,16,17,1
7377,7,home,17,24,7
7377,8,<ENDS>,24,24,0
7378,0,<START>,0,0,0
7378,1,home,0,7,7
7378,2,work,7,13,6
7378,3,home,13,18,5
7378,4,shop,18,19,1
7378,5,home,19,24,5
7378,6,<ENDS>,24,24,0
7379,0,<START>,0,0,0
7379,1,home,0,7,7
7379,2,shop,7,8,1
7379,3,education,8,11,3
7379,4,home,11,18,7
7379,5,shop,18,19,1
7379,6,home,19,24,5
7379,7,<ENDS>,24,24,0
7380,0,<START>,0,0,0
7380,1,home,0,7,7
7380,2,work,7,13,6
7380,3,home,13,24,11
7380,4,<ENDS>,24,24,0
7381,0,<START>,0,0,0
7381,1,home,0,6,6
7381,2,work,6,13,7
7381,3,shop,13,14,1
7381,4,home,14,24,10
7381,5,<ENDS>,24,24,0
7382,0,<START>,0,0,0
7382,1,home,0,8,8
7382,2,education,8,11,3
7382,3,home,11,14,3
7382,4,education,14,17,3
7382,5,home,17,20,3
7382,6,shop,20,21,1
7382,7,home,21,24,3
7382,8,<ENDS>,24,24,0
7383,0,<START>,0,0,0
7383,1,home,0,7,7
7383,2,work,7,14,7
7383,3,home,14,20,6
7383,4,shop,20,21,1
7383,5,home,21,24,3
7383,6,<ENDS>,24,24,0
7384,0,<START>,0,0,0
7384,1,home,0,7,7
7384,2,education,7,12,5
7384,3,home,12,19,7
7384,4,shop,19,21,2
7384,5,home,21,24,3
7384,6,<ENDS>,24,24,0
7385,0,<START>,0,0,0
7385,1,home,0,7,7
7385,2,work,7,14,7
7385,3,shop,14,15,1
7385,4,work,15,20,5
7385,5,home,20,24,4
7385,6,<ENDS>,24,24,0
7386,0,<START>,0,0,0
7386,1,home,0,6,6
7386,2,work,6,12,6
7386,3,shop,12,13,1
7386,4,education,13,15,2
7386,5,work,15,19,4
7386,6,home,19,24,5
7386,7,<ENDS>,24,24,0
7387,0,<START>,0,0,0
7387,1,home,0,8,8
7387,2,education,8,11,3
7387,3,home,11,24,13
7387,4,<ENDS>,24,24,0
7388,0,<START>,0,0,0
7388,1,home,0,8,8
7388,2,work,8,15,7
7388,3,home,15,24,9
7388,4,<ENDS>,24,24,0
7389,0,<START>,0,0,0
7389,1,home,0,7,7
7389,2,work,7,14,7
7389,3,home,14,20,6
7389,4,shop,20,21,1
7389,5,home,21,24,3
7389,6,<ENDS>,24,24,0
7390,0,<START>,0,0,0
7390,1,home,0,7,7
7390,2,shop,7,9,2
7390,3,education,9,12,3
7390,4,shop,12,14,2
7390,5,education,14,16,2
7390,6,home,16,24,8
7390,7,<ENDS>,24,24,0
7391,0,<START>,0,0,0
7391,1,home,0,9,9
7391,2,work,9,16,7
7391,3,home,16,24,8
7391,4,<ENDS>,24,24,0
7392,0,<START>,0,0,0
7392,1,home,0,7,7
7392,2,education,7,13,6
7392,3,home,13,20,7
7392,4,shop,20,21,1
7392,5,home,21,24,3
7392,6,<ENDS>,24,24,0
7393,0,<START>,0,0,0
7393,1,home,0,7,7
7393,2,education,7,10,3
7393,3,home,10,14,4
7393,4,education,14,16,2
7393,5,shop,16,17,1
7393,6,home,17,24,7
7393,7,<ENDS>,24,24,0
7394,0,<START>,0,0,0
7394,1,home,0,8,8
7394,2,work,8,15,7
7394,3,home,15,21,6
7394,4,work,21,22,1
7394,5,home,22,24,2
7394,6,<ENDS>,24,24,0
7395,0,<START>,0,0,0
7395,1,home,0,8,8
7395,2,work,8,14,6
7395,3,home,14,24,10
7395,4,<ENDS>,24,24,0
7396,0,<START>,0,0,0
7396,1,home,0,6,6
7396,2,work,6,7,1
7396,3,home,7,11,4
7396,4,work,11,13,2
7396,5,shop,13,14,1
7396,6,work,14,17,3
7396,7,home,17,23,6
7396,8,work,23,24,1
7396,9,<ENDS>,24,24,0
7397,0,<START>,0,0,0
7397,1,home,0,7,7
7397,2,education,7,12,5
7397,3,home,12,20,8
7397,4,shop,20,21,1
7397,5,home,21,24,3
7397,6,<ENDS>,24,24,0
7398,0,<START>,0,0,0
7398,1,home,0,7,7
7398,2,education,7,12,5
7398,3,shop,12,13,1
7398,4,education,13,16,3
7398,5,shop,16,17,1
7398,6,home,17,24,7
7398,7,<ENDS>,24,24,0
7399,0,<START>,0,0,0
7399,1,home,0,7,7
7399,2,work,7,13,6
7399,3,shop,13,14,1
7399,4,work,14,19,5
7399,5,home,19,24,5
7399,6,<ENDS>,24,24,0
7400,0,<START>,0,0,0
7400,1,home,0,7,7
7400,2,education,7,11,4
7400,3,home,11,14,3
7400,4,education,14,16,2
7400,5,home,16,24,8
7400,6,<ENDS>,24,24,0
7401,0,<START>,0,0,0
7401,1,home,0,7,7
7401,2,work,7,13,6
7401,3,home,13,24,11
7401,4,<ENDS>,24,24,0
7402,0,<START>,0,0,0
7402,1,home,0,7,7
7402,2,shop,7,8,1
7402,3,home,8,11,3
7402,4,work,11,18,7
7402,5,home,18,23,5
7402,6,work,23,24,1
7402,7,<ENDS>,24,24,0
7403,0,<START>,0,0,0
7403,1,home,0,6,6
7403,2,shop,6,7,1
7403,3,home,7,10,3
7403,4,education,10,13,3
7403,5,shop,13,15,2
7403,6,home,15,21,6
7403,7,shop,21,22,1
7403,8,home,22,24,2
7403,9,<ENDS>,24,24,0
7404,0,<START>,0,0,0
7404,1,home,0,7,7
7404,2,education,7,12,5
7404,3,shop,12,14,2
7404,4,education,14,16,2
7404,5,shop,16,17,1
7404,6,home,17,24,7
7404,7,<ENDS>,24,24,0
7405,0,<START>,0,0,0
7405,1,home,0,6,6
7405,2,work,6,13,7
7405,3,home,13,20,7
7405,4,shop,20,21,1
7405,5,home,21,24,3
7405,6,<ENDS>,24,24,0
7406,0,<START>,0,0,0
7406,1,home,0,8,8
7406,2,education,8,11,3
7406,3,home,11,19,8
7406,4,shop,19,20,1
7406,5,home,20,24,4
7406,6,<ENDS>,24,24,0
7407,0,<START>,0,0,0
7407,1,home,0,9,9
7407,2,work,9,17,8
7407,3,home,17,24,7
7407,4,<ENDS>,24,24,0
7408,0,<START>,0,0,0
7408,1,home,0,8,8
7408,2,work,8,15,7
7408,3,shop,15,16,1
7408,4,work,16,20,4
7408,5,home,20,24,4
7408,6,<ENDS>,24,24,0
7409,0,<START>,0,0,0
7409,1,home,0,7,7
7409,2,work,7,9,2
7409,3,home,9,10,1
7409,4,work,10,12,2
7409,5,home,12,17,5
7409,6,work,17,19,2
7409,7,home,19,23,4
7409,8,work,23,24,1
7409,9,<ENDS>,24,24,0
7410,0,<START>,0,0,0
7410,1,home,0,8,8
7410,2,education,8,11,3
7410,3,home,11,16,5
7410,4,shop,16,18,2
7410,5,home,18,24,6
7410,6,<ENDS>,24,24,0
7411,0,<START>,0,0,0
7411,1,home,0,6,6
7411,2,work,6,8,2
7411,3,home,8,14,6
7411,4,work,14,17,3
7411,5,home,17,23,6
7411,6,work,23,24,1
7411,7,<ENDS>,24,24,0
7412,0,<START>,0,0,0
7412,1,home,0,8,8
7412,2,work,8,15,7
7412,3,home,15,20,5
7412,4,shop,20,21,1
7412,5,home,21,24,3
7412,6,<ENDS>,24,24,0
7413,0,<START>,0,0,0
7413,1,home,0,7,7
7413,2,work,7,13,6
7413,3,home,13,17,4
7413,4,work,17,19,2
7413,5,home,19,23,4
7413,6,work,23,24,1
7413,7,<ENDS>,24,24,0
7414,0,<START>,0,0,0
7414,1,home,0,8,8
7414,2,work,8,15,7
7414,3,shop,15,16,1
7414,4,work,16,20,4
7414,5,home,20,24,4
7414,6,<ENDS>,24,24,0
7415,0,<START>,0,0,0
7415,1,home,0,8,8
7415,2,work,8,14,6
7415,3,shop,14,15,1
7415,4,work,15,20,5
7415,5,home,20,24,4
7415,6,<ENDS>,24,24,0
7416,0,<START>,0,0,0
7416,1,home,0,7,7
7416,2,work,7,14,7
7416,3,home,14,21,7
7416,4,shop,21,22,1
7416,5,home,22,24,2
7416,6,<ENDS>,24,24,0
7417,0,<START>,0,0,0
7417,1,home,0,7,7
7417,2,education,7,11,4
7417,3,home,11,14,3
7417,4,education,14,16,2
7417,5,shop,16,17,1
7417,6,home,17,24,7
7417,7,<ENDS>,24,24,0
7418,0,<START>,0,0,0
7418,1,home,0,6,6
7418,2,work,6,13,7
7418,3,home,13,21,8
7418,4,work,21,22,1
7418,5,home,22,24,2
7418,6,<ENDS>,24,24,0
7419,0,<START>,0,0,0
7419,1,home,0,7,7
7419,2,education,7,8,1
7419,3,home,8,14,6
7419,4,education,14,16,2
7419,5,shop,16,17,1
7419,6,home,17,24,7
7419,7,<ENDS>,24,24,0
7420,0,<START>,0,0,0
7420,1,home,0,6,6
7420,2,work,6,13,7
7420,3,home,13,24,11
7420,4,<ENDS>,24,24,0
7421,0,<START>,0,0,0
7421,1,home,0,6,6
7421,2,work,6,13,7
7421,3,home,13,18,5
7421,4,work,18,20,2
7421,5,home,20,24,4
7421,6,<ENDS>,24,24,0
7422,0,<START>,0,0,0
7422,1,home,0,6,6
7422,2,work,6,7,1
7422,3,home,7,12,5
7422,4,work,12,15,3
7422,5,home,15,22,7
7422,6,work,22,23,1
7422,7,home,23,24,1
7422,8,<ENDS>,24,24,0
7423,0,<START>,0,0,0
7423,1,home,0,7,7
7423,2,work,7,14,7
7423,3,shop,14,15,1
7423,4,home,15,22,7
7423,5,work,22,23,1
7423,6,home,23,24,1
7423,7,<ENDS>,24,24,0
7424,0,<START>,0,0,0
7424,1,home,0,7,7
7424,2,work,7,13,6
7424,3,shop,13,14,1
7424,4,education,14,17,3
7424,5,home,17,24,7
7424,6,<ENDS>,24,24,0
7425,0,<START>,0,0,0
7425,1,home,0,7,7
7425,2,work,7,13,6
7425,3,home,13,17,4
7425,4,shop,17,18,1
7425,5,home,18,24,6
7425,6,<ENDS>,24,24,0
7426,0,<START>,0,0,0
7426,1,home,0,7,7
7426,2,work,7,13,6
7426,3,shop,13,14,1
7426,4,work,14,19,5
7426,5,home,19,24,5
7426,6,<ENDS>,24,24,0
7427,0,<START>,0,0,0
7427,1,home,0,7,7
7427,2,work,7,14,7
7427,3,shop,14,15,1
7427,4,home,15,24,9
7427,5,<ENDS>,24,24,0
7428,0,<START>,0,0,0
7428,1,home,0,8,8
7428,2,work,8,15,7
7428,3,shop,15,16,1
7428,4,work,16,20,4
7428,5,home,20,24,4
7428,6,<ENDS>,24,24,0
7429,0,<START>,0,0,0
7429,1,home,0,9,9
7429,2,work,9,16,7
7429,3,home,16,24,8
7429,4,<ENDS>,24,24,0
7430,0,<START>,0,0,0
7430,1,home,0,6,6
7430,2,work,6,13,7
7430,3,home,13,19,6
7430,4,shop,19,20,1
7430,5,home,20,24,4
7430,6,<ENDS>,24,24,0
7431,0,<START>,0,0,0
7431,1,home,0,7,7
7431,2,work,7,14,7
7431,3,shop,14,15,1
7431,4,home,15,23,8
7431,5,work,23,24,1
7431,6,<ENDS>,24,24,0
7432,0,<START>,0,0,0
7432,1,home,0,8,8
7432,2,education,8,11,3
7432,3,home,11,17,6
7432,4,shop,17,18,1
7432,5,home,18,24,6
7432,6,<ENDS>,24,24,0
7433,0,<START>,0,0,0
7433,1,home,0,6,6
7433,2,shop,6,7,1
7433,3,home,7,9,2
7433,4,education,9,12,3
7433,5,home,12,17,5
7433,6,shop,17,18,1
7433,7,home,18,24,6
7433,8,<ENDS>,24,24,0
7434,0,<START>,0,0,0
7434,1,home,0,6,6
7434,2,work,6,12,6
7434,3,shop,12,13,1
7434,4,work,13,19,6
7434,5,home,19,24,5
7434,6,<ENDS>,24,24,0
7435,0,<START>,0,0,0
7435,1,home,0,7,7
7435,2,education,7,13,6
7435,3,shop,13,15,2
7435,4,home,15,24,9
7435,5,<ENDS>,24,24,0
7436,0,<START>,0,0,0
7436,1,home,0,6,6
7436,2,work,6,8,2
7436,3,home,8,13,5
7436,4,work,13,15,2
7436,5,home,15,21,6
7436,6,work,21,22,1
7436,7,home,22,24,2
7436,8,<ENDS>,24,24,0
7437,0,<START>,0,0,0
7437,1,home,0,7,7
7437,2,work,7,14,7
7437,3,home,14,18,4
7437,4,work,18,20,2
7437,5,home,20,24,4
7437,6,<ENDS>,24,24,0
7438,0,<START>,0,0,0
7438,1,home,0,6,6
7438,2,work,6,8,2
7438,3,home,8,11,3
7438,4,work,11,12,1
7438,5,home,12,16,4
7438,6,work,16,18,2
7438,7,home,18,24,6
7438,8,<ENDS>,24,24,0
7439,0,<START>,0,0,0
7439,1,home,0,8,8
7439,2,work,8,15,7
7439,3,home,15,24,9
7439,4,<ENDS>,24,24,0
7440,0,<START>,0,0,0
7440,1,home,0,6,6
7440,2,work,6,13,7
7440,3,shop,13,14,1
7440,4,home,14,23,9
7440,5,work,23,24,1
7440,6,<ENDS>,24,24,0
7441,0,<START>,0,0,0
7441,1,home,0,7,7
7441,2,work,7,13,6
7441,3,home,13,17,4
7441,4,work,17,19,2
7441,5,home,19,24,5
7441,6,<ENDS>,24,24,0
7442,0,<START>,0,0,0
7442,1,home,0,7,7
7442,2,work,7,13,6
7442,3,home,13,24,11
7442,4,<ENDS>,24,24,0
7443,0,<START>,0,0,0
7443,1,home,0,7,7
7443,2,work,7,14,7
7443,3,shop,14,15,1
7443,4,work,15,20,5
7443,5,home,20,24,4
7443,6,<ENDS>,24,24,0
7444,0,<START>,0,0,0
7444,1,home,0,8,8
7444,2,shop,8,9,1
7444,3,work,9,16,7
7444,4,home,16,21,5
7444,5,work,21,22,1
7444,6,home,22,24,2
7444,7,<ENDS>,24,24,0
7445,0,<START>,0,0,0
7445,1,home,0,7,7
7445,2,work,7,14,7
7445,3,home,14,24,10
7445,4,<ENDS>,24,24,0
7446,0,<START>,0,0,0
7446,1,home,0,7,7
7446,2,education,7,11,4
7446,3,home,11,20,9
7446,4,shop,20,21,1
7446,5,home,21,24,3
7446,6,<ENDS>,24,24,0
7447,0,<START>,0,0,0
7447,1,home,0,7,7
7447,2,work,7,13,6
7447,3,home,13,24,11
7447,4,<ENDS>,24,24,0
7448,0,<START>,0,0,0
7448,1,home,0,6,6
7448,2,work,6,8,2
7448,3,home,8,13,5
7448,4,work,13,15,2
7448,5,home,15,21,6
7448,6,work,21,22,1
7448,7,home,22,24,2
7448,8,<ENDS>,24,24,0
7449,0,<START>,0,0,0
7449,1,home,0,6,6
7449,2,shop,6,7,1
7449,3,home,7,9,2
7449,4,education,9,12,3
7449,5,home,12,18,6
7449,6,shop,18,20,2
7449,7,home,20,24,4
7449,8,<ENDS>,24,24,0
7450,0,<START>,0,0,0
7450,1,home,0,6,6
7450,2,work,6,13,7
7450,3,home,13,24,11
7450,4,<ENDS>,24,24,0
7451,0,<START>,0,0,0
7451,1,home,0,7,7
7451,2,work,7,10,3
7451,3,home,10,16,6
7451,4,work,16,18,2
7451,5,home,18,24,6
7451,6,<ENDS>,24,24,0
7452,0,<START>,0,0,0
7452,1,home,0,7,7
7452,2,work,7,13,6
7452,3,home,13,18,5
7452,4,work,18,19,1
7452,5,home,19,24,5
7452,6,<ENDS>,24,24,0
7453,0,<START>,0,0,0
7453,1,home,0,6,6
7453,2,work,6,13,7
7453,3,home,13,17,4
7453,4,work,17,20,3
7453,5,home,20,24,4
7453,6,<ENDS>,24,24,0
7454,0,<START>,0,0,0
7454,1,home,0,6,6
7454,2,shop,6,7,1
7454,3,home,7,13,6
7454,4,education,13,16,3
7454,5,shop,16,18,2
7454,6,home,18,24,6
7454,7,<ENDS>,24,24,0
7455,0,<START>,0,0,0
7455,1,home,0,6,6
7455,2,work,6,13,7
7455,3,shop,13,14,1
7455,4,work,14,20,6
7455,5,home,20,24,4
7455,6,<ENDS>,24,24,0
7456,0,<START>,0,0,0
7456,1,home,0,7,7
7456,2,work,7,13,6
7456,3,shop,13,14,1
7456,4,home,14,24,10
7456,5,<ENDS>,24,24,0
7457,0,<START>,0,0,0
7457,1,home,0,7,7
7457,2,work,7,14,7
7457,3,home,14,21,7
7457,4,work,21,22,1
7457,5,home,22,24,2
7457,6,<ENDS>,24,24,0
7458,0,<START>,0,0,0
7458,1,home,0,8,8
7458,2,work,8,15,7
7458,3,home,15,21,6
7458,4,work,21,22,1
7458,5,home,22,24,2
7458,6,<ENDS>,24,24,0
7459,0,<START>,0,0,0
7459,1,home,0,6,6
7459,2,work,6,8,2
7459,3,home,8,14,6
7459,4,work,14,16,2
7459,5,home,16,22,6
7459,6,work,22,23,1
7459,7,home,23,24,1
7459,8,<ENDS>,24,24,0
7460,0,<START>,0,0,0
7460,1,home,0,7,7
7460,2,education,7,13,6
7460,3,shop,13,15,2
7460,4,home,15,21,6
7460,5,shop,21,22,1
7460,6,home,22,24,2
7460,7,<ENDS>,24,24,0
7461,0,<START>,0,0,0
7461,1,home,0,9,9
7461,2,work,9,16,7
7461,3,home,16,24,8
7461,4,<ENDS>,24,24,0
7462,0,<START>,0,0,0
7462,1,home,0,7,7
7462,2,education,7,11,4
7462,3,home,11,18,7
7462,4,shop,18,19,1
7462,5,home,19,24,5
7462,6,<ENDS>,24,24,0
7463,0,<START>,0,0,0
7463,1,home,0,6,6
7463,2,shop,6,7,1
7463,3,home,7,10,3
7463,4,education,10,13,3
7463,5,home,13,17,4
7463,6,shop,17,18,1
7463,7,home,18,24,6
7463,8,<ENDS>,24,24,0
7464,0,<START>,0,0,0
7464,1,home,0,7,7
7464,2,work,7,13,6
7464,3,shop,13,14,1
7464,4,home,14,23,9
7464,5,work,23,24,1
7464,6,<ENDS>,24,24,0
7465,0,<START>,0,0,0
7465,1,home,0,6,6
7465,2,work,6,13,7
7465,3,home,13,21,8
7465,4,shop,21,22,1
7465,5,home,22,24,2
7465,6,<ENDS>,24,24,0
7466,0,<START>,0,0,0
7466,1,home,0,7,7
7466,2,work,7,13,6
7466,3,home,13,24,11
7466,4,<ENDS>,24,24,0
7467,0,<START>,0,0,0
7467,1,home,0,7,7
7467,2,work,7,14,7
7467,3,home,14,22,8
7467,4,work,22,23,1
7467,5,home,23,24,1
7467,6,<ENDS>,24,24,0
7468,0,<START>,0,0,0
7468,1,home,0,8,8
7468,2,work,8,15,7
7468,3,home,15,24,9
7468,4,<ENDS>,24,24,0
7469,0,<START>,0,0,0
7469,1,home,0,6,6
7469,2,work,6,13,7
7469,3,home,13,24,11
7469,4,<ENDS>,24,24,0
7470,0,<START>,0,0,0
7470,1,home,0,8,8
7470,2,shop,8,9,1
7470,3,home,9,21,12
7470,4,work,21,22,1
7470,5,home,22,24,2
7470,6,<ENDS>,24,24,0
7471,0,<START>,0,0,0
7471,1,home,0,7,7
7471,2,shop,7,8,1
7471,3,work,8,14,6
7471,4,home,14,24,10
7471,5,<ENDS>,24,24,0
7472,0,<START>,0,0,0
7472,1,home,0,7,7
7472,2,work,7,14,7
7472,3,shop,14,15,1
7472,4,work,15,19,4
7472,5,home,19,24,5
7472,6,<ENDS>,24,24,0
7473,0,<START>,0,0,0
7473,1,home,0,8,8
7473,2,work,8,15,7
7473,3,home,15,24,9
7473,4,<ENDS>,24,24,0
7474,0,<START>,0,0,0
7474,1,home,0,8,8
7474,2,work,8,16,8
7474,3,home,16,24,8
7474,4,<ENDS>,24,24,0
7475,0,<START>,0,0,0
7475,1,home,0,7,7
7475,2,shop,7,9,2
7475,3,education,9,12,3
7475,4,home,12,14,2
7475,5,education,14,16,2
7475,6,home,16,24,8
7475,7,<ENDS>,24,24,0
7476,0,<START>,0,0,0
7476,1,home,0,8,8
7476,2,work,8,14,6
7476,3,home,14,24,10
7476,4,<ENDS>,24,24,0
7477,0,<START>,0,0,0
7477,1,home,0,6,6
7477,2,shop,6,7,1
7477,3,home,7,10,3
7477,4,education,10,16,6
7477,5,home,16,24,8
7477,6,<ENDS>,24,24,0
7478,0,<START>,0,0,0
7478,1,home,0,6,6
7478,2,work,6,13,7
7478,3,shop,13,15,2
7478,4,work,15,19,4
7478,5,home,19,24,5
7478,6,<ENDS>,24,24,0
7479,0,<START>,0,0,0
7479,1,home,0,7,7
7479,2,education,7,12,5
7479,3,shop,12,14,2
7479,4,education,14,16,2
7479,5,home,16,24,8
7479,6,<ENDS>,24,24,0
7480,0,<START>,0,0,0
7480,1,home,0,7,7
7480,2,work,7,13,6
7480,3,home,13,20,7
7480,4,shop,20,21,1
7480,5,home,21,24,3
7480,6,<ENDS>,24,24,0
7481,0,<START>,0,0,0
7481,1,home,0,6,6
7481,2,work,6,8,2
7481,3,home,8,9,1
7481,4,work,9,11,2
7481,5,home,11,18,7
7481,6,work,18,20,2
7481,7,home,20,24,4
7481,8,<ENDS>,24,24,0
7482,0,<START>,0,0,0
7482,1,home,0,7,7
7482,2,work,7,14,7
7482,3,home,14,22,8
7482,4,work,22,23,1
7482,5,home,23,24,1
7482,6,<ENDS>,24,24,0
7483,0,<START>,0,0,0
7483,1,home,0,7,7
7483,2,education,7,11,4
7483,3,home,11,18,7
7483,4,shop,18,19,1
7483,5,home,19,24,5
7483,6,<ENDS>,24,24,0
7484,0,<START>,0,0,0
7484,1,home,0,7,7
7484,2,shop,7,8,1
7484,3,work,8,13,5
7484,4,home,13,17,4
7484,5,work,17,20,3
7484,6,home,20,24,4
7484,7,<ENDS>,24,24,0
7485,0,<START>,0,0,0
7485,1,home,0,6,6
7485,2,shop,6,7,1
7485,3,home,7,9,2
7485,4,education,9,15,6
7485,5,shop,15,17,2
7485,6,home,17,24,7
7485,7,<ENDS>,24,24,0
7486,0,<START>,0,0,0
7486,1,home,0,7,7
7486,2,work,7,13,6
7486,3,shop,13,14,1
7486,4,home,14,24,10
7486,5,<ENDS>,24,24,0
7487,0,<START>,0,0,0
7487,1,home,0,6,6
7487,2,work,6,13,7
7487,3,home,13,18,5
7487,4,work,18,20,2
7487,5,home,20,24,4
7487,6,<ENDS>,24,24,0
7488,0,<START>,0,0,0
7488,1,home,0,7,7
7488,2,education,7,14,7
7488,3,shop,14,15,1
7488,4,home,15,21,6
7488,5,shop,21,22,1
7488,6,home,22,24,2
7488,7,<ENDS>,24,24,0
7489,0,<START>,0,0,0
7489,1,home,0,7,7
7489,2,work,7,14,7
7489,3,home,14,18,4
7489,4,work,18,20,2
7489,5,home,20,24,4
7489,6,<ENDS>,24,24,0
7490,0,<START>,0,0,0
7490,1,home,0,8,8
7490,2,work,8,15,7
7490,3,shop,15,16,1
7490,4,work,16,20,4
7490,5,home,20,24,4
7490,6,<ENDS>,24,24,0
7491,0,<START>,0,0,0
7491,1,home,0,7,7
7491,2,education,7,11,4
7491,3,home,11,18,7
7491,4,shop,18,19,1
7491,5,home,19,24,5
7491,6,<ENDS>,24,24,0
7492,0,<START>,0,0,0
7492,1,home,0,7,7
7492,2,work,7,13,6
7492,3,shop,13,14,1
7492,4,home,14,20,6
7492,5,shop,20,21,1
7492,6,home,21,24,3
7492,7,<ENDS>,24,24,0
7493,0,<START>,0,0,0
7493,1,home,0,8,8
7493,2,work,8,14,6
7493,3,shop,14,15,1
7493,4,home,15,24,9
7493,5,<ENDS>,24,24,0
7494,0,<START>,0,0,0
7494,1,home,0,8,8
7494,2,education,8,11,3
7494,3,home,11,16,5
7494,4,work,16,20,4
7494,5,home,20,24,4
7494,6,<ENDS>,24,24,0
7495,0,<START>,0,0,0
7495,1,home,0,7,7
7495,2,work,7,13,6
7495,3,shop,13,15,2
7495,4,home,15,24,9
7495,5,<ENDS>,24,24,0
7496,0,<START>,0,0,0
7496,1,home,0,7,7
7496,2,education,7,12,5
7496,3,home,12,18,6
7496,4,shop,18,19,1
7496,5,home,19,24,5
7496,6,<ENDS>,24,24,0
7497,0,<START>,0,0,0
7497,1,home,0,6,6
7497,2,work,6,13,7
7497,3,home,13,19,6
7497,4,shop,19,20,1
7497,5,home,20,24,4
7497,6,<ENDS>,24,24,0
7498,0,<START>,0,0,0
7498,1,home,0,6,6
7498,2,shop,6,7,1
7498,3,home,7,9,2
7498,4,work,9,17,8
7498,5,home,17,24,7
7498,6,<ENDS>,24,24,0
7499,0,<START>,0,0,0
7499,1,home,0,7,7
7499,2,work,7,13,6
7499,3,shop,13,14,1
7499,4,home,14,24,10
7499,5,<ENDS>,24,24,0
7500,0,<START>,0,0,0
7500,1,home,0,7,7
7500,2,work,7,13,6
7500,3,shop,13,14,1
7500,4,home,14,24,10
7500,5,<ENDS>,24,24,0
7501,0,<START>,0,0,0
7501,1,home,0,6,6
7501,2,work,6,13,7
7501,3,home,13,19,6
7501,4,shop,19,20,1
7501,5,home,20,24,4
7501,6,<ENDS>,24,24,0
7502,0,<START>,0,0,0
7502,1,home,0,7,7
7502,2,shop,7,8,1
7502,3,education,8,12,4
7502,4,home,12,19,7
7502,5,shop,19,21,2
7502,6,home,21,24,3
7502,7,<ENDS>,24,24,0
7503,0,<START>,0,0,0
7503,1,home,0,6,6
7503,2,shop,6,7,1
7503,3,home,7,10,3
7503,4,education,10,14,4
7503,5,shop,14,15,1
7503,6,home,15,21,6
7503,7,shop,21,22,1
7503,8,home,22,24,2
7503,9,<ENDS>,24,24,0
7504,0,<START>,0,0,0
7504,1,home,0,6,6
7504,2,work,6,8,2
7504,3,home,8,12,4
7504,4,work,12,14,2
7504,5,home,14,21,7
7504,6,work,21,22,1
7504,7,home,22,24,2
7504,8,<ENDS>,24,24,0
7505,0,<START>,0,0,0
7505,1,home,0,7,7
7505,2,work,7,13,6
7505,3,home,13,17,4
7505,4,work,17,18,1
7505,5,home,18,24,6
7505,6,<ENDS>,24,24,0
7506,0,<START>,0,0,0
7506,1,home,0,7,7
7506,2,shop,7,9,2
7506,3,education,9,12,3
7506,4,home,12,20,8
7506,5,shop,20,21,1
7506,6,home,21,24,3
7506,7,<ENDS>,24,24,0
7507,0,<START>,0,0,0
7507,1,home,0,9,9
7507,2,education,9,12,3
7507,3,home,12,13,1
7507,4,work,13,20,7
7507,5,home,20,24,4
7507,6,<ENDS>,24,24,0
7508,0,<START>,0,0,0
7508,1,home,0,7,7
7508,2,work,7,9,2
7508,3,home,9,14,5
7508,4,work,14,17,3
7508,5,home,17,23,6
7508,6,work,23,24,1
7508,7,<ENDS>,24,24,0
7509,0,<START>,0,0,0
7509,1,home,0,6,6
7509,2,work,6,12,6
7509,3,shop,12,13,1
7509,4,work,13,19,6
7509,5,education,19,20,1
7509,6,home,20,24,4
7509,7,<ENDS>,24,24,0
7510,0,<START>,0,0,0
7510,1,home,0,7,7
7510,2,work,7,13,6
7510,3,shop,13,14,1
7510,4,work,14,19,5
7510,5,home,19,24,5
7510,6,<ENDS>,24,24,0
7511,0,<START>,0,0,0
7511,1,home,0,6,6
7511,2,work,6,8,2
7511,3,home,8,12,4
7511,4,work,12,14,2
7511,5,home,14,18,4
7511,6,work,18,20,2
7511,7,home,20,24,4
7511,8,<ENDS>,24,24,0
7512,0,<START>,0,0,0
7512,1,home,0,6,6
7512,2,shop,6,7,1
7512,3,home,7,11,4
7512,4,shop,11,12,1
7512,5,home,12,17,5
7512,6,work,17,20,3
7512,7,home,20,24,4
7512,8,<ENDS>,24,24,0
7513,0,<START>,0,0,0
7513,1,home,0,7,7
7513,2,education,7,12,5
7513,3,shop,12,14,2
7513,4,education,14,16,2
7513,5,home,16,24,8
7513,6,<ENDS>,24,24,0
7514,0,<START>,0,0,0
7514,1,home,0,6,6
7514,2,work,6,13,7
7514,3,home,13,24,11
7514,4,<ENDS>,24,24,0
7515,0,<START>,0,0,0
7515,1,home,0,8,8
7515,2,shop,8,9,1
7515,3,work,9,16,7
7515,4,home,16,24,8
7515,5,<ENDS>,24,24,0
7516,0,<START>,0,0,0
7516,1,home,0,7,7
7516,2,work,7,13,6
7516,3,shop,13,14,1
7516,4,home,14,24,10
7516,5,<ENDS>,24,24,0
7517,0,<START>,0,0,0
7517,1,home,0,8,8
7517,2,work,8,15,7
7517,3,home,15,16,1
7517,4,shop,16,17,1
7517,5,work,17,20,3
7517,6,home,20,24,4
7517,7,<ENDS>,24,24,0
7518,0,<START>,0,0,0
7518,1,home,0,6,6
7518,2,shop,6,7,1
7518,3,home,7,9,2
7518,4,education,9,12,3
7518,5,home,12,19,7
7518,6,shop,19,21,2
7518,7,home,21,24,3
7518,8,<ENDS>,24,24,0
7519,0,<START>,0,0,0
7519,1,home,0,7,7
7519,2,work,7,13,6
7519,3,home,13,24,11
7519,4,<ENDS>,24,24,0
7520,0,<START>,0,0,0
7520,1,home,0,7,7
7520,2,work,7,14,7
7520,3,home,14,24,10
7520,4,<ENDS>,24,24,0
7521,0,<START>,0,0,0
7521,1,home,0,7,7
7521,2,work,7,9,2
7521,3,home,9,16,7
7521,4,work,16,18,2
7521,5,home,18,24,6
7521,6,<ENDS>,24,24,0
7522,0,<START>,0,0,0
7522,1,home,0,6,6
7522,2,work,6,9,3
7522,3,home,9,15,6
7522,4,work,15,17,2
7522,5,home,17,24,7
7522,6,<ENDS>,24,24,0
7523,0,<START>,0,0,0
7523,1,home,0,6,6
7523,2,work,6,13,7
7523,3,home,13,17,4
7523,4,work,17,20,3
7523,5,home,20,24,4
7523,6,<ENDS>,24,24,0
7524,0,<START>,0,0,0
7524,1,home,0,7,7
7524,2,work,7,14,7
7524,3,shop,14,15,1
7524,4,work,15,19,4
7524,5,education,19,20,1
7524,6,home,20,24,4
7524,7,<ENDS>,24,24,0
7525,0,<START>,0,0,0
7525,1,home,0,7,7
7525,2,education,7,12,5
7525,3,shop,12,14,2
7525,4,education,14,16,2
7525,5,shop,16,18,2
7525,6,home,18,24,6
7525,7,<ENDS>,24,24,0
7526,0,<START>,0,0,0
7526,1,home,0,7,7
7526,2,shop,7,8,1
7526,3,education,8,11,3
7526,4,home,11,19,8
7526,5,shop,19,20,1
7526,6,home,20,24,4
7526,7,<ENDS>,24,24,0
7527,0,<START>,0,0,0
7527,1,home,0,8,8
7527,2,work,8,15,7
7527,3,home,15,17,2
7527,4,work,17,20,3
7527,5,home,20,24,4
7527,6,<ENDS>,24,24,0
7528,0,<START>,0,0,0
7528,1,home,0,8,8
7528,2,work,8,15,7
7528,3,shop,15,16,1
7528,4,home,16,24,8
7528,5,<ENDS>,24,24,0
7529,0,<START>,0,0,0
7529,1,home,0,6,6
7529,2,shop,6,7,1
7529,3,home,7,11,4
7529,4,work,11,18,7
7529,5,home,18,24,6
7529,6,<ENDS>,24,24,0
7530,0,<START>,0,0,0
7530,1,home,0,8,8
7530,2,work,8,14,6
7530,3,shop,14,15,1
7530,4,work,15,20,5
7530,5,home,20,24,4
7530,6,<ENDS>,24,24,0
7531,0,<START>,0,0,0
7531,1,home,0,7,7
7531,2,work,7,9,2
7531,3,home,9,12,3
7531,4,work,12,15,3
7531,5,home,15,21,6
7531,6,work,21,22,1
7531,7,home,22,24,2
7531,8,<ENDS>,24,24,0
7532,0,<START>,0,0,0
7532,1,home,0,7,7
7532,2,shop,7,8,1
7532,3,education,8,11,3
7532,4,home,11,17,6
7532,5,shop,17,19,2
7532,6,home,19,24,5
7532,7,<ENDS>,24,24,0
7533,0,<START>,0,0,0
7533,1,home,0,6,6
7533,2,work,6,13,7
7533,3,shop,13,14,1
7533,4,work,14,18,4
7533,5,home,18,24,6
7533,6,<ENDS>,24,24,0
7534,0,<START>,0,0,0
7534,1,home,0,7,7
7534,2,work,7,13,6
7534,3,home,13,17,4
7534,4,work,17,20,3
7534,5,home,20,24,4
7534,6,<ENDS>,24,24,0
7535,0,<START>,0,0,0
7535,1,home,0,6,6
7535,2,shop,6,7,1
7535,3,home,7,13,6
7535,4,education,13,16,3
7535,5,home,16,24,8
7535,6,<ENDS>,24,24,0
7536,0,<START>,0,0,0
7536,1,home,0,6,6
7536,2,work,6,8,2
7536,3,home,8,14,6
7536,4,work,14,17,3
7536,5,home,17,21,4
7536,6,work,21,22,1
7536,7,home,22,24,2
7536,8,<ENDS>,24,24,0
7537,0,<START>,0,0,0
7537,1,home,0,8,8
7537,2,work,8,15,7
7537,3,home,15,21,6
7537,4,work,21,22,1
7537,5,home,22,24,2
7537,6,<ENDS>,24,24,0
7538,0,<START>,0,0,0
7538,1,home,0,6,6
7538,2,work,6,13,7
7538,3,home,13,24,11
7538,4,<ENDS>,24,24,0
7539,0,<START>,0,0,0
7539,1,home,0,8,8
7539,2,work,8,15,7
7539,3,shop,15,16,1
7539,4,home,16,24,8
7539,5,<ENDS>,24,24,0
7540,0,<START>,0,0,0
7540,1,home,0,7,7
7540,2,education,7,11,4
7540,3,home,11,18,7
7540,4,shop,18,19,1
7540,5,home,19,24,5
7540,6,<ENDS>,24,24,0
7541,0,<START>,0,0,0
7541,1,home,0,8,8
7541,2,shop,8,9,1
7541,3,work,9,16,7
7541,4,home,16,24,8
7541,5,<ENDS>,24,24,0
7542,0,<START>,0,0,0
7542,1,home,0,7,7
7542,2,work,7,13,6
7542,3,shop,13,14,1
7542,4,home,14,24,10
7542,5,<ENDS>,24,24,0
7543,0,<START>,0,0,0
7543,1,home,0,7,7
7543,2,work,7,14,7
7543,3,home,14,19,5
7543,4,shop,19,20,1
7543,5,home,20,24,4
7543,6,<ENDS>,24,24,0
7544,0,<START>,0,0,0
7544,1,home,0,8,8
7544,2,work,8,15,7
7544,3,shop,15,16,1
7544,4,home,16,24,8
7544,5,<ENDS>,24,24,0
7545,0,<START>,0,0,0
7545,1,home,0,7,7
7545,2,education,7,10,3
7545,3,home,10,14,4
7545,4,education,14,16,2
7545,5,shop,16,18,2
7545,6,home,18,24,6
7545,7,<ENDS>,24,24,0
7546,0,<START>,0,0,0
7546,1,home,0,7,7
7546,2,education,7,11,4
7546,3,home,11,18,7
7546,4,shop,18,19,1
7546,5,home,19,24,5
7546,6,<ENDS>,24,24,0
7547,0,<START>,0,0,0
7547,1,home,0,8,8
7547,2,shop,8,9,1
7547,3,home,9,12,3
7547,4,shop,12,13,1
7547,5,education,13,16,3
7547,6,home,16,24,8
7547,7,<ENDS>,24,24,0
7548,0,<START>,0,0,0
7548,1,home,0,6,6
7548,2,work,6,8,2
7548,3,home,8,13,5
7548,4,work,13,15,2
7548,5,shop,15,16,1
7548,6,work,16,18,2
7548,7,home,18,24,6
7548,8,<ENDS>,24,24,0
7549,0,<START>,0,0,0
7549,1,home,0,7,7
7549,2,shop,7,8,1
7549,3,work,8,15,7
7549,4,shop,15,16,1
7549,5,home,16,24,8
7549,6,<ENDS>,24,24,0
7550,0,<START>,0,0,0
7550,1,home,0,6,6
7550,2,shop,6,7,1
7550,3,work,7,9,2
7550,4,home,9,15,6
7550,5,work,15,17,2
7550,6,home,17,23,6
7550,7,work,23,24,1
7550,8,<ENDS>,24,24,0
7551,0,<START>,0,0,0
7551,1,home,0,6,6
7551,2,work,6,13,7
7551,3,home,13,17,4
7551,4,work,17,20,3
7551,5,home,20,24,4
7551,6,<ENDS>,24,24,0
7552,0,<START>,0,0,0
7552,1,home,0,9,9
7552,2,work,9,15,6
7552,3,home,15,23,8
7552,4,work,23,24,1
7552,5,<ENDS>,24,24,0
7553,0,<START>,0,0,0
7553,1,home,0,7,7
7553,2,work,7,8,1
7553,3,shop,8,9,1
7553,4,home,9,13,4
7553,5,work,13,15,2
7553,6,home,15,21,6
7553,7,work,21,22,1
7553,8,home,22,24,2
7553,9,<ENDS>,24,24,0
7554,0,<START>,0,0,0
7554,1,work,0,11,11
7554,2,shop,11,12,1
7554,3,work,12,19,7
7554,4,home,19,24,5
7554,5,<ENDS>,24,24,0
7555,0,<START>,0,0,0
7555,1,home,0,6,6
7555,2,work,6,8,2
7555,3,home,8,10,2
7555,4,work,10,11,1
7555,5,home,11,15,4
7555,6,work,15,17,2
7555,7,home,17,21,4
7555,8,work,21,22,1
7555,9,home,22,24,2
7555,10,<ENDS>,24,24,0
7556,0,<START>,0,0,0
7556,1,home,0,7,7
7556,2,education,7,11,4
7556,3,home,11,18,7
7556,4,shop,18,19,1
7556,5,home,19,24,5
7556,6,<ENDS>,24,24,0
7557,0,<START>,0,0,0
7557,1,home,0,8,8
7557,2,work,8,15,7
7557,3,shop,15,16,1
7557,4,home,16,24,8
7557,5,<ENDS>,24,24,0
7558,0,<START>,0,0,0
7558,1,home,0,7,7
7558,2,work,7,13,6
7558,3,shop,13,14,1
7558,4,home,14,24,10
7558,5,<ENDS>,24,24,0
7559,0,<START>,0,0,0
7559,1,home,0,8,8
7559,2,work,8,14,6
7559,3,shop,14,15,1
7559,4,home,15,22,7
7559,5,work,22,23,1
7559,6,home,23,24,1
7559,7,<ENDS>,24,24,0
7560,0,<START>,0,0,0
7560,1,home,0,7,7
7560,2,education,7,11,4
7560,3,home,11,18,7
7560,4,shop,18,20,2
7560,5,home,20,24,4
7560,6,<ENDS>,24,24,0
7561,0,<START>,0,0,0
7561,1,home,0,8,8
7561,2,work,8,15,7
7561,3,home,15,24,9
7561,4,<ENDS>,24,24,0
7562,0,<START>,0,0,0
7562,1,home,0,8,8
7562,2,work,8,16,8
7562,3,home,16,24,8
7562,4,<ENDS>,24,24,0
7563,0,<START>,0,0,0
7563,1,home,0,6,6
7563,2,work,6,13,7
7563,3,shop,13,14,1
7563,4,home,14,24,10
7563,5,<ENDS>,24,24,0
7564,0,<START>,0,0,0
7564,1,home,0,6,6
7564,2,shop,6,7,1
7564,3,work,7,13,6
7564,4,shop,13,14,1
7564,5,home,14,24,10
7564,6,<ENDS>,24,24,0
7565,0,<START>,0,0,0
7565,1,home,0,7,7
7565,2,education,7,10,3
7565,3,home,10,13,3
7565,4,education,13,16,3
7565,5,home,16,24,8
7565,6,<ENDS>,24,24,0
7566,0,<START>,0,0,0
7566,1,home,0,7,7
7566,2,work,7,13,6
7566,3,shop,13,14,1
7566,4,home,14,18,4
7566,5,work,18,20,2
7566,6,home,20,24,4
7566,7,<ENDS>,24,24,0
7567,0,<START>,0,0,0
7567,1,home,0,6,6
7567,2,work,6,13,7
7567,3,shop,13,14,1
7567,4,home,14,24,10
7567,5,<ENDS>,24,24,0
7568,0,<START>,0,0,0
7568,1,home,0,6,6
7568,2,work,6,13,7
7568,3,home,13,24,11
7568,4,<ENDS>,24,24,0
7569,0,<START>,0,0,0
7569,1,home,0,8,8
7569,2,work,8,13,5
7569,3,home,13,24,11
7569,4,<ENDS>,24,24,0
7570,0,<START>,0,0,0
7570,1,home,0,7,7
7570,2,work,7,9,2
7570,3,home,9,15,6
7570,4,work,15,17,2
7570,5,home,17,23,6
7570,6,work,23,24,1
7570,7,<ENDS>,24,24,0
7571,0,<START>,0,0,0
7571,1,home,0,8,8
7571,2,work,8,15,7
7571,3,home,15,24,9
7571,4,<ENDS>,24,24,0
7572,0,<START>,0,0,0
7572,1,home,0,7,7
7572,2,work,7,13,6
7572,3,home,13,24,11
7572,4,<ENDS>,24,24,0
7573,0,<START>,0,0,0
7573,1,home,0,7,7
7573,2,work,7,13,6
7573,3,home,13,21,8
7573,4,shop,21,22,1
7573,5,home,22,24,2
7573,6,<ENDS>,24,24,0
7574,0,<START>,0,0,0
7574,1,home,0,8,8
7574,2,work,8,15,7
7574,3,home,15,18,3
7574,4,shop,18,19,1
7574,5,home,19,24,5
7574,6,<ENDS>,24,24,0
7575,0,<START>,0,0,0
7575,1,home,0,7,7
7575,2,shop,7,8,1
7575,3,home,8,10,2
7575,4,education,10,12,2
7575,5,shop,12,13,1
7575,6,education,13,16,3
7575,7,shop,16,17,1
7575,8,home,17,21,4
7575,9,shop,21,22,1
7575,10,home,22,24,2
7575,11,<ENDS>,24,24,0
7576,0,<START>,0,0,0
7576,1,home,0,6,6
7576,2,work,6,13,7
7576,3,home,13,19,6
7576,4,shop,19,20,1
7576,5,home,20,24,4
7576,6,<ENDS>,24,24,0
7577,0,<START>,0,0,0
7577,1,home,0,6,6
7577,2,work,6,13,7
7577,3,shop,13,14,1
7577,4,work,14,17,3
7577,5,home,17,24,7
7577,6,<ENDS>,24,24,0
7578,0,<START>,0,0,0
7578,1,home,0,6,6
7578,2,work,6,13,7
7578,3,shop,13,14,1
7578,4,home,14,24,10
7578,5,<ENDS>,24,24,0
7579,0,<START>,0,0,0
7579,1,home,0,7,7
7579,2,work,7,9,2
7579,3,home,9,14,5
7579,4,work,14,15,1
7579,5,home,15,22,7
7579,6,work,22,23,1
7579,7,home,23,24,1
7579,8,<ENDS>,24,24,0
7580,0,<START>,0,0,0
7580,1,home,0,7,7
7580,2,work,7,14,7
7580,3,home,14,24,10
7580,4,<ENDS>,24,24,0
7581,0,<START>,0,0,0
7581,1,home,0,6,6
7581,2,work,6,13,7
7581,3,home,13,18,5
7581,4,work,18,20,2
7581,5,home,20,24,4
7581,6,<ENDS>,24,24,0
7582,0,<START>,0,0,0
7582,1,home,0,8,8
7582,2,work,8,15,7
7582,3,home,15,24,9
7582,4,<ENDS>,24,24,0
7583,0,<START>,0,0,0
7583,1,home,0,8,8
7583,2,work,8,14,6
7583,3,home,14,18,4
7583,4,work,18,20,2
7583,5,home,20,24,4
7583,6,<ENDS>,24,24,0
7584,0,<START>,0,0,0
7584,1,home,0,7,7
7584,2,education,7,11,4
7584,3,home,11,20,9
7584,4,shop,20,21,1
7584,5,home,21,24,3
7584,6,<ENDS>,24,24,0
7585,0,<START>,0,0,0
7585,1,home,0,6,6
7585,2,work,6,13,7
7585,3,shop,13,14,1
7585,4,home,14,24,10
7585,5,<ENDS>,24,24,0
7586,0,<START>,0,0,0
7586,1,home,0,7,7
7586,2,work,7,13,6
7586,3,shop,13,15,2
7586,4,home,15,17,2
7586,5,work,17,20,3
7586,6,home,20,24,4
7586,7,<ENDS>,24,24,0
7587,0,<START>,0,0,0
7587,1,home,0,7,7
7587,2,work,7,14,7
7587,3,home,14,24,10
7587,4,<ENDS>,24,24,0
7588,0,<START>,0,0,0
7588,1,home,0,7,7
7588,2,work,7,14,7
7588,3,shop,14,15,1
7588,4,home,15,23,8
7588,5,work,23,24,1
7588,6,<ENDS>,24,24,0
7589,0,<START>,0,0,0
7589,1,home,0,8,8
7589,2,education,8,11,3
7589,3,home,11,17,6
7589,4,shop,17,18,1
7589,5,home,18,24,6
7589,6,<ENDS>,24,24,0
7590,0,<START>,0,0,0
7590,1,home,0,6,6
7590,2,shop,6,7,1
7590,3,work,7,15,8
7590,4,home,15,24,9
7590,5,<ENDS>,24,24,0
7591,0,<START>,0,0,0
7591,1,home,0,7,7
7591,2,education,7,12,5
7591,3,home,12,19,7
7591,4,shop,19,20,1
7591,5,home,20,24,4
7591,6,<ENDS>,24,24,0
7592,0,<START>,0,0,0
7592,1,home,0,6,6
7592,2,work,6,13,7
7592,3,home,13,24,11
7592,4,<ENDS>,24,24,0
7593,0,<START>,0,0,0
7593,1,home,0,7,7
7593,2,work,7,14,7
7593,3,home,14,24,10
7593,4,<ENDS>,24,24,0
7594,0,<START>,0,0,0
7594,1,home,0,7,7
7594,2,shop,7,8,1
7594,3,education,8,13,5
7594,4,shop,13,15,2
7594,5,home,15,24,9
7594,6,<ENDS>,24,24,0
7595,0,<START>,0,0,0
7595,1,home,0,7,7
7595,2,education,7,12,5
7595,3,shop,12,14,2
7595,4,home,14,21,7
7595,5,shop,21,22,1
7595,6,home,22,24,2
7595,7,<ENDS>,24,24,0
7596,0,<START>,0,0,0
7596,1,home,0,8,8
7596,2,education,8,12,4
7596,3,shop,12,13,1
7596,4,education,13,16,3
7596,5,home,16,24,8
7596,6,<ENDS>,24,24,0
7597,0,<START>,0,0,0
7597,1,home,0,7,7
7597,2,work,7,13,6
7597,3,shop,13,14,1
7597,4,work,14,20,6
7597,5,home,20,24,4
7597,6,<ENDS>,24,24,0
7598,0,<START>,0,0,0
7598,1,home,0,7,7
7598,2,work,7,13,6
7598,3,shop,13,14,1
7598,4,home,14,21,7
7598,5,work,21,22,1
7598,6,home,22,24,2
7598,7,<ENDS>,24,24,0
7599,0,<START>,0,0,0
7599,1,home,0,7,7
7599,2,work,7,13,6
7599,3,shop,13,14,1
7599,4,work,14,19,5
7599,5,home,19,24,5
7599,6,<ENDS>,24,24,0
7600,0,<START>,0,0,0
7600,1,home,0,7,7
7600,2,shop,7,9,2
7600,3,education,9,12,3
7600,4,shop,12,14,2
7600,5,education,14,17,3
7600,6,home,17,24,7
7600,7,<ENDS>,24,24,0
7601,0,<START>,0,0,0
7601,1,home,0,9,9
7601,2,shop,9,10,1
7601,3,work,10,16,6
7601,4,home,16,24,8
7601,5,<ENDS>,24,24,0
7602,0,<START>,0,0,0
7602,1,home,0,8,8
7602,2,work,8,15,7
7602,3,home,15,21,6
7602,4,work,21,22,1
7602,5,home,22,24,2
7602,6,<ENDS>,24,24,0
7603,0,<START>,0,0,0
7603,1,home,0,6,6
7603,2,work,6,13,7
7603,3,home,13,22,9
7603,4,work,22,23,1
7603,5,home,23,24,1
7603,6,<ENDS>,24,24,0
7604,0,<START>,0,0,0
7604,1,home,0,7,7
7604,2,work,7,9,2
7604,3,home,9,14,5
7604,4,work,14,16,2
7604,5,home,16,23,7
7604,6,work,23,24,1
7604,7,<ENDS>,24,24,0
7605,0,<START>,0,0,0
7605,1,home,0,6,6
7605,2,work,6,13,7
7605,3,home,13,17,4
7605,4,shop,17,18,1
7605,5,home,18,24,6
7605,6,<ENDS>,24,24,0
7606,0,<START>,0,0,0
7606,1,home,0,6,6
7606,2,work,6,8,2
7606,3,home,8,12,4
7606,4,work,12,14,2
7606,5,home,14,17,3
7606,6,work,17,19,2
7606,7,home,19,24,5
7606,8,<ENDS>,24,24,0
7607,0,<START>,0,0,0
7607,1,home,0,6,6
7607,2,shop,6,7,1
7607,3,home,7,10,3
7607,4,education,10,16,6
7607,5,home,16,24,8
7607,6,<ENDS>,24,24,0
7608,0,<START>,0,0,0
7608,1,home,0,6,6
7608,2,work,6,8,2
7608,3,home,8,14,6
7608,4,work,14,16,2
7608,5,home,16,21,5
7608,6,work,21,22,1
7608,7,home,22,24,2
7608,8,<ENDS>,24,24,0
7609,0,<START>,0,0,0
7609,1,home,0,6,6
7609,2,work,6,13,7
7609,3,shop,13,14,1
7609,4,work,14,20,6
7609,5,home,20,24,4
7609,6,<ENDS>,24,24,0
7610,0,<START>,0,0,0
7610,1,home,0,7,7
7610,2,work,7,9,2
7610,3,home,9,14,5
7610,4,work,14,17,3
7610,5,home,17,24,7
7610,6,<ENDS>,24,24,0
7611,0,<START>,0,0,0
7611,1,home,0,8,8
7611,2,education,8,12,4
7611,3,home,12,18,6
7611,4,shop,18,19,1
7611,5,home,19,24,5
7611,6,<ENDS>,24,24,0
7612,0,<START>,0,0,0
7612,1,home,0,7,7
7612,2,shop,7,8,1
7612,3,work,8,15,7
7612,4,home,15,21,6
7612,5,work,21,22,1
7612,6,home,22,24,2
7612,7,<ENDS>,24,24,0
7613,0,<START>,0,0,0
7613,1,home,0,8,8
7613,2,shop,8,9,1
7613,3,work,9,16,7
7613,4,home,16,24,8
7613,5,<ENDS>,24,24,0
7614,0,<START>,0,0,0
7614,1,home,0,6,6
7614,2,shop,6,7,1
7614,3,home,7,10,3
7614,4,education,10,13,3
7614,5,shop,13,15,2
7614,6,home,15,24,9
7614,7,<ENDS>,24,24,0
7615,0,<START>,0,0,0
7615,1,home,0,8,8
7615,2,work,8,14,6
7615,3,home,14,24,10
7615,4,<ENDS>,24,24,0
7616,0,<START>,0,0,0
7616,1,home,0,6,6
7616,2,work,6,8,2
7616,3,home,8,11,3
7616,4,work,11,13,2
7616,5,home,13,20,7
7616,6,shop,20,21,1
7616,7,home,21,24,3
7616,8,<ENDS>,24,24,0
7617,0,<START>,0,0,0
7617,1,home,0,8,8
7617,2,work,8,15,7
7617,3,shop,15,16,1
7617,4,home,16,20,4
7617,5,shop,20,21,1
7617,6,home,21,24,3
7617,7,<ENDS>,24,24,0
7618,0,<START>,0,0,0
7618,1,home,0,8,8
7618,2,education,8,12,4
7618,3,shop,12,14,2
7618,4,home,14,20,6
7618,5,shop,20,21,1
7618,6,home,21,24,3
7618,7,<ENDS>,24,24,0
7619,0,<START>,0,0,0
7619,1,home,0,7,7
7619,2,education,7,11,4
7619,3,home,11,19,8
7619,4,shop,19,21,2
7619,5,home,21,24,3
7619,6,<ENDS>,24,24,0
7620,0,<START>,0,0,0
7620,1,home,0,8,8
7620,2,work,8,15,7
7620,3,shop,15,17,2
7620,4,work,17,20,3
7620,5,home,20,24,4
7620,6,<ENDS>,24,24,0
7621,0,<START>,0,0,0
7621,1,home,0,9,9
7621,2,work,9,16,7
7621,3,home,16,24,8
7621,4,<ENDS>,24,24,0
7622,0,<START>,0,0,0
7622,1,home,0,6,6
7622,2,shop,6,7,1
7622,3,home,7,13,6
7622,4,education,13,16,3
7622,5,home,16,24,8
7622,6,<ENDS>,24,24,0
7623,0,<START>,0,0,0
7623,1,home,0,6,6
7623,2,work,6,13,7
7623,3,home,13,21,8
7623,4,shop,21,22,1
7623,5,home,22,24,2
7623,6,<ENDS>,24,24,0
7624,0,<START>,0,0,0
7624,1,home,0,7,7
7624,2,education,7,10,3
7624,3,home,10,16,6
7624,4,shop,16,17,1
7624,5,home,17,24,7
7624,6,<ENDS>,24,24,0
7625,0,<START>,0,0,0
7625,1,home,0,6,6
7625,2,work,6,13,7
7625,3,shop,13,14,1
7625,4,home,14,24,10
7625,5,<ENDS>,24,24,0
7626,0,<START>,0,0,0
7626,1,home,0,7,7
7626,2,education,7,12,5
7626,3,shop,12,14,2
7626,4,education,14,17,3
7626,5,home,17,24,7
7626,6,<ENDS>,24,24,0
7627,0,<START>,0,0,0
7627,1,home,0,6,6
7627,2,work,6,13,7
7627,3,home,13,17,4
7627,4,work,17,20,3
7627,5,home,20,24,4
7627,6,<ENDS>,24,24,0
7628,0,<START>,0,0,0
7628,1,home,0,7,7
7628,2,shop,7,8,1
7628,3,education,8,11,3
7628,4,home,11,18,7
7628,5,shop,18,20,2
7628,6,home,20,24,4
7628,7,<ENDS>,24,24,0
7629,0,<START>,0,0,0
7629,1,home,0,6,6
7629,2,work,6,8,2
7629,3,home,8,14,6
7629,4,shop,14,15,1
7629,5,home,15,22,7
7629,6,work,22,23,1
7629,7,home,23,24,1
7629,8,<ENDS>,24,24,0
7630,0,<START>,0,0,0
7630,1,home,0,6,6
7630,2,shop,6,7,1
7630,3,work,7,13,6
7630,4,home,13,17,4
7630,5,work,17,20,3
7630,6,home,20,24,4
7630,7,<ENDS>,24,24,0
7631,0,<START>,0,0,0
7631,1,home,0,6,6
7631,2,work,6,13,7
7631,3,shop,13,14,1
7631,4,home,14,24,10
7631,5,<ENDS>,24,24,0
7632,0,<START>,0,0,0
7632,1,home,0,6,6
7632,2,work,6,13,7
7632,3,home,13,17,4
7632,4,shop,17,18,1
7632,5,home,18,24,6
7632,6,<ENDS>,24,24,0
7633,0,<START>,0,0,0
7633,1,home,0,7,7
7633,2,work,7,9,2
7633,3,home,9,13,4
7633,4,shop,13,14,1
7633,5,home,14,21,7
7633,6,work,21,22,1
7633,7,home,22,24,2
7633,8,<ENDS>,24,24,0
7634,0,<START>,0,0,0
7634,1,home,0,8,8
7634,2,work,8,14,6
7634,3,home,14,24,10
7634,4,<ENDS>,24,24,0
7635,0,<START>,0,0,0
7635,1,home,0,7,7
7635,2,work,7,14,7
7635,3,shop,14,15,1
7635,4,home,15,18,3
7635,5,shop,18,19,1
7635,6,home,19,23,4
7635,7,work,23,24,1
7635,8,<ENDS>,24,24,0
7636,0,<START>,0,0,0
7636,1,home,0,6,6
7636,2,work,6,13,7
7636,3,home,13,21,8
7636,4,work,21,22,1
7636,5,home,22,24,2
7636,6,<ENDS>,24,24,0
7637,0,<START>,0,0,0
7637,1,home,0,7,7
7637,2,work,7,13,6
7637,3,shop,13,14,1
7637,4,education,14,16,2
7637,5,home,16,24,8
7637,6,<ENDS>,24,24,0
7638,0,<START>,0,0,0
7638,1,home,0,7,7
7638,2,work,7,14,7
7638,3,home,14,24,10
7638,4,<ENDS>,24,24,0
7639,0,<START>,0,0,0
7639,1,home,0,7,7
7639,2,work,7,13,6
7639,3,home,13,17,4
7639,4,work,17,20,3
7639,5,home,20,24,4
7639,6,<ENDS>,24,24,0
7640,0,<START>,0,0,0
7640,1,home,0,6,6
7640,2,work,6,13,7
7640,3,home,13,24,11
7640,4,<ENDS>,24,24,0
7641,0,<START>,0,0,0
7641,1,home,0,7,7
7641,2,shop,7,8,1
7641,3,education,8,11,3
7641,4,home,11,17,6
7641,5,shop,17,18,1
7641,6,home,18,24,6
7641,7,<ENDS>,24,24,0
7642,0,<START>,0,0,0
7642,1,home,0,6,6
7642,2,work,6,13,7
7642,3,shop,13,14,1
7642,4,work,14,19,5
7642,5,home,19,24,5
7642,6,<ENDS>,24,24,0
7643,0,<START>,0,0,0
7643,1,home,0,7,7
7643,2,education,7,11,4
7643,3,home,11,14,3
7643,4,education,14,16,2
7643,5,shop,16,17,1
7643,6,home,17,24,7
7643,7,<ENDS>,24,24,0
7644,0,<START>,0,0,0
7644,1,home,0,7,7
7644,2,work,7,13,6
7644,3,home,13,18,5
7644,4,work,18,20,2
7644,5,home,20,24,4
7644,6,<ENDS>,24,24,0
7645,0,<START>,0,0,0
7645,1,home,0,6,6
7645,2,shop,6,7,1
7645,3,home,7,13,6
7645,4,education,13,16,3
7645,5,home,16,24,8
7645,6,<ENDS>,24,24,0
7646,0,<START>,0,0,0
7646,1,home,0,8,8
7646,2,shop,8,9,1
7646,3,home,9,15,6
7646,4,work,15,20,5
7646,5,home,20,24,4
7646,6,<ENDS>,24,24,0
7647,0,<START>,0,0,0
7647,1,home,0,6,6
7647,2,shop,6,7,1
7647,3,work,7,14,7
7647,4,shop,14,15,1
7647,5,work,15,20,5
7647,6,home,20,24,4
7647,7,<ENDS>,24,24,0
7648,0,<START>,0,0,0
7648,1,home,0,9,9
7648,2,work,9,16,7
7648,3,home,16,24,8
7648,4,<ENDS>,24,24,0
7649,0,<START>,0,0,0
7649,1,home,0,7,7
7649,2,shop,7,8,1
7649,3,work,8,15,7
7649,4,home,15,21,6
7649,5,work,21,22,1
7649,6,home,22,24,2
7649,7,<ENDS>,24,24,0
7650,0,<START>,0,0,0
7650,1,home,0,7,7
7650,2,work,7,14,7
7650,3,shop,14,15,1
7650,4,home,15,24,9
7650,5,<ENDS>,24,24,0
7651,0,<START>,0,0,0
7651,1,home,0,8,8
7651,2,education,8,12,4
7651,3,shop,12,13,1
7651,4,work,13,19,6
7651,5,home,19,24,5
7651,6,<ENDS>,24,24,0
7652,0,<START>,0,0,0
7652,1,home,0,8,8
7652,2,work,8,15,7
7652,3,shop,15,16,1
7652,4,home,16,21,5
7652,5,work,21,22,1
7652,6,home,22,24,2
7652,7,<ENDS>,24,24,0
7653,0,<START>,0,0,0
7653,1,home,0,6,6
7653,2,shop,6,7,1
7653,3,home,7,10,3
7653,4,education,10,13,3
7653,5,home,13,19,6
7653,6,shop,19,20,1
7653,7,home,20,24,4
7653,8,<ENDS>,24,24,0
7654,0,<START>,0,0,0
7654,1,home,0,7,7
7654,2,work,7,13,6
7654,3,home,13,24,11
7654,4,<ENDS>,24,24,0
7655,0,<START>,0,0,0
7655,1,home,0,7,7
7655,2,education,7,13,6
7655,3,shop,13,15,2
7655,4,home,15,24,9
7655,5,<ENDS>,24,24,0
7656,0,<START>,0,0,0
7656,1,home,0,7,7
7656,2,work,7,14,7
7656,3,home,14,18,4
7656,4,work,18,20,2
7656,5,home,20,24,4
7656,6,<ENDS>,24,24,0
7657,0,<START>,0,0,0
7657,1,home,0,8,8
7657,2,work,8,14,6
7657,3,shop,14,15,1
7657,4,home,15,24,9
7657,5,<ENDS>,24,24,0
7658,0,<START>,0,0,0
7658,1,home,0,8,8
7658,2,work,8,15,7
7658,3,home,15,21,6
7658,4,work,21,22,1
7658,5,home,22,24,2
7658,6,<ENDS>,24,24,0
7659,0,<START>,0,0,0
7659,1,home,0,9,9
7659,2,work,9,15,6
7659,3,home,15,23,8
7659,4,work,23,24,1
7659,5,<ENDS>,24,24,0
7660,0,<START>,0,0,0
7660,1,home,0,8,8
7660,2,work,8,15,7
7660,3,home,15,23,8
7660,4,work,23,24,1
7660,5,<ENDS>,24,24,0
7661,0,<START>,0,0,0
7661,1,home,0,8,8
7661,2,work,8,14,6
7661,3,home,14,24,10
7661,4,<ENDS>,24,24,0
7662,0,<START>,0,0,0
7662,1,home,0,6,6
7662,2,work,6,8,2
7662,3,home,8,9,1
7662,4,work,9,11,2
7662,5,home,11,17,6
7662,6,work,17,19,2
7662,7,home,19,24,5
7662,8,<ENDS>,24,24,0
7663,0,<START>,0,0,0
7663,1,home,0,9,9
7663,2,work,9,15,6
7663,3,home,15,24,9
7663,4,<ENDS>,24,24,0
7664,0,<START>,0,0,0
7664,1,home,0,7,7
7664,2,shop,7,8,1
7664,3,education,8,13,5
7664,4,shop,13,15,2
7664,5,home,15,18,3
7664,6,shop,18,19,1
7664,7,home,19,24,5
7664,8,<ENDS>,24,24,0
7665,0,<START>,0,0,0
7665,1,home,0,8,8
7665,2,work,8,13,5
7665,3,home,13,19,6
7665,4,shop,19,20,1
7665,5,home,20,24,4
7665,6,<ENDS>,24,24,0
7666,0,<START>,0,0,0
7666,1,home,0,6,6
7666,2,work,6,13,7
7666,3,home,13,17,4
7666,4,work,17,20,3
7666,5,home,20,24,4
7666,6,<ENDS>,24,24,0
7667,0,<START>,0,0,0
7667,1,home,0,6,6
7667,2,shop,6,7,1
7667,3,home,7,10,3
7667,4,education,10,12,2
7667,5,shop,12,14,2
7667,6,home,14,24,10
7667,7,<ENDS>,24,24,0
7668,0,<START>,0,0,0
7668,1,home,0,6,6
7668,2,work,6,8,2
7668,3,home,8,15,7
7668,4,work,15,18,3
7668,5,home,18,24,6
7668,6,<ENDS>,24,24,0
7669,0,<START>,0,0,0
7669,1,home,0,6,6
7669,2,work,6,13,7
7669,3,home,13,22,9
7669,4,work,22,23,1
7669,5,home,23,24,1
7669,6,<ENDS>,24,24,0
7670,0,<START>,0,0,0
7670,1,home,0,7,7
7670,2,work,7,15,8
7670,3,home,15,20,5
7670,4,shop,20,21,1
7670,5,home,21,24,3
7670,6,<ENDS>,24,24,0
7671,0,<START>,0,0,0
7671,1,home,0,7,7
7671,2,work,7,13,6
7671,3,shop,13,14,1
7671,4,work,14,20,6
7671,5,home,20,24,4
7671,6,<ENDS>,24,24,0
7672,0,<START>,0,0,0
7672,1,home,0,7,7
7672,2,work,7,13,6
7672,3,shop,13,14,1
7672,4,home,14,15,1
7672,5,work,15,20,5
7672,6,home,20,24,4
7672,7,<ENDS>,24,24,0
7673,0,<START>,0,0,0
7673,1,home,0,6,6
7673,2,work,6,7,1
7673,3,home,7,13,6
7673,4,work,13,16,3
7673,5,home,16,22,6
7673,6,work,22,23,1
7673,7,home,23,24,1
7673,8,<ENDS>,24,24,0
7674,0,<START>,0,0,0
7674,1,home,0,7,7
7674,2,work,7,14,7
7674,3,shop,14,15,1
7674,4,home,15,24,9
7674,5,<ENDS>,24,24,0
7675,0,<START>,0,0,0
7675,1,home,0,7,7
7675,2,work,7,13,6
7675,3,home,13,22,9
7675,4,work,22,23,1
7675,5,home,23,24,1
7675,6,<ENDS>,24,24,0
7676,0,<START>,0,0,0
7676,1,home,0,7,7
7676,2,work,7,14,7
7676,3,shop,14,15,1
7676,4,home,15,23,8
7676,5,work,23,24,1
7676,6,<ENDS>,24,24,0
7677,0,<START>,0,0,0
7677,1,home,0,7,7
7677,2,shop,7,8,1
7677,3,work,8,14,6
7677,4,shop,14,15,1
7677,5,home,15,24,9
7677,6,<ENDS>,24,24,0
7678,0,<START>,0,0,0
7678,1,home,0,8,8
7678,2,work,8,16,8
7678,3,home,16,24,8
7678,4,<ENDS>,24,24,0
7679,0,<START>,0,0,0
7679,1,home,0,7,7
7679,2,shop,7,8,1
7679,3,work,8,10,2
7679,4,home,10,17,7
7679,5,work,17,19,2
7679,6,home,19,24,5
7679,7,<ENDS>,24,24,0
7680,0,<START>,0,0,0
7680,1,home,0,6,6
7680,2,shop,6,7,1
7680,3,home,7,9,2
7680,4,education,9,12,3
7680,5,home,12,19,7
7680,6,shop,19,20,1
7680,7,home,20,24,4
7680,8,<ENDS>,24,24,0
7681,0,<START>,0,0,0
7681,1,home,0,7,7
7681,2,work,7,13,6
7681,3,home,13,24,11
7681,4,<ENDS>,24,24,0
7682,0,<START>,0,0,0
7682,1,home,0,8,8
7682,2,work,8,15,7
7682,3,shop,15,16,1
7682,4,work,16,20,4
7682,5,home,20,24,4
7682,6,<ENDS>,24,24,0
7683,0,<START>,0,0,0
7683,1,home,0,7,7
7683,2,work,7,13,6
7683,3,shop,13,15,2
7683,4,home,15,22,7
7683,5,work,22,23,1
7683,6,home,23,24,1
7683,7,<ENDS>,24,24,0
7684,0,<START>,0,0,0
7684,1,home,0,6,6
7684,2,work,6,14,8
7684,3,home,14,22,8
7684,4,work,22,23,1
7684,5,home,23,24,1
7684,6,<ENDS>,24,24,0
7685,0,<START>,0,0,0
7685,1,home,0,7,7
7685,2,education,7,11,4
7685,3,home,11,18,7
7685,4,shop,18,19,1
7685,5,home,19,24,5
7685,6,<ENDS>,24,24,0
7686,0,<START>,0,0,0
7686,1,home,0,7,7
7686,2,work,7,14,7
7686,3,shop,14,15,1
7686,4,work,15,20,5
7686,5,home,20,24,4
7686,6,<ENDS>,24,24,0
7687,0,<START>,0,0,0
7687,1,home,0,7,7
7687,2,education,7,11,4
7687,3,home,11,19,8
7687,4,shop,19,20,1
7687,5,home,20,24,4
7687,6,<ENDS>,24,24,0
7688,0,<START>,0,0,0
7688,1,home,0,7,7
7688,2,work,7,9,2
7688,3,home,9,15,6
7688,4,work,15,17,2
7688,5,home,17,23,6
7688,6,work,23,24,1
7688,7,<ENDS>,24,24,0
7689,0,<START>,0,0,0
7689,1,home,0,6,6
7689,2,work,6,13,7
7689,3,home,13,24,11
7689,4,<ENDS>,24,24,0
7690,0,<START>,0,0,0
7690,1,home,0,7,7
7690,2,education,7,13,6
7690,3,shop,13,15,2
7690,4,home,15,24,9
7690,5,<ENDS>,24,24,0
7691,0,<START>,0,0,0
7691,1,home,0,7,7
7691,2,education,7,10,3
7691,3,home,10,17,7
7691,4,shop,17,18,1
7691,5,home,18,24,6
7691,6,<ENDS>,24,24,0
7692,0,<START>,0,0,0
7692,1,home,0,7,7
7692,2,work,7,14,7
7692,3,home,14,18,4
7692,4,shop,18,19,1
7692,5,home,19,24,5
7692,6,<ENDS>,24,24,0
7693,0,<START>,0,0,0
7693,1,home,0,6,6
7693,2,work,6,13,7
7693,3,shop,13,14,1
7693,4,work,14,19,5
7693,5,home,19,24,5
7693,6,<ENDS>,24,24,0
7694,0,<START>,0,0,0
7694,1,home,0,7,7
7694,2,shop,7,8,1
7694,3,education,8,14,6
7694,4,shop,14,15,1
7694,5,home,15,19,4
7694,6,shop,19,20,1
7694,7,home,20,24,4
7694,8,<ENDS>,24,24,0
7695,0,<START>,0,0,0
7695,1,home,0,7,7
7695,2,work,7,8,1
7695,3,home,8,11,3
7695,4,work,11,13,2
7695,5,home,13,21,8
7695,6,work,21,22,1
7695,7,home,22,24,2
7695,8,<ENDS>,24,24,0
7696,0,<START>,0,0,0
7696,1,home,0,7,7
7696,2,work,7,14,7
7696,3,shop,14,15,1
7696,4,home,15,24,9
7696,5,<ENDS>,24,24,0
7697,0,<START>,0,0,0
7697,1,home,0,6,6
7697,2,work,6,7,1
7697,3,home,7,11,4
7697,4,work,11,13,2
7697,5,home,13,21,8
7697,6,shop,21,22,1
7697,7,home,22,24,2
7697,8,<ENDS>,24,24,0
7698,0,<START>,0,0,0
7698,1,home,0,6,6
7698,2,work,6,13,7
7698,3,shop,13,14,1
7698,4,work,14,20,6
7698,5,home,20,24,4
7698,6,<ENDS>,24,24,0
7699,0,<START>,0,0,0
7699,1,home,0,7,7
7699,2,work,7,13,6
7699,3,home,13,24,11
7699,4,<ENDS>,24,24,0
7700,0,<START>,0,0,0
7700,1,home,0,6,6
7700,2,shop,6,7,1
7700,3,home,7,11,4
7700,4,work,11,19,8
7700,5,home,19,24,5
7700,6,<ENDS>,24,24,0
7701,0,<START>,0,0,0
7701,1,home,0,7,7
7701,2,shop,7,8,1
7701,3,education,8,12,4
7701,4,home,12,19,7
7701,5,shop,19,20,1
7701,6,home,20,24,4
7701,7,<ENDS>,24,24,0
7702,0,<START>,0,0,0
7702,1,home,0,9,9
7702,2,work,9,17,8
7702,3,home,17,24,7
7702,4,<ENDS>,24,24,0
7703,0,<START>,0,0,0
7703,1,home,0,6,6
7703,2,work,6,13,7
7703,3,home,13,22,9
7703,4,work,22,23,1
7703,5,home,23,24,1
7703,6,<ENDS>,24,24,0
7704,0,<START>,0,0,0
7704,1,home,0,8,8
7704,2,education,8,12,4
7704,3,work,12,18,6
7704,4,home,18,23,5
7704,5,work,23,24,1
7704,6,<ENDS>,24,24,0
7705,0,<START>,0,0,0
7705,1,home,0,7,7
7705,2,work,7,13,6
7705,3,home,13,17,4
7705,4,shop,17,18,1
7705,5,home,18,24,6
7705,6,<ENDS>,24,24,0
7706,0,<START>,0,0,0
7706,1,home,0,7,7
7706,2,work,7,9,2
7706,3,home,9,16,7
7706,4,work,16,18,2
7706,5,home,18,24,6
7706,6,<ENDS>,24,24,0
7707,0,<START>,0,0,0
7707,1,home,0,6,6
7707,2,work,6,8,2
7707,3,home,8,14,6
7707,4,work,14,16,2
7707,5,home,16,17,1
7707,6,work,17,19,2
7707,7,home,19,24,5
7707,8,<ENDS>,24,24,0
7708,0,<START>,0,0,0
7708,1,home,0,8,8
7708,2,education,8,12,4
7708,3,home,12,18,6
7708,4,shop,18,19,1
7708,5,home,19,24,5
7708,6,<ENDS>,24,24,0
7709,0,<START>,0,0,0
7709,1,home,0,9,9
7709,2,education,9,12,3
7709,3,work,12,19,7
7709,4,home,19,24,5
7709,5,<ENDS>,24,24,0
7710,0,<START>,0,0,0
7710,1,home,0,7,7
7710,2,work,7,13,6
7710,3,home,13,22,9
7710,4,work,22,23,1
7710,5,home,23,24,1
7710,6,<ENDS>,24,24,0
7711,0,<START>,0,0,0
7711,1,home,0,9,9
7711,2,work,9,16,7
7711,3,home,16,24,8
7711,4,<ENDS>,24,24,0
7712,0,<START>,0,0,0
7712,1,home,0,6,6
7712,2,work,6,13,7
7712,3,home,13,18,5
7712,4,shop,18,19,1
7712,5,home,19,24,5
7712,6,<ENDS>,24,24,0
7713,0,<START>,0,0,0
7713,1,home,0,6,6
7713,2,shop,6,7,1
7713,3,home,7,10,3
7713,4,education,10,12,2
7713,5,home,12,20,8
7713,6,shop,20,21,1
7713,7,home,21,24,3
7713,8,<ENDS>,24,24,0
7714,0,<START>,0,0,0
7714,1,home,0,7,7
7714,2,work,7,13,6
7714,3,home,13,24,11
7714,4,<ENDS>,24,24,0
7715,0,<START>,0,0,0
7715,1,home,0,7,7
7715,2,shop,7,8,1
7715,3,home,8,13,5
7715,4,education,13,16,3
7715,5,home,16,24,8
7715,6,<ENDS>,24,24,0
7716,0,<START>,0,0,0
7716,1,home,0,6,6
7716,2,work,6,13,7
7716,3,shop,13,14,1
7716,4,work,14,20,6
7716,5,home,20,24,4
7716,6,<ENDS>,24,24,0
7717,0,<START>,0,0,0
7717,1,home,0,7,7
7717,2,work,7,15,8
7717,3,home,15,21,6
7717,4,work,21,22,1
7717,5,home,22,24,2
7717,6,<ENDS>,24,24,0
7718,0,<START>,0,0,0
7718,1,home,0,6,6
7718,2,work,6,13,7
7718,3,home,13,24,11
7718,4,<ENDS>,24,24,0
7719,0,<START>,0,0,0
7719,1,home,0,8,8
7719,2,work,8,15,7
7719,3,shop,15,16,1
7719,4,home,16,24,8
7719,5,<ENDS>,24,24,0
7720,0,<START>,0,0,0
7720,1,home,0,7,7
7720,2,work,7,13,6
7720,3,home,13,22,9
7720,4,work,22,23,1
7720,5,home,23,24,1
7720,6,<ENDS>,24,24,0
7721,0,<START>,0,0,0
7721,1,home,0,6,6
7721,2,work,6,13,7
7721,3,home,13,14,1
7721,4,education,14,16,2
7721,5,shop,16,17,1
7721,6,home,17,24,7
7721,7,<ENDS>,24,24,0
7722,0,<START>,0,0,0
7722,1,home,0,8,8
7722,2,work,8,10,2
7722,3,home,10,15,5
7722,4,work,15,17,2
7722,5,home,17,24,7
7722,6,<ENDS>,24,24,0
7723,0,<START>,0,0,0
7723,1,home,0,8,8
7723,2,work,8,15,7
7723,3,shop,15,16,1
7723,4,work,16,17,1
7723,5,home,17,24,7
7723,6,<ENDS>,24,24,0
7724,0,<START>,0,0,0
7724,1,home,0,6,6
7724,2,shop,6,7,1
7724,3,work,7,14,7
7724,4,home,14,16,2
7724,5,work,16,20,4
7724,6,home,20,24,4
7724,7,<ENDS>,24,24,0
7725,0,<START>,0,0,0
7725,1,home,0,6,6
7725,2,work,6,8,2
7725,3,home,8,9,1
7725,4,work,9,11,2
7725,5,home,11,16,5
7725,6,work,16,18,2
7725,7,home,18,24,6
7725,8,<ENDS>,24,24,0
7726,0,<START>,0,0,0
7726,1,home,0,7,7
7726,2,work,7,14,7
7726,3,shop,14,15,1
7726,4,home,15,24,9
7726,5,<ENDS>,24,24,0
7727,0,<START>,0,0,0
7727,1,home,0,7,7
7727,2,education,7,11,4
7727,3,home,11,14,3
7727,4,education,14,15,1
7727,5,shop,15,16,1
7727,6,home,16,24,8
7727,7,<ENDS>,24,24,0
7728,0,<START>,0,0,0
7728,1,home,0,7,7
7728,2,education,7,11,4
7728,3,home,11,18,7
7728,4,shop,18,19,1
7728,5,home,19,24,5
7728,6,<ENDS>,24,24,0
7729,0,<START>,0,0,0
7729,1,home,0,7,7
7729,2,work,7,13,6
7729,3,home,13,21,8
7729,4,work,21,22,1
7729,5,home,22,24,2
7729,6,<ENDS>,24,24,0
7730,0,<START>,0,0,0
7730,1,home,0,7,7
7730,2,education,7,11,4
7730,3,home,11,19,8
7730,4,shop,19,20,1
7730,5,home,20,24,4
7730,6,<ENDS>,24,24,0
7731,0,<START>,0,0,0
7731,1,home,0,6,6
7731,2,shop,6,7,1
7731,3,work,7,14,7
7731,4,home,14,24,10
7731,5,<ENDS>,24,24,0
7732,0,<START>,0,0,0
7732,1,home,0,7,7
7732,2,shop,7,8,1
7732,3,home,8,13,5
7732,4,work,13,19,6
7732,5,education,19,20,1
7732,6,work,20,21,1
7732,7,home,21,24,3
7732,8,<ENDS>,24,24,0
7733,0,<START>,0,0,0
7733,1,home,0,7,7
7733,2,work,7,9,2
7733,3,home,9,15,6
7733,4,work,15,17,2
7733,5,home,17,24,7
7733,6,<ENDS>,24,24,0
7734,0,<START>,0,0,0
7734,1,home,0,6,6
7734,2,work,6,13,7
7734,3,shop,13,15,2
7734,4,work,15,19,4
7734,5,home,19,24,5
7734,6,<ENDS>,24,24,0
7735,0,<START>,0,0,0
7735,1,home,0,7,7
7735,2,work,7,14,7
7735,3,shop,14,15,1
7735,4,home,15,23,8
7735,5,work,23,24,1
7735,6,<ENDS>,24,24,0
7736,0,<START>,0,0,0
7736,1,home,0,6,6
7736,2,work,6,13,7
7736,3,shop,13,14,1
7736,4,home,14,24,10
7736,5,<ENDS>,24,24,0
7737,0,<START>,0,0,0
7737,1,home,0,6,6
7737,2,shop,6,7,1
7737,3,home,7,9,2
7737,4,education,9,11,2
7737,5,home,11,18,7
7737,6,shop,18,19,1
7737,7,home,19,24,5
7737,8,<ENDS>,24,24,0
7738,0,<START>,0,0,0
7738,1,home,0,6,6
7738,2,work,6,13,7
7738,3,shop,13,15,2
7738,4,home,15,24,9
7738,5,<ENDS>,24,24,0
7739,0,<START>,0,0,0
7739,1,home,0,8,8
7739,2,shop,8,9,1
7739,3,home,9,13,4
7739,4,work,13,19,6
7739,5,home,19,24,5
7739,6,<ENDS>,24,24,0
7740,0,<START>,0,0,0
7740,1,home,0,7,7
7740,2,education,7,11,4
7740,3,home,11,13,2
7740,4,education,13,15,2
7740,5,shop,15,16,1
7740,6,home,16,24,8
7740,7,<ENDS>,24,24,0
7741,0,<START>,0,0,0
7741,1,home,0,6,6
7741,2,shop,6,7,1
7741,3,work,7,13,6
7741,4,home,13,16,3
7741,5,work,16,20,4
7741,6,home,20,24,4
7741,7,<ENDS>,24,24,0
7742,0,<START>,0,0,0
7742,1,home,0,7,7
7742,2,work,7,14,7
7742,3,home,14,24,10
7742,4,<ENDS>,24,24,0
7743,0,<START>,0,0,0
7743,1,home,0,8,8
7743,2,work,8,15,7
7743,3,home,15,23,8
7743,4,work,23,24,1
7743,5,<ENDS>,24,24,0
7744,0,<START>,0,0,0
7744,1,home,0,7,7
7744,2,work,7,13,6
7744,3,home,13,15,2
7744,4,work,15,19,4
7744,5,home,19,24,5
7744,6,<ENDS>,24,24,0
7745,0,<START>,0,0,0
7745,1,home,0,9,9
7745,2,work,9,16,7
7745,3,home,16,24,8
7745,4,<ENDS>,24,24,0
7746,0,<START>,0,0,0
7746,1,home,0,6,6
7746,2,work,6,13,7
7746,3,shop,13,14,1
7746,4,home,14,18,4
7746,5,work,18,20,2
7746,6,home,20,24,4
7746,7,<ENDS>,24,24,0
7747,0,<START>,0,0,0
7747,1,home,0,7,7
7747,2,work,7,13,6
7747,3,home,13,22,9
7747,4,work,22,23,1
7747,5,home,23,24,1
7747,6,<ENDS>,24,24,0
7748,0,<START>,0,0,0
7748,1,home,0,7,7
7748,2,work,7,14,7
7748,3,home,14,24,10
7748,4,<ENDS>,24,24,0
7749,0,<START>,0,0,0
7749,1,home,0,7,7
7749,2,work,7,13,6
7749,3,home,13,16,3
7749,4,work,16,19,3
7749,5,home,19,24,5
7749,6,<ENDS>,24,24,0
7750,0,<START>,0,0,0
7750,1,home,0,7,7
7750,2,work,7,15,8
7750,3,shop,15,16,1
7750,4,home,16,24,8
7750,5,<ENDS>,24,24,0
7751,0,<START>,0,0,0
7751,1,home,0,7,7
7751,2,work,7,13,6
7751,3,shop,13,14,1
7751,4,home,14,18,4
7751,5,work,18,20,2
7751,6,home,20,24,4
7751,7,<ENDS>,24,24,0
7752,0,<START>,0,0,0
7752,1,home,0,8,8
7752,2,work,8,15,7
7752,3,home,15,24,9
7752,4,<ENDS>,24,24,0
7753,0,<START>,0,0,0
7753,1,home,0,7,7
7753,2,work,7,15,8
7753,3,home,15,24,9
7753,4,<ENDS>,24,24,0
7754,0,<START>,0,0,0
7754,1,home,0,7,7
7754,2,education,7,12,5
7754,3,shop,12,13,1
7754,4,education,13,15,2
7754,5,shop,15,16,1
7754,6,home,16,24,8
7754,7,<ENDS>,24,24,0
7755,0,<START>,0,0,0
7755,1,home,0,7,7
7755,2,work,7,14,7
7755,3,home,14,24,10
7755,4,<ENDS>,24,24,0
7756,0,<START>,0,0,0
7756,1,home,0,8,8
7756,2,education,8,12,4
7756,3,shop,12,13,1
7756,4,work,13,19,6
7756,5,home,19,24,5
7756,6,<ENDS>,24,24,0
7757,0,<START>,0,0,0
7757,1,home,0,7,7
7757,2,shop,7,8,1
7757,3,work,8,14,6
7757,4,shop,14,15,1
7757,5,work,15,20,5
7757,6,home,20,24,4
7757,7,<ENDS>,24,24,0
7758,0,<START>,0,0,0
7758,1,home,0,8,8
7758,2,work,8,15,7
7758,3,home,15,24,9
7758,4,<ENDS>,24,24,0
7759,0,<START>,0,0,0
7759,1,home,0,10,10
7759,2,work,10,16,6
7759,3,home,16,24,8
7759,4,<ENDS>,24,24,0
7760,0,<START>,0,0,0
7760,1,home,0,6,6
7760,2,work,6,12,6
7760,3,shop,12,13,1
7760,4,education,13,16,3
7760,5,home,16,21,5
7760,6,shop,21,22,1
7760,7,home,22,24,2
7760,8,<ENDS>,24,24,0
7761,0,<START>,0,0,0
7761,1,home,0,7,7
7761,2,work,7,13,6
7761,3,home,13,22,9
7761,4,work,22,23,1
7761,5,home,23,24,1
7761,6,<ENDS>,24,24,0
7762,0,<START>,0,0,0
7762,1,home,0,6,6
7762,2,work,6,13,7
7762,3,home,13,15,2
7762,4,work,15,20,5
7762,5,home,20,24,4
7762,6,<ENDS>,24,24,0
7763,0,<START>,0,0,0
7763,1,home,0,6,6
7763,2,work,6,8,2
7763,3,home,8,14,6
7763,4,work,14,16,2
7763,5,home,16,23,7
7763,6,work,23,24,1
7763,7,<ENDS>,24,24,0
7764,0,<START>,0,0,0
7764,1,home,0,8,8
7764,2,work,8,15,7
7764,3,home,15,21,6
7764,4,shop,21,22,1
7764,5,home,22,24,2
7764,6,<ENDS>,24,24,0
7765,0,<START>,0,0,0
7765,1,home,0,8,8
7765,2,work,8,14,6
7765,3,shop,14,15,1
7765,4,work,15,19,4
7765,5,home,19,24,5
7765,6,<ENDS>,24,24,0
7766,0,<START>,0,0,0
7766,1,home,0,7,7
7766,2,work,7,13,6
7766,3,shop,13,14,1
7766,4,work,14,20,6
7766,5,home,20,24,4
7766,6,<ENDS>,24,24,0
7767,0,<START>,0,0,0
7767,1,home,0,6,6
7767,2,work,6,13,7
7767,3,shop,13,14,1
7767,4,work,14,19,5
7767,5,home,19,24,5
7767,6,<ENDS>,24,24,0
7768,0,<START>,0,0,0
7768,1,home,0,6,6
7768,2,shop,6,7,1
7768,3,home,7,17,10
7768,4,work,17,20,3
7768,5,home,20,24,4
7768,6,<ENDS>,24,24,0
7769,0,<START>,0,0,0
7769,1,home,0,7,7
7769,2,work,7,14,7
7769,3,shop,14,15,1
7769,4,work,15,20,5
7769,5,home,20,24,4
7769,6,<ENDS>,24,24,0
7770,0,<START>,0,0,0
7770,1,home,0,8,8
7770,2,work,8,15,7
7770,3,home,15,21,6
7770,4,work,21,22,1
7770,5,home,22,24,2
7770,6,<ENDS>,24,24,0
7771,0,<START>,0,0,0
7771,1,home,0,8,8
7771,2,education,8,9,1
7771,3,home,9,13,4
7771,4,education,13,16,3
7771,5,shop,16,17,1
7771,6,home,17,24,7
7771,7,<ENDS>,24,24,0
7772,0,<START>,0,0,0
7772,1,home,0,7,7
7772,2,work,7,13,6
7772,3,home,13,21,8
7772,4,work,21,22,1
7772,5,home,22,24,2
7772,6,<ENDS>,24,24,0
7773,0,<START>,0,0,0
7773,1,home,0,7,7
7773,2,work,7,13,6
7773,3,home,13,24,11
7773,4,<ENDS>,24,24,0
7774,0,<START>,0,0,0
7774,1,home,0,6,6
7774,2,work,6,13,7
7774,3,home,13,17,4
7774,4,work,17,20,3
7774,5,home,20,24,4
7774,6,<ENDS>,24,24,0
7775,0,<START>,0,0,0
7775,1,home,0,7,7
7775,2,education,7,11,4
7775,3,home,11,16,5
7775,4,shop,16,17,1
7775,5,home,17,21,4
7775,6,shop,21,22,1
7775,7,home,22,24,2
7775,8,<ENDS>,24,24,0
7776,0,<START>,0,0,0
7776,1,home,0,7,7
7776,2,education,7,11,4
7776,3,home,11,18,7
7776,4,shop,18,19,1
7776,5,home,19,24,5
7776,6,<ENDS>,24,24,0
7777,0,<START>,0,0,0
7777,1,home,0,7,7
7777,2,shop,7,8,1
7777,3,home,8,13,5
7777,4,work,13,18,5
7777,5,home,18,24,6
7777,6,<ENDS>,24,24,0
7778,0,<START>,0,0,0
7778,1,home,0,7,7
7778,2,work,7,13,6
7778,3,home,13,18,5
7778,4,work,18,20,2
7778,5,home,20,24,4
7778,6,<ENDS>,24,24,0
7779,0,<START>,0,0,0
7779,1,home,0,7,7
7779,2,work,7,14,7
7779,3,shop,14,15,1
7779,4,work,15,20,5
7779,5,home,20,24,4
7779,6,<ENDS>,24,24,0
7780,0,<START>,0,0,0
7780,1,home,0,7,7
7780,2,shop,7,8,1
7780,3,education,8,14,6
7780,4,shop,14,15,1
7780,5,home,15,24,9
7780,6,<ENDS>,24,24,0
7781,0,<START>,0,0,0
7781,1,home,0,7,7
7781,2,work,7,13,6
7781,3,home,13,24,11
7781,4,<ENDS>,24,24,0
7782,0,<START>,0,0,0
7782,1,home,0,8,8
7782,2,work,8,15,7
7782,3,home,15,20,5
7782,4,shop,20,21,1
7782,5,home,21,24,3
7782,6,<ENDS>,24,24,0
7783,0,<START>,0,0,0
7783,1,home,0,7,7
7783,2,work,7,13,6
7783,3,shop,13,14,1
7783,4,home,14,24,10
7783,5,<ENDS>,24,24,0
7784,0,<START>,0,0,0
7784,1,home,0,7,7
7784,2,shop,7,8,1
7784,3,work,8,16,8
7784,4,home,16,24,8
7784,5,<ENDS>,24,24,0
7785,0,<START>,0,0,0
7785,1,home,0,7,7
7785,2,work,7,13,6
7785,3,home,13,21,8
7785,4,shop,21,22,1
7785,5,home,22,24,2
7785,6,<ENDS>,24,24,0
7786,0,<START>,0,0,0
7786,1,home,0,6,6
7786,2,work,6,13,7
7786,3,home,13,19,6
7786,4,shop,19,20,1
7786,5,home,20,24,4
7786,6,<ENDS>,24,24,0
7787,0,<START>,0,0,0
7787,1,home,0,7,7
7787,2,education,7,12,5
7787,3,shop,12,14,2
7787,4,home,14,20,6
7787,5,shop,20,21,1
7787,6,home,21,24,3
7787,7,<ENDS>,24,24,0
7788,0,<START>,0,0,0
7788,1,home,0,7,7
7788,2,work,7,13,6
7788,3,shop,13,14,1
7788,4,home,14,24,10
7788,5,<ENDS>,24,24,0
7789,0,<START>,0,0,0
7789,1,home,0,8,8
7789,2,work,8,14,6
7789,3,shop,14,15,1
7789,4,work,15,19,4
7789,5,home,19,24,5
7789,6,<ENDS>,24,24,0
7790,0,<START>,0,0,0
7790,1,home,0,7,7
7790,2,work,7,13,6
7790,3,home,13,21,8
7790,4,shop,21,22,1
7790,5,home,22,24,2
7790,6,<ENDS>,24,24,0
7791,0,<START>,0,0,0
7791,1,home,0,7,7
7791,2,shop,7,8,1
7791,3,education,8,11,3
7791,4,home,11,18,7
7791,5,shop,18,20,2
7791,6,home,20,24,4
7791,7,<ENDS>,24,24,0
7792,0,<START>,0,0,0
7792,1,home,0,6,6
7792,2,work,6,8,2
7792,3,home,8,12,4
7792,4,work,12,15,3
7792,5,home,15,21,6
7792,6,work,21,22,1
7792,7,home,22,24,2
7792,8,<ENDS>,24,24,0
7793,0,<START>,0,0,0
7793,1,home,0,8,8
7793,2,work,8,15,7
7793,3,home,15,24,9
7793,4,<ENDS>,24,24,0
7794,0,<START>,0,0,0
7794,1,home,0,6,6
7794,2,work,6,13,7
7794,3,shop,13,14,1
7794,4,home,14,24,10
7794,5,<ENDS>,24,24,0
7795,0,<START>,0,0,0
7795,1,home,0,6,6
7795,2,shop,6,7,1
7795,3,home,7,11,4
7795,4,work,11,17,6
7795,5,home,17,24,7
7795,6,<ENDS>,24,24,0
7796,0,<START>,0,0,0
7796,1,home,0,6,6
7796,2,work,6,13,7
7796,3,home,13,19,6
7796,4,shop,19,20,1
7796,5,home,20,24,4
7796,6,<ENDS>,24,24,0
7797,0,<START>,0,0,0
7797,1,home,0,6,6
7797,2,work,6,8,2
7797,3,home,8,13,5
7797,4,work,13,16,3
7797,5,home,16,23,7
7797,6,work,23,24,1
7797,7,<ENDS>,24,24,0
7798,0,<START>,0,0,0
7798,1,home,0,6,6
7798,2,shop,6,7,1
7798,3,work,7,14,7
7798,4,home,14,24,10
7798,5,<ENDS>,24,24,0
7799,0,<START>,0,0,0
7799,1,home,0,6,6
7799,2,work,6,8,2
7799,3,home,8,12,4
7799,4,work,12,14,2
7799,5,home,14,21,7
7799,6,work,21,22,1
7799,7,home,22,24,2
7799,8,<ENDS>,24,24,0
7800,0,<START>,0,0,0
7800,1,home,0,8,8
7800,2,work,8,14,6
7800,3,shop,14,15,1
7800,4,home,15,23,8
7800,5,work,23,24,1
7800,6,<ENDS>,24,24,0
7801,0,<START>,0,0,0
7801,1,home,0,6,6
7801,2,shop,6,7,1
7801,3,home,7,9,2
7801,4,education,9,12,3
7801,5,shop,12,14,2
7801,6,education,14,16,2
7801,7,home,16,24,8
7801,8,<ENDS>,24,24,0
7802,0,<START>,0,0,0
7802,1,home,0,8,8
7802,2,work,8,14,6
7802,3,home,14,24,10
7802,4,<ENDS>,24,24,0
7803,0,<START>,0,0,0
7803,1,home,0,7,7
7803,2,shop,7,8,1
7803,3,work,8,16,8
7803,4,shop,16,17,1
7803,5,home,17,24,7
7803,6,<ENDS>,24,24,0
7804,0,<START>,0,0,0
7804,1,home,0,7,7
7804,2,work,7,13,6
7804,3,home,13,24,11
7804,4,<ENDS>,24,24,0
7805,0,<START>,0,0,0
7805,1,home,0,7,7
7805,2,education,7,11,4
7805,3,home,11,17,6
7805,4,shop,17,18,1
7805,5,home,18,24,6
7805,6,<ENDS>,24,24,0
7806,0,<START>,0,0,0
7806,1,home,0,8,8
7806,2,work,8,15,7
7806,3,home,15,24,9
7806,4,<ENDS>,24,24,0
7807,0,<START>,0,0,0
7807,1,home,0,6,6
7807,2,work,6,12,6
7807,3,shop,12,13,1
7807,4,work,13,19,6
7807,5,home,19,24,5
7807,6,<ENDS>,24,24,0
7808,0,<START>,0,0,0
7808,1,home,0,6,6
7808,2,work,6,13,7
7808,3,shop,13,14,1
7808,4,home,14,22,8
7808,5,work,22,23,1
7808,6,home,23,24,1
7808,7,<ENDS>,24,24,0
7809,0,<START>,0,0,0
7809,1,home,0,7,7
7809,2,work,7,13,6
7809,3,home,13,17,4
7809,4,work,17,20,3
7809,5,home,20,24,4
7809,6,<ENDS>,24,24,0
7810,0,<START>,0,0,0
7810,1,home,0,6,6
7810,2,work,6,13,7
7810,3,shop,13,14,1
7810,4,work,14,19,5
7810,5,home,19,24,5
7810,6,<ENDS>,24,24,0
7811,0,<START>,0,0,0
7811,1,home,0,6,6
7811,2,work,6,8,2
7811,3,home,8,13,5
7811,4,work,13,15,2
7811,5,shop,15,16,1
7811,6,home,16,22,6
7811,7,work,22,23,1
7811,8,home,23,24,1
7811,9,<ENDS>,24,24,0
7812,0,<START>,0,0,0
7812,1,home,0,7,7
7812,2,work,7,8,1
7812,3,home,8,14,6
7812,4,work,14,15,1
7812,5,home,15,22,7
7812,6,work,22,23,1
7812,7,home,23,24,1
7812,8,<ENDS>,24,24,0
7813,0,<START>,0,0,0
7813,1,home,0,6,6
7813,2,work,6,13,7
7813,3,home,13,19,6
7813,4,shop,19,20,1
7813,5,home,20,24,4
7813,6,<ENDS>,24,24,0
7814,0,<START>,0,0,0
7814,1,home,0,7,7
7814,2,shop,7,9,2
7814,3,education,9,12,3
7814,4,home,12,19,7
7814,5,shop,19,20,1
7814,6,home,20,24,4
7814,7,<ENDS>,24,24,0
7815,0,<START>,0,0,0
7815,1,home,0,6,6
7815,2,shop,6,7,1
7815,3,work,7,13,6
7815,4,home,13,24,11
7815,5,<ENDS>,24,24,0
7816,0,<START>,0,0,0
7816,1,home,0,8,8
7816,2,work,8,14,6
7816,3,home,14,19,5
7816,4,shop,19,20,1
7816,5,home,20,24,4
7816,6,<ENDS>,24,24,0
7817,0,<START>,0,0,0
7817,1,home,0,7,7
7817,2,work,7,14,7
7817,3,shop,14,15,1
7817,4,home,15,24,9
7817,5,<ENDS>,24,24,0
7818,0,<START>,0,0,0
7818,1,home,0,6,6
7818,2,work,6,8,2
7818,3,home,8,13,5
7818,4,work,13,15,2
7818,5,shop,15,16,1
7818,6,home,16,24,8
7818,7,<ENDS>,24,24,0
7819,0,<START>,0,0,0
7819,1,home,0,8,8
7819,2,work,8,15,7
7819,3,shop,15,16,1
7819,4,work,16,20,4
7819,5,home,20,24,4
7819,6,<ENDS>,24,24,0
7820,0,<START>,0,0,0
7820,1,home,0,8,8
7820,2,work,8,15,7
7820,3,home,15,24,9
7820,4,<ENDS>,24,24,0
7821,0,<START>,0,0,0
7821,1,home,0,7,7
7821,2,work,7,13,6
7821,3,shop,13,14,1
7821,4,home,14,18,4
7821,5,work,18,20,2
7821,6,home,20,24,4
7821,7,<ENDS>,24,24,0
7822,0,<START>,0,0,0
7822,1,home,0,8,8
7822,2,work,8,14,6
7822,3,home,14,24,10
7822,4,<ENDS>,24,24,0
7823,0,<START>,0,0,0
7823,1,home,0,6,6
7823,2,work,6,8,2
7823,3,home,8,13,5
7823,4,work,13,15,2
7823,5,home,15,22,7
7823,6,work,22,23,1
7823,7,home,23,24,1
7823,8,<ENDS>,24,24,0
7824,0,<START>,0,0,0
7824,1,home,0,6,6
7824,2,shop,6,7,1
7824,3,home,7,13,6
7824,4,education,13,16,3
7824,5,shop,16,17,1
7824,6,home,17,24,7
7824,7,<ENDS>,24,24,0
7825,0,<START>,0,0,0
7825,1,home,0,7,7
7825,2,shop,7,8,1
7825,3,education,8,11,3
7825,4,home,11,16,5
7825,5,shop,16,17,1
7825,6,home,17,24,7
7825,7,<ENDS>,24,24,0
7826,0,<START>,0,0,0
7826,1,home,0,6,6
7826,2,work,6,14,8
7826,3,home,14,24,10
7826,4,<ENDS>,24,24,0
7827,0,<START>,0,0,0
7827,1,home,0,6,6
7827,2,shop,6,7,1
7827,3,home,7,10,3
7827,4,education,10,12,2
7827,5,shop,12,13,1
7827,6,home,13,21,8
7827,7,shop,21,22,1
7827,8,home,22,24,2
7827,9,<ENDS>,24,24,0
7828,0,<START>,0,0,0
7828,1,home,0,6,6
7828,2,work,6,13,7
7828,3,shop,13,14,1
7828,4,education,14,16,2
7828,5,home,16,23,7
7828,6,work,23,24,1
7828,7,<ENDS>,24,24,0
7829,0,<START>,0,0,0
7829,1,home,0,6,6
7829,2,work,6,13,7
7829,3,shop,13,14,1
7829,4,home,14,18,4
7829,5,work,18,20,2
7829,6,home,20,24,4
7829,7,<ENDS>,24,24,0
7830,0,<START>,0,0,0
7830,1,home,0,7,7
7830,2,education,7,11,4
7830,3,home,11,20,9
7830,4,shop,20,21,1
7830,5,home,21,24,3
7830,6,<ENDS>,24,24,0
7831,0,<START>,0,0,0
7831,1,home,0,8,8
7831,2,education,8,12,4
7831,3,home,12,18,6
7831,4,shop,18,19,1
7831,5,home,19,24,5
7831,6,<ENDS>,24,24,0
7832,0,<START>,0,0,0
7832,1,home,0,9,9
7832,2,work,9,16,7
7832,3,home,16,24,8
7832,4,<ENDS>,24,24,0
7833,0,<START>,0,0,0
7833,1,home,0,7,7
7833,2,shop,7,8,1
7833,3,education,8,11,3
7833,4,home,11,19,8
7833,5,shop,19,20,1
7833,6,home,20,24,4
7833,7,<ENDS>,24,24,0
7834,0,<START>,0,0,0
7834,1,home,0,6,6
7834,2,work,6,13,7
7834,3,shop,13,14,1
7834,4,home,14,24,10
7834,5,<ENDS>,24,24,0
7835,0,<START>,0,0,0
7835,1,home,0,6,6
7835,2,shop,6,7,1
7835,3,home,7,9,2
7835,4,work,9,16,7
7835,5,home,16,22,6
7835,6,work,22,23,1
7835,7,home,23,24,1
7835,8,<ENDS>,24,24,0
7836,0,<START>,0,0,0
7836,1,home,0,6,6
7836,2,shop,6,7,1
7836,3,home,7,13,6
7836,4,education,13,16,3
7836,5,home,16,24,8
7836,6,<ENDS>,24,24,0
7837,0,<START>,0,0,0
7837,1,home,0,8,8
7837,2,work,8,15,7
7837,3,home,15,24,9
7837,4,<ENDS>,24,24,0
7838,0,<START>,0,0,0
7838,1,home,0,6,6
7838,2,work,6,8,2
7838,3,home,8,12,4
7838,4,work,12,14,2
7838,5,shop,14,15,1
7838,6,home,15,21,6
7838,7,work,21,22,1
7838,8,home,22,24,2
7838,9,<ENDS>,24,24,0
7839,0,<START>,0,0,0
7839,1,home,0,9,9
7839,2,work,9,16,7
7839,3,home,16,24,8
7839,4,<ENDS>,24,24,0
7840,0,<START>,0,0,0
7840,1,home,0,7,7
7840,2,work,7,14,7
7840,3,shop,14,15,1
7840,4,home,15,24,9
7840,5,<ENDS>,24,24,0
7841,0,<START>,0,0,0
7841,1,home,0,6,6
7841,2,shop,6,7,1
7841,3,work,7,14,7
7841,4,home,14,18,4
7841,5,work,18,20,2
7841,6,home,20,24,4
7841,7,<ENDS>,24,24,0
7842,0,<START>,0,0,0
7842,1,home,0,8,8
7842,2,work,8,15,7
7842,3,home,15,19,4
7842,4,shop,19,20,1
7842,5,home,20,24,4
7842,6,<ENDS>,24,24,0
7843,0,<START>,0,0,0
7843,1,home,0,8,8
7843,2,work,8,17,9
7843,3,home,17,24,7
7843,4,<ENDS>,24,24,0
7844,0,<START>,0,0,0
7844,1,home,0,6,6
7844,2,shop,6,7,1
7844,3,home,7,13,6
7844,4,education,13,16,3
7844,5,shop,16,17,1
7844,6,home,17,24,7
7844,7,<ENDS>,24,24,0
7845,0,<START>,0,0,0
7845,1,home,0,7,7
7845,2,education,7,11,4
7845,3,home,11,17,6
7845,4,shop,17,18,1
7845,5,home,18,24,6
7845,6,<ENDS>,24,24,0
7846,0,<START>,0,0,0
7846,1,home,0,7,7
7846,2,education,7,11,4
7846,3,home,11,18,7
7846,4,shop,18,19,1
7846,5,home,19,24,5
7846,6,<ENDS>,24,24,0
7847,0,<START>,0,0,0
7847,1,home,0,7,7
7847,2,work,7,13,6
7847,3,shop,13,14,1
7847,4,home,14,24,10
7847,5,<ENDS>,24,24,0
7848,0,<START>,0,0,0
7848,1,home,0,10,10
7848,2,work,10,17,7
7848,3,home,17,24,7
7848,4,<ENDS>,24,24,0
7849,0,<START>,0,0,0
7849,1,home,0,8,8
7849,2,work,8,15,7
7849,3,home,15,24,9
7849,4,<ENDS>,24,24,0
7850,0,<START>,0,0,0
7850,1,home,0,8,8
7850,2,work,8,15,7
7850,3,home,15,21,6
7850,4,work,21,22,1
7850,5,home,22,24,2
7850,6,<ENDS>,24,24,0
7851,0,<START>,0,0,0
7851,1,home,0,8,8
7851,2,education,8,11,3
7851,3,home,11,17,6
7851,4,shop,17,18,1
7851,5,home,18,24,6
7851,6,<ENDS>,24,24,0
7852,0,<START>,0,0,0
7852,1,home,0,6,6
7852,2,work,6,13,7
7852,3,shop,13,14,1
7852,4,home,14,24,10
7852,5,<ENDS>,24,24,0
7853,0,<START>,0,0,0
7853,1,home,0,7,7
7853,2,work,7,13,6
7853,3,shop,13,14,1
7853,4,home,14,17,3
7853,5,work,17,20,3
7853,6,home,20,24,4
7853,7,<ENDS>,24,24,0
7854,0,<START>,0,0,0
7854,1,home,0,8,8
7854,2,education,8,14,6
7854,3,shop,14,15,1
7854,4,home,15,21,6
7854,5,shop,21,22,1
7854,6,home,22,24,2
7854,7,<ENDS>,24,24,0
7855,0,<START>,0,0,0
7855,1,home,0,7,7
7855,2,work,7,13,6
7855,3,home,13,24,11
7855,4,<ENDS>,24,24,0
7856,0,<START>,0,0,0
7856,1,home,0,7,7
7856,2,shop,7,8,1
7856,3,work,8,15,7
7856,4,home,15,24,9
7856,5,<ENDS>,24,24,0
7857,0,<START>,0,0,0
7857,1,home,0,7,7
7857,2,work,7,13,6
7857,3,shop,13,14,1
7857,4,work,14,18,4
7857,5,home,18,24,6
7857,6,<ENDS>,24,24,0
7858,0,<START>,0,0,0
7858,1,home,0,7,7
7858,2,education,7,11,4
7858,3,home,11,18,7
7858,4,shop,18,19,1
7858,5,home,19,24,5
7858,6,<ENDS>,24,24,0
7859,0,<START>,0,0,0
7859,1,home,0,8,8
7859,2,work,8,13,5
7859,3,shop,13,14,1
7859,4,education,14,16,2
7859,5,home,16,24,8
7859,6,<ENDS>,24,24,0
7860,0,<START>,0,0,0
7860,1,home,0,8,8
7860,2,work,8,15,7
7860,3,home,15,24,9
7860,4,<ENDS>,24,24,0
7861,0,<START>,0,0,0
7861,1,home,0,8,8
7861,2,shop,8,9,1
7861,3,education,9,12,3
7861,4,shop,12,15,3
7861,5,home,15,24,9
7861,6,<ENDS>,24,24,0
7862,0,<START>,0,0,0
7862,1,home,0,6,6
7862,2,work,6,13,7
7862,3,home,13,24,11
7862,4,<ENDS>,24,24,0
7863,0,<START>,0,0,0
7863,1,home,0,9,9
7863,2,work,9,15,6
7863,3,home,15,21,6
7863,4,work,21,22,1
7863,5,home,22,24,2
7863,6,<ENDS>,24,24,0
7864,0,<START>,0,0,0
7864,1,home,0,8,8
7864,2,work,8,14,6
7864,3,home,14,18,4
7864,4,work,18,20,2
7864,5,home,20,24,4
7864,6,<ENDS>,24,24,0
7865,0,<START>,0,0,0
7865,1,home,0,7,7
7865,2,education,7,12,5
7865,3,shop,12,14,2
7865,4,education,14,16,2
7865,5,home,16,24,8
7865,6,<ENDS>,24,24,0
7866,0,<START>,0,0,0
7866,1,work,0,7,7
7866,2,shop,7,8,1
7866,3,work,8,14,6
7866,4,home,14,24,10
7866,5,<ENDS>,24,24,0
7867,0,<START>,0,0,0
7867,1,home,0,6,6
7867,2,work,6,8,2
7867,3,home,8,14,6
7867,4,work,14,16,2
7867,5,home,16,22,6
7867,6,work,22,23,1
7867,7,home,23,24,1
7867,8,<ENDS>,24,24,0
7868,0,<START>,0,0,0
7868,1,home,0,7,7
7868,2,work,7,13,6
7868,3,home,13,16,3
7868,4,work,16,20,4
7868,5,home,20,24,4
7868,6,<ENDS>,24,24,0
7869,0,<START>,0,0,0
7869,1,home,0,9,9
7869,2,work,9,16,7
7869,3,home,16,24,8
7869,4,<ENDS>,24,24,0
7870,0,<START>,0,0,0
7870,1,home,0,9,9
7870,2,work,9,16,7
7870,3,home,16,24,8
7870,4,<ENDS>,24,24,0
7871,0,<START>,0,0,0
7871,1,home,0,7,7
7871,2,shop,7,8,1
7871,3,education,8,11,3
7871,4,home,11,15,4
7871,5,shop,15,16,1
7871,6,home,16,24,8
7871,7,<ENDS>,24,24,0
7872,0,<START>,0,0,0
7872,1,home,0,7,7
7872,2,shop,7,8,1
7872,3,work,8,13,5
7872,4,home,13,24,11
7872,5,<ENDS>,24,24,0
7873,0,<START>,0,0,0
7873,1,home,0,7,7
7873,2,education,7,13,6
7873,3,home,13,21,8
7873,4,shop,21,22,1
7873,5,home,22,24,2
7873,6,<ENDS>,24,24,0
7874,0,<START>,0,0,0
7874,1,home,0,7,7
7874,2,education,7,11,4
7874,3,home,11,18,7
7874,4,shop,18,19,1
7874,5,home,19,24,5
7874,6,<ENDS>,24,24,0
7875,0,<START>,0,0,0
7875,1,home,0,6,6
7875,2,work,6,13,7
7875,3,home,13,17,4
7875,4,shop,17,18,1
7875,5,home,18,24,6
7875,6,<ENDS>,24,24,0
7876,0,<START>,0,0,0
7876,1,home,0,8,8
7876,2,education,8,12,4
7876,3,home,12,19,7
7876,4,shop,19,20,1
7876,5,home,20,24,4
7876,6,<ENDS>,24,24,0
7877,0,<START>,0,0,0
7877,1,home,0,7,7
7877,2,education,7,11,4
7877,3,home,11,19,8
7877,4,shop,19,20,1
7877,5,home,20,24,4
7877,6,<ENDS>,24,24,0
7878,0,<START>,0,0,0
7878,1,home,0,7,7
7878,2,work,7,13,6
7878,3,home,13,17,4
7878,4,work,17,20,3
7878,5,home,20,24,4
7878,6,<ENDS>,24,24,0
7879,0,<START>,0,0,0
7879,1,home,0,9,9
7879,2,education,9,12,3
7879,3,work,12,19,7
7879,4,home,19,24,5
7879,5,<ENDS>,24,24,0
7880,0,<START>,0,0,0
7880,1,home,0,9,9
7880,2,work,9,16,7
7880,3,home,16,21,5
7880,4,shop,21,22,1
7880,5,home,22,24,2
7880,6,<ENDS>,24,24,0
7881,0,<START>,0,0,0
7881,1,home,0,8,8
7881,2,work,8,14,6
7881,3,shop,14,15,1
7881,4,home,15,24,9
7881,5,<ENDS>,24,24,0
7882,0,<START>,0,0,0
7882,1,home,0,7,7
7882,2,work,7,10,3
7882,3,home,10,16,6
7882,4,work,16,18,2
7882,5,home,18,21,3
7882,6,work,21,22,1
7882,7,home,22,24,2
7882,8,<ENDS>,24,24,0
7883,0,<START>,0,0,0
7883,1,home,0,6,6
7883,2,shop,6,7,1
7883,3,home,7,13,6
7883,4,education,13,16,3
7883,5,shop,16,18,2
7883,6,home,18,24,6
7883,7,<ENDS>,24,24,0
7884,0,<START>,0,0,0
7884,1,home,0,6,6
7884,2,work,6,8,2
7884,3,home,8,12,4
7884,4,work,12,14,2
7884,5,home,14,21,7
7884,6,work,21,22,1
7884,7,home,22,24,2
7884,8,<ENDS>,24,24,0
7885,0,<START>,0,0,0
7885,1,home,0,8,8
7885,2,work,8,15,7
7885,3,home,15,24,9
7885,4,<ENDS>,24,24,0
7886,0,<START>,0,0,0
7886,1,home,0,8,8
7886,2,work,8,14,6
7886,3,home,14,24,10
7886,4,<ENDS>,24,24,0
7887,0,<START>,0,0,0
7887,1,home,0,7,7
7887,2,work,7,13,6
7887,3,shop,13,14,1
7887,4,education,14,16,2
7887,5,home,16,24,8
7887,6,<ENDS>,24,24,0
7888,0,<START>,0,0,0
7888,1,home,0,7,7
7888,2,education,7,11,4
7888,3,home,11,18,7
7888,4,shop,18,20,2
7888,5,home,20,24,4
7888,6,<ENDS>,24,24,0
7889,0,<START>,0,0,0
7889,1,home,0,10,10
7889,2,work,10,18,8
7889,3,home,18,24,6
7889,4,<ENDS>,24,24,0
7890,0,<START>,0,0,0
7890,1,home,0,6,6
7890,2,work,6,8,2
7890,3,home,8,9,1
7890,4,work,9,11,2
7890,5,home,11,17,6
7890,6,work,17,19,2
7890,7,home,19,23,4
7890,8,work,23,24,1
7890,9,<ENDS>,24,24,0
7891,0,<START>,0,0,0
7891,1,home,0,8,8
7891,2,work,8,13,5
7891,3,home,13,24,11
7891,4,<ENDS>,24,24,0
7892,0,<START>,0,0,0
7892,1,home,0,7,7
7892,2,work,7,15,8
7892,3,home,15,22,7
7892,4,work,22,23,1
7892,5,home,23,24,1
7892,6,<ENDS>,24,24,0
7893,0,<START>,0,0,0
7893,1,home,0,7,7
7893,2,education,7,12,5
7893,3,shop,12,13,1
7893,4,education,13,15,2
7893,5,shop,15,17,2
7893,6,home,17,24,7
7893,7,<ENDS>,24,24,0
7894,0,<START>,0,0,0
7894,1,home,0,8,8
7894,2,work,8,15,7
7894,3,home,15,24,9
7894,4,<ENDS>,24,24,0
7895,0,<START>,0,0,0
7895,1,home,0,7,7
7895,2,work,7,14,7
7895,3,shop,14,15,1
7895,4,work,15,19,4
7895,5,home,19,24,5
7895,6,<ENDS>,24,24,0
7896,0,<START>,0,0,0
7896,1,home,0,6,6
7896,2,work,6,13,7
7896,3,shop,13,14,1
7896,4,home,14,24,10
7896,5,<ENDS>,24,24,0
7897,0,<START>,0,0,0
7897,1,home,0,6,6
7897,2,work,6,13,7
7897,3,home,13,24,11
7897,4,<ENDS>,24,24,0
7898,0,<START>,0,0,0
7898,1,home,0,7,7
7898,2,work,7,9,2
7898,3,home,9,15,6
7898,4,work,15,18,3
7898,5,home,18,24,6
7898,6,<ENDS>,24,24,0
7899,0,<START>,0,0,0
7899,1,home,0,8,8
7899,2,work,8,15,7
7899,3,home,15,21,6
7899,4,work,21,22,1
7899,5,home,22,24,2
7899,6,<ENDS>,24,24,0
7900,0,<START>,0,0,0
7900,1,home,0,8,8
7900,2,education,8,11,3
7900,3,home,11,18,7
7900,4,shop,18,20,2
7900,5,home,20,24,4
7900,6,<ENDS>,24,24,0
7901,0,<START>,0,0,0
7901,1,home,0,8,8
7901,2,work,8,15,7
7901,3,home,15,24,9
7901,4,<ENDS>,24,24,0
7902,0,<START>,0,0,0
7902,1,home,0,7,7
7902,2,work,7,15,8
7902,3,home,15,24,9
7902,4,<ENDS>,24,24,0
7903,0,<START>,0,0,0
7903,1,home,0,8,8
7903,2,work,8,15,7
7903,3,home,15,20,5
7903,4,shop,20,21,1
7903,5,home,21,24,3
7903,6,<ENDS>,24,24,0
7904,0,<START>,0,0,0
7904,1,home,0,8,8
7904,2,work,8,15,7
7904,3,home,15,24,9
7904,4,<ENDS>,24,24,0
7905,0,<START>,0,0,0
7905,1,home,0,7,7
7905,2,work,7,14,7
7905,3,shop,14,15,1
7905,4,home,15,24,9
7905,5,<ENDS>,24,24,0
7906,0,<START>,0,0,0
7906,1,home,0,8,8
7906,2,work,8,15,7
7906,3,home,15,21,6
7906,4,work,21,22,1
7906,5,home,22,24,2
7906,6,<ENDS>,24,24,0
7907,0,<START>,0,0,0
7907,1,home,0,8,8
7907,2,work,8,14,6
7907,3,home,14,24,10
7907,4,<ENDS>,24,24,0
7908,0,<START>,0,0,0
7908,1,home,0,7,7
7908,2,work,7,14,7
7908,3,home,14,24,10
7908,4,<ENDS>,24,24,0
7909,0,<START>,0,0,0
7909,1,home,0,6,6
7909,2,work,6,8,2
7909,3,home,8,10,2
7909,4,work,10,12,2
7909,5,home,12,18,6
7909,6,work,18,20,2
7909,7,home,20,24,4
7909,8,<ENDS>,24,24,0
7910,0,<START>,0,0,0
7910,1,home,0,7,7
7910,2,work,7,14,7
7910,3,home,14,24,10
7910,4,<ENDS>,24,24,0
7911,0,<START>,0,0,0
7911,1,home,0,9,9
7911,2,work,9,15,6
7911,3,home,15,24,9
7911,4,<ENDS>,24,24,0
7912,0,<START>,0,0,0
7912,1,home,0,8,8
7912,2,work,8,16,8
7912,3,home,16,24,8
7912,4,<ENDS>,24,24,0
7913,0,<START>,0,0,0
7913,1,home,0,7,7
7913,2,work,7,13,6
7913,3,home,13,17,4
7913,4,shop,17,18,1
7913,5,home,18,24,6
7913,6,<ENDS>,24,24,0
7914,0,<START>,0,0,0
7914,1,home,0,8,8
7914,2,work,8,15,7
7914,3,home,15,24,9
7914,4,<ENDS>,24,24,0
7915,0,<START>,0,0,0
7915,1,home,0,8,8
7915,2,work,8,15,7
7915,3,home,15,21,6
7915,4,work,21,22,1
7915,5,home,22,24,2
7915,6,<ENDS>,24,24,0
7916,0,<START>,0,0,0
7916,1,work,0,7,7
7916,2,shop,7,8,1
7916,3,home,8,12,4
7916,4,work,12,18,6
7916,5,home,18,24,6
7916,6,<ENDS>,24,24,0
7917,0,<START>,0,0,0
7917,1,home,0,6,6
7917,2,shop,6,7,1
7917,3,home,7,13,6
7917,4,education,13,16,3
7917,5,shop,16,18,2
7917,6,home,18,24,6
7917,7,<ENDS>,24,24,0
7918,0,<START>,0,0,0
7918,1,home,0,8,8
7918,2,work,8,15,7
7918,3,home,15,24,9
7918,4,<ENDS>,24,24,0
7919,0,<START>,0,0,0
7919,1,home,0,7,7
7919,2,work,7,15,8
7919,3,shop,15,16,1
7919,4,home,16,24,8
7919,5,<ENDS>,24,24,0
7920,0,<START>,0,0,0
7920,1,home,0,7,7
7920,2,work,7,13,6
7920,3,home,13,24,11
7920,4,<ENDS>,24,24,0
7921,0,<START>,0,0,0
7921,1,home,0,7,7
7921,2,work,7,13,6
7921,3,home,13,17,4
7921,4,work,17,20,3
7921,5,home,20,24,4
7921,6,<ENDS>,24,24,0
7922,0,<START>,0,0,0
7922,1,home,0,7,7
7922,2,work,7,9,2
7922,3,home,9,13,4
7922,4,work,13,15,2
7922,5,home,15,16,1
7922,6,work,16,18,2
7922,7,home,18,23,5
7922,8,work,23,24,1
7922,9,<ENDS>,24,24,0
7923,0,<START>,0,0,0
7923,1,home,0,7,7
7923,2,work,7,13,6
7923,3,home,13,17,4
7923,4,shop,17,18,1
7923,5,home,18,24,6
7923,6,<ENDS>,24,24,0
7924,0,<START>,0,0,0
7924,1,home,0,6,6
7924,2,work,6,13,7
7924,3,home,13,16,3
7924,4,work,16,20,4
7924,5,home,20,24,4
7924,6,<ENDS>,24,24,0
7925,0,<START>,0,0,0
7925,1,home,0,7,7
7925,2,work,7,13,6
7925,3,home,13,24,11
7925,4,<ENDS>,24,24,0
7926,0,<START>,0,0,0
7926,1,home,0,8,8
7926,2,work,8,14,6
7926,3,home,14,24,10
7926,4,<ENDS>,24,24,0
7927,0,<START>,0,0,0
7927,1,home,0,9,9
7927,2,work,9,16,7
7927,3,shop,16,17,1
7927,4,home,17,24,7
7927,5,<ENDS>,24,24,0
7928,0,<START>,0,0,0
7928,1,home,0,6,6
7928,2,shop,6,7,1
7928,3,home,7,13,6
7928,4,education,13,15,2
7928,5,shop,15,16,1
7928,6,home,16,24,8
7928,7,<ENDS>,24,24,0
7929,0,<START>,0,0,0
7929,1,home,0,7,7
7929,2,work,7,13,6
7929,3,home,13,24,11
7929,4,<ENDS>,24,24,0
7930,0,<START>,0,0,0
7930,1,home,0,7,7
7930,2,education,7,11,4
7930,3,home,11,19,8
7930,4,shop,19,20,1
7930,5,home,20,24,4
7930,6,<ENDS>,24,24,0
7931,0,<START>,0,0,0
7931,1,home,0,6,6
7931,2,work,6,13,7
7931,3,home,13,19,6
7931,4,shop,19,20,1
7931,5,home,20,24,4
7931,6,<ENDS>,24,24,0
7932,0,<START>,0,0,0
7932,1,home,0,6,6
7932,2,work,6,13,7
7932,3,shop,13,14,1
7932,4,home,14,18,4
7932,5,work,18,20,2
7932,6,home,20,24,4
7932,7,<ENDS>,24,24,0
7933,0,<START>,0,0,0
7933,1,home,0,8,8
7933,2,work,8,14,6
7933,3,home,14,24,10
7933,4,<ENDS>,24,24,0
7934,0,<START>,0,0,0
7934,1,home,0,6,6
7934,2,shop,6,7,1
7934,3,home,7,13,6
7934,4,education,13,16,3
7934,5,home,16,24,8
7934,6,<ENDS>,24,24,0
7935,0,<START>,0,0,0
7935,1,home,0,7,7
7935,2,work,7,14,7
7935,3,shop,14,15,1
7935,4,home,15,24,9
7935,5,<ENDS>,24,24,0
7936,0,<START>,0,0,0
7936,1,home,0,7,7
7936,2,shop,7,8,1
7936,3,home,8,12,4
7936,4,education,12,15,3
7936,5,work,15,19,4
7936,6,home,19,23,4
7936,7,work,23,24,1
7936,8,<ENDS>,24,24,0
7937,0,<START>,0,0,0
7937,1,home,0,7,7
7937,2,work,7,13,6
7937,3,home,13,24,11
7937,4,<ENDS>,24,24,0
7938,0,<START>,0,0,0
7938,1,home,0,7,7
7938,2,education,7,12,5
7938,3,home,12,17,5
7938,4,shop,17,19,2
7938,5,home,19,24,5
7938,6,<ENDS>,24,24,0
7939,0,<START>,0,0,0
7939,1,home,0,6,6
7939,2,work,6,8,2
7939,3,home,8,9,1
7939,4,work,9,11,2
7939,5,home,11,16,5
7939,6,work,16,18,2
7939,7,home,18,22,4
7939,8,work,22,23,1
7939,9,home,23,24,1
7939,10,<ENDS>,24,24,0
7940,0,<START>,0,0,0
7940,1,home,0,8,8
7940,2,work,8,15,7
7940,3,shop,15,16,1
7940,4,home,16,24,8
7940,5,<ENDS>,24,24,0
7941,0,<START>,0,0,0
7941,1,home,0,6,6
7941,2,shop,6,7,1
7941,3,home,7,9,2
7941,4,education,9,12,3
7941,5,shop,12,13,1
7941,6,education,13,16,3
7941,7,home,16,21,5
7941,8,shop,21,22,1
7941,9,home,22,24,2
7941,10,<ENDS>,24,24,0
7942,0,<START>,0,0,0
7942,1,home,0,6,6
7942,2,work,6,8,2
7942,3,home,8,10,2
7942,4,work,10,12,2
7942,5,home,12,16,4
7942,6,work,16,18,2
7942,7,home,18,23,5
7942,8,work,23,24,1
7942,9,<ENDS>,24,24,0
7943,0,<START>,0,0,0
7943,1,home,0,7,7
7943,2,work,7,13,6
7943,3,home,13,16,3
7943,4,work,16,18,2
7943,5,home,18,24,6
7943,6,<ENDS>,24,24,0
7944,0,<START>,0,0,0
7944,1,home,0,7,7
7944,2,shop,7,8,1
7944,3,education,8,12,4
7944,4,shop,12,15,3
7944,5,home,15,24,9
7944,6,<ENDS>,24,24,0
7945,0,<START>,0,0,0
7945,1,home,0,9,9
7945,2,work,9,16,7
7945,3,home,16,24,8
7945,4,<ENDS>,24,24,0
7946,0,<START>,0,0,0
7946,1,home,0,7,7
7946,2,work,7,14,7
7946,3,shop,14,15,1
7946,4,home,15,22,7
7946,5,work,22,23,1
7946,6,home,23,24,1
7946,7,<ENDS>,24,24,0
7947,0,<START>,0,0,0
7947,1,home,0,8,8
7947,2,education,8,11,3
7947,3,home,11,15,4
7947,4,work,15,20,5
7947,5,home,20,24,4
7947,6,<ENDS>,24,24,0
7948,0,<START>,0,0,0
7948,1,home,0,7,7
7948,2,work,7,13,6
7948,3,home,13,17,4
7948,4,work,17,20,3
7948,5,home,20,24,4
7948,6,<ENDS>,24,24,0
7949,0,<START>,0,0,0
7949,1,home,0,8,8
7949,2,work,8,14,6
7949,3,shop,14,15,1
7949,4,work,15,20,5
7949,5,home,20,24,4
7949,6,<ENDS>,24,24,0
7950,0,<START>,0,0,0
7950,1,home,0,7,7
7950,2,work,7,14,7
7950,3,home,14,24,10
7950,4,<ENDS>,24,24,0
7951,0,<START>,0,0,0
7951,1,home,0,7,7
7951,2,work,7,13,6
7951,3,home,13,24,11
7951,4,<ENDS>,24,24,0
7952,0,<START>,0,0,0
7952,1,home,0,7,7
7952,2,work,7,14,7
7952,3,shop,14,15,1
7952,4,home,15,24,9
7952,5,<ENDS>,24,24,0
7953,0,<START>,0,0,0
7953,1,home,0,8,8
7953,2,work,8,13,5
7953,3,shop,13,14,1
7953,4,work,14,18,4
7953,5,home,18,24,6
7953,6,<ENDS>,24,24,0
7954,0,<START>,0,0,0
7954,1,home,0,7,7
7954,2,education,7,11,4
7954,3,home,11,19,8
7954,4,shop,19,20,1
7954,5,home,20,24,4
7954,6,<ENDS>,24,24,0
7955,0,<START>,0,0,0
7955,1,home,0,8,8
7955,2,work,8,14,6
7955,3,shop,14,15,1
7955,4,home,15,21,6
7955,5,work,21,22,1
7955,6,home,22,24,2
7955,7,<ENDS>,24,24,0
7956,0,<START>,0,0,0
7956,1,home,0,7,7
7956,2,work,7,14,7
7956,3,home,14,24,10
7956,4,<ENDS>,24,24,0
7957,0,<START>,0,0,0
7957,1,home,0,7,7
7957,2,shop,7,9,2
7957,3,education,9,12,3
7957,4,shop,12,13,1
7957,5,education,13,16,3
7957,6,home,16,24,8
7957,7,<ENDS>,24,24,0
7958,0,<START>,0,0,0
7958,1,home,0,7,7
7958,2,work,7,13,6
7958,3,home,13,18,5
7958,4,shop,18,19,1
7958,5,home,19,24,5
7958,6,<ENDS>,24,24,0
7959,0,<START>,0,0,0
7959,1,home,0,6,6
7959,2,work,6,13,7
7959,3,home,13,17,4
7959,4,work,17,19,2
7959,5,home,19,24,5
7959,6,<ENDS>,24,24,0
7960,0,<START>,0,0,0
7960,1,home,0,6,6
7960,2,work,6,13,7
7960,3,home,13,18,5
7960,4,work,18,20,2
7960,5,home,20,24,4
7960,6,<ENDS>,24,24,0
7961,0,<START>,0,0,0
7961,1,home,0,6,6
7961,2,work,6,13,7
7961,3,shop,13,14,1
7961,4,home,14,24,10
7961,5,<ENDS>,24,24,0
7962,0,<START>,0,0,0
7962,1,home,0,7,7
7962,2,shop,7,8,1
7962,3,home,8,14,6
7962,4,education,14,17,3
7962,5,shop,17,18,1
7962,6,home,18,24,6
7962,7,<ENDS>,24,24,0
7963,0,<START>,0,0,0
7963,1,home,0,8,8
7963,2,work,8,13,5
7963,3,home,13,19,6
7963,4,shop,19,20,1
7963,5,home,20,24,4
7963,6,<ENDS>,24,24,0
7964,0,<START>,0,0,0
7964,1,work,0,1,1
7964,2,home,1,7,6
7964,3,education,7,12,5
7964,4,shop,12,14,2
7964,5,education,14,16,2
7964,6,shop,16,17,1
7964,7,home,17,24,7
7964,8,<ENDS>,24,24,0
7965,0,<START>,0,0,0
7965,1,home,0,8,8
7965,2,work,8,15,7
7965,3,home,15,22,7
7965,4,work,22,23,1
7965,5,home,23,24,1
7965,6,<ENDS>,24,24,0
7966,0,<START>,0,0,0
7966,1,home,0,7,7
7966,2,work,7,13,6
7966,3,home,13,22,9
7966,4,work,22,23,1
7966,5,home,23,24,1
7966,6,<ENDS>,24,24,0
7967,0,<START>,0,0,0
7967,1,home,0,7,7
7967,2,education,7,11,4
7967,3,home,11,18,7
7967,4,shop,18,19,1
7967,5,home,19,24,5
7967,6,<ENDS>,24,24,0
7968,0,<START>,0,0,0
7968,1,home,0,6,6
7968,2,work,6,13,7
7968,3,home,13,18,5
7968,4,work,18,20,2
7968,5,home,20,24,4
7968,6,<ENDS>,24,24,0
7969,0,<START>,0,0,0
7969,1,home,0,6,6
7969,2,work,6,8,2
7969,3,home,8,14,6
7969,4,work,14,17,3
7969,5,home,17,23,6
7969,6,work,23,24,1
7969,7,<ENDS>,24,24,0
7970,0,<START>,0,0,0
7970,1,home,0,7,7
7970,2,work,7,13,6
7970,3,shop,13,14,1
7970,4,education,14,16,2
7970,5,home,16,24,8
7970,6,<ENDS>,24,24,0
7971,0,<START>,0,0,0
7971,1,home,0,6,6
7971,2,work,6,13,7
7971,3,shop,13,14,1
7971,4,home,14,22,8
7971,5,work,22,23,1
7971,6,home,23,24,1
7971,7,<ENDS>,24,24,0
7972,0,<START>,0,0,0
7972,1,home,0,7,7
7972,2,education,7,12,5
7972,3,shop,12,14,2
7972,4,education,14,16,2
7972,5,home,16,24,8
7972,6,<ENDS>,24,24,0
7973,0,<START>,0,0,0
7973,1,home,0,7,7
7973,2,work,7,13,6
7973,3,home,13,17,4
7973,4,work,17,20,3
7973,5,home,20,24,4
7973,6,<ENDS>,24,24,0
7974,0,<START>,0,0,0
7974,1,home,0,7,7
7974,2,work,7,13,6
7974,3,home,13,24,11
7974,4,<ENDS>,24,24,0
7975,0,<START>,0,0,0
7975,1,home,0,7,7
7975,2,work,7,13,6
7975,3,home,13,21,8
7975,4,work,21,22,1
7975,5,home,22,24,2
7975,6,<ENDS>,24,24,0
7976,0,<START>,0,0,0
7976,1,home,0,6,6
7976,2,work,6,8,2
7976,3,home,8,9,1
7976,4,work,9,11,2
7976,5,home,11,15,4
7976,6,shop,15,16,1
7976,7,home,16,22,6
7976,8,work,22,23,1
7976,9,home,23,24,1
7976,10,<ENDS>,24,24,0
7977,0,<START>,0,0,0
7977,1,home,0,7,7
7977,2,work,7,13,6
7977,3,shop,13,14,1
7977,4,work,14,19,5
7977,5,home,19,24,5
7977,6,<ENDS>,24,24,0
7978,0,<START>,0,0,0
7978,1,home,0,6,6
7978,2,work,6,13,7
7978,3,home,13,22,9
7978,4,work,22,23,1
7978,5,home,23,24,1
7978,6,<ENDS>,24,24,0
7979,0,<START>,0,0,0
7979,1,home,0,6,6
7979,2,work,6,13,7
7979,3,home,13,17,4
7979,4,shop,17,18,1
7979,5,home,18,24,6
7979,6,<ENDS>,24,24,0
7980,0,<START>,0,0,0
7980,1,home,0,8,8
7980,2,work,8,15,7
7980,3,shop,15,16,1
7980,4,work,16,20,4
7980,5,home,20,24,4
7980,6,<ENDS>,24,24,0
7981,0,<START>,0,0,0
7981,1,home,0,8,8
7981,2,education,8,12,4
7981,3,shop,12,13,1
7981,4,education,13,15,2
7981,5,shop,15,16,1
7981,6,home,16,24,8
7981,7,<ENDS>,24,24,0
7982,0,<START>,0,0,0
7982,1,home,0,7,7
7982,2,work,7,13,6
7982,3,shop,13,14,1
7982,4,work,14,20,6
7982,5,home,20,24,4
7982,6,<ENDS>,24,24,0
7983,0,<START>,0,0,0
7983,1,home,0,8,8
7983,2,education,8,12,4
7983,3,shop,12,14,2
7983,4,home,14,21,7
7983,5,shop,21,22,1
7983,6,home,22,24,2
7983,7,<ENDS>,24,24,0
7984,0,<START>,0,0,0
7984,1,home,0,8,8
7984,2,work,8,15,7
7984,3,home,15,22,7
7984,4,work,22,23,1
7984,5,home,23,24,1
7984,6,<ENDS>,24,24,0
7985,0,<START>,0,0,0
7985,1,home,0,7,7
7985,2,education,7,12,5
7985,3,home,12,19,7
7985,4,shop,19,21,2
7985,5,home,21,24,3
7985,6,<ENDS>,24,24,0
7986,0,<START>,0,0,0
7986,1,home,0,7,7
7986,2,work,7,8,1
7986,3,home,8,12,4
7986,4,work,12,15,3
7986,5,home,15,22,7
7986,6,work,22,23,1
7986,7,home,23,24,1
7986,8,<ENDS>,24,24,0
7987,0,<START>,0,0,0
7987,1,home,0,7,7
7987,2,work,7,14,7
7987,3,home,14,24,10
7987,4,<ENDS>,24,24,0
7988,0,<START>,0,0,0
7988,1,home,0,7,7
7988,2,education,7,11,4
7988,3,home,11,17,6
7988,4,shop,17,18,1
7988,5,home,18,24,6
7988,6,<ENDS>,24,24,0
7989,0,<START>,0,0,0
7989,1,home,0,6,6
7989,2,work,6,12,6
7989,3,shop,12,13,1
7989,4,work,13,19,6
7989,5,education,19,20,1
7989,6,home,20,24,4
7989,7,<ENDS>,24,24,0
7990,0,<START>,0,0,0
7990,1,home,0,7,7
7990,2,work,7,13,6
7990,3,shop,13,14,1
7990,4,work,14,20,6
7990,5,home,20,24,4
7990,6,<ENDS>,24,24,0
7991,0,<START>,0,0,0
7991,1,home,0,6,6
7991,2,work,6,8,2
7991,3,home,8,12,4
7991,4,work,12,14,2
7991,5,home,14,21,7
7991,6,work,21,22,1
7991,7,home,22,24,2
7991,8,<ENDS>,24,24,0
7992,0,<START>,0,0,0
7992,1,home,0,8,8
7992,2,work,8,15,7
7992,3,home,15,24,9
7992,4,<ENDS>,24,24,0
7993,0,<START>,0,0,0
7993,1,home,0,7,7
7993,2,work,7,14,7
7993,3,shop,14,15,1
7993,4,work,15,20,5
7993,5,home,20,24,4
7993,6,<ENDS>,24,24,0
7994,0,<START>,0,0,0
7994,1,home,0,9,9
7994,2,work,9,16,7
7994,3,home,16,22,6
7994,4,work,22,23,1
7994,5,home,23,24,1
7994,6,<ENDS>,24,24,0
7995,0,<START>,0,0,0
7995,1,home,0,7,7
7995,2,work,7,13,6
7995,3,home,13,20,7
7995,4,shop,20,21,1
7995,5,home,21,24,3
7995,6,<ENDS>,24,24,0
7996,0,<START>,0,0,0
7996,1,home,0,6,6
7996,2,shop,6,7,1
7996,3,home,7,13,6
7996,4,education,13,16,3
7996,5,shop,16,17,1
7996,6,home,17,24,7
7996,7,<ENDS>,24,24,0
7997,0,<START>,0,0,0
7997,1,home,0,6,6
7997,2,work,6,13,7
7997,3,home,13,24,11
7997,4,<ENDS>,24,24,0
7998,0,<START>,0,0,0
7998,1,home,0,7,7
7998,2,work,7,13,6
7998,3,shop,13,15,2
7998,4,work,15,19,4
7998,5,home,19,24,5
7998,6,<ENDS>,24,24,0
7999,0,<START>,0,0,0
7999,1,home,0,8,8
7999,2,work,8,15,7
7999,3,home,15,18,3
7999,4,work,18,20,2
7999,5,home,20,24,4
7999,6,<ENDS>,24,24,0
8000,0,<START>,0,0,0
8000,1,home,0,7,7
8000,2,work,7,9,2
8000,3,home,9,13,4
8000,4,work,13,15,2
8000,5,home,15,22,7
8000,6,work,22,23,1
8000,7,home,23,24,1
8000,8,<ENDS>,24,24,0
8001,0,<START>,0,0,0
8001,1,home,0,8,8
8001,2,education,8,12,4
8001,3,home,12,19,7
8001,4,shop,19,21,2
8001,5,home,21,24,3
8001,6,<ENDS>,24,24,0
8002,0,<START>,0,0,0
8002,1,home,0,6,6
8002,2,work,6,13,7
8002,3,shop,13,14,1
8002,4,home,14,24,10
8002,5,<ENDS>,24,24,0
8003,0,<START>,0,0,0
8003,1,home,0,7,7
8003,2,work,7,13,6
8003,3,shop,13,14,1
8003,4,work,14,20,6
8003,5,home,20,24,4
8003,6,<ENDS>,24,24,0
8004,0,<START>,0,0,0
8004,1,home,0,7,7
8004,2,work,7,14,7
8004,3,home,14,24,10
8004,4,<ENDS>,24,24,0
8005,0,<START>,0,0,0
8005,1,home,0,7,7
8005,2,work,7,14,7
8005,3,home,14,24,10
8005,4,<ENDS>,24,24,0
8006,0,<START>,0,0,0
8006,1,home,0,6,6
8006,2,work,6,8,2
8006,3,home,8,9,1
8006,4,work,9,11,2
8006,5,home,11,17,6
8006,6,work,17,19,2
8006,7,home,19,24,5
8006,8,<ENDS>,24,24,0
8007,0,<START>,0,0,0
8007,1,home,0,6,6
8007,2,shop,6,7,1
8007,3,home,7,10,3
8007,4,education,10,15,5
8007,5,shop,15,17,2
8007,6,home,17,24,7
8007,7,<ENDS>,24,24,0
8008,0,<START>,0,0,0
8008,1,home,0,7,7
8008,2,work,7,14,7
8008,3,shop,14,15,1
8008,4,work,15,19,4
8008,5,education,19,20,1
8008,6,home,20,24,4
8008,7,<ENDS>,24,24,0
8009,0,<START>,0,0,0
8009,1,home,0,7,7
8009,2,work,7,13,6
8009,3,home,13,19,6
8009,4,shop,19,20,1
8009,5,home,20,24,4
8009,6,<ENDS>,24,24,0
8010,0,<START>,0,0,0
8010,1,home,0,6,6
8010,2,shop,6,7,1
8010,3,home,7,13,6
8010,4,education,13,16,3
8010,5,home,16,24,8
8010,6,<ENDS>,24,24,0
8011,0,<START>,0,0,0
8011,1,home,0,8,8
8011,2,work,8,14,6
8011,3,home,14,24,10
8011,4,<ENDS>,24,24,0
8012,0,<START>,0,0,0
8012,1,home,0,6,6
8012,2,shop,6,7,1
8012,3,home,7,10,3
8012,4,education,10,14,4
8012,5,shop,14,16,2
8012,6,home,16,24,8
8012,7,<ENDS>,24,24,0
8013,0,<START>,0,0,0
8013,1,home,0,8,8
8013,2,education,8,11,3
8013,3,shop,11,12,1
8013,4,work,12,19,7
8013,5,home,19,22,3
8013,6,work,22,23,1
8013,7,home,23,24,1
8013,8,<ENDS>,24,24,0
8014,0,<START>,0,0,0
8014,1,home,0,6,6
8014,2,work,6,13,7
8014,3,shop,13,14,1
8014,4,home,14,24,10
8014,5,<ENDS>,24,24,0
8015,0,<START>,0,0,0
8015,1,home,0,8,8
8015,2,work,8,14,6
8015,3,shop,14,15,1
8015,4,work,15,20,5
8015,5,home,20,24,4
8015,6,<ENDS>,24,24,0
8016,0,<START>,0,0,0
8016,1,home,0,8,8
8016,2,education,8,11,3
8016,3,home,11,18,7
8016,4,shop,18,19,1
8016,5,home,19,24,5
8016,6,<ENDS>,24,24,0
8017,0,<START>,0,0,0
8017,1,home,0,6,6
8017,2,work,6,13,7
8017,3,shop,13,14,1
8017,4,home,14,23,9
8017,5,work,23,24,1
8017,6,<ENDS>,24,24,0
8018,0,<START>,0,0,0
8018,1,home,0,6,6
8018,2,shop,6,7,1
8018,3,home,7,10,3
8018,4,education,10,12,2
8018,5,home,12,19,7
8018,6,shop,19,20,1
8018,7,home,20,24,4
8018,8,<ENDS>,24,24,0
8019,0,<START>,0,0,0
8019,1,home,0,7,7
8019,2,work,7,13,6
8019,3,home,13,24,11
8019,4,<ENDS>,24,24,0
8020,0,<START>,0,0,0
8020,1,home,0,7,7
8020,2,education,7,11,4
8020,3,home,11,19,8
8020,4,shop,19,20,1
8020,5,home,20,24,4
8020,6,<ENDS>,24,24,0
8021,0,<START>,0,0,0
8021,1,home,0,8,8
8021,2,education,8,11,3
8021,3,home,11,24,13
8021,4,<ENDS>,24,24,0
8022,0,<START>,0,0,0
8022,1,home,0,6,6
8022,2,work,6,8,2
8022,3,home,8,10,2
8022,4,work,10,12,2
8022,5,home,12,18,6
8022,6,work,18,20,2
8022,7,home,20,23,3
8022,8,work,23,24,1
8022,9,<ENDS>,24,24,0
8023,0,<START>,0,0,0
8023,1,home,0,7,7
8023,2,shop,7,8,1
8023,3,home,8,13,5
8023,4,work,13,19,6
8023,5,home,19,22,3
8023,6,work,22,23,1
8023,7,home,23,24,1
8023,8,<ENDS>,24,24,0
8024,0,<START>,0,0,0
8024,1,home,0,7,7
8024,2,work,7,14,7
8024,3,shop,14,15,1
8024,4,home,15,24,9
8024,5,<ENDS>,24,24,0
8025,0,<START>,0,0,0
8025,1,home,0,7,7
8025,2,shop,7,8,1
8025,3,home,8,12,4
8025,4,education,12,16,4
8025,5,home,16,24,8
8025,6,<ENDS>,24,24,0
8026,0,<START>,0,0,0
8026,1,home,0,7,7
8026,2,shop,7,8,1
8026,3,home,8,13,5
8026,4,work,13,19,6
8026,5,home,19,24,5
8026,6,<ENDS>,24,24,0
8027,0,<START>,0,0,0
8027,1,home,0,7,7
8027,2,work,7,15,8
8027,3,home,15,21,6
8027,4,work,21,22,1
8027,5,home,22,24,2
8027,6,<ENDS>,24,24,0
8028,0,<START>,0,0,0
8028,1,home,0,7,7
8028,2,work,7,13,6
8028,3,home,13,18,5
8028,4,work,18,20,2
8028,5,home,20,24,4
8028,6,<ENDS>,24,24,0
8029,0,<START>,0,0,0
8029,1,home,0,8,8
8029,2,work,8,14,6
8029,3,home,14,18,4
8029,4,shop,18,19,1
8029,5,home,19,24,5
8029,6,<ENDS>,24,24,0
8030,0,<START>,0,0,0
8030,1,home,0,8,8
8030,2,education,8,12,4
8030,3,shop,12,13,1
8030,4,work,13,19,6
8030,5,home,19,24,5
8030,6,<ENDS>,24,24,0
8031,0,<START>,0,0,0
8031,1,home,0,9,9
8031,2,work,9,16,7
8031,3,home,16,21,5
8031,4,work,21,22,1
8031,5,home,22,24,2
8031,6,<ENDS>,24,24,0
8032,0,<START>,0,0,0
8032,1,home,0,7,7
8032,2,education,7,11,4
8032,3,home,11,18,7
8032,4,shop,18,19,1
8032,5,home,19,24,5
8032,6,<ENDS>,24,24,0
8033,0,<START>,0,0,0
8033,1,home,0,6,6
8033,2,shop,6,7,1
8033,3,home,7,10,3
8033,4,education,10,13,3
8033,5,shop,13,15,2
8033,6,home,15,24,9
8033,7,<ENDS>,24,24,0
8034,0,<START>,0,0,0
8034,1,home,0,8,8
8034,2,work,8,14,6
8034,3,shop,14,15,1
8034,4,home,15,24,9
8034,5,<ENDS>,24,24,0
8035,0,<START>,0,0,0
8035,1,home,0,6,6
8035,2,work,6,13,7
8035,3,shop,13,14,1
8035,4,work,14,20,6
8035,5,home,20,24,4
8035,6,<ENDS>,24,24,0
8036,0,<START>,0,0,0
8036,1,home,0,7,7
8036,2,work,7,14,7
8036,3,shop,14,15,1
8036,4,home,15,23,8
8036,5,work,23,24,1
8036,6,<ENDS>,24,24,0
8037,0,<START>,0,0,0
8037,1,home,0,5,5
8037,2,work,5,7,2
8037,3,home,7,13,6
8037,4,work,13,15,2
8037,5,home,15,23,8
8037,6,work,23,24,1
8037,7,<ENDS>,24,24,0
8038,0,<START>,0,0,0
8038,1,home,0,6,6
8038,2,work,6,13,7
8038,3,home,13,24,11
8038,4,<ENDS>,24,24,0
8039,0,<START>,0,0,0
8039,1,home,0,6,6
8039,2,work,6,13,7
8039,3,home,13,17,4
8039,4,shop,17,18,1
8039,5,home,18,24,6
8039,6,<ENDS>,24,24,0
8040,0,<START>,0,0,0
8040,1,home,0,7,7
8040,2,work,7,13,6
8040,3,shop,13,14,1
8040,4,work,14,19,5
8040,5,home,19,24,5
8040,6,<ENDS>,24,24,0
8041,0,<START>,0,0,0
8041,1,home,0,7,7
8041,2,shop,7,8,1
8041,3,work,8,14,6
8041,4,shop,14,15,1
8041,5,home,15,24,9
8041,6,<ENDS>,24,24,0
8042,0,<START>,0,0,0
8042,1,home,0,7,7
8042,2,work,7,12,5
8042,3,shop,12,13,1
8042,4,work,13,19,6
8042,5,home,19,23,4
8042,6,work,23,24,1
8042,7,<ENDS>,24,24,0
8043,0,<START>,0,0,0
8043,1,home,0,7,7
8043,2,work,7,14,7
8043,3,home,14,24,10
8043,4,<ENDS>,24,24,0
8044,0,<START>,0,0,0
8044,1,home,0,7,7
8044,2,work,7,13,6
8044,3,shop,13,14,1
8044,4,home,14,24,10
8044,5,<ENDS>,24,24,0
8045,0,<START>,0,0,0
8045,1,home,0,7,7
8045,2,education,7,11,4
8045,3,home,11,17,6
8045,4,shop,17,18,1
8045,5,home,18,24,6
8045,6,<ENDS>,24,24,0
8046,0,<START>,0,0,0
8046,1,home,0,6,6
8046,2,work,6,14,8
8046,3,shop,14,15,1
8046,4,work,15,20,5
8046,5,home,20,24,4
8046,6,<ENDS>,24,24,0
8047,0,<START>,0,0,0
8047,1,home,0,8,8
8047,2,work,8,13,5
8047,3,shop,13,14,1
8047,4,work,14,19,5
8047,5,home,19,24,5
8047,6,<ENDS>,24,24,0
8048,0,<START>,0,0,0
8048,1,home,0,7,7
8048,2,work,7,13,6
8048,3,shop,13,14,1
8048,4,home,14,24,10
8048,5,<ENDS>,24,24,0
8049,0,<START>,0,0,0
8049,1,home,0,6,6
8049,2,work,6,13,7
8049,3,home,13,15,2
8049,4,work,15,19,4
8049,5,home,19,24,5
8049,6,<ENDS>,24,24,0
8050,0,<START>,0,0,0
8050,1,home,0,6,6
8050,2,work,6,13,7
8050,3,home,13,20,7
8050,4,shop,20,21,1
8050,5,home,21,24,3
8050,6,<ENDS>,24,24,0
8051,0,<START>,0,0,0
8051,1,home,0,7,7
8051,2,education,7,11,4
8051,3,home,11,21,10
8051,4,shop,21,22,1
8051,5,home,22,24,2
8051,6,<ENDS>,24,24,0
8052,0,<START>,0,0,0
8052,1,home,0,8,8
8052,2,work,8,15,7
8052,3,home,15,24,9
8052,4,<ENDS>,24,24,0
8053,0,<START>,0,0,0
8053,1,home,0,8,8
8053,2,work,8,15,7
8053,3,shop,15,16,1
8053,4,home,16,21,5
8053,5,work,21,22,1
8053,6,home,22,24,2
8053,7,<ENDS>,24,24,0
8054,0,<START>,0,0,0
8054,1,home,0,6,6
8054,2,shop,6,7,1
8054,3,home,7,10,3
8054,4,education,10,15,5
8054,5,shop,15,17,2
8054,6,home,17,24,7
8054,7,<ENDS>,24,24,0
8055,0,<START>,0,0,0
8055,1,home,0,8,8
8055,2,shop,8,10,2
8055,3,work,10,17,7
8055,4,home,17,24,7
8055,5,<ENDS>,24,24,0
8056,0,<START>,0,0,0
8056,1,home,0,7,7
8056,2,work,7,14,7
8056,3,shop,14,15,1
8056,4,home,15,17,2
8056,5,work,17,20,3
8056,6,home,20,24,4
8056,7,<ENDS>,24,24,0
8057,0,<START>,0,0,0
8057,1,home,0,7,7
8057,2,work,7,14,7
8057,3,shop,14,15,1
8057,4,work,15,19,4
8057,5,home,19,24,5
8057,6,<ENDS>,24,24,0
8058,0,<START>,0,0,0
8058,1,home,0,7,7
8058,2,education,7,11,4
8058,3,home,11,17,6
8058,4,shop,17,18,1
8058,5,home,18,24,6
8058,6,<ENDS>,24,24,0
8059,0,<START>,0,0,0
8059,1,home,0,7,7
8059,2,work,7,9,2
8059,3,home,9,15,6
8059,4,work,15,17,2
8059,5,home,17,23,6
8059,6,work,23,24,1
8059,7,<ENDS>,24,24,0
8060,0,<START>,0,0,0
8060,1,home,0,6,6
8060,2,work,6,13,7
8060,3,shop,13,14,1
8060,4,work,14,19,5
8060,5,home,19,24,5
8060,6,<ENDS>,24,24,0
8061,0,<START>,0,0,0
8061,1,home,0,8,8
8061,2,work,8,15,7
8061,3,shop,15,16,1
8061,4,work,16,19,3
8061,5,home,19,24,5
8061,6,<ENDS>,24,24,0
8062,0,<START>,0,0,0
8062,1,home,0,6,6
8062,2,work,6,14,8
8062,3,home,14,18,4
8062,4,work,18,20,2
8062,5,home,20,24,4
8062,6,<ENDS>,24,24,0
8063,0,<START>,0,0,0
8063,1,home,0,6,6
8063,2,shop,6,7,1
8063,3,work,7,16,9
8063,4,home,16,24,8
8063,5,<ENDS>,24,24,0
8064,0,<START>,0,0,0
8064,1,home,0,8,8
8064,2,work,8,15,7
8064,3,home,15,24,9
8064,4,<ENDS>,24,24,0
8065,0,<START>,0,0,0
8065,1,home,0,8,8
8065,2,work,8,15,7
8065,3,home,15,24,9
8065,4,<ENDS>,24,24,0
8066,0,<START>,0,0,0
8066,1,home,0,7,7
8066,2,education,7,12,5
8066,3,shop,12,14,2
8066,4,home,14,20,6
8066,5,shop,20,21,1
8066,6,home,21,24,3
8066,7,<ENDS>,24,24,0
8067,0,<START>,0,0,0
8067,1,home,0,8,8
8067,2,education,8,11,3
8067,3,shop,11,12,1
8067,4,work,12,19,7
8067,5,home,19,21,2
8067,6,work,21,22,1
8067,7,home,22,24,2
8067,8,<ENDS>,24,24,0
8068,0,<START>,0,0,0
8068,1,home,0,6,6
8068,2,work,6,8,2
8068,3,home,8,9,1
8068,4,work,9,11,2
8068,5,home,11,16,5
8068,6,work,16,18,2
8068,7,home,18,24,6
8068,8,<ENDS>,24,24,0
8069,0,<START>,0,0,0
8069,1,home,0,7,7
8069,2,work,7,9,2
8069,3,home,9,15,6
8069,4,work,15,17,2
8069,5,home,17,23,6
8069,6,work,23,24,1
8069,7,<ENDS>,24,24,0
8070,0,<START>,0,0,0
8070,1,home,0,8,8
8070,2,work,8,14,6
8070,3,home,14,24,10
8070,4,<ENDS>,24,24,0
8071,0,<START>,0,0,0
8071,1,home,0,7,7
8071,2,education,7,12,5
8071,3,shop,12,14,2
8071,4,education,14,16,2
8071,5,home,16,21,5
8071,6,shop,21,22,1
8071,7,home,22,24,2
8071,8,<ENDS>,24,24,0
8072,0,<START>,0,0,0
8072,1,home,0,7,7
8072,2,work,7,12,5
8072,3,shop,12,13,1
8072,4,education,13,16,3
8072,5,home,16,24,8
8072,6,<ENDS>,24,24,0
8073,0,<START>,0,0,0
8073,1,home,0,7,7
8073,2,education,7,11,4
8073,3,home,11,17,6
8073,4,shop,17,19,2
8073,5,home,19,24,5
8073,6,<ENDS>,24,24,0
8074,0,<START>,0,0,0
8074,1,home,0,6,6
8074,2,work,6,8,2
8074,3,home,8,9,1
8074,4,work,9,11,2
8074,5,home,11,15,4
8074,6,work,15,16,1
8074,7,home,16,23,7
8074,8,work,23,24,1
8074,9,<ENDS>,24,24,0
8075,0,<START>,0,0,0
8075,1,home,0,7,7
8075,2,education,7,11,4
8075,3,home,11,20,9
8075,4,shop,20,21,1
8075,5,home,21,24,3
8075,6,<ENDS>,24,24,0
8076,0,<START>,0,0,0
8076,1,home,0,6,6
8076,2,shop,6,7,1
8076,3,home,7,11,4
8076,4,work,11,19,8
8076,5,home,19,24,5
8076,6,<ENDS>,24,24,0
8077,0,<START>,0,0,0
8077,1,home,0,7,7
8077,2,shop,7,8,1
8077,3,home,8,12,4
8077,4,work,12,19,7
8077,5,home,19,24,5
8077,6,<ENDS>,24,24,0
8078,0,<START>,0,0,0
8078,1,home,0,6,6
8078,2,work,6,8,2
8078,3,home,8,11,3
8078,4,work,11,13,2
8078,5,home,13,21,8
8078,6,work,21,22,1
8078,7,home,22,24,2
8078,8,<ENDS>,24,24,0
8079,0,<START>,0,0,0
8079,1,home,0,6,6
8079,2,work,6,12,6
8079,3,shop,12,13,1
8079,4,work,13,19,6
8079,5,home,19,24,5
8079,6,<ENDS>,24,24,0
8080,0,<START>,0,0,0
8080,1,home,0,7,7
8080,2,work,7,13,6
8080,3,shop,13,14,1
8080,4,home,14,22,8
8080,5,work,22,23,1
8080,6,home,23,24,1
8080,7,<ENDS>,24,24,0
8081,0,<START>,0,0,0
8081,1,home,0,6,6
8081,2,shop,6,7,1
8081,3,home,7,8,1
8081,4,education,8,11,3
8081,5,home,11,15,4
8081,6,shop,15,16,1
8081,7,home,16,24,8
8081,8,<ENDS>,24,24,0
8082,0,<START>,0,0,0
8082,1,home,0,7,7
8082,2,work,7,13,6
8082,3,home,13,18,5
8082,4,shop,18,19,1
8082,5,home,19,23,4
8082,6,work,23,24,1
8082,7,<ENDS>,24,24,0
8083,0,<START>,0,0,0
8083,1,home,0,8,8
8083,2,work,8,14,6
8083,3,home,14,24,10
8083,4,<ENDS>,24,24,0
8084,0,<START>,0,0,0
8084,1,home,0,8,8
8084,2,education,8,11,3
8084,3,home,11,14,3
8084,4,education,14,16,2
8084,5,home,16,24,8
8084,6,<ENDS>,24,24,0
8085,0,<START>,0,0,0
8085,1,home,0,8,8
8085,2,work,8,15,7
8085,3,home,15,24,9
8085,4,<ENDS>,24,24,0
8086,0,<START>,0,0,0
8086,1,home,0,7,7
8086,2,work,7,14,7
8086,3,shop,14,15,1
8086,4,home,15,24,9
8086,5,<ENDS>,24,24,0
8087,0,<START>,0,0,0
8087,1,home,0,6,6
8087,2,shop,6,7,1
8087,3,home,7,9,2
8087,4,education,9,12,3
8087,5,shop,12,13,1
8087,6,education,13,16,3
8087,7,home,16,20,4
8087,8,shop,20,21,1
8087,9,home,21,24,3
8087,10,<ENDS>,24,24,0
8088,0,<START>,0,0,0
8088,1,home,0,6,6
8088,2,work,6,7,1
8088,3,home,7,13,6
8088,4,work,13,15,2
8088,5,home,15,21,6
8088,6,work,21,22,1
8088,7,home,22,24,2
8088,8,<ENDS>,24,24,0
8089,0,<START>,0,0,0
8089,1,home,0,8,8
8089,2,work,8,15,7
8089,3,home,15,18,3
8089,4,work,18,20,2
8089,5,home,20,24,4
8089,6,<ENDS>,24,24,0
8090,0,<START>,0,0,0
8090,1,home,0,7,7
8090,2,work,7,13,6
8090,3,home,13,24,11
8090,4,<ENDS>,24,24,0
8091,0,<START>,0,0,0
8091,1,home,0,6,6
8091,2,work,6,8,2
8091,3,home,8,9,1
8091,4,work,9,11,2
8091,5,home,11,16,5
8091,6,work,16,18,2
8091,7,home,18,22,4
8091,8,work,22,23,1
8091,9,home,23,24,1
8091,10,<ENDS>,24,24,0
8092,0,<START>,0,0,0
8092,1,home,0,7,7
8092,2,education,7,11,4
8092,3,home,11,16,5
8092,4,shop,16,17,1
8092,5,home,17,24,7
8092,6,<ENDS>,24,24,0
8093,0,<START>,0,0,0
8093,1,home,0,7,7
8093,2,work,7,14,7
8093,3,home,14,18,4
8093,4,work,18,20,2
8093,5,home,20,24,4
8093,6,<ENDS>,24,24,0
8094,0,<START>,0,0,0
8094,1,home,0,7,7
8094,2,work,7,14,7
8094,3,home,14,20,6
8094,4,shop,20,21,1
8094,5,home,21,24,3
8094,6,<ENDS>,24,24,0
8095,0,<START>,0,0,0
8095,1,home,0,6,6
8095,2,work,6,8,2
8095,3,home,8,9,1
8095,4,work,9,11,2
8095,5,home,11,17,6
8095,6,work,17,19,2
8095,7,home,19,24,5
8095,8,<ENDS>,24,24,0
8096,0,<START>,0,0,0
8096,1,home,0,8,8
8096,2,work,8,15,7
8096,3,home,15,20,5
8096,4,shop,20,21,1
8096,5,home,21,24,3
8096,6,<ENDS>,24,24,0
8097,0,<START>,0,0,0
8097,1,home,0,8,8
8097,2,education,8,12,4
8097,3,home,12,19,7
8097,4,shop,19,20,1
8097,5,home,20,24,4
8097,6,<ENDS>,24,24,0
8098,0,<START>,0,0,0
8098,1,home,0,6,6
8098,2,work,6,13,7
8098,3,shop,13,15,2
8098,4,work,15,19,4
8098,5,home,19,24,5
8098,6,<ENDS>,24,24,0
8099,0,<START>,0,0,0
8099,1,home,0,6,6
8099,2,shop,6,7,1
8099,3,work,7,13,6
8099,4,home,13,24,11
8099,5,<ENDS>,24,24,0
8100,0,<START>,0,0,0
8100,1,home,0,7,7
8100,2,work,7,9,2
8100,3,home,9,13,4
8100,4,work,13,15,2
8100,5,home,15,21,6
8100,6,work,21,22,1
8100,7,home,22,24,2
8100,8,<ENDS>,24,24,0
8101,0,<START>,0,0,0
8101,1,home,0,7,7
8101,2,education,7,11,4
8101,3,home,11,15,4
8101,4,shop,15,16,1
8101,5,home,16,24,8
8101,6,<ENDS>,24,24,0
8102,0,<START>,0,0,0
8102,1,home,0,9,9
8102,2,work,9,16,7
8102,3,shop,16,17,1
8102,4,home,17,23,6
8102,5,work,23,24,1
8102,6,<ENDS>,24,24,0
8103,0,<START>,0,0,0
8103,1,home,0,7,7
8103,2,work,7,14,7
8103,3,shop,14,15,1
8103,4,home,15,24,9
8103,5,<ENDS>,24,24,0
8104,0,<START>,0,0,0
8104,1,home,0,7,7
8104,2,work,7,14,7
8104,3,home,14,24,10
8104,4,<ENDS>,24,24,0
8105,0,<START>,0,0,0
8105,1,home,0,6,6
8105,2,shop,6,7,1
8105,3,work,7,13,6
8105,4,home,13,18,5
8105,5,work,18,19,1
8105,6,home,19,24,5
8105,7,<ENDS>,24,24,0
8106,0,<START>,0,0,0
8106,1,home,0,8,8
8106,2,work,8,14,6
8106,3,home,14,22,8
8106,4,work,22,23,1
8106,5,home,23,24,1
8106,6,<ENDS>,24,24,0
8107,0,<START>,0,0,0
8107,1,home,0,6,6
8107,2,work,6,13,7
8107,3,home,13,17,4
8107,4,work,17,20,3
8107,5,home,20,24,4
8107,6,<ENDS>,24,24,0
8108,0,<START>,0,0,0
8108,1,home,0,6,6
8108,2,work,6,8,2
8108,3,home,8,14,6
8108,4,work,14,16,2
8108,5,home,16,23,7
8108,6,work,23,24,1
8108,7,<ENDS>,24,24,0
8109,0,<START>,0,0,0
8109,1,home,0,8,8
8109,2,work,8,14,6
8109,3,shop,14,15,1
8109,4,work,15,20,5
8109,5,home,20,24,4
8109,6,<ENDS>,24,24,0
8110,0,<START>,0,0,0
8110,1,home,0,6,6
8110,2,work,6,7,1
8110,3,home,7,11,4
8110,4,work,11,13,2
8110,5,shop,13,14,1
8110,6,work,14,16,2
8110,7,home,16,23,7
8110,8,work,23,24,1
8110,9,<ENDS>,24,24,0
8111,0,<START>,0,0,0
8111,1,home,0,6,6
8111,2,work,6,8,2
8111,3,home,8,13,5
8111,4,work,13,15,2
8111,5,home,15,22,7
8111,6,work,22,23,1
8111,7,home,23,24,1
8111,8,<ENDS>,24,24,0
8112,0,<START>,0,0,0
8112,1,home,0,6,6
8112,2,shop,6,7,1
8112,3,work,7,14,7
8112,4,home,14,21,7
8112,5,work,21,22,1
8112,6,home,22,24,2
8112,7,<ENDS>,24,24,0
8113,0,<START>,0,0,0
8113,1,home,0,8,8
8113,2,work,8,16,8
8113,3,home,16,20,4
8113,4,shop,20,21,1
8113,5,home,21,24,3
8113,6,<ENDS>,24,24,0
8114,0,<START>,0,0,0
8114,1,home,0,8,8
8114,2,work,8,13,5
8114,3,home,13,20,7
8114,4,shop,20,21,1
8114,5,home,21,24,3
8114,6,<ENDS>,24,24,0
8115,0,<START>,0,0,0
8115,1,home,0,8,8
8115,2,work,8,15,7
8115,3,shop,15,16,1
8115,4,work,16,20,4
8115,5,home,20,24,4
8115,6,<ENDS>,24,24,0
8116,0,<START>,0,0,0
8116,1,home,0,6,6
8116,2,shop,6,7,1
8116,3,home,7,10,3
8116,4,education,10,15,5
8116,5,shop,15,16,1
8116,6,work,16,20,4
8116,7,home,20,24,4
8116,8,<ENDS>,24,24,0
8117,0,<START>,0,0,0
8117,1,home,0,6,6
8117,2,work,6,13,7
8117,3,home,13,24,11
8117,4,<ENDS>,24,24,0
8118,0,<START>,0,0,0
8118,1,home,0,8,8
8118,2,work,8,15,7
8118,3,home,15,23,8
8118,4,work,23,24,1
8118,5,<ENDS>,24,24,0
8119,0,<START>,0,0,0
8119,1,home,0,6,6
8119,2,work,6,13,7
8119,3,shop,13,14,1
8119,4,home,14,24,10
8119,5,<ENDS>,24,24,0
8120,0,<START>,0,0,0
8120,1,home,0,6,6
8120,2,work,6,13,7
8120,3,home,13,23,10
8120,4,work,23,24,1
8120,5,<ENDS>,24,24,0
8121,0,<START>,0,0,0
8121,1,home,0,6,6
8121,2,work,6,8,2
8121,3,home,8,13,5
8121,4,work,13,15,2
8121,5,home,15,21,6
8121,6,work,21,22,1
8121,7,home,22,24,2
8121,8,<ENDS>,24,24,0
8122,0,<START>,0,0,0
8122,1,home,0,7,7
8122,2,work,7,13,6
8122,3,home,13,17,4
8122,4,work,17,20,3
8122,5,home,20,24,4
8122,6,<ENDS>,24,24,0
8123,0,<START>,0,0,0
8123,1,home,0,7,7
8123,2,education,7,11,4
8123,3,home,11,13,2
8123,4,education,13,15,2
8123,5,shop,15,16,1
8123,6,home,16,24,8
8123,7,<ENDS>,24,24,0
8124,0,<START>,0,0,0
8124,1,home,0,7,7
8124,2,work,7,14,7
8124,3,shop,14,15,1
8124,4,work,15,19,4
8124,5,home,19,23,4
8124,6,work,23,24,1
8124,7,<ENDS>,24,24,0
8125,0,<START>,0,0,0
8125,1,home,0,8,8
8125,2,work,8,15,7
8125,3,home,15,21,6
8125,4,work,21,22,1
8125,5,home,22,24,2
8125,6,<ENDS>,24,24,0
8126,0,<START>,0,0,0
8126,1,home,0,7,7
8126,2,work,7,13,6
8126,3,home,13,24,11
8126,4,<ENDS>,24,24,0
8127,0,<START>,0,0,0
8127,1,home,0,8,8
8127,2,education,8,12,4
8127,3,home,12,24,12
8127,4,<ENDS>,24,24,0
8128,0,<START>,0,0,0
8128,1,home,0,8,8
8128,2,work,8,15,7
8128,3,home,15,21,6
8128,4,work,21,22,1
8128,5,home,22,24,2
8128,6,<ENDS>,24,24,0
8129,0,<START>,0,0,0
8129,1,home,0,6,6
8129,2,shop,6,7,1
8129,3,home,7,13,6
8129,4,education,13,16,3
8129,5,home,16,24,8
8129,6,<ENDS>,24,24,0
8130,0,<START>,0,0,0
8130,1,home,0,7,7
8130,2,work,7,14,7
8130,3,home,14,24,10
8130,4,<ENDS>,24,24,0
8131,0,<START>,0,0,0
8131,1,home,0,7,7
8131,2,education,7,11,4
8131,3,home,11,14,3
8131,4,education,14,16,2
8131,5,home,16,24,8
8131,6,<ENDS>,24,24,0
8132,0,<START>,0,0,0
8132,1,home,0,6,6
8132,2,work,6,13,7
8132,3,shop,13,14,1
8132,4,home,14,24,10
8132,5,<ENDS>,24,24,0
8133,0,<START>,0,0,0
8133,1,home,0,6,6
8133,2,work,6,13,7
8133,3,home,13,24,11
8133,4,<ENDS>,24,24,0
8134,0,<START>,0,0,0
8134,1,home,0,7,7
8134,2,education,7,11,4
8134,3,home,11,17,6
8134,4,shop,17,19,2
8134,5,home,19,24,5
8134,6,<ENDS>,24,24,0
8135,0,<START>,0,0,0
8135,1,home,0,6,6
8135,2,work,6,13,7
8135,3,shop,13,14,1
8135,4,home,14,24,10
8135,5,<ENDS>,24,24,0
8136,0,<START>,0,0,0
8136,1,home,0,7,7
8136,2,work,7,13,6
8136,3,shop,13,14,1
8136,4,home,14,24,10
8136,5,<ENDS>,24,24,0
8137,0,<START>,0,0,0
8137,1,home,0,7,7
8137,2,shop,7,8,1
8137,3,education,8,11,3
8137,4,home,11,17,6
8137,5,shop,17,19,2
8137,6,home,19,24,5
8137,7,<ENDS>,24,24,0
8138,0,<START>,0,0,0
8138,1,home,0,6,6
8138,2,work,6,13,7
8138,3,shop,13,14,1
8138,4,work,14,19,5
8138,5,home,19,24,5
8138,6,<ENDS>,24,24,0
8139,0,<START>,0,0,0
8139,1,home,0,7,7
8139,2,shop,7,8,1
8139,3,education,8,12,4
8139,4,home,12,19,7
8139,5,shop,19,21,2
8139,6,home,21,24,3
8139,7,<ENDS>,24,24,0
8140,0,<START>,0,0,0
8140,1,home,0,6,6
8140,2,shop,6,7,1
8140,3,home,7,13,6
8140,4,education,13,16,3
8140,5,shop,16,17,1
8140,6,home,17,24,7
8140,7,<ENDS>,24,24,0
8141,0,<START>,0,0,0
8141,1,home,0,8,8
8141,2,work,8,13,5
8141,3,home,13,17,4
8141,4,work,17,19,2
8141,5,home,19,24,5
8141,6,<ENDS>,24,24,0
8142,0,<START>,0,0,0
8142,1,home,0,7,7
8142,2,work,7,14,7
8142,3,home,14,24,10
8142,4,<ENDS>,24,24,0
8143,0,<START>,0,0,0
8143,1,home,0,8,8
8143,2,work,8,14,6
8143,3,home,14,24,10
8143,4,<ENDS>,24,24,0
8144,0,<START>,0,0,0
8144,1,home,0,7,7
8144,2,work,7,14,7
8144,3,home,14,21,7
8144,4,work,21,22,1
8144,5,home,22,24,2
8144,6,<ENDS>,24,24,0
8145,0,<START>,0,0,0
8145,1,home,0,7,7
8145,2,work,7,13,6
8145,3,shop,13,14,1
8145,4,work,14,19,5
8145,5,home,19,24,5
8145,6,<ENDS>,24,24,0
8146,0,<START>,0,0,0
8146,1,home,0,7,7
8146,2,work,7,13,6
8146,3,home,13,21,8
8146,4,work,21,22,1
8146,5,home,22,24,2
8146,6,<ENDS>,24,24,0
8147,0,<START>,0,0,0
8147,1,home,0,7,7
8147,2,work,7,9,2
8147,3,home,9,15,6
8147,4,work,15,17,2
8147,5,home,17,23,6
8147,6,work,23,24,1
8147,7,<ENDS>,24,24,0
8148,0,<START>,0,0,0
8148,1,home,0,9,9
8148,2,work,9,14,5
8148,3,home,14,17,3
8148,4,work,17,20,3
8148,5,home,20,24,4
8148,6,<ENDS>,24,24,0
8149,0,<START>,0,0,0
8149,1,home,0,7,7
8149,2,work,7,14,7
8149,3,shop,14,15,1
8149,4,home,15,21,6
8149,5,work,21,22,1
8149,6,home,22,24,2
8149,7,<ENDS>,24,24,0
8150,0,<START>,0,0,0
8150,1,home,0,8,8
8150,2,work,8,15,7
8150,3,home,15,21,6
8150,4,shop,21,22,1
8150,5,home,22,24,2
8150,6,<ENDS>,24,24,0
8151,0,<START>,0,0,0
8151,1,home,0,6,6
8151,2,work,6,13,7
8151,3,home,13,17,4
8151,4,work,17,20,3
8151,5,home,20,24,4
8151,6,<ENDS>,24,24,0
8152,0,<START>,0,0,0
8152,1,home,0,7,7
8152,2,education,7,11,4
8152,3,home,11,19,8
8152,4,shop,19,20,1
8152,5,home,20,24,4
8152,6,<ENDS>,24,24,0
8153,0,<START>,0,0,0
8153,1,home,0,7,7
8153,2,work,7,14,7
8153,3,shop,14,15,1
8153,4,work,15,20,5
8153,5,home,20,24,4
8153,6,<ENDS>,24,24,0
8154,0,<START>,0,0,0
8154,1,home,0,8,8
8154,2,work,8,14,6
8154,3,shop,14,15,1
8154,4,work,15,20,5
8154,5,home,20,24,4
8154,6,<ENDS>,24,24,0
8155,0,<START>,0,0,0
8155,1,home,0,7,7
8155,2,work,7,13,6
8155,3,shop,13,14,1
8155,4,work,14,19,5
8155,5,home,19,24,5
8155,6,<ENDS>,24,24,0
8156,0,<START>,0,0,0
8156,1,work,0,8,8
8156,2,shop,8,9,1
8156,3,home,9,13,4
8156,4,education,13,15,2
8156,5,work,15,19,4
8156,6,home,19,24,5
8156,7,<ENDS>,24,24,0
8157,0,<START>,0,0,0
8157,1,home,0,8,8
8157,2,education,8,11,3
8157,3,home,11,19,8
8157,4,shop,19,21,2
8157,5,home,21,24,3
8157,6,<ENDS>,24,24,0
8158,0,<START>,0,0,0
8158,1,home,0,7,7
8158,2,education,7,12,5
8158,3,home,12,19,7
8158,4,shop,19,21,2
8158,5,home,21,24,3
8158,6,<ENDS>,24,24,0
8159,0,<START>,0,0,0
8159,1,home,0,7,7
8159,2,work,7,14,7
8159,3,home,14,18,4
8159,4,work,18,20,2
8159,5,home,20,24,4
8159,6,<ENDS>,24,24,0
8160,0,<START>,0,0,0
8160,1,home,0,7,7
8160,2,work,7,13,6
8160,3,shop,13,14,1
8160,4,home,14,24,10
8160,5,<ENDS>,24,24,0
8161,0,<START>,0,0,0
8161,1,home,0,7,7
8161,2,work,7,14,7
8161,3,home,14,24,10
8161,4,<ENDS>,24,24,0
8162,0,<START>,0,0,0
8162,1,home,0,7,7
8162,2,work,7,13,6
8162,3,home,13,17,4
8162,4,shop,17,18,1
8162,5,home,18,24,6
8162,6,<ENDS>,24,24,0
8163,0,<START>,0,0,0
8163,1,home,0,8,8
8163,2,work,8,14,6
8163,3,home,14,24,10
8163,4,<ENDS>,24,24,0
8164,0,<START>,0,0,0
8164,1,home,0,8,8
8164,2,education,8,11,3
8164,3,shop,11,12,1
8164,4,work,12,19,7
8164,5,home,19,24,5
8164,6,<ENDS>,24,24,0
8165,0,<START>,0,0,0
8165,1,home,0,7,7
8165,2,work,7,13,6
8165,3,home,13,24,11
8165,4,<ENDS>,24,24,0
8166,0,<START>,0,0,0
8166,1,home,0,7,7
8166,2,education,7,12,5
8166,3,home,12,18,6
8166,4,shop,18,19,1
8166,5,home,19,24,5
8166,6,<ENDS>,24,24,0
8167,0,<START>,0,0,0
8167,1,home,0,6,6
8167,2,shop,6,7,1
8167,3,home,7,13,6
8167,4,education,13,16,3
8167,5,home,16,24,8
8167,6,<ENDS>,24,24,0
8168,0,<START>,0,0,0
8168,1,home,0,8,8
8168,2,work,8,15,7
8168,3,home,15,24,9
8168,4,<ENDS>,24,24,0
8169,0,<START>,0,0,0
8169,1,home,0,7,7
8169,2,work,7,14,7
8169,3,home,14,23,9
8169,4,work,23,24,1
8169,5,<ENDS>,24,24,0
8170,0,<START>,0,0,0
8170,1,home,0,6,6
8170,2,shop,6,7,1
8170,3,home,7,12,5
8170,4,work,12,18,6
8170,5,home,18,24,6
8170,6,<ENDS>,24,24,0
8171,0,<START>,0,0,0
8171,1,home,0,6,6
8171,2,work,6,13,7
8171,3,home,13,16,3
8171,4,work,16,19,3
8171,5,home,19,24,5
8171,6,<ENDS>,24,24,0
8172,0,<START>,0,0,0
8172,1,home,0,7,7
8172,2,education,7,10,3
8172,3,home,10,14,4
8172,4,education,14,16,2
8172,5,home,16,24,8
8172,6,<ENDS>,24,24,0
8173,0,<START>,0,0,0
8173,1,home,0,6,6
8173,2,work,6,7,1
8173,3,home,7,11,4
8173,4,work,11,12,1
8173,5,home,12,18,6
8173,6,work,18,20,2
8173,7,home,20,24,4
8173,8,<ENDS>,24,24,0
8174,0,<START>,0,0,0
8174,1,home,0,8,8
8174,2,work,8,15,7
8174,3,shop,15,16,1
8174,4,home,16,24,8
8174,5,<ENDS>,24,24,0
8175,0,<START>,0,0,0
8175,1,home,0,6,6
8175,2,shop,6,7,1
8175,3,home,7,9,2
8175,4,education,9,12,3
8175,5,home,12,18,6
8175,6,shop,18,19,1
8175,7,home,19,24,5
8175,8,<ENDS>,24,24,0
8176,0,<START>,0,0,0
8176,1,home,0,8,8
8176,2,work,8,15,7
8176,3,home,15,24,9
8176,4,<ENDS>,24,24,0
8177,0,<START>,0,0,0
8177,1,home,0,7,7
8177,2,work,7,13,6
8177,3,shop,13,14,1
8177,4,work,14,19,5
8177,5,home,19,24,5
8177,6,<ENDS>,24,24,0
8178,0,<START>,0,0,0
8178,1,home,0,6,6
8178,2,work,6,13,7
8178,3,home,13,17,4
8178,4,work,17,20,3
8178,5,home,20,24,4
8178,6,<ENDS>,24,24,0
8179,0,<START>,0,0,0
8179,1,home,0,6,6
8179,2,work,6,13,7
8179,3,home,13,16,3
8179,4,work,16,20,4
8179,5,home,20,24,4
8179,6,<ENDS>,24,24,0
8180,0,<START>,0,0,0
8180,1,home,0,8,8
8180,2,work,8,14,6
8180,3,shop,14,15,1
8180,4,home,15,24,9
8180,5,<ENDS>,24,24,0
8181,0,<START>,0,0,0
8181,1,home,0,7,7
8181,2,work,7,13,6
8181,3,home,13,17,4
8181,4,shop,17,18,1
8181,5,home,18,24,6
8181,6,<ENDS>,24,24,0
8182,0,<START>,0,0,0
8182,1,home,0,8,8
8182,2,education,8,11,3
8182,3,home,11,19,8
8182,4,shop,19,20,1
8182,5,home,20,24,4
8182,6,<ENDS>,24,24,0
8183,0,<START>,0,0,0
8183,1,home,0,7,7
8183,2,work,7,13,6
8183,3,home,13,24,11
8183,4,<ENDS>,24,24,0
8184,0,<START>,0,0,0
8184,1,home,0,7,7
8184,2,shop,7,9,2
8184,3,education,9,12,3
8184,4,home,12,19,7
8184,5,shop,19,20,1
8184,6,home,20,24,4
8184,7,<ENDS>,24,24,0
8185,0,<START>,0,0,0
8185,1,home,0,6,6
8185,2,work,6,8,2
8185,3,shop,8,9,1
8185,4,home,9,14,5
8185,5,work,14,16,2
8185,6,home,16,24,8
8185,7,<ENDS>,24,24,0
8186,0,<START>,0,0,0
8186,1,home,0,7,7
8186,2,work,7,14,7
8186,3,shop,14,15,1
8186,4,work,15,20,5
8186,5,home,20,24,4
8186,6,<ENDS>,24,24,0
8187,0,<START>,0,0,0
8187,1,home,0,7,7
8187,2,work,7,13,6
8187,3,home,13,22,9
8187,4,work,22,23,1
8187,5,home,23,24,1
8187,6,<ENDS>,24,24,0
8188,0,<START>,0,0,0
8188,1,home,0,7,7
8188,2,work,7,9,2
8188,3,home,9,11,2
8188,4,work,11,13,2
8188,5,home,13,17,4
8188,6,work,17,19,2
8188,7,home,19,24,5
8188,8,<ENDS>,24,24,0
8189,0,<START>,0,0,0
8189,1,home,0,6,6
8189,2,work,6,13,7
8189,3,shop,13,14,1
8189,4,home,14,24,10
8189,5,<ENDS>,24,24,0
8190,0,<START>,0,0,0
8190,1,home,0,7,7
8190,2,education,7,11,4
8190,3,home,11,20,9
8190,4,shop,20,21,1
8190,5,home,21,24,3
8190,6,<ENDS>,24,24,0
8191,0,<START>,0,0,0
8191,1,home,0,7,7
8191,2,work,7,13,6
8191,3,home,13,23,10
8191,4,work,23,24,1
8191,5,<ENDS>,24,24,0
8192,0,<START>,0,0,0
8192,1,home,0,6,6
8192,2,work,6,8,2
8192,3,home,8,12,4
8192,4,work,12,14,2
8192,5,home,14,17,3
8192,6,work,17,19,2
8192,7,home,19,23,4
8192,8,work,23,24,1
8192,9,<ENDS>,24,24,0
8193,0,<START>,0,0,0
8193,1,home,0,7,7
8193,2,education,7,13,6
8193,3,shop,13,15,2
8193,4,home,15,24,9
8193,5,<ENDS>,24,24,0
8194,0,<START>,0,0,0
8194,1,home,0,6,6
8194,2,shop,6,7,1
8194,3,work,7,13,6
8194,4,home,13,24,11
8194,5,<ENDS>,24,24,0
8195,0,<START>,0,0,0
8195,1,home,0,7,7
8195,2,work,7,13,6
8195,3,home,13,21,8
8195,4,shop,21,22,1
8195,5,home,22,24,2
8195,6,<ENDS>,24,24,0
8196,0,<START>,0,0,0
8196,1,home,0,6,6
8196,2,work,6,13,7
8196,3,shop,13,14,1
8196,4,work,14,19,5
8196,5,education,19,20,1
8196,6,home,20,24,4
8196,7,<ENDS>,24,24,0
8197,0,<START>,0,0,0
8197,1,home,0,7,7
8197,2,work,7,13,6
8197,3,home,13,17,4
8197,4,work,17,20,3
8197,5,home,20,24,4
8197,6,<ENDS>,24,24,0
8198,0,<START>,0,0,0
8198,1,home,0,6,6
8198,2,work,6,13,7
8198,3,shop,13,14,1
8198,4,work,14,19,5
8198,5,home,19,24,5
8198,6,<ENDS>,24,24,0
8199,0,<START>,0,0,0
8199,1,home,0,7,7
8199,2,shop,7,8,1
8199,3,education,8,11,3
8199,4,home,11,18,7
8199,5,shop,18,20,2
8199,6,home,20,24,4
8199,7,<ENDS>,24,24,0
8200,0,<START>,0,0,0
8200,1,home,0,7,7
8200,2,education,7,12,5
8200,3,home,12,16,4
8200,4,shop,16,17,1
8200,5,home,17,24,7
8200,6,<ENDS>,24,24,0
8201,0,<START>,0,0,0
8201,1,home,0,7,7
8201,2,work,7,9,2
8201,3,home,9,13,4
8201,4,work,13,15,2
8201,5,home,15,23,8
8201,6,work,23,24,1
8201,7,<ENDS>,24,24,0
8202,0,<START>,0,0,0
8202,1,home,0,6,6
8202,2,work,6,8,2
8202,3,home,8,14,6
8202,4,work,14,16,2
8202,5,home,16,22,6
8202,6,work,22,23,1
8202,7,home,23,24,1
8202,8,<ENDS>,24,24,0
8203,0,<START>,0,0,0
8203,1,home,0,6,6
8203,2,work,6,13,7
8203,3,shop,13,15,2
8203,4,home,15,24,9
8203,5,<ENDS>,24,24,0
8204,0,<START>,0,0,0
8204,1,home,0,8,8
8204,2,work,8,15,7
8204,3,home,15,23,8
8204,4,work,23,24,1
8204,5,<ENDS>,24,24,0
8205,0,<START>,0,0,0
8205,1,home,0,7,7
8205,2,work,7,13,6
8205,3,home,13,16,3
8205,4,work,16,20,4
8205,5,home,20,24,4
8205,6,<ENDS>,24,24,0
8206,0,<START>,0,0,0
8206,1,home,0,6,6
8206,2,work,6,13,7
8206,3,home,13,24,11
8206,4,<ENDS>,24,24,0
8207,0,<START>,0,0,0
8207,1,home,0,8,8
8207,2,education,8,12,4
8207,3,home,12,19,7
8207,4,shop,19,20,1
8207,5,home,20,24,4
8207,6,<ENDS>,24,24,0
8208,0,<START>,0,0,0
8208,1,home,0,6,6
8208,2,work,6,13,7
8208,3,home,13,17,4
8208,4,work,17,20,3
8208,5,home,20,24,4
8208,6,<ENDS>,24,24,0
8209,0,<START>,0,0,0
8209,1,home,0,6,6
8209,2,work,6,8,2
8209,3,home,8,12,4
8209,4,work,12,13,1
8209,5,shop,13,14,1
8209,6,home,14,18,4
8209,7,work,18,20,2
8209,8,home,20,24,4
8209,9,<ENDS>,24,24,0
8210,0,<START>,0,0,0
8210,1,home,0,8,8
8210,2,work,8,15,7
8210,3,home,15,24,9
8210,4,<ENDS>,24,24,0
8211,0,<START>,0,0,0
8211,1,home,0,7,7
8211,2,education,7,11,4
8211,3,home,11,17,6
8211,4,shop,17,18,1
8211,5,home,18,24,6
8211,6,<ENDS>,24,24,0
8212,0,<START>,0,0,0
8212,1,home,0,6,6
8212,2,work,6,13,7
8212,3,shop,13,14,1
8212,4,home,14,24,10
8212,5,<ENDS>,24,24,0
8213,0,<START>,0,0,0
8213,1,home,0,7,7
8213,2,work,7,14,7
8213,3,home,14,18,4
8213,4,shop,18,19,1
8213,5,home,19,24,5
8213,6,<ENDS>,24,24,0
8214,0,<START>,0,0,0
8214,1,home,0,8,8
8214,2,work,8,14,6
8214,3,shop,14,15,1
8214,4,work,15,19,4
8214,5,home,19,24,5
8214,6,<ENDS>,24,24,0
8215,0,<START>,0,0,0
8215,1,home,0,8,8
8215,2,work,8,13,5
8215,3,shop,13,14,1
8215,4,work,14,20,6
8215,5,home,20,24,4
8215,6,<ENDS>,24,24,0
8216,0,<START>,0,0,0
8216,1,home,0,6,6
8216,2,work,6,8,2
8216,3,home,8,14,6
8216,4,work,14,16,2
8216,5,home,16,23,7
8216,6,work,23,24,1
8216,7,<ENDS>,24,24,0
8217,0,<START>,0,0,0
8217,1,home,0,8,8
8217,2,education,8,12,4
8217,3,home,12,16,4
8217,4,work,16,20,4
8217,5,home,20,24,4
8217,6,<ENDS>,24,24,0
8218,0,<START>,0,0,0
8218,1,home,0,7,7
8218,2,work,7,13,6
8218,3,home,13,24,11
8218,4,<ENDS>,24,24,0
8219,0,<START>,0,0,0
8219,1,home,0,8,8
8219,2,work,8,14,6
8219,3,shop,14,15,1
8219,4,home,15,24,9
8219,5,<ENDS>,24,24,0
8220,0,<START>,0,0,0
8220,1,home,0,6,6
8220,2,shop,6,7,1
8220,3,home,7,13,6
8220,4,work,13,19,6
8220,5,home,19,24,5
8220,6,<ENDS>,24,24,0
8221,0,<START>,0,0,0
8221,1,home,0,6,6
8221,2,work,6,13,7
8221,3,home,13,18,5
8221,4,work,18,20,2
8221,5,home,20,24,4
8221,6,<ENDS>,24,24,0
8222,0,<START>,0,0,0
8222,1,home,0,6,6
8222,2,work,6,8,2
8222,3,home,8,12,4
8222,4,work,12,14,2
8222,5,home,14,22,8
8222,6,work,22,23,1
8222,7,home,23,24,1
8222,8,<ENDS>,24,24,0
8223,0,<START>,0,0,0
8223,1,home,0,7,7
8223,2,work,7,13,6
8223,3,shop,13,14,1
8223,4,home,14,24,10
8223,5,<ENDS>,24,24,0
8224,0,<START>,0,0,0
8224,1,home,0,7,7
8224,2,work,7,13,6
8224,3,home,13,24,11
8224,4,<ENDS>,24,24,0
8225,0,<START>,0,0,0
8225,1,home,0,7,7
8225,2,work,7,13,6
8225,3,shop,13,14,1
8225,4,home,14,18,4
8225,5,work,18,20,2
8225,6,home,20,24,4
8225,7,<ENDS>,24,24,0
8226,0,<START>,0,0,0
8226,1,home,0,7,7
8226,2,work,7,13,6
8226,3,home,13,24,11
8226,4,<ENDS>,24,24,0
8227,0,<START>,0,0,0
8227,1,home,0,6,6
8227,2,work,6,8,2
8227,3,home,8,14,6
8227,4,work,14,16,2
8227,5,home,16,23,7
8227,6,work,23,24,1
8227,7,<ENDS>,24,24,0
8228,0,<START>,0,0,0
8228,1,home,0,8,8
8228,2,education,8,13,5
8228,3,work,13,19,6
8228,4,home,19,24,5
8228,5,<ENDS>,24,24,0
8229,0,<START>,0,0,0
8229,1,home,0,8,8
8229,2,shop,8,9,1
8229,3,work,9,16,7
8229,4,home,16,22,6
8229,5,work,22,23,1
8229,6,home,23,24,1
8229,7,<ENDS>,24,24,0
8230,0,<START>,0,0,0
8230,1,home,0,7,7
8230,2,work,7,15,8
8230,3,home,15,21,6
8230,4,shop,21,22,1
8230,5,home,22,24,2
8230,6,<ENDS>,24,24,0
8231,0,<START>,0,0,0
8231,1,home,0,7,7
8231,2,work,7,14,7
8231,3,home,14,19,5
8231,4,shop,19,20,1
8231,5,home,20,24,4
8231,6,<ENDS>,24,24,0
8232,0,<START>,0,0,0
8232,1,home,0,7,7
8232,2,education,7,11,4
8232,3,home,11,14,3
8232,4,education,14,16,2
8232,5,home,16,24,8
8232,6,<ENDS>,24,24,0
8233,0,<START>,0,0,0
8233,1,home,0,7,7
8233,2,work,7,9,2
8233,3,home,9,15,6
8233,4,work,15,17,2
8233,5,home,17,24,7
8233,6,<ENDS>,24,24,0
8234,0,<START>,0,0,0
8234,1,home,0,6,6
8234,2,work,6,13,7
8234,3,home,13,24,11
8234,4,<ENDS>,24,24,0
8235,0,<START>,0,0,0
8235,1,home,0,7,7
8235,2,work,7,13,6
8235,3,home,13,17,4
8235,4,work,17,20,3
8235,5,home,20,24,4
8235,6,<ENDS>,24,24,0
8236,0,<START>,0,0,0
8236,1,home,0,6,6
8236,2,work,6,13,7
8236,3,home,13,23,10
8236,4,work,23,24,1
8236,5,<ENDS>,24,24,0
8237,0,<START>,0,0,0
8237,1,home,0,7,7
8237,2,work,7,10,3
8237,3,home,10,15,5
8237,4,work,15,17,2
8237,5,home,17,24,7
8237,6,<ENDS>,24,24,0
8238,0,<START>,0,0,0
8238,1,home,0,8,8
8238,2,work,8,15,7
8238,3,home,15,24,9
8238,4,<ENDS>,24,24,0
8239,0,<START>,0,0,0
8239,1,home,0,6,6
8239,2,work,6,8,2
8239,3,home,8,14,6
8239,4,work,14,17,3
8239,5,home,17,24,7
8239,6,<ENDS>,24,24,0
8240,0,<START>,0,0,0
8240,1,home,0,8,8
8240,2,work,8,15,7
8240,3,shop,15,16,1
8240,4,work,16,20,4
8240,5,home,20,24,4
8240,6,<ENDS>,24,24,0
8241,0,<START>,0,0,0
8241,1,home,0,8,8
8241,2,education,8,12,4
8241,3,work,12,19,7
8241,4,home,19,24,5
8241,5,<ENDS>,24,24,0
8242,0,<START>,0,0,0
8242,1,home,0,6,6
8242,2,shop,6,7,1
8242,3,home,7,10,3
8242,4,education,10,12,2
8242,5,home,12,18,6
8242,6,shop,18,19,1
8242,7,home,19,24,5
8242,8,<ENDS>,24,24,0
8243,0,<START>,0,0,0
8243,1,home,0,6,6
8243,2,work,6,13,7
8243,3,shop,13,14,1
8243,4,work,14,20,6
8243,5,home,20,24,4
8243,6,<ENDS>,24,24,0
8244,0,<START>,0,0,0
8244,1,home,0,8,8
8244,2,work,8,16,8
8244,3,home,16,24,8
8244,4,<ENDS>,24,24,0
8245,0,<START>,0,0,0
8245,1,home,0,7,7
8245,2,education,7,12,5
8245,3,home,12,19,7
8245,4,shop,19,21,2
8245,5,home,21,24,3
8245,6,<ENDS>,24,24,0
8246,0,<START>,0,0,0
8246,1,home,0,8,8
8246,2,work,8,14,6
8246,3,home,14,22,8
8246,4,work,22,23,1
8246,5,home,23,24,1
8246,6,<ENDS>,24,24,0
8247,0,<START>,0,0,0
8247,1,home,0,8,8
8247,2,work,8,14,6
8247,3,home,14,24,10
8247,4,<ENDS>,24,24,0
8248,0,<START>,0,0,0
8248,1,home,0,6,6
8248,2,work,6,13,7
8248,3,home,13,24,11
8248,4,<ENDS>,24,24,0
8249,0,<START>,0,0,0
8249,1,home,0,8,8
8249,2,work,8,15,7
8249,3,shop,15,16,1
8249,4,home,16,24,8
8249,5,<ENDS>,24,24,0
8250,0,<START>,0,0,0
8250,1,home,0,7,7
8250,2,work,7,13,6
8250,3,shop,13,15,2
8250,4,home,15,24,9
8250,5,<ENDS>,24,24,0
8251,0,<START>,0,0,0
8251,1,home,0,7,7
8251,2,shop,7,9,2
8251,3,education,9,12,3
8251,4,home,12,18,6
8251,5,shop,18,20,2
8251,6,home,20,24,4
8251,7,<ENDS>,24,24,0
8252,0,<START>,0,0,0
8252,1,home,0,7,7
8252,2,work,7,13,6
8252,3,shop,13,14,1
8252,4,work,14,19,5
8252,5,home,19,24,5
8252,6,<ENDS>,24,24,0
8253,0,<START>,0,0,0
8253,1,home,0,7,7
8253,2,work,7,14,7
8253,3,shop,14,15,1
8253,4,work,15,20,5
8253,5,home,20,24,4
8253,6,<ENDS>,24,24,0
8254,0,<START>,0,0,0
8254,1,home,0,8,8
8254,2,education,8,12,4
8254,3,shop,12,14,2
8254,4,education,14,17,3
8254,5,shop,17,18,1
8254,6,home,18,24,6
8254,7,<ENDS>,24,24,0
8255,0,<START>,0,0,0
8255,1,home,0,9,9
8255,2,work,9,15,6
8255,3,shop,15,17,2
8255,4,home,17,24,7
8255,5,<ENDS>,24,24,0
8256,0,<START>,0,0,0
8256,1,home,0,8,8
8256,2,work,8,14,6
8256,3,shop,14,15,1
8256,4,home,15,24,9
8256,5,<ENDS>,24,24,0
8257,0,<START>,0,0,0
8257,1,home,0,7,7
8257,2,work,7,14,7
8257,3,home,14,16,2
8257,4,work,16,20,4
8257,5,home,20,24,4
8257,6,<ENDS>,24,24,0
8258,0,<START>,0,0,0
8258,1,home,0,6,6
8258,2,work,6,13,7
8258,3,home,13,24,11
8258,4,<ENDS>,24,24,0
8259,0,<START>,0,0,0
8259,1,home,0,9,9
8259,2,work,9,15,6
8259,3,home,15,24,9
8259,4,<ENDS>,24,24,0
8260,0,<START>,0,0,0
8260,1,home,0,7,7
8260,2,work,7,14,7
8260,3,shop,14,15,1
8260,4,work,15,20,5
8260,5,home,20,24,4
8260,6,<ENDS>,24,24,0
8261,0,<START>,0,0,0
8261,1,home,0,8,8
8261,2,work,8,15,7
8261,3,shop,15,16,1
8261,4,work,16,20,4
8261,5,home,20,24,4
8261,6,<ENDS>,24,24,0
8262,0,<START>,0,0,0
8262,1,home,0,7,7
8262,2,work,7,9,2
8262,3,home,9,13,4
8262,4,work,13,15,2
8262,5,home,15,22,7
8262,6,work,22,23,1
8262,7,home,23,24,1
8262,8,<ENDS>,24,24,0
8263,0,<START>,0,0,0
8263,1,home,0,6,6
8263,2,shop,6,7,1
8263,3,home,7,9,2
8263,4,work,9,16,7
8263,5,home,16,24,8
8263,6,<ENDS>,24,24,0
8264,0,<START>,0,0,0
8264,1,home,0,8,8
8264,2,work,8,16,8
8264,3,shop,16,17,1
8264,4,home,17,24,7
8264,5,<ENDS>,24,24,0
8265,0,<START>,0,0,0
8265,1,home,0,7,7
8265,2,work,7,14,7
8265,3,shop,14,16,2
8265,4,work,16,20,4
8265,5,home,20,24,4
8265,6,<ENDS>,24,24,0
8266,0,<START>,0,0,0
8266,1,home,0,7,7
8266,2,work,7,13,6
8266,3,home,13,24,11
8266,4,<ENDS>,24,24,0
8267,0,<START>,0,0,0
8267,1,home,0,8,8
8267,2,education,8,12,4
8267,3,work,12,19,7
8267,4,home,19,22,3
8267,5,work,22,23,1
8267,6,home,23,24,1
8267,7,<ENDS>,24,24,0
8268,0,<START>,0,0,0
8268,1,home,0,6,6
8268,2,work,6,13,7
8268,3,shop,13,14,1
8268,4,home,14,24,10
8268,5,<ENDS>,24,24,0
8269,0,<START>,0,0,0
8269,1,home,0,8,8
8269,2,education,8,11,3
8269,3,home,11,18,7
8269,4,shop,18,20,2
8269,5,home,20,24,4
8269,6,<ENDS>,24,24,0
8270,0,<START>,0,0,0
8270,1,home,0,6,6
8270,2,work,6,8,2
8270,3,home,8,12,4
8270,4,work,12,14,2
8270,5,home,14,17,3
8270,6,work,17,19,2
8270,7,home,19,24,5
8270,8,<ENDS>,24,24,0
8271,0,<START>,0,0,0
8271,1,home,0,7,7
8271,2,work,7,14,7
8271,3,shop,14,15,1
8271,4,work,15,20,5
8271,5,home,20,24,4
8271,6,<ENDS>,24,24,0
8272,0,<START>,0,0,0
8272,1,home,0,8,8
8272,2,work,8,14,6
8272,3,shop,14,15,1
8272,4,home,15,24,9
8272,5,<ENDS>,24,24,0
8273,0,<START>,0,0,0
8273,1,home,0,6,6
8273,2,work,6,13,7
8273,3,home,13,24,11
8273,4,<ENDS>,24,24,0
8274,0,<START>,0,0,0
8274,1,home,0,8,8
8274,2,shop,8,9,1
8274,3,work,9,17,8
8274,4,home,17,24,7
8274,5,<ENDS>,24,24,0
8275,0,<START>,0,0,0
8275,1,home,0,8,8
8275,2,work,8,15,7
8275,3,home,15,22,7
8275,4,work,22,23,1
8275,5,home,23,24,1
8275,6,<ENDS>,24,24,0
8276,0,<START>,0,0,0
8276,1,home,0,6,6
8276,2,work,6,13,7
8276,3,shop,13,14,1
8276,4,work,14,18,4
8276,5,home,18,24,6
8276,6,<ENDS>,24,24,0
8277,0,<START>,0,0,0
8277,1,home,0,8,8
8277,2,work,8,15,7
8277,3,shop,15,16,1
8277,4,home,16,24,8
8277,5,<ENDS>,24,24,0
8278,0,<START>,0,0,0
8278,1,home,0,6,6
8278,2,work,6,12,6
8278,3,shop,12,13,1
8278,4,work,13,19,6
8278,5,home,19,24,5
8278,6,<ENDS>,24,24,0
8279,0,<START>,0,0,0
8279,1,home,0,8,8
8279,2,work,8,14,6
8279,3,shop,14,15,1
8279,4,home,15,22,7
8279,5,work,22,23,1
8279,6,home,23,24,1
8279,7,<ENDS>,24,24,0
8280,0,<START>,0,0,0
8280,1,home,0,7,7
8280,2,work,7,14,7
8280,3,home,14,21,7
8280,4,work,21,22,1
8280,5,home,22,24,2
8280,6,<ENDS>,24,24,0
8281,0,<START>,0,0,0
8281,1,home,0,8,8
8281,2,education,8,11,3
8281,3,home,11,17,6
8281,4,shop,17,18,1
8281,5,home,18,24,6
8281,6,<ENDS>,24,24,0
8282,0,<START>,0,0,0
8282,1,home,0,8,8
8282,2,work,8,15,7
8282,3,home,15,24,9
8282,4,<ENDS>,24,24,0
8283,0,<START>,0,0,0
8283,1,home,0,8,8
8283,2,work,8,14,6
8283,3,shop,14,15,1
8283,4,home,15,19,4
8283,5,shop,19,20,1
8283,6,home,20,24,4
8283,7,<ENDS>,24,24,0
8284,0,<START>,0,0,0
8284,1,home,0,7,7
8284,2,education,7,11,4
8284,3,home,11,19,8
8284,4,shop,19,20,1
8284,5,home,20,24,4
8284,6,<ENDS>,24,24,0
8285,0,<START>,0,0,0
8285,1,home,0,9,9
8285,2,work,9,16,7
8285,3,home,16,20,4
8285,4,shop,20,21,1
8285,5,home,21,24,3
8285,6,<ENDS>,24,24,0
8286,0,<START>,0,0,0
8286,1,home,0,6,6
8286,2,shop,6,7,1
8286,3,work,7,14,7
8286,4,home,14,17,3
8286,5,work,17,20,3
8286,6,home,20,24,4
8286,7,<ENDS>,24,24,0
8287,0,<START>,0,0,0
8287,1,home,0,6,6
8287,2,work,6,13,7
8287,3,home,13,17,4
8287,4,work,17,20,3
8287,5,home,20,24,4
8287,6,<ENDS>,24,24,0
8288,0,<START>,0,0,0
8288,1,home,0,6,6
8288,2,work,6,13,7
8288,3,shop,13,14,1
8288,4,work,14,20,6
8288,5,home,20,24,4
8288,6,<ENDS>,24,24,0
8289,0,<START>,0,0,0
8289,1,home,0,7,7
8289,2,work,7,13,6
8289,3,shop,13,14,1
8289,4,home,14,24,10
8289,5,<ENDS>,24,24,0
8290,0,<START>,0,0,0
8290,1,home,0,6,6
8290,2,work,6,13,7
8290,3,shop,13,14,1
8290,4,home,14,18,4
8290,5,work,18,20,2
8290,6,home,20,24,4
8290,7,<ENDS>,24,24,0
8291,0,<START>,0,0,0
8291,1,home,0,7,7
8291,2,education,7,11,4
8291,3,home,11,18,7
8291,4,shop,18,20,2
8291,5,home,20,24,4
8291,6,<ENDS>,24,24,0
8292,0,<START>,0,0,0
8292,1,home,0,7,7
8292,2,work,7,14,7
8292,3,home,14,18,4
8292,4,work,18,20,2
8292,5,home,20,24,4
8292,6,<ENDS>,24,24,0
8293,0,<START>,0,0,0
8293,1,home,0,6,6
8293,2,work,6,13,7
8293,3,home,13,24,11
8293,4,<ENDS>,24,24,0
8294,0,<START>,0,0,0
8294,1,home,0,7,7
8294,2,work,7,14,7
8294,3,home,14,24,10
8294,4,<ENDS>,24,24,0
8295,0,<START>,0,0,0
8295,1,home,0,7,7
8295,2,work,7,13,6
8295,3,home,13,15,2
8295,4,work,15,19,4
8295,5,home,19,24,5
8295,6,<ENDS>,24,24,0
8296,0,<START>,0,0,0
8296,1,home,0,6,6
8296,2,work,6,13,7
8296,3,home,13,18,5
8296,4,work,18,20,2
8296,5,home,20,24,4
8296,6,<ENDS>,24,24,0
8297,0,<START>,0,0,0
8297,1,home,0,6,6
8297,2,shop,6,7,1
8297,3,work,7,14,7
8297,4,shop,14,15,1
8297,5,work,15,18,3
8297,6,home,18,24,6
8297,7,<ENDS>,24,24,0
8298,0,<START>,0,0,0
8298,1,home,0,7,7
8298,2,work,7,13,6
8298,3,shop,13,14,1
8298,4,work,14,20,6
8298,5,home,20,24,4
8298,6,<ENDS>,24,24,0
8299,0,<START>,0,0,0
8299,1,home,0,6,6
8299,2,shop,6,7,1
8299,3,home,7,10,3
8299,4,education,10,12,2
8299,5,shop,12,14,2
8299,6,education,14,16,2
8299,7,shop,16,17,1
8299,8,home,17,24,7
8299,9,<ENDS>,24,24,0
8300,0,<START>,0,0,0
8300,1,home,0,6,6
8300,2,work,6,13,7
8300,3,shop,13,14,1
8300,4,work,14,19,5
8300,5,home,19,24,5
8300,6,<ENDS>,24,24,0
8301,0,<START>,0,0,0
8301,1,home,0,10,10
8301,2,education,10,16,6
8301,3,shop,16,17,1
8301,4,work,17,20,3
8301,5,home,20,24,4
8301,6,<ENDS>,24,24,0
8302,0,<START>,0,0,0
8302,1,home,0,7,7
8302,2,shop,7,8,1
8302,3,education,8,11,3
8302,4,home,11,14,3
8302,5,education,14,16,2
8302,6,shop,16,19,3
8302,7,home,19,24,5
8302,8,<ENDS>,24,24,0
8303,0,<START>,0,0,0
8303,1,home,0,7,7
8303,2,shop,7,8,1
8303,3,education,8,11,3
8303,4,home,11,18,7
8303,5,shop,18,19,1
8303,6,home,19,24,5
8303,7,<ENDS>,24,24,0
8304,0,<START>,0,0,0
8304,1,home,0,8,8
8304,2,education,8,13,5
8304,3,shop,13,14,1
8304,4,work,14,20,6
8304,5,home,20,24,4
8304,6,<ENDS>,24,24,0
8305,0,<START>,0,0,0
8305,1,home,0,6,6
8305,2,shop,6,7,1
8305,3,work,7,13,6
8305,4,home,13,24,11
8305,5,<ENDS>,24,24,0
8306,0,<START>,0,0,0
8306,1,home,0,6,6
8306,2,work,6,13,7
8306,3,home,13,16,3
8306,4,work,16,20,4
8306,5,home,20,24,4
8306,6,<ENDS>,24,24,0
8307,0,<START>,0,0,0
8307,1,home,0,7,7
8307,2,work,7,13,6
8307,3,home,13,21,8
8307,4,shop,21,22,1
8307,5,home,22,24,2
8307,6,<ENDS>,24,24,0
8308,0,<START>,0,0,0
8308,1,home,0,6,6
8308,2,shop,6,7,1
8308,3,home,7,10,3
8308,4,education,10,13,3
8308,5,shop,13,14,1
8308,6,education,14,16,2
8308,7,shop,16,18,2
8308,8,home,18,24,6
8308,9,<ENDS>,24,24,0
8309,0,<START>,0,0,0
8309,1,home,0,6,6
8309,2,shop,6,7,1
8309,3,home,7,9,2
8309,4,education,9,13,4
8309,5,home,13,21,8
8309,6,shop,21,22,1
8309,7,home,22,24,2
8309,8,<ENDS>,24,24,0
8310,0,<START>,0,0,0
8310,1,home,0,6,6
8310,2,shop,6,7,1
8310,3,home,7,10,3
8310,4,education,10,13,3
8310,5,shop,13,14,1
8310,6,education,14,16,2
8310,7,shop,16,17,1
8310,8,home,17,24,7
8310,9,<ENDS>,24,24,0
8311,0,<START>,0,0,0
8311,1,home,0,7,7
8311,2,work,7,14,7
8311,3,shop,14,15,1
8311,4,home,15,24,9
8311,5,<ENDS>,24,24,0
8312,0,<START>,0,0,0
8312,1,home,0,8,8
8312,2,education,8,11,3
8312,3,home,11,19,8
8312,4,shop,19,20,1
8312,5,home,20,24,4
8312,6,<ENDS>,24,24,0
8313,0,<START>,0,0,0
8313,1,home,0,6,6
8313,2,work,6,12,6
8313,3,shop,12,13,1
8313,4,work,13,19,6
8313,5,home,19,24,5
8313,6,<ENDS>,24,24,0
8314,0,<START>,0,0,0
8314,1,home,0,6,6
8314,2,shop,6,7,1
8314,3,work,7,14,7
8314,4,home,14,18,4
8314,5,work,18,20,2
8314,6,home,20,24,4
8314,7,<ENDS>,24,24,0
8315,0,<START>,0,0,0
8315,1,home,0,8,8
8315,2,work,8,14,6
8315,3,home,14,24,10
8315,4,<ENDS>,24,24,0
8316,0,<START>,0,0,0
8316,1,home,0,7,7
8316,2,work,7,14,7
8316,3,home,14,24,10
8316,4,<ENDS>,24,24,0
8317,0,<START>,0,0,0
8317,1,home,0,7,7
8317,2,work,7,13,6
8317,3,home,13,18,5
8317,4,work,18,20,2
8317,5,home,20,24,4
8317,6,<ENDS>,24,24,0
8318,0,<START>,0,0,0
8318,1,home,0,9,9
8318,2,work,9,17,8
8318,3,home,17,22,5
8318,4,work,22,23,1
8318,5,home,23,24,1
8318,6,<ENDS>,24,24,0
8319,0,<START>,0,0,0
8319,1,home,0,7,7
8319,2,shop,7,8,1
8319,3,education,8,11,3
8319,4,home,11,20,9
8319,5,shop,20,21,1
8319,6,home,21,24,3
8319,7,<ENDS>,24,24,0
8320,0,<START>,0,0,0
8320,1,home,0,7,7
8320,2,work,7,13,6
8320,3,home,13,17,4
8320,4,work,17,20,3
8320,5,home,20,24,4
8320,6,<ENDS>,24,24,0
8321,0,<START>,0,0,0
8321,1,home,0,8,8
8321,2,work,8,14,6
8321,3,home,14,18,4
8321,4,shop,18,19,1
8321,5,home,19,24,5
8321,6,<ENDS>,24,24,0
8322,0,<START>,0,0,0
8322,1,home,0,6,6
8322,2,shop,6,7,1
8322,3,home,7,10,3
8322,4,education,10,13,3
8322,5,shop,13,15,2
8322,6,home,15,24,9
8322,7,<ENDS>,24,24,0
8323,0,<START>,0,0,0
8323,1,home,0,9,9
8323,2,education,9,15,6
8323,3,home,15,21,6
8323,4,work,21,22,1
8323,5,home,22,24,2
8323,6,<ENDS>,24,24,0
8324,0,<START>,0,0,0
8324,1,home,0,7,7
8324,2,work,7,13,6
8324,3,home,13,22,9
8324,4,work,22,23,1
8324,5,home,23,24,1
8324,6,<ENDS>,24,24,0
8325,0,<START>,0,0,0
8325,1,home,0,6,6
8325,2,work,6,14,8
8325,3,home,14,23,9
8325,4,work,23,24,1
8325,5,<ENDS>,24,24,0
8326,0,<START>,0,0,0
8326,1,home,0,6,6
8326,2,shop,6,7,1
8326,3,home,7,11,4
8326,4,work,11,18,7
8326,5,home,18,21,3
8326,6,work,21,22,1
8326,7,home,22,24,2
8326,8,<ENDS>,24,24,0
8327,0,<START>,0,0,0
8327,1,home,0,6,6
8327,2,work,6,8,2
8327,3,home,8,12,4
8327,4,work,12,14,2
8327,5,home,14,21,7
8327,6,work,21,22,1
8327,7,home,22,24,2
8327,8,<ENDS>,24,24,0
8328,0,<START>,0,0,0
8328,1,home,0,9,9
8328,2,work,9,16,7
8328,3,home,16,24,8
8328,4,<ENDS>,24,24,0
8329,0,<START>,0,0,0
8329,1,home,0,9,9
8329,2,work,9,17,8
8329,3,home,17,24,7
8329,4,<ENDS>,24,24,0
8330,0,<START>,0,0,0
8330,1,home,0,6,6
8330,2,work,6,13,7
8330,3,home,13,17,4
8330,4,work,17,20,3
8330,5,home,20,24,4
8330,6,<ENDS>,24,24,0
8331,0,<START>,0,0,0
8331,1,home,0,8,8
8331,2,work,8,15,7
8331,3,home,15,21,6
8331,4,work,21,22,1
8331,5,home,22,24,2
8331,6,<ENDS>,24,24,0
8332,0,<START>,0,0,0
8332,1,home,0,7,7
8332,2,work,7,14,7
8332,3,home,14,24,10
8332,4,<ENDS>,24,24,0
8333,0,<START>,0,0,0
8333,1,home,0,6,6
8333,2,shop,6,7,1
8333,3,home,7,13,6
8333,4,education,13,16,3
8333,5,shop,16,17,1
8333,6,home,17,24,7
8333,7,<ENDS>,24,24,0
8334,0,<START>,0,0,0
8334,1,home,0,8,8
8334,2,work,8,14,6
8334,3,shop,14,16,2
8334,4,home,16,22,6
8334,5,work,22,23,1
8334,6,home,23,24,1
8334,7,<ENDS>,24,24,0
8335,0,<START>,0,0,0
8335,1,home,0,7,7
8335,2,work,7,9,2
8335,3,home,9,16,7
8335,4,work,16,19,3
8335,5,home,19,23,4
8335,6,work,23,24,1
8335,7,<ENDS>,24,24,0
8336,0,<START>,0,0,0
8336,1,home,0,7,7
8336,2,shop,7,8,1
8336,3,work,8,15,7
8336,4,shop,15,16,1
8336,5,home,16,24,8
8336,6,<ENDS>,24,24,0
8337,0,<START>,0,0,0
8337,1,home,0,6,6
8337,2,work,6,7,1
8337,3,home,7,11,4
8337,4,work,11,13,2
8337,5,home,13,21,8
8337,6,work,21,22,1
8337,7,home,22,24,2
8337,8,<ENDS>,24,24,0
8338,0,<START>,0,0,0
8338,1,home,0,6,6
8338,2,work,6,13,7
8338,3,shop,13,14,1
8338,4,home,14,19,5
8338,5,shop,19,20,1
8338,6,home,20,24,4
8338,7,<ENDS>,24,24,0
8339,0,<START>,0,0,0
8339,1,home,0,6,6
8339,2,shop,6,7,1
8339,3,work,7,14,7
8339,4,home,14,18,4
8339,5,work,18,20,2
8339,6,home,20,24,4
8339,7,<ENDS>,24,24,0
8340,0,<START>,0,0,0
8340,1,home,0,7,7
8340,2,work,7,14,7
8340,3,home,14,18,4
8340,4,shop,18,19,1
8340,5,home,19,24,5
8340,6,<ENDS>,24,24,0
8341,0,<START>,0,0,0
8341,1,home,0,6,6
8341,2,work,6,13,7
8341,3,home,13,19,6
8341,4,shop,19,20,1
8341,5,home,20,24,4
8341,6,<ENDS>,24,24,0
8342,0,<START>,0,0,0
8342,1,home,0,8,8
8342,2,work,8,14,6
8342,3,home,14,24,10
8342,4,<ENDS>,24,24,0
8343,0,<START>,0,0,0
8343,1,home,0,8,8
8343,2,work,8,13,5
8343,3,home,13,24,11
8343,4,<ENDS>,24,24,0
8344,0,<START>,0,0,0
8344,1,home,0,6,6
8344,2,shop,6,7,1
8344,3,home,7,9,2
8344,4,education,9,13,4
8344,5,home,13,21,8
8344,6,shop,21,22,1
8344,7,home,22,24,2
8344,8,<ENDS>,24,24,0
8345,0,<START>,0,0,0
8345,1,home,0,6,6
8345,2,work,6,13,7
8345,3,shop,13,14,1
8345,4,work,14,20,6
8345,5,home,20,24,4
8345,6,<ENDS>,24,24,0
8346,0,<START>,0,0,0
8346,1,home,0,7,7
8346,2,work,7,13,6
8346,3,home,13,19,6
8346,4,shop,19,20,1
8346,5,home,20,24,4
8346,6,<ENDS>,24,24,0
8347,0,<START>,0,0,0
8347,1,home,0,8,8
8347,2,shop,8,9,1
8347,3,work,9,16,7
8347,4,home,16,24,8
8347,5,<ENDS>,24,24,0
8348,0,<START>,0,0,0
8348,1,home,0,8,8
8348,2,work,8,15,7
8348,3,home,15,21,6
8348,4,work,21,22,1
8348,5,home,22,24,2
8348,6,<ENDS>,24,24,0
8349,0,<START>,0,0,0
8349,1,home,0,8,8
8349,2,work,8,14,6
8349,3,home,14,24,10
8349,4,<ENDS>,24,24,0
8350,0,<START>,0,0,0
8350,1,home,0,6,6
8350,2,shop,6,7,1
8350,3,home,7,10,3
8350,4,education,10,12,2
8350,5,shop,12,13,1
8350,6,education,13,14,1
8350,7,shop,14,15,1
8350,8,home,15,24,9
8350,9,<ENDS>,24,24,0
8351,0,<START>,0,0,0
8351,1,home,0,7,7
8351,2,shop,7,8,1
8351,3,education,8,12,4
8351,4,home,12,21,9
8351,5,shop,21,22,1
8351,6,home,22,24,2
8351,7,<ENDS>,24,24,0
8352,0,<START>,0,0,0
8352,1,home,0,7,7
8352,2,education,7,12,5
8352,3,home,12,19,7
8352,4,shop,19,21,2
8352,5,home,21,24,3
8352,6,<ENDS>,24,24,0
8353,0,<START>,0,0,0
8353,1,home,0,7,7
8353,2,education,7,12,5
8353,3,shop,12,14,2
8353,4,education,14,17,3
8353,5,shop,17,18,1
8353,6,home,18,24,6
8353,7,<ENDS>,24,24,0
8354,0,<START>,0,0,0
8354,1,home,0,8,8
8354,2,work,8,15,7
8354,3,home,15,24,9
8354,4,<ENDS>,24,24,0
8355,0,<START>,0,0,0
8355,1,home,0,7,7
8355,2,education,7,11,4
8355,3,home,11,14,3
8355,4,education,14,16,2
8355,5,home,16,24,8
8355,6,<ENDS>,24,24,0
8356,0,<START>,0,0,0
8356,1,home,0,7,7
8356,2,work,7,15,8
8356,3,home,15,24,9
8356,4,<ENDS>,24,24,0
8357,0,<START>,0,0,0
8357,1,home,0,6,6
8357,2,work,6,13,7
8357,3,home,13,19,6
8357,4,shop,19,20,1
8357,5,home,20,24,4
8357,6,<ENDS>,24,24,0
8358,0,<START>,0,0,0
8358,1,home,0,6,6
8358,2,work,6,7,1
8358,3,home,7,9,2
8358,4,work,9,10,1
8358,5,home,10,13,3
8358,6,work,13,16,3
8358,7,home,16,22,6
8358,8,work,22,23,1
8358,9,home,23,24,1
8358,10,<ENDS>,24,24,0
8359,0,<START>,0,0,0
8359,1,home,0,7,7
8359,2,shop,7,8,1
8359,3,education,8,11,3
8359,4,home,11,13,2
8359,5,education,13,16,3
8359,6,home,16,24,8
8359,7,<ENDS>,24,24,0
8360,0,<START>,0,0,0
8360,1,home,0,6,6
8360,2,shop,6,7,1
8360,3,home,7,12,5
8360,4,work,12,19,7
8360,5,home,19,24,5
8360,6,<ENDS>,24,24,0
8361,0,<START>,0,0,0
8361,1,home,0,6,6
8361,2,shop,6,7,1
8361,3,home,7,17,10
8361,4,work,17,20,3
8361,5,home,20,24,4
8361,6,<ENDS>,24,24,0
8362,0,<START>,0,0,0
8362,1,home,0,8,8
8362,2,work,8,15,7
8362,3,shop,15,17,2
8362,4,home,17,24,7
8362,5,<ENDS>,24,24,0
8363,0,<START>,0,0,0
8363,1,home,0,7,7
8363,2,work,7,14,7
8363,3,home,14,24,10
8363,4,<ENDS>,24,24,0
8364,0,<START>,0,0,0
8364,1,home,0,8,8
8364,2,education,8,13,5
8364,3,shop,13,14,1
8364,4,home,14,24,10
8364,5,<ENDS>,24,24,0
8365,0,<START>,0,0,0
8365,1,home,0,6,6
8365,2,shop,6,7,1
8365,3,home,7,10,3
8365,4,education,10,12,2
8365,5,shop,12,14,2
8365,6,home,14,24,10
8365,7,<ENDS>,24,24,0
8366,0,<START>,0,0,0
8366,1,home,0,7,7
8366,2,shop,7,8,1
8366,3,home,8,9,1
8366,4,education,9,12,3
8366,5,work,12,19,7
8366,6,home,19,24,5
8366,7,<ENDS>,24,24,0
8367,0,<START>,0,0,0
8367,1,home,0,6,6
8367,2,work,6,8,2
8367,3,home,8,12,4
8367,4,work,12,14,2
8367,5,home,14,21,7
8367,6,work,21,22,1
8367,7,home,22,24,2
8367,8,<ENDS>,24,24,0
8368,0,<START>,0,0,0
8368,1,home,0,7,7
8368,2,work,7,13,6
8368,3,home,13,21,8
8368,4,work,21,22,1
8368,5,home,22,24,2
8368,6,<ENDS>,24,24,0
8369,0,<START>,0,0,0
8369,1,home,0,7,7
8369,2,work,7,14,7
8369,3,home,14,24,10
8369,4,<ENDS>,24,24,0
8370,0,<START>,0,0,0
8370,1,home,0,7,7
8370,2,work,7,14,7
8370,3,home,14,24,10
8370,4,<ENDS>,24,24,0
8371,0,<START>,0,0,0
8371,1,home,0,8,8
8371,2,shop,8,9,1
8371,3,work,9,16,7
8371,4,home,16,24,8
8371,5,<ENDS>,24,24,0
8372,0,<START>,0,0,0
8372,1,home,0,6,6
8372,2,shop,6,7,1
8372,3,home,7,9,2
8372,4,education,9,12,3
8372,5,shop,12,14,2
8372,6,education,14,16,2
8372,7,home,16,24,8
8372,8,<ENDS>,24,24,0
8373,0,<START>,0,0,0
8373,1,home,0,6,6
8373,2,shop,6,7,1
8373,3,work,7,8,1
8373,4,home,8,14,6
8373,5,work,14,16,2
8373,6,home,16,23,7
8373,7,work,23,24,1
8373,8,<ENDS>,24,24,0
8374,0,<START>,0,0,0
8374,1,home,0,7,7
8374,2,shop,7,8,1
8374,3,education,8,11,3
8374,4,home,11,17,6
8374,5,shop,17,18,1
8374,6,home,18,24,6
8374,7,<ENDS>,24,24,0
8375,0,<START>,0,0,0
8375,1,home,0,6,6
8375,2,work,6,7,1
8375,3,home,7,9,2
8375,4,work,9,11,2
8375,5,home,11,15,4
8375,6,work,15,17,2
8375,7,home,17,23,6
8375,8,work,23,24,1
8375,9,<ENDS>,24,24,0
8376,0,<START>,0,0,0
8376,1,home,0,7,7
8376,2,work,7,13,6
8376,3,home,13,20,7
8376,4,shop,20,21,1
8376,5,home,21,24,3
8376,6,<ENDS>,24,24,0
8377,0,<START>,0,0,0
8377,1,home,0,6,6
8377,2,work,6,13,7
8377,3,shop,13,14,1
8377,4,work,14,20,6
8377,5,home,20,24,4
8377,6,<ENDS>,24,24,0
8378,0,<START>,0,0,0
8378,1,home,0,8,8
8378,2,work,8,16,8
8378,3,home,16,24,8
8378,4,<ENDS>,24,24,0
8379,0,<START>,0,0,0
8379,1,home,0,7,7
8379,2,work,7,13,6
8379,3,home,13,23,10
8379,4,work,23,24,1
8379,5,<ENDS>,24,24,0
8380,0,<START>,0,0,0
8380,1,home,0,7,7
8380,2,work,7,13,6
8380,3,home,13,20,7
8380,4,shop,20,21,1
8380,5,home,21,24,3
8380,6,<ENDS>,24,24,0
8381,0,<START>,0,0,0
8381,1,home,0,6,6
8381,2,work,6,13,7
8381,3,home,13,15,2
8381,4,work,15,20,5
8381,5,home,20,24,4
8381,6,<ENDS>,24,24,0
8382,0,<START>,0,0,0
8382,1,home,0,7,7
8382,2,education,7,11,4
8382,3,home,11,16,5
8382,4,shop,16,18,2
8382,5,home,18,24,6
8382,6,<ENDS>,24,24,0
8383,0,<START>,0,0,0
8383,1,home,0,7,7
8383,2,work,7,14,7
8383,3,shop,14,15,1
8383,4,home,15,24,9
8383,5,<ENDS>,24,24,0
8384,0,<START>,0,0,0
8384,1,home,0,8,8
8384,2,work,8,15,7
8384,3,shop,15,16,1
8384,4,home,16,21,5
8384,5,work,21,22,1
8384,6,home,22,24,2
8384,7,<ENDS>,24,24,0
8385,0,<START>,0,0,0
8385,1,home,0,7,7
8385,2,work,7,9,2
8385,3,home,9,13,4
8385,4,work,13,16,3
8385,5,home,16,24,8
8385,6,<ENDS>,24,24,0
8386,0,<START>,0,0,0
8386,1,home,0,6,6
8386,2,shop,6,8,2
8386,3,home,8,13,5
8386,4,work,13,19,6
8386,5,home,19,24,5
8386,6,<ENDS>,24,24,0
8387,0,<START>,0,0,0
8387,1,home,0,6,6
8387,2,shop,6,7,1
8387,3,home,7,9,2
8387,4,education,9,12,3
8387,5,home,12,24,12
8387,6,<ENDS>,24,24,0
8388,0,<START>,0,0,0
8388,1,home,0,7,7
8388,2,shop,7,8,1
8388,3,home,8,11,3
8388,4,work,11,13,2
8388,5,home,13,21,8
8388,6,work,21,22,1
8388,7,home,22,24,2
8388,8,<ENDS>,24,24,0
8389,0,<START>,0,0,0
8389,1,home,0,7,7
8389,2,work,7,13,6
8389,3,home,13,22,9
8389,4,work,22,23,1
8389,5,home,23,24,1
8389,6,<ENDS>,24,24,0
8390,0,<START>,0,0,0
8390,1,home,0,6,6
8390,2,work,6,13,7
8390,3,home,13,17,4
8390,4,work,17,20,3
8390,5,home,20,24,4
8390,6,<ENDS>,24,24,0
8391,0,<START>,0,0,0
8391,1,home,0,7,7
8391,2,work,7,13,6
8391,3,shop,13,14,1
8391,4,home,14,24,10
8391,5,<ENDS>,24,24,0
8392,0,<START>,0,0,0
8392,1,home,0,7,7
8392,2,work,7,13,6
8392,3,shop,13,14,1
8392,4,home,14,18,4
8392,5,work,18,20,2
8392,6,home,20,24,4
8392,7,<ENDS>,24,24,0
8393,0,<START>,0,0,0
8393,1,home,0,8,8
8393,2,work,8,14,6
8393,3,shop,14,15,1
8393,4,home,15,22,7
8393,5,work,22,23,1
8393,6,home,23,24,1
8393,7,<ENDS>,24,24,0
8394,0,<START>,0,0,0
8394,1,home,0,7,7
8394,2,shop,7,8,1
8394,3,home,8,11,3
8394,4,work,11,18,7
8394,5,home,18,21,3
8394,6,work,21,22,1
8394,7,home,22,24,2
8394,8,<ENDS>,24,24,0
8395,0,<START>,0,0,0
8395,1,work,0,9,9
8395,2,shop,9,10,1
8395,3,work,10,17,7
8395,4,home,17,21,4
8395,5,work,21,22,1
8395,6,home,22,24,2
8395,7,<ENDS>,24,24,0
8396,0,<START>,0,0,0
8396,1,home,0,8,8
8396,2,work,8,14,6
8396,3,shop,14,15,1
8396,4,home,15,21,6
8396,5,work,21,22,1
8396,6,home,22,24,2
8396,7,<ENDS>,24,24,0
8397,0,<START>,0,0,0
8397,1,home,0,8,8
8397,2,work,8,15,7
8397,3,home,15,24,9
8397,4,<ENDS>,24,24,0
8398,0,<START>,0,0,0
8398,1,home,0,6,6
8398,2,work,6,7,1
8398,3,home,7,11,4
8398,4,work,11,13,2
8398,5,home,13,21,8
8398,6,work,21,22,1
8398,7,home,22,24,2
8398,8,<ENDS>,24,24,0
8399,0,<START>,0,0,0
8399,1,home,0,7,7
8399,2,education,7,11,4
8399,3,home,11,14,3
8399,4,education,14,16,2
8399,5,home,16,24,8
8399,6,<ENDS>,24,24,0
8400,0,<START>,0,0,0
8400,1,home,0,7,7
8400,2,work,7,14,7
8400,3,home,14,24,10
8400,4,<ENDS>,24,24,0
8401,0,<START>,0,0,0
8401,1,home,0,6,6
8401,2,work,6,12,6
8401,3,shop,12,13,1
8401,4,work,13,14,1
8401,5,home,14,24,10
8401,6,<ENDS>,24,24,0
8402,0,<START>,0,0,0
8402,1,home,0,6,6
8402,2,work,6,13,7
8402,3,home,13,21,8
8402,4,work,21,22,1
8402,5,home,22,24,2
8402,6,<ENDS>,24,24,0
8403,0,<START>,0,0,0
8403,1,home,0,8,8
8403,2,work,8,15,7
8403,3,shop,15,16,1
8403,4,home,16,24,8
8403,5,<ENDS>,24,24,0
8404,0,<START>,0,0,0
8404,1,home,0,9,9
8404,2,work,9,16,7
8404,3,shop,16,17,1
8404,4,home,17,24,7
8404,5,<ENDS>,24,24,0
8405,0,<START>,0,0,0
8405,1,home,0,6,6
8405,2,work,6,8,2
8405,3,home,8,13,5
8405,4,work,13,15,2
8405,5,home,15,21,6
8405,6,work,21,22,1
8405,7,home,22,24,2
8405,8,<ENDS>,24,24,0
8406,0,<START>,0,0,0
8406,1,home,0,6,6
8406,2,work,6,13,7
8406,3,shop,13,14,1
8406,4,work,14,20,6
8406,5,home,20,24,4
8406,6,<ENDS>,24,24,0
8407,0,<START>,0,0,0
8407,1,home,0,7,7
8407,2,work,7,13,6
8407,3,home,13,18,5
8407,4,shop,18,19,1
8407,5,home,19,24,5
8407,6,<ENDS>,24,24,0
8408,0,<START>,0,0,0
8408,1,home,0,7,7
8408,2,work,7,9,2
8408,3,home,9,13,4
8408,4,work,13,15,2
8408,5,home,15,21,6
8408,6,work,21,22,1
8408,7,home,22,24,2
8408,8,<ENDS>,24,24,0
8409,0,<START>,0,0,0
8409,1,home,0,7,7
8409,2,education,7,11,4
8409,3,home,11,14,3
8409,4,education,14,16,2
8409,5,home,16,24,8
8409,6,<ENDS>,24,24,0
8410,0,<START>,0,0,0
8410,1,home,0,7,7
8410,2,shop,7,8,1
8410,3,home,8,14,6
8410,4,work,14,20,6
8410,5,home,20,24,4
8410,6,<ENDS>,24,24,0
8411,0,<START>,0,0,0
8411,1,home,0,6,6
8411,2,work,6,13,7
8411,3,shop,13,14,1
8411,4,home,14,24,10
8411,5,<ENDS>,24,24,0
8412,0,<START>,0,0,0
8412,1,home,0,8,8
8412,2,work,8,15,7
8412,3,home,15,24,9
8412,4,<ENDS>,24,24,0
8413,0,<START>,0,0,0
8413,1,home,0,7,7
8413,2,work,7,14,7
8413,3,shop,14,15,1
8413,4,home,15,24,9
8413,5,<ENDS>,24,24,0
8414,0,<START>,0,0,0
8414,1,work,0,9,9
8414,2,shop,9,10,1
8414,3,work,10,17,7
8414,4,home,17,24,7
8414,5,<ENDS>,24,24,0
8415,0,<START>,0,0,0
8415,1,home,0,8,8
8415,2,work,8,13,5
8415,3,home,13,18,5
8415,4,shop,18,20,2
8415,5,home,20,24,4
8415,6,<ENDS>,24,24,0
8416,0,<START>,0,0,0
8416,1,home,0,6,6
8416,2,work,6,13,7
8416,3,home,13,21,8
8416,4,shop,21,22,1
8416,5,home,22,24,2
8416,6,<ENDS>,24,24,0
8417,0,<START>,0,0,0
8417,1,home,0,7,7
8417,2,shop,7,9,2
8417,3,education,9,12,3
8417,4,shop,12,14,2
8417,5,education,14,16,2
8417,6,home,16,24,8
8417,7,<ENDS>,24,24,0
8418,0,<START>,0,0,0
8418,1,home,0,7,7
8418,2,education,7,11,4
8418,3,home,11,18,7
8418,4,shop,18,19,1
8418,5,home,19,24,5
8418,6,<ENDS>,24,24,0
8419,0,<START>,0,0,0
8419,1,home,0,7,7
8419,2,work,7,13,6
8419,3,shop,13,14,1
8419,4,work,14,20,6
8419,5,home,20,24,4
8419,6,<ENDS>,24,24,0
8420,0,<START>,0,0,0
8420,1,home,0,6,6
8420,2,shop,6,7,1
8420,3,home,7,10,3
8420,4,education,10,15,5
8420,5,shop,15,17,2
8420,6,home,17,24,7
8420,7,<ENDS>,24,24,0
8421,0,<START>,0,0,0
8421,1,home,0,6,6
8421,2,work,6,13,7
8421,3,home,13,18,5
8421,4,work,18,20,2
8421,5,home,20,24,4
8421,6,<ENDS>,24,24,0
8422,0,<START>,0,0,0
8422,1,home,0,8,8
8422,2,work,8,15,7
8422,3,shop,15,16,1
8422,4,home,16,24,8
8422,5,<ENDS>,24,24,0
8423,0,<START>,0,0,0
8423,1,home,0,7,7
8423,2,work,7,13,6
8423,3,home,13,23,10
8423,4,work,23,24,1
8423,5,<ENDS>,24,24,0
8424,0,<START>,0,0,0
8424,1,home,0,6,6
8424,2,work,6,13,7
8424,3,shop,13,14,1
8424,4,home,14,24,10
8424,5,<ENDS>,24,24,0
8425,0,<START>,0,0,0
8425,1,home,0,8,8
8425,2,work,8,15,7
8425,3,home,15,24,9
8425,4,<ENDS>,24,24,0
8426,0,<START>,0,0,0
8426,1,home,0,7,7
8426,2,work,7,9,2
8426,3,home,9,13,4
8426,4,work,13,15,2
8426,5,home,15,22,7
8426,6,work,22,23,1
8426,7,home,23,24,1
8426,8,<ENDS>,24,24,0
8427,0,<START>,0,0,0
8427,1,home,0,6,6
8427,2,shop,6,7,1
8427,3,home,7,13,6
8427,4,education,13,16,3
8427,5,home,16,24,8
8427,6,<ENDS>,24,24,0
8428,0,<START>,0,0,0
8428,1,home,0,8,8
8428,2,work,8,15,7
8428,3,home,15,24,9
8428,4,<ENDS>,24,24,0
8429,0,<START>,0,0,0
8429,1,home,0,7,7
8429,2,education,7,12,5
8429,3,shop,12,14,2
8429,4,home,14,24,10
8429,5,<ENDS>,24,24,0
8430,0,<START>,0,0,0
8430,1,home,0,7,7
8430,2,work,7,14,7
8430,3,home,14,24,10
8430,4,<ENDS>,24,24,0
8431,0,<START>,0,0,0
8431,1,home,0,6,6
8431,2,shop,6,7,1
8431,3,home,7,13,6
8431,4,education,13,16,3
8431,5,home,16,24,8
8431,6,<ENDS>,24,24,0
8432,0,<START>,0,0,0
8432,1,home,0,6,6
8432,2,shop,6,7,1
8432,3,home,7,9,2
8432,4,education,9,14,5
8432,5,shop,14,15,1
8432,6,home,15,24,9
8432,7,<ENDS>,24,24,0
8433,0,<START>,0,0,0
8433,1,home,0,8,8
8433,2,work,8,14,6
8433,3,shop,14,15,1
8433,4,home,15,18,3
8433,5,work,18,20,2
8433,6,home,20,24,4
8433,7,<ENDS>,24,24,0
8434,0,<START>,0,0,0
8434,1,home,0,7,7
8434,2,work,7,14,7
8434,3,shop,14,15,1
8434,4,home,15,24,9
8434,5,<ENDS>,24,24,0
8435,0,<START>,0,0,0
8435,1,home,0,7,7
8435,2,shop,7,8,1
8435,3,work,8,16,8
8435,4,home,16,24,8
8435,5,<ENDS>,24,24,0
8436,0,<START>,0,0,0
8436,1,home,0,7,7
8436,2,work,7,14,7
8436,3,home,14,18,4
8436,4,work,18,20,2
8436,5,home,20,24,4
8436,6,<ENDS>,24,24,0
8437,0,<START>,0,0,0
8437,1,home,0,7,7
8437,2,education,7,11,4
8437,3,home,11,17,6
8437,4,shop,17,18,1
8437,5,home,18,24,6
8437,6,<ENDS>,24,24,0
8438,0,<START>,0,0,0
8438,1,home,0,6,6
8438,2,work,6,8,2
8438,3,home,8,13,5
8438,4,work,13,15,2
8438,5,home,15,21,6
8438,6,work,21,22,1
8438,7,home,22,24,2
8438,8,<ENDS>,24,24,0
8439,0,<START>,0,0,0
8439,1,home,0,7,7
8439,2,work,7,14,7
8439,3,home,14,24,10
8439,4,<ENDS>,24,24,0
8440,0,<START>,0,0,0
8440,1,home,0,8,8
8440,2,work,8,14,6
8440,3,home,14,20,6
8440,4,shop,20,21,1
8440,5,home,21,24,3
8440,6,<ENDS>,24,24,0
8441,0,<START>,0,0,0
8441,1,home,0,6,6
8441,2,work,6,13,7
8441,3,home,13,24,11
8441,4,<ENDS>,24,24,0
8442,0,<START>,0,0,0
8442,1,home,0,7,7
8442,2,shop,7,8,1
8442,3,work,8,14,6
8442,4,home,14,21,7
8442,5,work,21,22,1
8442,6,home,22,24,2
8442,7,<ENDS>,24,24,0
8443,0,<START>,0,0,0
8443,1,home,0,7,7
8443,2,work,7,9,2
8443,3,home,9,13,4
8443,4,work,13,17,4
8443,5,home,17,24,7
8443,6,<ENDS>,24,24,0
8444,0,<START>,0,0,0
8444,1,home,0,6,6
8444,2,work,6,13,7
8444,3,shop,13,14,1
8444,4,work,14,19,5
8444,5,home,19,24,5
8444,6,<ENDS>,24,24,0
8445,0,<START>,0,0,0
8445,1,home,0,8,8
8445,2,work,8,14,6
8445,3,shop,14,15,1
8445,4,work,15,20,5
8445,5,home,20,24,4
8445,6,<ENDS>,24,24,0
8446,0,<START>,0,0,0
8446,1,home,0,7,7
8446,2,work,7,14,7
8446,3,shop,14,15,1
8446,4,work,15,19,4
8446,5,home,19,24,5
8446,6,<ENDS>,24,24,0
8447,0,<START>,0,0,0
8447,1,home,0,8,8
8447,2,work,8,15,7
8447,3,home,15,24,9
8447,4,<ENDS>,24,24,0
8448,0,<START>,0,0,0
8448,1,home,0,6,6
8448,2,work,6,13,7
8448,3,shop,13,14,1
8448,4,work,14,19,5
8448,5,home,19,24,5
8448,6,<ENDS>,24,24,0
8449,0,<START>,0,0,0
8449,1,home,0,7,7
8449,2,shop,7,8,1
8449,3,home,8,9,1
8449,4,work,9,17,8
8449,5,home,17,24,7
8449,6,<ENDS>,24,24,0
8450,0,<START>,0,0,0
8450,1,home,0,7,7
8450,2,work,7,13,6
8450,3,home,13,24,11
8450,4,<ENDS>,24,24,0
8451,0,<START>,0,0,0
8451,1,home,0,7,7
8451,2,work,7,14,7
8451,3,shop,14,15,1
8451,4,home,15,21,6
8451,5,shop,21,22,1
8451,6,home,22,24,2
8451,7,<ENDS>,24,24,0
8452,0,<START>,0,0,0
8452,1,home,0,9,9
8452,2,work,9,16,7
8452,3,home,16,22,6
8452,4,work,22,23,1
8452,5,home,23,24,1
8452,6,<ENDS>,24,24,0
8453,0,<START>,0,0,0
8453,1,home,0,8,8
8453,2,work,8,15,7
8453,3,home,15,24,9
8453,4,<ENDS>,24,24,0
8454,0,<START>,0,0,0
8454,1,home,0,7,7
8454,2,work,7,14,7
8454,3,home,14,24,10
8454,4,<ENDS>,24,24,0
8455,0,<START>,0,0,0
8455,1,home,0,7,7
8455,2,work,7,14,7
8455,3,shop,14,15,1
8455,4,work,15,20,5
8455,5,home,20,24,4
8455,6,<ENDS>,24,24,0
8456,0,<START>,0,0,0
8456,1,home,0,6,6
8456,2,shop,6,7,1
8456,3,work,7,14,7
8456,4,home,14,18,4
8456,5,work,18,20,2
8456,6,home,20,24,4
8456,7,<ENDS>,24,24,0
8457,0,<START>,0,0,0
8457,1,home,0,7,7
8457,2,shop,7,8,1
8457,3,education,8,11,3
8457,4,home,11,19,8
8457,5,shop,19,20,1
8457,6,home,20,24,4
8457,7,<ENDS>,24,24,0
8458,0,<START>,0,0,0
8458,1,home,0,7,7
8458,2,work,7,9,2
8458,3,home,9,15,6
8458,4,work,15,17,2
8458,5,home,17,23,6
8458,6,work,23,24,1
8458,7,<ENDS>,24,24,0
8459,0,<START>,0,0,0
8459,1,home,0,7,7
8459,2,work,7,13,6
8459,3,shop,13,14,1
8459,4,work,14,20,6
8459,5,home,20,24,4
8459,6,<ENDS>,24,24,0
8460,0,<START>,0,0,0
8460,1,home,0,6,6
8460,2,work,6,8,2
8460,3,home,8,9,1
8460,4,work,9,10,1
8460,5,shop,10,11,1
8460,6,work,11,12,1
8460,7,home,12,17,5
8460,8,work,17,19,2
8460,9,home,19,24,5
8460,10,<ENDS>,24,24,0
8461,0,<START>,0,0,0
8461,1,home,0,6,6
8461,2,work,6,13,7
8461,3,shop,13,14,1
8461,4,home,14,24,10
8461,5,<ENDS>,24,24,0
8462,0,<START>,0,0,0
8462,1,home,0,6,6
8462,2,work,6,8,2
8462,3,home,8,12,4
8462,4,work,12,14,2
8462,5,home,14,17,3
8462,6,work,17,19,2
8462,7,home,19,24,5
8462,8,<ENDS>,24,24,0
8463,0,<START>,0,0,0
8463,1,home,0,6,6
8463,2,work,6,13,7
8463,3,shop,13,14,1
8463,4,work,14,19,5
8463,5,home,19,24,5
8463,6,<ENDS>,24,24,0
8464,0,<START>,0,0,0
8464,1,home,0,8,8
8464,2,work,8,14,6
8464,3,home,14,24,10
8464,4,<ENDS>,24,24,0
8465,0,<START>,0,0,0
8465,1,home,0,7,7
8465,2,work,7,13,6
8465,3,shop,13,14,1
8465,4,work,14,20,6
8465,5,home,20,24,4
8465,6,<ENDS>,24,24,0
8466,0,<START>,0,0,0
8466,1,home,0,7,7
8466,2,work,7,14,7
8466,3,home,14,24,10
8466,4,<ENDS>,24,24,0
8467,0,<START>,0,0,0
8467,1,home,0,8,8
8467,2,work,8,16,8
8467,3,home,16,24,8
8467,4,<ENDS>,24,24,0
8468,0,<START>,0,0,0
8468,1,home,0,6,6
8468,2,work,6,9,3
8468,3,home,9,14,5
8468,4,work,14,16,2
8468,5,home,16,22,6
8468,6,work,22,23,1
8468,7,home,23,24,1
8468,8,<ENDS>,24,24,0
8469,0,<START>,0,0,0
8469,1,home,0,7,7
8469,2,shop,7,9,2
8469,3,education,9,12,3
8469,4,home,12,18,6
8469,5,shop,18,19,1
8469,6,home,19,24,5
8469,7,<ENDS>,24,24,0
8470,0,<START>,0,0,0
8470,1,home,0,8,8
8470,2,work,8,15,7
8470,3,shop,15,16,1
8470,4,work,16,20,4
8470,5,home,20,24,4
8470,6,<ENDS>,24,24,0
8471,0,<START>,0,0,0
8471,1,home,0,8,8
8471,2,work,8,15,7
8471,3,home,15,23,8
8471,4,work,23,24,1
8471,5,<ENDS>,24,24,0
8472,0,<START>,0,0,0
8472,1,home,0,7,7
8472,2,work,7,13,6
8472,3,home,13,17,4
8472,4,work,17,20,3
8472,5,home,20,24,4
8472,6,<ENDS>,24,24,0
8473,0,<START>,0,0,0
8473,1,home,0,7,7
8473,2,work,7,14,7
8473,3,shop,14,15,1
8473,4,home,15,24,9
8473,5,<ENDS>,24,24,0
8474,0,<START>,0,0,0
8474,1,home,0,7,7
8474,2,work,7,14,7
8474,3,home,14,22,8
8474,4,work,22,23,1
8474,5,home,23,24,1
8474,6,<ENDS>,24,24,0
8475,0,<START>,0,0,0
8475,1,home,0,7,7
8475,2,work,7,14,7
8475,3,shop,14,15,1
8475,4,work,15,20,5
8475,5,home,20,24,4
8475,6,<ENDS>,24,24,0
8476,0,<START>,0,0,0
8476,1,home,0,7,7
8476,2,work,7,13,6
8476,3,shop,13,14,1
8476,4,work,14,20,6
8476,5,home,20,24,4
8476,6,<ENDS>,24,24,0
8477,0,<START>,0,0,0
8477,1,home,0,7,7
8477,2,work,7,13,6
8477,3,home,13,16,3
8477,4,work,16,20,4
8477,5,home,20,24,4
8477,6,<ENDS>,24,24,0
8478,0,<START>,0,0,0
8478,1,home,0,6,6
8478,2,work,6,12,6
8478,3,shop,12,13,1
8478,4,work,13,19,6
8478,5,home,19,24,5
8478,6,<ENDS>,24,24,0
8479,0,<START>,0,0,0
8479,1,home,0,8,8
8479,2,work,8,13,5
8479,3,home,13,24,11
8479,4,<ENDS>,24,24,0
8480,0,<START>,0,0,0
8480,1,home,0,7,7
8480,2,shop,7,8,1
8480,3,work,8,15,7
8480,4,home,15,24,9
8480,5,<ENDS>,24,24,0
8481,0,<START>,0,0,0
8481,1,home,0,7,7
8481,2,work,7,13,6
8481,3,shop,13,14,1
8481,4,work,14,19,5
8481,5,home,19,24,5
8481,6,<ENDS>,24,24,0
8482,0,<START>,0,0,0
8482,1,home,0,8,8
8482,2,work,8,14,6
8482,3,shop,14,15,1
8482,4,home,15,23,8
8482,5,work,23,24,1
8482,6,<ENDS>,24,24,0
8483,0,<START>,0,0,0
8483,1,home,0,7,7
8483,2,work,7,13,6
8483,3,shop,13,14,1
8483,4,work,14,20,6
8483,5,home,20,24,4
8483,6,<ENDS>,24,24,0
8484,0,<START>,0,0,0
8484,1,home,0,6,6
8484,2,work,6,8,2
8484,3,home,8,12,4
8484,4,work,12,14,2
8484,5,home,14,21,7
8484,6,work,21,22,1
8484,7,home,22,24,2
8484,8,<ENDS>,24,24,0
8485,0,<START>,0,0,0
8485,1,home,0,6,6
8485,2,work,6,13,7
8485,3,home,13,20,7
8485,4,shop,20,21,1
8485,5,home,21,24,3
8485,6,<ENDS>,24,24,0
8486,0,<START>,0,0,0
8486,1,home,0,7,7
8486,2,work,7,14,7
8486,3,shop,14,15,1
8486,4,home,15,24,9
8486,5,<ENDS>,24,24,0
8487,0,<START>,0,0,0
8487,1,home,0,6,6
8487,2,shop,6,7,1
8487,3,home,7,13,6
8487,4,education,13,16,3
8487,5,home,16,24,8
8487,6,<ENDS>,24,24,0
8488,0,<START>,0,0,0
8488,1,home,0,6,6
8488,2,shop,6,7,1
8488,3,home,7,13,6
8488,4,education,13,16,3
8488,5,home,16,24,8
8488,6,<ENDS>,24,24,0
8489,0,<START>,0,0,0
8489,1,home,0,7,7
8489,2,education,7,12,5
8489,3,shop,12,13,1
8489,4,education,13,16,3
8489,5,home,16,24,8
8489,6,<ENDS>,24,24,0
8490,0,<START>,0,0,0
8490,1,home,0,7,7
8490,2,education,7,11,4
8490,3,home,11,18,7
8490,4,shop,18,19,1
8490,5,home,19,24,5
8490,6,<ENDS>,24,24,0
8491,0,<START>,0,0,0
8491,1,home,0,8,8
8491,2,work,8,14,6
8491,3,home,14,18,4
8491,4,work,18,20,2
8491,5,home,20,24,4
8491,6,<ENDS>,24,24,0
8492,0,<START>,0,0,0
8492,1,home,0,7,7
8492,2,work,7,13,6
8492,3,home,13,21,8
8492,4,work,21,22,1
8492,5,home,22,24,2
8492,6,<ENDS>,24,24,0
8493,0,<START>,0,0,0
8493,1,home,0,7,7
8493,2,shop,7,8,1
8493,3,education,8,11,3
8493,4,home,11,18,7
8493,5,shop,18,20,2
8493,6,home,20,24,4
8493,7,<ENDS>,24,24,0
8494,0,<START>,0,0,0
8494,1,home,0,6,6
8494,2,work,6,13,7
8494,3,home,13,24,11
8494,4,<ENDS>,24,24,0
8495,0,<START>,0,0,0
8495,1,home,0,6,6
8495,2,work,6,8,2
8495,3,home,8,13,5
8495,4,work,13,15,2
8495,5,home,15,22,7
8495,6,work,22,23,1
8495,7,home,23,24,1
8495,8,<ENDS>,24,24,0
8496,0,<START>,0,0,0
8496,1,home,0,7,7
8496,2,work,7,13,6
8496,3,shop,13,14,1
8496,4,home,14,22,8
8496,5,work,22,23,1
8496,6,home,23,24,1
8496,7,<ENDS>,24,24,0
8497,0,<START>,0,0,0
8497,1,home,0,7,7
8497,2,education,7,11,4
8497,3,home,11,20,9
8497,4,shop,20,21,1
8497,5,home,21,24,3
8497,6,<ENDS>,24,24,0
8498,0,<START>,0,0,0
8498,1,home,0,6,6
8498,2,shop,6,7,1
8498,3,home,7,8,1
8498,4,work,8,15,7
8498,5,shop,15,16,1
8498,6,work,16,20,4
8498,7,home,20,24,4
8498,8,<ENDS>,24,24,0
8499,0,<START>,0,0,0
8499,1,home,0,7,7
8499,2,work,7,14,7
8499,3,home,14,18,4
8499,4,work,18,20,2
8499,5,home,20,24,4
8499,6,<ENDS>,24,24,0
8500,0,<START>,0,0,0
8500,1,home,0,7,7
8500,2,shop,7,8,1
8500,3,education,8,11,3
8500,4,home,11,18,7
8500,5,shop,18,19,1
8500,6,home,19,24,5
8500,7,<ENDS>,24,24,0
8501,0,<START>,0,0,0
8501,1,home,0,8,8
8501,2,work,8,15,7
8501,3,home,15,24,9
8501,4,<ENDS>,24,24,0
8502,0,<START>,0,0,0
8502,1,home,0,8,8
8502,2,work,8,14,6
8502,3,home,14,20,6
8502,4,shop,20,21,1
8502,5,home,21,24,3
8502,6,<ENDS>,24,24,0
8503,0,<START>,0,0,0
8503,1,home,0,7,7
8503,2,work,7,13,6
8503,3,home,13,17,4
8503,4,work,17,20,3
8503,5,home,20,24,4
8503,6,<ENDS>,24,24,0
8504,0,<START>,0,0,0
8504,1,home,0,8,8
8504,2,education,8,11,3
8504,3,home,11,16,5
8504,4,work,16,20,4
8504,5,home,20,24,4
8504,6,<ENDS>,24,24,0
8505,0,<START>,0,0,0
8505,1,home,0,8,8
8505,2,education,8,12,4
8505,3,home,12,20,8
8505,4,shop,20,21,1
8505,5,home,21,24,3
8505,6,<ENDS>,24,24,0
8506,0,<START>,0,0,0
8506,1,home,0,6,6
8506,2,shop,6,7,1
8506,3,work,7,14,7
8506,4,home,14,17,3
8506,5,work,17,18,1
8506,6,home,18,24,6
8506,7,<ENDS>,24,24,0
8507,0,<START>,0,0,0
8507,1,home,0,6,6
8507,2,shop,6,7,1
8507,3,work,7,13,6
8507,4,home,13,24,11
8507,5,<ENDS>,24,24,0
8508,0,<START>,0,0,0
8508,1,home,0,7,7
8508,2,work,7,13,6
8508,3,home,13,24,11
8508,4,<ENDS>,24,24,0
8509,0,<START>,0,0,0
8509,1,home,0,6,6
8509,2,work,6,13,7
8509,3,shop,13,14,1
8509,4,work,14,19,5
8509,5,home,19,24,5
8509,6,<ENDS>,24,24,0
8510,0,<START>,0,0,0
8510,1,home,0,7,7
8510,2,shop,7,9,2
8510,3,education,9,12,3
8510,4,shop,12,13,1
8510,5,education,13,15,2
8510,6,shop,15,16,1
8510,7,home,16,24,8
8510,8,<ENDS>,24,24,0
8511,0,<START>,0,0,0
8511,1,home,0,7,7
8511,2,shop,7,9,2
8511,3,education,9,12,3
8511,4,shop,12,13,1
8511,5,education,13,16,3
8511,6,shop,16,17,1
8511,7,home,17,24,7
8511,8,<ENDS>,24,24,0
8512,0,<START>,0,0,0
8512,1,home,0,7,7
8512,2,work,7,13,6
8512,3,home,13,24,11
8512,4,<ENDS>,24,24,0
8513,0,<START>,0,0,0
8513,1,home,0,8,8
8513,2,education,8,12,4
8513,3,work,12,19,7
8513,4,home,19,24,5
8513,5,<ENDS>,24,24,0
8514,0,<START>,0,0,0
8514,1,home,0,6,6
8514,2,work,6,13,7
8514,3,home,13,24,11
8514,4,<ENDS>,24,24,0
8515,0,<START>,0,0,0
8515,1,home,0,6,6
8515,2,shop,6,7,1
8515,3,work,7,14,7
8515,4,home,14,24,10
8515,5,<ENDS>,24,24,0
8516,0,<START>,0,0,0
8516,1,home,0,6,6
8516,2,shop,6,7,1
8516,3,work,7,14,7
8516,4,home,14,24,10
8516,5,<ENDS>,24,24,0
8517,0,<START>,0,0,0
8517,1,home,0,7,7
8517,2,shop,7,8,1
8517,3,education,8,11,3
8517,4,home,11,18,7
8517,5,shop,18,20,2
8517,6,home,20,24,4
8517,7,<ENDS>,24,24,0
8518,0,<START>,0,0,0
8518,1,home,0,8,8
8518,2,work,8,15,7
8518,3,home,15,24,9
8518,4,<ENDS>,24,24,0
8519,0,<START>,0,0,0
8519,1,home,0,8,8
8519,2,work,8,15,7
8519,3,home,15,24,9
8519,4,<ENDS>,24,24,0
8520,0,<START>,0,0,0
8520,1,home,0,8,8
8520,2,education,8,12,4
8520,3,home,12,20,8
8520,4,shop,20,21,1
8520,5,home,21,24,3
8520,6,<ENDS>,24,24,0
8521,0,<START>,0,0,0
8521,1,home,0,7,7
8521,2,education,7,11,4
8521,3,home,11,17,6
8521,4,shop,17,18,1
8521,5,home,18,24,6
8521,6,<ENDS>,24,24,0
8522,0,<START>,0,0,0
8522,1,home,0,6,6
8522,2,shop,6,7,1
8522,3,home,7,10,3
8522,4,education,10,15,5
8522,5,shop,15,16,1
8522,6,home,16,24,8
8522,7,<ENDS>,24,24,0
8523,0,<START>,0,0,0
8523,1,home,0,7,7
8523,2,work,7,14,7
8523,3,home,14,24,10
8523,4,<ENDS>,24,24,0
8524,0,<START>,0,0,0
8524,1,home,0,7,7
8524,2,education,7,11,4
8524,3,home,11,16,5
8524,4,shop,16,17,1
8524,5,home,17,24,7
8524,6,<ENDS>,24,24,0
8525,0,<START>,0,0,0
8525,1,home,0,8,8
8525,2,work,8,15,7
8525,3,home,15,24,9
8525,4,<ENDS>,24,24,0
8526,0,<START>,0,0,0
8526,1,home,0,8,8
8526,2,work,8,13,5
8526,3,shop,13,14,1
8526,4,home,14,24,10
8526,5,<ENDS>,24,24,0
8527,0,<START>,0,0,0
8527,1,home,0,6,6
8527,2,work,6,8,2
8527,3,home,8,12,4
8527,4,work,12,14,2
8527,5,home,14,17,3
8527,6,work,17,19,2
8527,7,home,19,24,5
8527,8,<ENDS>,24,24,0
8528,0,<START>,0,0,0
8528,1,home,0,7,7
8528,2,work,7,13,6
8528,3,home,13,16,3
8528,4,work,16,20,4
8528,5,home,20,24,4
8528,6,<ENDS>,24,24,0
8529,0,<START>,0,0,0
8529,1,home,0,8,8
8529,2,education,8,11,3
8529,3,home,11,23,12
8529,4,work,23,24,1
8529,5,<ENDS>,24,24,0
8530,0,<START>,0,0,0
8530,1,home,0,8,8
8530,2,work,8,15,7
8530,3,home,15,24,9
8530,4,<ENDS>,24,24,0
8531,0,<START>,0,0,0
8531,1,home,0,6,6
8531,2,shop,6,7,1
8531,3,work,7,14,7
8531,4,shop,14,15,1
8531,5,work,15,19,4
8531,6,home,19,24,5
8531,7,<ENDS>,24,24,0
8532,0,<START>,0,0,0
8532,1,home,0,7,7
8532,2,education,7,12,5
8532,3,home,12,19,7
8532,4,shop,19,20,1
8532,5,home,20,24,4
8532,6,<ENDS>,24,24,0
8533,0,<START>,0,0,0
8533,1,home,0,8,8
8533,2,work,8,14,6
8533,3,shop,14,15,1
8533,4,work,15,20,5
8533,5,home,20,24,4
8533,6,<ENDS>,24,24,0
8534,0,<START>,0,0,0
8534,1,home,0,6,6
8534,2,work,6,12,6
8534,3,shop,12,13,1
8534,4,work,13,19,6
8534,5,home,19,24,5
8534,6,<ENDS>,24,24,0
8535,0,<START>,0,0,0
8535,1,home,0,6,6
8535,2,work,6,13,7
8535,3,home,13,17,4
8535,4,work,17,20,3
8535,5,home,20,24,4
8535,6,<ENDS>,24,24,0
8536,0,<START>,0,0,0
8536,1,home,0,7,7
8536,2,work,7,14,7
8536,3,home,14,18,4
8536,4,shop,18,19,1
8536,5,home,19,24,5
8536,6,<ENDS>,24,24,0
8537,0,<START>,0,0,0
8537,1,home,0,6,6
8537,2,shop,6,7,1
8537,3,home,7,9,2
8537,4,education,9,12,3
8537,5,shop,12,13,1
8537,6,home,13,19,6
8537,7,shop,19,20,1
8537,8,home,20,24,4
8537,9,<ENDS>,24,24,0
8538,0,<START>,0,0,0
8538,1,home,0,6,6
8538,2,work,6,8,2
8538,3,home,8,12,4
8538,4,work,12,15,3
8538,5,home,15,21,6
8538,6,work,21,22,1
8538,7,home,22,24,2
8538,8,<ENDS>,24,24,0
8539,0,<START>,0,0,0
8539,1,home,0,6,6
8539,2,shop,6,7,1
8539,3,home,7,10,3
8539,4,education,10,13,3
8539,5,shop,13,15,2
8539,6,home,15,21,6
8539,7,shop,21,22,1
8539,8,home,22,24,2
8539,9,<ENDS>,24,24,0
8540,0,<START>,0,0,0
8540,1,home,0,6,6
8540,2,shop,6,7,1
8540,3,home,7,13,6
8540,4,education,13,16,3
8540,5,home,16,24,8
8540,6,<ENDS>,24,24,0
8541,0,<START>,0,0,0
8541,1,home,0,6,6
8541,2,work,6,13,7
8541,3,shop,13,14,1
8541,4,home,14,21,7
8541,5,work,21,22,1
8541,6,home,22,24,2
8541,7,<ENDS>,24,24,0
8542,0,<START>,0,0,0
8542,1,home,0,7,7
8542,2,work,7,8,1
8542,3,home,8,12,4
8542,4,work,12,14,2
8542,5,home,14,18,4
8542,6,work,18,19,1
8542,7,home,19,24,5
8542,8,<ENDS>,24,24,0
8543,0,<START>,0,0,0
8543,1,home,0,8,8
8543,2,education,8,15,7
8543,3,home,15,24,9
8543,4,<ENDS>,24,24,0
8544,0,<START>,0,0,0
8544,1,home,0,8,8
8544,2,education,8,12,4
8544,3,home,12,16,4
8544,4,work,16,20,4
8544,5,home,20,24,4
8544,6,<ENDS>,24,24,0
8545,0,<START>,0,0,0
8545,1,home,0,8,8
8545,2,work,8,15,7
8545,3,home,15,24,9
8545,4,<ENDS>,24,24,0
8546,0,<START>,0,0,0
8546,1,home,0,7,7
8546,2,work,7,13,6
8546,3,home,13,22,9
8546,4,work,22,23,1
8546,5,home,23,24,1
8546,6,<ENDS>,24,24,0
8547,0,<START>,0,0,0
8547,1,home,0,7,7
8547,2,work,7,13,6
8547,3,home,13,17,4
8547,4,work,17,20,3
8547,5,home,20,24,4
8547,6,<ENDS>,24,24,0
8548,0,<START>,0,0,0
8548,1,home,0,7,7
8548,2,work,7,13,6
8548,3,home,13,24,11
8548,4,<ENDS>,24,24,0
8549,0,<START>,0,0,0
8549,1,home,0,6,6
8549,2,work,6,13,7
8549,3,home,13,17,4
8549,4,shop,17,18,1
8549,5,home,18,24,6
8549,6,<ENDS>,24,24,0
8550,0,<START>,0,0,0
8550,1,home,0,6,6
8550,2,work,6,8,2
8550,3,home,8,14,6
8550,4,work,14,16,2
8550,5,home,16,21,5
8550,6,work,21,22,1
8550,7,home,22,24,2
8550,8,<ENDS>,24,24,0
8551,0,<START>,0,0,0
8551,1,home,0,8,8
8551,2,work,8,14,6
8551,3,shop,14,15,1
8551,4,work,15,19,4
8551,5,home,19,24,5
8551,6,<ENDS>,24,24,0
8552,0,<START>,0,0,0
8552,1,home,0,8,8
8552,2,shop,8,9,1
8552,3,work,9,17,8
8552,4,home,17,24,7
8552,5,<ENDS>,24,24,0
8553,0,<START>,0,0,0
8553,1,home,0,8,8
8553,2,work,8,15,7
8553,3,home,15,22,7
8553,4,work,22,23,1
8553,5,home,23,24,1
8553,6,<ENDS>,24,24,0
8554,0,<START>,0,0,0
8554,1,home,0,7,7
8554,2,education,7,13,6
8554,3,home,13,19,6
8554,4,shop,19,20,1
8554,5,home,20,24,4
8554,6,<ENDS>,24,24,0
8555,0,<START>,0,0,0
8555,1,home,0,8,8
8555,2,work,8,14,6
8555,3,home,14,21,7
8555,4,shop,21,22,1
8555,5,home,22,24,2
8555,6,<ENDS>,24,24,0
8556,0,<START>,0,0,0
8556,1,home,0,7,7
8556,2,education,7,11,4
8556,3,home,11,14,3
8556,4,education,14,15,1
8556,5,shop,15,16,1
8556,6,home,16,24,8
8556,7,<ENDS>,24,24,0
8557,0,<START>,0,0,0
8557,1,home,0,7,7
8557,2,work,7,15,8
8557,3,home,15,24,9
8557,4,<ENDS>,24,24,0
8558,0,<START>,0,0,0
8558,1,home,0,7,7
8558,2,work,7,13,6
8558,3,home,13,17,4
8558,4,shop,17,18,1
8558,5,home,18,24,6
8558,6,<ENDS>,24,24,0
8559,0,<START>,0,0,0
8559,1,home,0,8,8
8559,2,work,8,15,7
8559,3,home,15,24,9
8559,4,<ENDS>,24,24,0
8560,0,<START>,0,0,0
8560,1,home,0,7,7
8560,2,work,7,13,6
8560,3,shop,13,14,1
8560,4,home,14,24,10
8560,5,<ENDS>,24,24,0
8561,0,<START>,0,0,0
8561,1,home,0,6,6
8561,2,work,6,13,7
8561,3,home,13,17,4
8561,4,shop,17,18,1
8561,5,home,18,24,6
8561,6,<ENDS>,24,24,0
8562,0,<START>,0,0,0
8562,1,home,0,8,8
8562,2,work,8,15,7
8562,3,home,15,24,9
8562,4,<ENDS>,24,24,0
8563,0,<START>,0,0,0
8563,1,home,0,8,8
8563,2,work,8,14,6
8563,3,home,14,24,10
8563,4,<ENDS>,24,24,0
8564,0,<START>,0,0,0
8564,1,home,0,7,7
8564,2,work,7,13,6
8564,3,home,13,23,10
8564,4,work,23,24,1
8564,5,<ENDS>,24,24,0
8565,0,<START>,0,0,0
8565,1,home,0,6,6
8565,2,work,6,13,7
8565,3,home,13,17,4
8565,4,work,17,20,3
8565,5,home,20,24,4
8565,6,<ENDS>,24,24,0
8566,0,<START>,0,0,0
8566,1,home,0,7,7
8566,2,shop,7,8,1
8566,3,home,8,9,1
8566,4,education,9,14,5
8566,5,shop,14,15,1
8566,6,home,15,24,9
8566,7,<ENDS>,24,24,0
8567,0,<START>,0,0,0
8567,1,home,0,6,6
8567,2,work,6,13,7
8567,3,home,13,24,11
8567,4,<ENDS>,24,24,0
8568,0,<START>,0,0,0
8568,1,home,0,8,8
8568,2,work,8,14,6
8568,3,home,14,22,8
8568,4,work,22,23,1
8568,5,home,23,24,1
8568,6,<ENDS>,24,24,0
8569,0,<START>,0,0,0
8569,1,home,0,8,8
8569,2,work,8,15,7
8569,3,home,15,21,6
8569,4,shop,21,22,1
8569,5,home,22,24,2
8569,6,<ENDS>,24,24,0
8570,0,<START>,0,0,0
8570,1,home,0,6,6
8570,2,work,6,12,6
8570,3,shop,12,13,1
8570,4,work,13,17,4
8570,5,home,17,24,7
8570,6,<ENDS>,24,24,0
8571,0,<START>,0,0,0
8571,1,home,0,6,6
8571,2,work,6,8,2
8571,3,home,8,9,1
8571,4,work,9,11,2
8571,5,home,11,16,5
8571,6,work,16,18,2
8571,7,home,18,22,4
8571,8,work,22,23,1
8571,9,home,23,24,1
8571,10,<ENDS>,24,24,0
8572,0,<START>,0,0,0
8572,1,home,0,8,8
8572,2,work,8,15,7
8572,3,home,15,23,8
8572,4,work,23,24,1
8572,5,<ENDS>,24,24,0
8573,0,<START>,0,0,0
8573,1,home,0,8,8
8573,2,work,8,13,5
8573,3,home,13,24,11
8573,4,<ENDS>,24,24,0
8574,0,<START>,0,0,0
8574,1,home,0,7,7
8574,2,work,7,14,7
8574,3,shop,14,15,1
8574,4,home,15,24,9
8574,5,<ENDS>,24,24,0
8575,0,<START>,0,0,0
8575,1,home,0,7,7
8575,2,shop,7,8,1
8575,3,home,8,12,4
8575,4,work,12,14,2
8575,5,home,14,21,7
8575,6,work,21,22,1
8575,7,home,22,24,2
8575,8,<ENDS>,24,24,0
8576,0,<START>,0,0,0
8576,1,home,0,6,6
8576,2,work,6,7,1
8576,3,home,7,9,2
8576,4,work,9,11,2
8576,5,home,11,18,7
8576,6,work,18,19,1
8576,7,home,19,24,5
8576,8,<ENDS>,24,24,0
8577,0,<START>,0,0,0
8577,1,home,0,6,6
8577,2,work,6,8,2
8577,3,home,8,12,4
8577,4,work,12,14,2
8577,5,shop,14,15,1
8577,6,work,15,18,3
8577,7,home,18,24,6
8577,8,<ENDS>,24,24,0
8578,0,<START>,0,0,0
8578,1,home,0,9,9
8578,2,work,9,16,7
8578,3,shop,16,17,1
8578,4,home,17,24,7
8578,5,<ENDS>,24,24,0
8579,0,<START>,0,0,0
8579,1,home,0,9,9
8579,2,work,9,16,7
8579,3,shop,16,17,1
8579,4,home,17,21,4
8579,5,work,21,22,1
8579,6,home,22,24,2
8579,7,<ENDS>,24,24,0
8580,0,<START>,0,0,0
8580,1,home,0,6,6
8580,2,work,6,13,7
8580,3,home,13,17,4
8580,4,shop,17,18,1
8580,5,home,18,24,6
8580,6,<ENDS>,24,24,0
8581,0,<START>,0,0,0
8581,1,home,0,7,7
8581,2,work,7,9,2
8581,3,home,9,16,7
8581,4,work,16,18,2
8581,5,home,18,24,6
8581,6,<ENDS>,24,24,0
8582,0,<START>,0,0,0
8582,1,home,0,7,7
8582,2,shop,7,9,2
8582,3,education,9,12,3
8582,4,shop,12,14,2
8582,5,home,14,21,7
8582,6,shop,21,22,1
8582,7,home,22,24,2
8582,8,<ENDS>,24,24,0
8583,0,<START>,0,0,0
8583,1,home,0,7,7
8583,2,shop,7,8,1
8583,3,education,8,11,3
8583,4,home,11,18,7
8583,5,shop,18,19,1
8583,6,home,19,24,5
8583,7,<ENDS>,24,24,0
8584,0,<START>,0,0,0
8584,1,home,0,8,8
8584,2,education,8,12,4
8584,3,shop,12,14,2
8584,4,home,14,20,6
8584,5,shop,20,21,1
8584,6,home,21,24,3
8584,7,<ENDS>,24,24,0
8585,0,<START>,0,0,0
8585,1,home,0,8,8
8585,2,work,8,15,7
8585,3,home,15,20,5
8585,4,shop,20,21,1
8585,5,home,21,24,3
8585,6,<ENDS>,24,24,0
8586,0,<START>,0,0,0
8586,1,home,0,6,6
8586,2,work,6,13,7
8586,3,home,13,17,4
8586,4,work,17,20,3
8586,5,home,20,24,4
8586,6,<ENDS>,24,24,0
8587,0,<START>,0,0,0
8587,1,home,0,8,8
8587,2,education,8,13,5
8587,3,shop,13,14,1
8587,4,work,14,20,6
8587,5,home,20,24,4
8587,6,<ENDS>,24,24,0
8588,0,<START>,0,0,0
8588,1,home,0,7,7
8588,2,shop,7,8,1
8588,3,education,8,12,4
8588,4,shop,12,14,2
8588,5,education,14,16,2
8588,6,shop,16,17,1
8588,7,home,17,24,7
8588,8,<ENDS>,24,24,0
8589,0,<START>,0,0,0
8589,1,home,0,7,7
8589,2,work,7,9,2
8589,3,home,9,15,6
8589,4,work,15,17,2
8589,5,home,17,24,7
8589,6,<ENDS>,24,24,0
8590,0,<START>,0,0,0
8590,1,home,0,9,9
8590,2,work,9,17,8
8590,3,home,17,24,7
8590,4,<ENDS>,24,24,0
8591,0,<START>,0,0,0
8591,1,home,0,8,8
8591,2,work,8,15,7
8591,3,home,15,24,9
8591,4,<ENDS>,24,24,0
8592,0,<START>,0,0,0
8592,1,home,0,8,8
8592,2,work,8,13,5
8592,3,shop,13,14,1
8592,4,home,14,24,10
8592,5,<ENDS>,24,24,0
8593,0,<START>,0,0,0
8593,1,home,0,7,7
8593,2,education,7,12,5
8593,3,home,12,18,6
8593,4,shop,18,19,1
8593,5,home,19,24,5
8593,6,<ENDS>,24,24,0
8594,0,<START>,0,0,0
8594,1,home,0,8,8
8594,2,work,8,15,7
8594,3,home,15,24,9
8594,4,<ENDS>,24,24,0
8595,0,<START>,0,0,0
8595,1,home,0,7,7
8595,2,work,7,13,6
8595,3,home,13,23,10
8595,4,work,23,24,1
8595,5,<ENDS>,24,24,0
8596,0,<START>,0,0,0
8596,1,home,0,6,6
8596,2,work,6,7,1
8596,3,home,7,11,4
8596,4,work,11,12,1
8596,5,home,12,22,10
8596,6,work,22,23,1
8596,7,home,23,24,1
8596,8,<ENDS>,24,24,0
8597,0,<START>,0,0,0
8597,1,home,0,6,6
8597,2,work,6,7,1
8597,3,home,7,10,3
8597,4,work,10,13,3
8597,5,home,13,21,8
8597,6,work,21,22,1
8597,7,home,22,24,2
8597,8,<ENDS>,24,24,0
8598,0,<START>,0,0,0
8598,1,home,0,8,8
8598,2,shop,8,9,1
8598,3,work,9,15,6
8598,4,home,15,18,3
8598,5,work,18,20,2
8598,6,home,20,24,4
8598,7,<ENDS>,24,24,0
8599,0,<START>,0,0,0
8599,1,home,0,6,6
8599,2,work,6,13,7
8599,3,home,13,17,4
8599,4,work,17,20,3
8599,5,home,20,24,4
8599,6,<ENDS>,24,24,0
8600,0,<START>,0,0,0
8600,1,home,0,8,8
8600,2,education,8,15,7
8600,3,shop,15,16,1
8600,4,home,16,24,8
8600,5,<ENDS>,24,24,0
8601,0,<START>,0,0,0
8601,1,home,0,7,7
8601,2,education,7,8,1
8601,3,home,8,14,6
8601,4,education,14,16,2
8601,5,home,16,21,5
8601,6,shop,21,22,1
8601,7,home,22,24,2
8601,8,<ENDS>,24,24,0
8602,0,<START>,0,0,0
8602,1,home,0,7,7
8602,2,work,7,12,5
8602,3,shop,12,13,1
8602,4,work,13,17,4
8602,5,home,17,24,7
8602,6,<ENDS>,24,24,0
8603,0,<START>,0,0,0
8603,1,home,0,7,7
8603,2,work,7,13,6
8603,3,home,13,17,4
8603,4,work,17,20,3
8603,5,home,20,24,4
8603,6,<ENDS>,24,24,0
8604,0,<START>,0,0,0
8604,1,home,0,6,6
8604,2,work,6,13,7
8604,3,shop,13,14,1
8604,4,education,14,17,3
8604,5,home,17,24,7
8604,6,<ENDS>,24,24,0
8605,0,<START>,0,0,0
8605,1,home,0,7,7
8605,2,work,7,13,6
8605,3,home,13,24,11
8605,4,<ENDS>,24,24,0
8606,0,<START>,0,0,0
8606,1,home,0,6,6
8606,2,work,6,13,7
8606,3,home,13,24,11
8606,4,<ENDS>,24,24,0
8607,0,<START>,0,0,0
8607,1,home,0,7,7
8607,2,shop,7,8,1
8607,3,education,8,11,3
8607,4,home,11,19,8
8607,5,shop,19,20,1
8607,6,home,20,24,4
8607,7,<ENDS>,24,24,0
8608,0,<START>,0,0,0
8608,1,home,0,7,7
8608,2,shop,7,9,2
8608,3,education,9,12,3
8608,4,shop,12,14,2
8608,5,education,14,16,2
8608,6,home,16,24,8
8608,7,<ENDS>,24,24,0
8609,0,<START>,0,0,0
8609,1,home,0,8,8
8609,2,work,8,15,7
8609,3,home,15,24,9
8609,4,<ENDS>,24,24,0
8610,0,<START>,0,0,0
8610,1,home,0,6,6
8610,2,work,6,13,7
8610,3,home,13,16,3
8610,4,work,16,20,4
8610,5,home,20,24,4
8610,6,<ENDS>,24,24,0
8611,0,<START>,0,0,0
8611,1,home,0,8,8
8611,2,education,8,11,3
8611,3,home,11,15,4
8611,4,work,15,20,5
8611,5,home,20,24,4
8611,6,<ENDS>,24,24,0
8612,0,<START>,0,0,0
8612,1,home,0,7,7
8612,2,shop,7,8,1
8612,3,education,8,11,3
8612,4,home,11,14,3
8612,5,education,14,17,3
8612,6,home,17,24,7
8612,7,<ENDS>,24,24,0
8613,0,<START>,0,0,0
8613,1,work,0,11,11
8613,2,shop,11,12,1
8613,3,work,12,19,7
8613,4,home,19,24,5
8613,5,<ENDS>,24,24,0
8614,0,<START>,0,0,0
8614,1,home,0,8,8
8614,2,work,8,16,8
8614,3,home,16,24,8
8614,4,<ENDS>,24,24,0
8615,0,<START>,0,0,0
8615,1,home,0,9,9
8615,2,education,9,12,3
8615,3,home,12,21,9
8615,4,work,21,22,1
8615,5,home,22,24,2
8615,6,<ENDS>,24,24,0
8616,0,<START>,0,0,0
8616,1,home,0,7,7
8616,2,work,7,8,1
8616,3,home,8,15,7
8616,4,work,15,17,2
8616,5,home,17,24,7
8616,6,<ENDS>,24,24,0
8617,0,<START>,0,0,0
8617,1,home,0,6,6
8617,2,work,6,12,6
8617,3,shop,12,13,1
8617,4,work,13,19,6
8617,5,home,19,24,5
8617,6,<ENDS>,24,24,0
8618,0,<START>,0,0,0
8618,1,home,0,7,7
8618,2,work,7,13,6
8618,3,home,13,23,10
8618,4,work,23,24,1
8618,5,<ENDS>,24,24,0
8619,0,<START>,0,0,0
8619,1,home,0,8,8
8619,2,work,8,15,7
8619,3,home,15,24,9
8619,4,<ENDS>,24,24,0
8620,0,<START>,0,0,0
8620,1,home,0,7,7
8620,2,work,7,13,6
8620,3,home,13,24,11
8620,4,<ENDS>,24,24,0
8621,0,<START>,0,0,0
8621,1,home,0,7,7
8621,2,work,7,14,7
8621,3,home,14,17,3
8621,4,shop,17,18,1
8621,5,home,18,21,3
8621,6,work,21,22,1
8621,7,home,22,24,2
8621,8,<ENDS>,24,24,0
8622,0,<START>,0,0,0
8622,1,home,0,6,6
8622,2,work,6,8,2
8622,3,home,8,9,1
8622,4,work,9,10,1
8622,5,home,10,14,4
8622,6,work,14,16,2
8622,7,home,16,22,6
8622,8,work,22,23,1
8622,9,home,23,24,1
8622,10,<ENDS>,24,24,0
8623,0,<START>,0,0,0
8623,1,home,0,7,7
8623,2,work,7,13,6
8623,3,home,13,18,5
8623,4,work,18,20,2
8623,5,home,20,24,4
8623,6,<ENDS>,24,24,0
8624,0,<START>,0,0,0
8624,1,home,0,7,7
8624,2,work,7,14,7
8624,3,shop,14,15,1
8624,4,home,15,24,9
8624,5,<ENDS>,24,24,0
8625,0,<START>,0,0,0
8625,1,home,0,7,7
8625,2,work,7,13,6
8625,3,home,13,17,4
8625,4,work,17,20,3
8625,5,home,20,24,4
8625,6,<ENDS>,24,24,0
8626,0,<START>,0,0,0
8626,1,home,0,8,8
8626,2,work,8,14,6
8626,3,home,14,19,5
8626,4,shop,19,20,1
8626,5,home,20,24,4
8626,6,<ENDS>,24,24,0
8627,0,<START>,0,0,0
8627,1,home,0,8,8
8627,2,work,8,14,6
8627,3,home,14,24,10
8627,4,<ENDS>,24,24,0
8628,0,<START>,0,0,0
8628,1,home,0,6,6
8628,2,work,6,13,7
8628,3,shop,13,14,1
8628,4,work,14,20,6
8628,5,home,20,24,4
8628,6,<ENDS>,24,24,0
8629,0,<START>,0,0,0
8629,1,home,0,8,8
8629,2,work,8,14,6
8629,3,home,14,23,9
8629,4,work,23,24,1
8629,5,<ENDS>,24,24,0
8630,0,<START>,0,0,0
8630,1,home,0,6,6
8630,2,work,6,13,7
8630,3,shop,13,14,1
8630,4,work,14,19,5
8630,5,home,19,24,5
8630,6,<ENDS>,24,24,0
8631,0,<START>,0,0,0
8631,1,home,0,6,6
8631,2,work,6,13,7
8631,3,home,13,17,4
8631,4,work,17,20,3
8631,5,home,20,24,4
8631,6,<ENDS>,24,24,0
8632,0,<START>,0,0,0
8632,1,home,0,6,6
8632,2,shop,6,7,1
8632,3,home,7,13,6
8632,4,education,13,16,3
8632,5,home,16,24,8
8632,6,<ENDS>,24,24,0
8633,0,<START>,0,0,0
8633,1,home,0,6,6
8633,2,work,6,13,7
8633,3,home,13,24,11
8633,4,<ENDS>,24,24,0
8634,0,<START>,0,0,0
8634,1,home,0,8,8
8634,2,work,8,15,7
8634,3,home,15,24,9
8634,4,<ENDS>,24,24,0
8635,0,<START>,0,0,0
8635,1,home,0,7,7
8635,2,shop,7,8,1
8635,3,education,8,13,5
8635,4,home,13,19,6
8635,5,shop,19,20,1
8635,6,home,20,24,4
8635,7,<ENDS>,24,24,0
8636,0,<START>,0,0,0
8636,1,home,0,7,7
8636,2,work,7,14,7
8636,3,home,14,24,10
8636,4,<ENDS>,24,24,0
8637,0,<START>,0,0,0
8637,1,home,0,9,9
8637,2,education,9,12,3
8637,3,shop,12,13,1
8637,4,work,13,20,7
8637,5,home,20,24,4
8637,6,<ENDS>,24,24,0
8638,0,<START>,0,0,0
8638,1,home,0,7,7
8638,2,work,7,13,6
8638,3,home,13,24,11
8638,4,<ENDS>,24,24,0
8639,0,<START>,0,0,0
8639,1,home,0,6,6
8639,2,shop,6,7,1
8639,3,home,7,10,3
8639,4,education,10,16,6
8639,5,home,16,24,8
8639,6,<ENDS>,24,24,0
8640,0,<START>,0,0,0
8640,1,home,0,8,8
8640,2,work,8,16,8
8640,3,shop,16,17,1
8640,4,work,17,20,3
8640,5,home,20,24,4
8640,6,<ENDS>,24,24,0
8641,0,<START>,0,0,0
8641,1,home,0,6,6
8641,2,shop,6,7,1
8641,3,home,7,9,2
8641,4,education,9,13,4
8641,5,shop,13,15,2
8641,6,home,15,24,9
8641,7,<ENDS>,24,24,0
8642,0,<START>,0,0,0
8642,1,home,0,6,6
8642,2,work,6,13,7
8642,3,shop,13,14,1
8642,4,work,14,19,5
8642,5,home,19,24,5
8642,6,<ENDS>,24,24,0
8643,0,<START>,0,0,0
8643,1,home,0,7,7
8643,2,work,7,13,6
8643,3,home,13,23,10
8643,4,work,23,24,1
8643,5,<ENDS>,24,24,0
8644,0,<START>,0,0,0
8644,1,home,0,7,7
8644,2,work,7,8,1
8644,3,home,8,12,4
8644,4,work,12,14,2
8644,5,home,14,21,7
8644,6,work,21,22,1
8644,7,home,22,24,2
8644,8,<ENDS>,24,24,0
8645,0,<START>,0,0,0
8645,1,home,0,8,8
8645,2,work,8,16,8
8645,3,home,16,24,8
8645,4,<ENDS>,24,24,0
8646,0,<START>,0,0,0
8646,1,home,0,7,7
8646,2,work,7,9,2
8646,3,home,9,11,2
8646,4,work,11,13,2
8646,5,home,13,18,5
8646,6,work,18,20,2
8646,7,home,20,24,4
8646,8,<ENDS>,24,24,0
8647,0,<START>,0,0,0
8647,1,home,0,8,8
8647,2,work,8,15,7
8647,3,shop,15,16,1
8647,4,home,16,24,8
8647,5,<ENDS>,24,24,0
8648,0,<START>,0,0,0
8648,1,home,0,9,9
8648,2,work,9,16,7
8648,3,home,16,20,4
8648,4,shop,20,21,1
8648,5,home,21,24,3
8648,6,<ENDS>,24,24,0
8649,0,<START>,0,0,0
8649,1,home,0,8,8
8649,2,shop,8,9,1
8649,3,home,9,13,4
8649,4,work,13,19,6
8649,5,home,19,24,5
8649,6,<ENDS>,24,24,0
8650,0,<START>,0,0,0
8650,1,home,0,7,7
8650,2,work,7,8,1
8650,3,home,8,12,4
8650,4,work,12,13,1
8650,5,home,13,14,1
8650,6,work,14,16,2
8650,7,home,16,22,6
8650,8,work,22,23,1
8650,9,home,23,24,1
8650,10,<ENDS>,24,24,0
8651,0,<START>,0,0,0
8651,1,home,0,6,6
8651,2,work,6,13,7
8651,3,home,13,24,11
8651,4,<ENDS>,24,24,0
8652,0,<START>,0,0,0
8652,1,home,0,5,5
8652,2,work,5,12,7
8652,3,shop,12,13,1
8652,4,work,13,19,6
8652,5,home,19,24,5
8652,6,<ENDS>,24,24,0
8653,0,<START>,0,0,0
8653,1,home,0,8,8
8653,2,work,8,14,6
8653,3,shop,14,15,1
8653,4,home,15,24,9
8653,5,<ENDS>,24,24,0
8654,0,<START>,0,0,0
8654,1,home,0,9,9
8654,2,work,9,14,5
8654,3,shop,14,15,1
8654,4,home,15,21,6
8654,5,work,21,22,1
8654,6,home,22,24,2
8654,7,<ENDS>,24,24,0
8655,0,<START>,0,0,0
8655,1,home,0,6,6
8655,2,shop,6,7,1
8655,3,work,7,13,6
8655,4,home,13,17,4
8655,5,work,17,19,2
8655,6,home,19,24,5
8655,7,<ENDS>,24,24,0
8656,0,<START>,0,0,0
8656,1,home,0,8,8
8656,2,work,8,15,7
8656,3,home,15,24,9
8656,4,<ENDS>,24,24,0
8657,0,<START>,0,0,0
8657,1,home,0,7,7
8657,2,work,7,14,7
8657,3,shop,14,15,1
8657,4,work,15,20,5
8657,5,home,20,24,4
8657,6,<ENDS>,24,24,0
8658,0,<START>,0,0,0
8658,1,home,0,6,6
8658,2,shop,6,7,1
8658,3,home,7,10,3
8658,4,education,10,12,2
8658,5,shop,12,14,2
8658,6,education,14,16,2
8658,7,shop,16,17,1
8658,8,home,17,24,7
8658,9,<ENDS>,24,24,0
8659,0,<START>,0,0,0
8659,1,home,0,8,8
8659,2,education,8,11,3
8659,3,home,11,18,7
8659,4,shop,18,19,1
8659,5,home,19,24,5
8659,6,<ENDS>,24,24,0
8660,0,<START>,0,0,0
8660,1,home,0,8,8
8660,2,work,8,13,5
8660,3,shop,13,14,1
8660,4,work,14,19,5
8660,5,home,19,24,5
8660,6,<ENDS>,24,24,0
8661,0,<START>,0,0,0
8661,1,home,0,7,7
8661,2,education,7,11,4
8661,3,home,11,19,8
8661,4,shop,19,21,2
8661,5,home,21,24,3
8661,6,<ENDS>,24,24,0
8662,0,<START>,0,0,0
8662,1,home,0,7,7
8662,2,work,7,13,6
8662,3,home,13,21,8
8662,4,shop,21,22,1
8662,5,home,22,24,2
8662,6,<ENDS>,24,24,0
8663,0,<START>,0,0,0
8663,1,home,0,7,7
8663,2,work,7,15,8
8663,3,home,15,21,6
8663,4,work,21,22,1
8663,5,home,22,24,2
8663,6,<ENDS>,24,24,0
8664,0,<START>,0,0,0
8664,1,home,0,6,6
8664,2,work,6,12,6
8664,3,shop,12,13,1
8664,4,work,13,19,6
8664,5,home,19,24,5
8664,6,<ENDS>,24,24,0
8665,0,<START>,0,0,0
8665,1,home,0,6,6
8665,2,shop,6,7,1
8665,3,work,7,13,6
8665,4,home,13,18,5
8665,5,shop,18,19,1
8665,6,home,19,24,5
8665,7,<ENDS>,24,24,0
8666,0,<START>,0,0,0
8666,1,home,0,7,7
8666,2,education,7,11,4
8666,3,home,11,18,7
8666,4,shop,18,19,1
8666,5,home,19,24,5
8666,6,<ENDS>,24,24,0
8667,0,<START>,0,0,0
8667,1,home,0,7,7
8667,2,work,7,13,6
8667,3,home,13,24,11
8667,4,<ENDS>,24,24,0
8668,0,<START>,0,0,0
8668,1,home,0,6,6
8668,2,work,6,13,7
8668,3,home,13,24,11
8668,4,<ENDS>,24,24,0
8669,0,<START>,0,0,0
8669,1,home,0,6,6
8669,2,work,6,12,6
8669,3,shop,12,13,1
8669,4,work,13,18,5
8669,5,home,18,24,6
8669,6,<ENDS>,24,24,0
8670,0,<START>,0,0,0
8670,1,home,0,6,6
8670,2,work,6,13,7
8670,3,shop,13,14,1
8670,4,home,14,16,2
8670,5,work,16,20,4
8670,6,home,20,24,4
8670,7,<ENDS>,24,24,0
8671,0,<START>,0,0,0
8671,1,home,0,6,6
8671,2,work,6,9,3
8671,3,home,9,13,4
8671,4,work,13,15,2
8671,5,home,15,22,7
8671,6,work,22,23,1
8671,7,home,23,24,1
8671,8,<ENDS>,24,24,0
8672,0,<START>,0,0,0
8672,1,home,0,7,7
8672,2,work,7,14,7
8672,3,home,14,21,7
8672,4,work,21,22,1
8672,5,home,22,24,2
8672,6,<ENDS>,24,24,0
8673,0,<START>,0,0,0
8673,1,home,0,6,6
8673,2,work,6,13,7
8673,3,home,13,24,11
8673,4,<ENDS>,24,24,0
8674,0,<START>,0,0,0
8674,1,home,0,6,6
8674,2,work,6,13,7
8674,3,home,13,17,4
8674,4,work,17,20,3
8674,5,home,20,24,4
8674,6,<ENDS>,24,24,0
8675,0,<START>,0,0,0
8675,1,work,0,1,1
8675,2,home,1,7,6
8675,3,education,7,12,5
8675,4,home,12,19,7
8675,5,shop,19,20,1
8675,6,home,20,24,4
8675,7,<ENDS>,24,24,0
8676,0,<START>,0,0,0
8676,1,home,0,7,7
8676,2,work,7,14,7
8676,3,home,14,24,10
8676,4,<ENDS>,24,24,0
8677,0,<START>,0,0,0
8677,1,home,0,7,7
8677,2,work,7,14,7
8677,3,home,14,18,4
8677,4,shop,18,19,1
8677,5,home,19,24,5
8677,6,<ENDS>,24,24,0
8678,0,<START>,0,0,0
8678,1,home,0,8,8
8678,2,work,8,15,7
8678,3,home,15,24,9
8678,4,<ENDS>,24,24,0
8679,0,<START>,0,0,0
8679,1,home,0,7,7
8679,2,work,7,14,7
8679,3,home,14,22,8
8679,4,work,22,23,1
8679,5,home,23,24,1
8679,6,<ENDS>,24,24,0
8680,0,<START>,0,0,0
8680,1,home,0,7,7
8680,2,education,7,12,5
8680,3,shop,12,14,2
8680,4,education,14,16,2
8680,5,home,16,24,8
8680,6,<ENDS>,24,24,0
8681,0,<START>,0,0,0
8681,1,home,0,7,7
8681,2,work,7,14,7
8681,3,shop,14,15,1
8681,4,home,15,21,6
8681,5,work,21,22,1
8681,6,home,22,24,2
8681,7,<ENDS>,24,24,0
8682,0,<START>,0,0,0
8682,1,home,0,7,7
8682,2,education,7,12,5
8682,3,shop,12,14,2
8682,4,education,14,16,2
8682,5,home,16,24,8
8682,6,<ENDS>,24,24,0
8683,0,<START>,0,0,0
8683,1,home,0,6,6
8683,2,shop,6,7,1
8683,3,home,7,9,2
8683,4,work,9,16,7
8683,5,home,16,21,5
8683,6,work,21,22,1
8683,7,home,22,24,2
8683,8,<ENDS>,24,24,0
8684,0,<START>,0,0,0
8684,1,home,0,6,6
8684,2,work,6,14,8
8684,3,shop,14,15,1
8684,4,work,15,20,5
8684,5,home,20,24,4
8684,6,<ENDS>,24,24,0
8685,0,<START>,0,0,0
8685,1,home,0,8,8
8685,2,work,8,14,6
8685,3,home,14,24,10
8685,4,<ENDS>,24,24,0
8686,0,<START>,0,0,0
8686,1,home,0,9,9
8686,2,work,9,15,6
8686,3,home,15,24,9
8686,4,<ENDS>,24,24,0
8687,0,<START>,0,0,0
8687,1,home,0,6,6
8687,2,work,6,13,7
8687,3,home,13,21,8
8687,4,shop,21,22,1
8687,5,home,22,24,2
8687,6,<ENDS>,24,24,0
8688,0,<START>,0,0,0
8688,1,home,0,8,8
8688,2,work,8,15,7
8688,3,home,15,24,9
8688,4,<ENDS>,24,24,0
8689,0,<START>,0,0,0
8689,1,home,0,8,8
8689,2,work,8,14,6
8689,3,home,14,24,10
8689,4,<ENDS>,24,24,0
8690,0,<START>,0,0,0
8690,1,home,0,8,8
8690,2,work,8,15,7
8690,3,home,15,21,6
8690,4,work,21,22,1
8690,5,home,22,24,2
8690,6,<ENDS>,24,24,0
8691,0,<START>,0,0,0
8691,1,home,0,7,7
8691,2,work,7,13,6
8691,3,home,13,17,4
8691,4,shop,17,18,1
8691,5,home,18,24,6
8691,6,<ENDS>,24,24,0
8692,0,<START>,0,0,0
8692,1,home,0,8,8
8692,2,shop,8,9,1
8692,3,work,9,16,7
8692,4,home,16,23,7
8692,5,work,23,24,1
8692,6,<ENDS>,24,24,0
8693,0,<START>,0,0,0
8693,1,home,0,7,7
8693,2,education,7,12,5
8693,3,home,12,19,7
8693,4,shop,19,20,1
8693,5,home,20,24,4
8693,6,<ENDS>,24,24,0
8694,0,<START>,0,0,0
8694,1,home,0,8,8
8694,2,work,8,13,5
8694,3,shop,13,14,1
8694,4,home,14,22,8
8694,5,work,22,23,1
8694,6,home,23,24,1
8694,7,<ENDS>,24,24,0
8695,0,<START>,0,0,0
8695,1,home,0,8,8
8695,2,work,8,14,6
8695,3,home,14,18,4
8695,4,shop,18,19,1
8695,5,home,19,24,5
8695,6,<ENDS>,24,24,0
8696,0,<START>,0,0,0
8696,1,home,0,6,6
8696,2,work,6,13,7
8696,3,home,13,18,5
8696,4,work,18,20,2
8696,5,home,20,24,4
8696,6,<ENDS>,24,24,0
8697,0,<START>,0,0,0
8697,1,home,0,6,6
8697,2,work,6,13,7
8697,3,shop,13,14,1
8697,4,home,14,24,10
8697,5,<ENDS>,24,24,0
8698,0,<START>,0,0,0
8698,1,home,0,7,7
8698,2,education,7,11,4
8698,3,home,11,19,8
8698,4,shop,19,20,1
8698,5,home,20,24,4
8698,6,<ENDS>,24,24,0
8699,0,<START>,0,0,0
8699,1,home,0,7,7
8699,2,shop,7,8,1
8699,3,work,8,15,7
8699,4,shop,15,16,1
8699,5,work,16,19,3
8699,6,home,19,24,5
8699,7,<ENDS>,24,24,0
8700,0,<START>,0,0,0
8700,1,home,0,8,8
8700,2,work,8,14,6
8700,3,shop,14,15,1
8700,4,home,15,24,9
8700,5,<ENDS>,24,24,0
8701,0,<START>,0,0,0
8701,1,home,0,6,6
8701,2,work,6,13,7
8701,3,shop,13,14,1
8701,4,work,14,20,6
8701,5,home,20,24,4
8701,6,<ENDS>,24,24,0
8702,0,<START>,0,0,0
8702,1,home,0,8,8
8702,2,education,8,13,5
8702,3,shop,13,14,1
8702,4,home,14,24,10
8702,5,<ENDS>,24,24,0
8703,0,<START>,0,0,0
8703,1,home,0,7,7
8703,2,work,7,14,7
8703,3,shop,14,15,1
8703,4,work,15,20,5
8703,5,home,20,24,4
8703,6,<ENDS>,24,24,0
8704,0,<START>,0,0,0
8704,1,home,0,7,7
8704,2,work,7,13,6
8704,3,home,13,21,8
8704,4,work,21,22,1
8704,5,home,22,24,2
8704,6,<ENDS>,24,24,0
8705,0,<START>,0,0,0
8705,1,home,0,8,8
8705,2,work,8,15,7
8705,3,home,15,22,7
8705,4,work,22,23,1
8705,5,home,23,24,1
8705,6,<ENDS>,24,24,0
8706,0,<START>,0,0,0
8706,1,home,0,6,6
8706,2,shop,6,7,1
8706,3,work,7,13,6
8706,4,home,13,17,4
8706,5,work,17,20,3
8706,6,home,20,24,4
8706,7,<ENDS>,24,24,0
8707,0,<START>,0,0,0
8707,1,home,0,7,7
8707,2,work,7,13,6
8707,3,shop,13,14,1
8707,4,work,14,20,6
8707,5,home,20,24,4
8707,6,<ENDS>,24,24,0
8708,0,<START>,0,0,0
8708,1,home,0,7,7
8708,2,work,7,14,7
8708,3,shop,14,15,1
8708,4,home,15,21,6
8708,5,work,21,22,1
8708,6,home,22,24,2
8708,7,<ENDS>,24,24,0
8709,0,<START>,0,0,0
8709,1,home,0,7,7
8709,2,education,7,11,4
8709,3,home,11,13,2
8709,4,education,13,16,3
8709,5,home,16,24,8
8709,6,<ENDS>,24,24,0
8710,0,<START>,0,0,0
8710,1,home,0,7,7
8710,2,work,7,13,6
8710,3,home,13,24,11
8710,4,<ENDS>,24,24,0
8711,0,<START>,0,0,0
8711,1,home,0,6,6
8711,2,work,6,14,8
8711,3,shop,14,15,1
8711,4,home,15,24,9
8711,5,<ENDS>,24,24,0
8712,0,<START>,0,0,0
8712,1,home,0,7,7
8712,2,work,7,14,7
8712,3,home,14,18,4
8712,4,shop,18,19,1
8712,5,home,19,24,5
8712,6,<ENDS>,24,24,0
8713,0,<START>,0,0,0
8713,1,home,0,8,8
8713,2,work,8,15,7
8713,3,home,15,24,9
8713,4,<ENDS>,24,24,0
8714,0,<START>,0,0,0
8714,1,home,0,7,7
8714,2,work,7,15,8
8714,3,home,15,19,4
8714,4,shop,19,20,1
8714,5,home,20,24,4
8714,6,<ENDS>,24,24,0
8715,0,<START>,0,0,0
8715,1,home,0,8,8
8715,2,education,8,13,5
8715,3,shop,13,14,1
8715,4,home,14,24,10
8715,5,<ENDS>,24,24,0
8716,0,<START>,0,0,0
8716,1,home,0,7,7
8716,2,education,7,11,4
8716,3,home,11,19,8
8716,4,shop,19,20,1
8716,5,home,20,24,4
8716,6,<ENDS>,24,24,0
8717,0,<START>,0,0,0
8717,1,home,0,7,7
8717,2,work,7,13,6
8717,3,home,13,24,11
8717,4,<ENDS>,24,24,0
8718,0,<START>,0,0,0
8718,1,home,0,7,7
8718,2,work,7,13,6
8718,3,home,13,24,11
8718,4,<ENDS>,24,24,0
8719,0,<START>,0,0,0
8719,1,home,0,11,11
8719,2,shop,11,12,1
8719,3,work,12,19,7
8719,4,home,19,24,5
8719,5,<ENDS>,24,24,0
8720,0,<START>,0,0,0
8720,1,home,0,6,6
8720,2,work,6,13,7
8720,3,shop,13,14,1
8720,4,home,14,24,10
8720,5,<ENDS>,24,24,0
8721,0,<START>,0,0,0
8721,1,home,0,7,7
8721,2,work,7,8,1
8721,3,home,8,9,1
8721,4,work,9,11,2
8721,5,home,11,14,3
8721,6,work,14,16,2
8721,7,home,16,21,5
8721,8,work,21,22,1
8721,9,home,22,24,2
8721,10,<ENDS>,24,24,0
8722,0,<START>,0,0,0
8722,1,home,0,7,7
8722,2,shop,7,8,1
8722,3,education,8,11,3
8722,4,home,11,18,7
8722,5,shop,18,19,1
8722,6,home,19,24,5
8722,7,<ENDS>,24,24,0
8723,0,<START>,0,0,0
8723,1,home,0,6,6
8723,2,shop,6,7,1
8723,3,home,7,9,2
8723,4,education,9,12,3
8723,5,home,12,18,6
8723,6,shop,18,19,1
8723,7,home,19,24,5
8723,8,<ENDS>,24,24,0
8724,0,<START>,0,0,0
8724,1,home,0,6,6
8724,2,shop,6,7,1
8724,3,home,7,12,5
8724,4,education,12,15,3
8724,5,shop,15,17,2
8724,6,home,17,24,7
8724,7,<ENDS>,24,24,0
8725,0,<START>,0,0,0
8725,1,home,0,7,7
8725,2,work,7,14,7
8725,3,home,14,17,3
8725,4,shop,17,18,1
8725,5,home,18,24,6
8725,6,<ENDS>,24,24,0
8726,0,<START>,0,0,0
8726,1,home,0,6,6
8726,2,work,6,7,1
8726,3,home,7,9,2
8726,4,work,9,11,2
8726,5,home,11,15,4
8726,6,work,15,17,2
8726,7,home,17,24,7
8726,8,<ENDS>,24,24,0
8727,0,<START>,0,0,0
8727,1,home,0,7,7
8727,2,shop,7,8,1
8727,3,education,8,12,4
8727,4,home,12,14,2
8727,5,education,14,16,2
8727,6,home,16,24,8
8727,7,<ENDS>,24,24,0
8728,0,<START>,0,0,0
8728,1,home,0,6,6
8728,2,shop,6,7,1
8728,3,home,7,9,2
8728,4,education,9,12,3
8728,5,home,12,19,7
8728,6,shop,19,20,1
8728,7,home,20,24,4
8728,8,<ENDS>,24,24,0
8729,0,<START>,0,0,0
8729,1,home,0,7,7
8729,2,shop,7,8,1
8729,3,work,8,16,8
8729,4,home,16,24,8
8729,5,<ENDS>,24,24,0
8730,0,<START>,0,0,0
8730,1,home,0,8,8
8730,2,work,8,13,5
8730,3,home,13,24,11
8730,4,<ENDS>,24,24,0
8731,0,<START>,0,0,0
8731,1,home,0,7,7
8731,2,work,7,13,6
8731,3,home,13,24,11
8731,4,<ENDS>,24,24,0
8732,0,<START>,0,0,0
8732,1,home,0,6,6
8732,2,work,6,7,1
8732,3,home,7,11,4
8732,4,work,11,13,2
8732,5,home,13,17,4
8732,6,work,17,19,2
8732,7,home,19,24,5
8732,8,<ENDS>,24,24,0
8733,0,<START>,0,0,0
8733,1,home,0,7,7
8733,2,work,7,15,8
8733,3,home,15,24,9
8733,4,<ENDS>,24,24,0
8734,0,<START>,0,0,0
8734,1,home,0,7,7
8734,2,work,7,14,7
8734,3,home,14,24,10
8734,4,<ENDS>,24,24,0
8735,0,<START>,0,0,0
8735,1,home,0,7,7
8735,2,work,7,14,7
8735,3,shop,14,15,1
8735,4,home,15,24,9
8735,5,<ENDS>,24,24,0
8736,0,<START>,0,0,0
8736,1,home,0,6,6
8736,2,work,6,9,3
8736,3,home,9,11,2
8736,4,work,11,12,1
8736,5,home,12,18,6
8736,6,work,18,19,1
8736,7,home,19,24,5
8736,8,<ENDS>,24,24,0
8737,0,<START>,0,0,0
8737,1,home,0,7,7
8737,2,work,7,13,6
8737,3,shop,13,14,1
8737,4,home,14,24,10
8737,5,<ENDS>,24,24,0
8738,0,<START>,0,0,0
8738,1,home,0,7,7
8738,2,work,7,14,7
8738,3,shop,14,15,1
8738,4,home,15,24,9
8738,5,<ENDS>,24,24,0
8739,0,<START>,0,0,0
8739,1,home,0,7,7
8739,2,shop,7,8,1
8739,3,education,8,12,4
8739,4,shop,12,14,2
8739,5,home,14,20,6
8739,6,shop,20,21,1
8739,7,home,21,24,3
8739,8,<ENDS>,24,24,0
8740,0,<START>,0,0,0
8740,1,home,0,8,8
8740,2,shop,8,9,1
8740,3,home,9,13,4
8740,4,work,13,20,7
8740,5,home,20,24,4
8740,6,<ENDS>,24,24,0
8741,0,<START>,0,0,0
8741,1,home,0,8,8
8741,2,work,8,15,7
8741,3,home,15,24,9
8741,4,<ENDS>,24,24,0
8742,0,<START>,0,0,0
8742,1,home,0,7,7
8742,2,work,7,13,6
8742,3,home,13,17,4
8742,4,work,17,20,3
8742,5,home,20,24,4
8742,6,<ENDS>,24,24,0
8743,0,<START>,0,0,0
8743,1,home,0,9,9
8743,2,work,9,15,6
8743,3,home,15,19,4
8743,4,shop,19,20,1
8743,5,home,20,24,4
8743,6,<ENDS>,24,24,0
8744,0,<START>,0,0,0
8744,1,home,0,7,7
8744,2,work,7,14,7
8744,3,home,14,24,10
8744,4,<ENDS>,24,24,0
8745,0,<START>,0,0,0
8745,1,home,0,7,7
8745,2,shop,7,8,1
8745,3,education,8,11,3
8745,4,home,11,19,8
8745,5,shop,19,21,2
8745,6,home,21,24,3
8745,7,<ENDS>,24,24,0
8746,0,<START>,0,0,0
8746,1,home,0,6,6
8746,2,work,6,13,7
8746,3,home,13,17,4
8746,4,work,17,20,3
8746,5,home,20,24,4
8746,6,<ENDS>,24,24,0
8747,0,<START>,0,0,0
8747,1,home,0,9,9
8747,2,work,9,14,5
8747,3,home,14,24,10
8747,4,<ENDS>,24,24,0
8748,0,<START>,0,0,0
8748,1,home,0,7,7
8748,2,work,7,14,7
8748,3,home,14,21,7
8748,4,shop,21,22,1
8748,5,home,22,24,2
8748,6,<ENDS>,24,24,0
8749,0,<START>,0,0,0
8749,1,home,0,8,8
8749,2,work,8,14,6
8749,3,shop,14,15,1
8749,4,work,15,20,5
8749,5,home,20,24,4
8749,6,<ENDS>,24,24,0
8750,0,<START>,0,0,0
8750,1,home,0,9,9
8750,2,work,9,16,7
8750,3,home,16,20,4
8750,4,shop,20,21,1
8750,5,home,21,24,3
8750,6,<ENDS>,24,24,0
8751,0,<START>,0,0,0
8751,1,home,0,7,7
8751,2,work,7,13,6
8751,3,home,13,17,4
8751,4,work,17,20,3
8751,5,home,20,24,4
8751,6,<ENDS>,24,24,0
8752,0,<START>,0,0,0
8752,1,home,0,6,6
8752,2,work,6,8,2
8752,3,home,8,14,6
8752,4,work,14,16,2
8752,5,home,16,22,6
8752,6,work,22,23,1
8752,7,home,23,24,1
8752,8,<ENDS>,24,24,0
8753,0,<START>,0,0,0
8753,1,home,0,7,7
8753,2,education,7,12,5
8753,3,home,12,14,2
8753,4,education,14,17,3
8753,5,shop,17,18,1
8753,6,home,18,24,6
8753,7,<ENDS>,24,24,0
8754,0,<START>,0,0,0
8754,1,home,0,7,7
8754,2,work,7,15,8
8754,3,shop,15,16,1
8754,4,work,16,20,4
8754,5,home,20,24,4
8754,6,<ENDS>,24,24,0
8755,0,<START>,0,0,0
8755,1,home,0,8,8
8755,2,work,8,15,7
8755,3,home,15,19,4
8755,4,shop,19,20,1
8755,5,home,20,24,4
8755,6,<ENDS>,24,24,0
8756,0,<START>,0,0,0
8756,1,home,0,7,7
8756,2,shop,7,8,1
8756,3,work,8,15,7
8756,4,home,15,22,7
8756,5,work,22,23,1
8756,6,home,23,24,1
8756,7,<ENDS>,24,24,0
8757,0,<START>,0,0,0
8757,1,home,0,8,8
8757,2,work,8,14,6
8757,3,home,14,24,10
8757,4,<ENDS>,24,24,0
8758,0,<START>,0,0,0
8758,1,home,0,7,7
8758,2,work,7,8,1
8758,3,home,8,9,1
8758,4,work,9,11,2
8758,5,home,11,17,6
8758,6,work,17,19,2
8758,7,home,19,24,5
8758,8,<ENDS>,24,24,0
8759,0,<START>,0,0,0
8759,1,home,0,8,8
8759,2,work,8,14,6
8759,3,home,14,20,6
8759,4,shop,20,21,1
8759,5,home,21,24,3
8759,6,<ENDS>,24,24,0
8760,0,<START>,0,0,0
8760,1,home,0,7,7
8760,2,education,7,11,4
8760,3,home,11,14,3
8760,4,education,14,15,1
8760,5,shop,15,17,2
8760,6,home,17,24,7
8760,7,<ENDS>,24,24,0
8761,0,<START>,0,0,0
8761,1,home,0,6,6
8761,2,shop,6,7,1
8761,3,home,7,13,6
8761,4,education,13,16,3
8761,5,home,16,24,8
8761,6,<ENDS>,24,24,0
8762,0,<START>,0,0,0
8762,1,home,0,7,7
8762,2,work,7,15,8
8762,3,home,15,23,8
8762,4,work,23,24,1
8762,5,<ENDS>,24,24,0
8763,0,<START>,0,0,0
8763,1,home,0,8,8
8763,2,work,8,15,7
8763,3,home,15,24,9
8763,4,<ENDS>,24,24,0
8764,0,<START>,0,0,0
8764,1,home,0,7,7
8764,2,work,7,14,7
8764,3,home,14,24,10
8764,4,<ENDS>,24,24,0
8765,0,<START>,0,0,0
8765,1,home,0,7,7
8765,2,work,7,13,6
8765,3,shop,13,15,2
8765,4,home,15,23,8
8765,5,work,23,24,1
8765,6,<ENDS>,24,24,0
8766,0,<START>,0,0,0
8766,1,home,0,8,8
8766,2,work,8,15,7
8766,3,home,15,22,7
8766,4,work,22,23,1
8766,5,home,23,24,1
8766,6,<ENDS>,24,24,0
8767,0,<START>,0,0,0
8767,1,home,0,6,6
8767,2,work,6,9,3
8767,3,home,9,11,2
8767,4,work,11,12,1
8767,5,shop,12,13,1
8767,6,work,13,15,2
8767,7,home,15,22,7
8767,8,work,22,23,1
8767,9,home,23,24,1
8767,10,<ENDS>,24,24,0
8768,0,<START>,0,0,0
8768,1,home,0,6,6
8768,2,work,6,8,2
8768,3,home,8,11,3
8768,4,work,11,13,2
8768,5,home,13,21,8
8768,6,work,21,22,1
8768,7,home,22,24,2
8768,8,<ENDS>,24,24,0
8769,0,<START>,0,0,0
8769,1,home,0,6,6
8769,2,work,6,13,7
8769,3,home,13,18,5
8769,4,shop,18,19,1
8769,5,home,19,24,5
8769,6,<ENDS>,24,24,0
8770,0,<START>,0,0,0
8770,1,home,0,6,6
8770,2,shop,6,7,1
8770,3,work,7,14,7
8770,4,home,14,24,10
8770,5,<ENDS>,24,24,0
8771,0,<START>,0,0,0
8771,1,home,0,7,7
8771,2,work,7,14,7
8771,3,home,14,24,10
8771,4,<ENDS>,24,24,0
8772,0,<START>,0,0,0
8772,1,home,0,6,6
8772,2,shop,6,7,1
8772,3,work,7,8,1
8772,4,home,8,10,2
8772,5,work,10,11,1
8772,6,home,11,16,5
8772,7,work,16,19,3
8772,8,home,19,24,5
8772,9,<ENDS>,24,24,0
8773,0,<START>,0,0,0
8773,1,home,0,8,8
8773,2,work,8,15,7
8773,3,home,15,21,6
8773,4,shop,21,22,1
8773,5,home,22,24,2
8773,6,<ENDS>,24,24,0
8774,0,<START>,0,0,0
8774,1,home,0,8,8
8774,2,work,8,15,7
8774,3,home,15,24,9
8774,4,<ENDS>,24,24,0
8775,0,<START>,0,0,0
8775,1,home,0,7,7
8775,2,education,7,11,4
8775,3,home,11,16,5
8775,4,shop,16,17,1
8775,5,home,17,24,7
8775,6,<ENDS>,24,24,0
8776,0,<START>,0,0,0
8776,1,home,0,6,6
8776,2,work,6,13,7
8776,3,shop,13,14,1
8776,4,work,14,19,5
8776,5,home,19,24,5
8776,6,<ENDS>,24,24,0
8777,0,<START>,0,0,0
8777,1,home,0,8,8
8777,2,education,8,13,5
8777,3,work,13,19,6
8777,4,home,19,24,5
8777,5,<ENDS>,24,24,0
8778,0,<START>,0,0,0
8778,1,home,0,7,7
8778,2,work,7,14,7
8778,3,home,14,24,10
8778,4,<ENDS>,24,24,0
8779,0,<START>,0,0,0
8779,1,home,0,7,7
8779,2,work,7,13,6
8779,3,home,13,24,11
8779,4,<ENDS>,24,24,0
8780,0,<START>,0,0,0
8780,1,home,0,6,6
8780,2,work,6,13,7
8780,3,home,13,18,5
8780,4,shop,18,19,1
8780,5,home,19,24,5
8780,6,<ENDS>,24,24,0
8781,0,<START>,0,0,0
8781,1,home,0,7,7
8781,2,work,7,13,6
8781,3,home,13,18,5
8781,4,shop,18,19,1
8781,5,home,19,24,5
8781,6,<ENDS>,24,24,0
8782,0,<START>,0,0,0
8782,1,home,0,7,7
8782,2,shop,7,8,1
8782,3,education,8,12,4
8782,4,shop,12,14,2
8782,5,education,14,16,2
8782,6,home,16,24,8
8782,7,<ENDS>,24,24,0
8783,0,<START>,0,0,0
8783,1,home,0,7,7
8783,2,work,7,14,7
8783,3,home,14,24,10
8783,4,<ENDS>,24,24,0
8784,0,<START>,0,0,0
8784,1,home,0,7,7
8784,2,work,7,13,6
8784,3,home,13,17,4
8784,4,work,17,20,3
8784,5,home,20,24,4
8784,6,<ENDS>,24,24,0
8785,0,<START>,0,0,0
8785,1,home,0,7,7
8785,2,shop,7,9,2
8785,3,education,9,12,3
8785,4,shop,12,14,2
8785,5,education,14,16,2
8785,6,shop,16,17,1
8785,7,home,17,24,7
8785,8,<ENDS>,24,24,0
8786,0,<START>,0,0,0
8786,1,home,0,6,6
8786,2,work,6,13,7
8786,3,shop,13,14,1
8786,4,work,14,18,4
8786,5,home,18,21,3
8786,6,shop,21,22,1
8786,7,home,22,24,2
8786,8,<ENDS>,24,24,0
8787,0,<START>,0,0,0
8787,1,home,0,8,8
8787,2,work,8,14,6
8787,3,home,14,24,10
8787,4,<ENDS>,24,24,0
8788,0,<START>,0,0,0
8788,1,home,0,6,6
8788,2,shop,6,7,1
8788,3,work,7,13,6
8788,4,home,13,19,6
8788,5,shop,19,20,1
8788,6,home,20,24,4
8788,7,<ENDS>,24,24,0
8789,0,<START>,0,0,0
8789,1,home,0,8,8
8789,2,education,8,11,3
8789,3,home,11,19,8
8789,4,shop,19,21,2
8789,5,home,21,24,3
8789,6,<ENDS>,24,24,0
8790,0,<START>,0,0,0
8790,1,home,0,8,8
8790,2,work,8,16,8
8790,3,home,16,23,7
8790,4,work,23,24,1
8790,5,<ENDS>,24,24,0
8791,0,<START>,0,0,0
8791,1,home,0,9,9
8791,2,work,9,16,7
8791,3,home,16,24,8
8791,4,<ENDS>,24,24,0
8792,0,<START>,0,0,0
8792,1,home,0,7,7
8792,2,shop,7,8,1
8792,3,education,8,11,3
8792,4,home,11,17,6
8792,5,shop,17,19,2
8792,6,home,19,24,5
8792,7,<ENDS>,24,24,0
8793,0,<START>,0,0,0
8793,1,home,0,7,7
8793,2,education,7,11,4
8793,3,home,11,13,2
8793,4,education,13,16,3
8793,5,home,16,24,8
8793,6,<ENDS>,24,24,0
8794,0,<START>,0,0,0
8794,1,home,0,7,7
8794,2,work,7,13,6
8794,3,home,13,24,11
8794,4,<ENDS>,24,24,0
8795,0,<START>,0,0,0
8795,1,home,0,6,6
8795,2,work,6,13,7
8795,3,shop,13,14,1
8795,4,work,14,19,5
8795,5,home,19,24,5
8795,6,<ENDS>,24,24,0
8796,0,<START>,0,0,0
8796,1,home,0,6,6
8796,2,shop,6,7,1
8796,3,work,7,14,7
8796,4,home,14,24,10
8796,5,<ENDS>,24,24,0
8797,0,<START>,0,0,0
8797,1,home,0,8,8
8797,2,education,8,11,3
8797,3,home,11,18,7
8797,4,shop,18,19,1
8797,5,home,19,24,5
8797,6,<ENDS>,24,24,0
8798,0,<START>,0,0,0
8798,1,home,0,7,7
8798,2,work,7,13,6
8798,3,shop,13,14,1
8798,4,work,14,19,5
8798,5,education,19,20,1
8798,6,home,20,24,4
8798,7,<ENDS>,24,24,0
8799,0,<START>,0,0,0
8799,1,home,0,7,7
8799,2,shop,7,8,1
8799,3,work,8,15,7
8799,4,home,15,18,3
8799,5,work,18,20,2
8799,6,home,20,24,4
8799,7,<ENDS>,24,24,0
8800,0,<START>,0,0,0
8800,1,home,0,8,8
8800,2,work,8,15,7
8800,3,shop,15,16,1
8800,4,work,16,20,4
8800,5,home,20,24,4
8800,6,<ENDS>,24,24,0
8801,0,<START>,0,0,0
8801,1,home,0,7,7
8801,2,work,7,13,6
8801,3,home,13,17,4
8801,4,work,17,20,3
8801,5,home,20,24,4
8801,6,<ENDS>,24,24,0
8802,0,<START>,0,0,0
8802,1,home,0,6,6
8802,2,shop,6,7,1
8802,3,work,7,14,7
8802,4,home,14,21,7
8802,5,work,21,22,1
8802,6,home,22,24,2
8802,7,<ENDS>,24,24,0
8803,0,<START>,0,0,0
8803,1,home,0,7,7
8803,2,work,7,13,6
8803,3,shop,13,14,1
8803,4,home,14,24,10
8803,5,<ENDS>,24,24,0
8804,0,<START>,0,0,0
8804,1,home,0,6,6
8804,2,work,6,13,7
8804,3,home,13,24,11
8804,4,<ENDS>,24,24,0
8805,0,<START>,0,0,0
8805,1,home,0,9,9
8805,2,education,9,12,3
8805,3,home,12,24,12
8805,4,<ENDS>,24,24,0
8806,0,<START>,0,0,0
8806,1,home,0,7,7
8806,2,education,7,11,4
8806,3,home,11,14,3
8806,4,education,14,16,2
8806,5,home,16,24,8
8806,6,<ENDS>,24,24,0
8807,0,<START>,0,0,0
8807,1,home,0,7,7
8807,2,work,7,13,6
8807,3,home,13,24,11
8807,4,<ENDS>,24,24,0
8808,0,<START>,0,0,0
8808,1,home,0,7,7
8808,2,work,7,13,6
8808,3,shop,13,14,1
8808,4,home,14,21,7
8808,5,shop,21,22,1
8808,6,home,22,24,2
8808,7,<ENDS>,24,24,0
8809,0,<START>,0,0,0
8809,1,home,0,7,7
8809,2,work,7,13,6
8809,3,home,13,24,11
8809,4,<ENDS>,24,24,0
8810,0,<START>,0,0,0
8810,1,home,0,6,6
8810,2,work,6,12,6
8810,3,shop,12,13,1
8810,4,work,13,19,6
8810,5,home,19,24,5
8810,6,<ENDS>,24,24,0
8811,0,<START>,0,0,0
8811,1,home,0,6,6
8811,2,work,6,8,2
8811,3,home,8,12,4
8811,4,work,12,15,3
8811,5,home,15,21,6
8811,6,work,21,22,1
8811,7,home,22,24,2
8811,8,<ENDS>,24,24,0
8812,0,<START>,0,0,0
8812,1,home,0,6,6
8812,2,work,6,13,7
8812,3,shop,13,14,1
8812,4,home,14,17,3
8812,5,work,17,19,2
8812,6,home,19,24,5
8812,7,<ENDS>,24,24,0
8813,0,<START>,0,0,0
8813,1,home,0,6,6
8813,2,work,6,8,2
8813,3,home,8,15,7
8813,4,work,15,18,3
8813,5,home,18,24,6
8813,6,<ENDS>,24,24,0
8814,0,<START>,0,0,0
8814,1,home,0,7,7
8814,2,work,7,13,6
8814,3,shop,13,14,1
8814,4,work,14,20,6
8814,5,home,20,24,4
8814,6,<ENDS>,24,24,0
8815,0,<START>,0,0,0
8815,1,home,0,8,8
8815,2,shop,8,9,1
8815,3,work,9,16,7
8815,4,home,16,21,5
8815,5,work,21,22,1
8815,6,home,22,24,2
8815,7,<ENDS>,24,24,0
8816,0,<START>,0,0,0
8816,1,home,0,7,7
8816,2,education,7,10,3
8816,3,home,10,17,7
8816,4,shop,17,19,2
8816,5,home,19,24,5
8816,6,<ENDS>,24,24,0
8817,0,<START>,0,0,0
8817,1,home,0,7,7
8817,2,education,7,11,4
8817,3,home,11,16,5
8817,4,shop,16,17,1
8817,5,home,17,24,7
8817,6,<ENDS>,24,24,0
8818,0,<START>,0,0,0
8818,1,home,0,7,7
8818,2,work,7,13,6
8818,3,shop,13,14,1
8818,4,home,14,24,10
8818,5,<ENDS>,24,24,0
8819,0,<START>,0,0,0
8819,1,home,0,7,7
8819,2,education,7,11,4
8819,3,home,11,17,6
8819,4,shop,17,18,1
8819,5,home,18,24,6
8819,6,<ENDS>,24,24,0
8820,0,<START>,0,0,0
8820,1,work,0,1,1
8820,2,home,1,7,6
8820,3,education,7,11,4
8820,4,home,11,17,6
8820,5,shop,17,18,1
8820,6,home,18,24,6
8820,7,<ENDS>,24,24,0
8821,0,<START>,0,0,0
8821,1,home,0,7,7
8821,2,shop,7,8,1
8821,3,education,8,13,5
8821,4,home,13,24,11
8821,5,<ENDS>,24,24,0
8822,0,<START>,0,0,0
8822,1,home,0,7,7
8822,2,shop,7,8,1
8822,3,education,8,12,4
8822,4,shop,12,14,2
8822,5,education,14,15,1
8822,6,shop,15,16,1
8822,7,home,16,24,8
8822,8,<ENDS>,24,24,0
8823,0,<START>,0,0,0
8823,1,home,0,8,8
8823,2,shop,8,9,1
8823,3,work,9,15,6
8823,4,home,15,24,9
8823,5,<ENDS>,24,24,0
8824,0,<START>,0,0,0
8824,1,home,0,7,7
8824,2,work,7,14,7
8824,3,home,14,24,10
8824,4,<ENDS>,24,24,0
8825,0,<START>,0,0,0
8825,1,home,0,8,8
8825,2,shop,8,9,1
8825,3,home,9,14,5
8825,4,work,14,20,6
8825,5,home,20,24,4
8825,6,<ENDS>,24,24,0
8826,0,<START>,0,0,0
8826,1,home,0,7,7
8826,2,shop,7,9,2
8826,3,education,9,13,4
8826,4,shop,13,15,2
8826,5,home,15,24,9
8826,6,<ENDS>,24,24,0
8827,0,<START>,0,0,0
8827,1,home,0,6,6
8827,2,work,6,13,7
8827,3,shop,13,14,1
8827,4,work,14,19,5
8827,5,home,19,24,5
8827,6,<ENDS>,24,24,0
8828,0,<START>,0,0,0
8828,1,home,0,7,7
8828,2,work,7,13,6
8828,3,shop,13,14,1
8828,4,home,14,21,7
8828,5,work,21,22,1
8828,6,home,22,24,2
8828,7,<ENDS>,24,24,0
8829,0,<START>,0,0,0
8829,1,home,0,9,9
8829,2,education,9,15,6
8829,3,work,15,20,5
8829,4,home,20,24,4
8829,5,<ENDS>,24,24,0
8830,0,<START>,0,0,0
8830,1,home,0,6,6
8830,2,work,6,13,7
8830,3,home,13,24,11
8830,4,<ENDS>,24,24,0
8831,0,<START>,0,0,0
8831,1,home,0,7,7
8831,2,work,7,14,7
8831,3,shop,14,15,1
8831,4,home,15,18,3
8831,5,work,18,19,1
8831,6,home,19,24,5
8831,7,<ENDS>,24,24,0
8832,0,<START>,0,0,0
8832,1,home,0,7,7
8832,2,education,7,12,5
8832,3,shop,12,14,2
8832,4,education,14,16,2
8832,5,shop,16,17,1
8832,6,home,17,24,7
8832,7,<ENDS>,24,24,0
8833,0,<START>,0,0,0
8833,1,home,0,8,8
8833,2,shop,8,9,1
8833,3,home,9,13,4
8833,4,work,13,19,6
8833,5,home,19,24,5
8833,6,<ENDS>,24,24,0
8834,0,<START>,0,0,0
8834,1,home,0,6,6
8834,2,work,6,12,6
8834,3,shop,12,13,1
8834,4,work,13,19,6
8834,5,home,19,24,5
8834,6,<ENDS>,24,24,0
8835,0,<START>,0,0,0
8835,1,home,0,7,7
8835,2,work,7,13,6
8835,3,shop,13,14,1
8835,4,work,14,19,5
8835,5,home,19,24,5
8835,6,<ENDS>,24,24,0
8836,0,<START>,0,0,0
8836,1,home,0,6,6
8836,2,work,6,9,3
8836,3,home,9,15,6
8836,4,work,15,17,2
8836,5,home,17,23,6
8836,6,work,23,24,1
8836,7,<ENDS>,24,24,0
8837,0,<START>,0,0,0
8837,1,home,0,7,7
8837,2,work,7,13,6
8837,3,shop,13,14,1
8837,4,work,14,20,6
8837,5,home,20,24,4
8837,6,<ENDS>,24,24,0
8838,0,<START>,0,0,0
8838,1,home,0,7,7
8838,2,work,7,14,7
8838,3,shop,14,15,1
8838,4,home,15,21,6
8838,5,work,21,22,1
8838,6,home,22,24,2
8838,7,<ENDS>,24,24,0
8839,0,<START>,0,0,0
8839,1,home,0,7,7
8839,2,work,7,9,2
8839,3,home,9,13,4
8839,4,work,13,15,2
8839,5,home,15,22,7
8839,6,work,22,23,1
8839,7,home,23,24,1
8839,8,<ENDS>,24,24,0
8840,0,<START>,0,0,0
8840,1,home,0,8,8
8840,2,work,8,15,7
8840,3,home,15,24,9
8840,4,<ENDS>,24,24,0
8841,0,<START>,0,0,0
8841,1,home,0,6,6
8841,2,work,6,13,7
8841,3,home,13,14,1
8841,4,work,14,20,6
8841,5,home,20,24,4
8841,6,<ENDS>,24,24,0
8842,0,<START>,0,0,0
8842,1,home,0,7,7
8842,2,work,7,13,6
8842,3,home,13,24,11
8842,4,<ENDS>,24,24,0
8843,0,<START>,0,0,0
8843,1,home,0,6,6
8843,2,shop,6,7,1
8843,3,home,7,13,6
8843,4,education,13,17,4
8843,5,home,17,21,4
8843,6,shop,21,22,1
8843,7,home,22,24,2
8843,8,<ENDS>,24,24,0
8844,0,<START>,0,0,0
8844,1,home,0,6,6
8844,2,shop,6,7,1
8844,3,home,7,9,2
8844,4,work,9,16,7
8844,5,home,16,24,8
8844,6,<ENDS>,24,24,0
8845,0,<START>,0,0,0
8845,1,home,0,6,6
8845,2,work,6,13,7
8845,3,shop,13,14,1
8845,4,work,14,19,5
8845,5,home,19,24,5
8845,6,<ENDS>,24,24,0
8846,0,<START>,0,0,0
8846,1,home,0,6,6
8846,2,work,6,8,2
8846,3,home,8,11,3
8846,4,work,11,12,1
8846,5,home,12,14,2
8846,6,work,14,15,1
8846,7,shop,15,16,1
8846,8,home,16,23,7
8846,9,work,23,24,1
8846,10,<ENDS>,24,24,0
8847,0,<START>,0,0,0
8847,1,home,0,6,6
8847,2,work,6,8,2
8847,3,home,8,9,1
8847,4,work,9,11,2
8847,5,home,11,15,4
8847,6,work,15,18,3
8847,7,home,18,24,6
8847,8,<ENDS>,24,24,0
8848,0,<START>,0,0,0
8848,1,home,0,6,6
8848,2,work,6,8,2
8848,3,home,8,13,5
8848,4,work,13,15,2
8848,5,home,15,23,8
8848,6,work,23,24,1
8848,7,<ENDS>,24,24,0
8849,0,<START>,0,0,0
8849,1,home,0,6,6
8849,2,work,6,13,7
8849,3,shop,13,15,2
8849,4,home,15,24,9
8849,5,<ENDS>,24,24,0
8850,0,<START>,0,0,0
8850,1,home,0,7,7
8850,2,shop,7,8,1
8850,3,work,8,14,6
8850,4,home,14,15,1
8850,5,shop,15,16,1
8850,6,home,16,24,8
8850,7,<ENDS>,24,24,0
8851,0,<START>,0,0,0
8851,1,home,0,9,9
8851,2,work,9,15,6
8851,3,shop,15,16,1
8851,4,home,16,24,8
8851,5,<ENDS>,24,24,0
8852,0,<START>,0,0,0
8852,1,home,0,8,8
8852,2,work,8,14,6
8852,3,shop,14,15,1
8852,4,home,15,24,9
8852,5,<ENDS>,24,24,0
8853,0,<START>,0,0,0
8853,1,home,0,8,8
8853,2,work,8,14,6
8853,3,home,14,24,10
8853,4,<ENDS>,24,24,0
8854,0,<START>,0,0,0
8854,1,home,0,6,6
8854,2,work,6,13,7
8854,3,shop,13,14,1
8854,4,work,14,20,6
8854,5,home,20,24,4
8854,6,<ENDS>,24,24,0
8855,0,<START>,0,0,0
8855,1,home,0,7,7
8855,2,work,7,13,6
8855,3,home,13,22,9
8855,4,work,22,23,1
8855,5,home,23,24,1
8855,6,<ENDS>,24,24,0
8856,0,<START>,0,0,0
8856,1,home,0,8,8
8856,2,work,8,14,6
8856,3,home,14,21,7
8856,4,work,21,22,1
8856,5,home,22,24,2
8856,6,<ENDS>,24,24,0
8857,0,<START>,0,0,0
8857,1,home,0,7,7
8857,2,work,7,14,7
8857,3,home,14,24,10
8857,4,<ENDS>,24,24,0
8858,0,<START>,0,0,0
8858,1,home,0,8,8
8858,2,education,8,11,3
8858,3,home,11,15,4
8858,4,work,15,20,5
8858,5,home,20,24,4
8858,6,<ENDS>,24,24,0
8859,0,<START>,0,0,0
8859,1,home,0,6,6
8859,2,work,6,13,7
8859,3,shop,13,14,1
8859,4,home,14,24,10
8859,5,<ENDS>,24,24,0
8860,0,<START>,0,0,0
8860,1,home,0,7,7
8860,2,work,7,9,2
8860,3,home,9,13,4
8860,4,work,13,15,2
8860,5,home,15,21,6
8860,6,work,21,22,1
8860,7,home,22,24,2
8860,8,<ENDS>,24,24,0
8861,0,<START>,0,0,0
8861,1,home,0,7,7
8861,2,work,7,14,7
8861,3,home,14,16,2
8861,4,work,16,20,4
8861,5,home,20,24,4
8861,6,<ENDS>,24,24,0
8862,0,<START>,0,0,0
8862,1,home,0,6,6
8862,2,work,6,13,7
8862,3,home,13,17,4
8862,4,work,17,20,3
8862,5,home,20,24,4
8862,6,<ENDS>,24,24,0
8863,0,<START>,0,0,0
8863,1,home,0,7,7
8863,2,work,7,8,1
8863,3,home,8,14,6
8863,4,work,14,16,2
8863,5,shop,16,17,1
8863,6,home,17,24,7
8863,7,<ENDS>,24,24,0
8864,0,<START>,0,0,0
8864,1,home,0,6,6
8864,2,shop,6,7,1
8864,3,home,7,13,6
8864,4,education,13,16,3
8864,5,home,16,24,8
8864,6,<ENDS>,24,24,0
8865,0,<START>,0,0,0
8865,1,home,0,6,6
8865,2,work,6,13,7
8865,3,shop,13,14,1
8865,4,work,14,19,5
8865,5,home,19,24,5
8865,6,<ENDS>,24,24,0
8866,0,<START>,0,0,0
8866,1,home,0,8,8
8866,2,work,8,14,6
8866,3,shop,14,15,1
8866,4,work,15,19,4
8866,5,home,19,24,5
8866,6,<ENDS>,24,24,0
8867,0,<START>,0,0,0
8867,1,home,0,6,6
8867,2,shop,6,7,1
8867,3,home,7,13,6
8867,4,education,13,16,3
8867,5,shop,16,18,2
8867,6,home,18,24,6
8867,7,<ENDS>,24,24,0
8868,0,<START>,0,0,0
8868,1,home,0,6,6
8868,2,work,6,8,2
8868,3,home,8,13,5
8868,4,work,13,15,2
8868,5,home,15,23,8
8868,6,work,23,24,1
8868,7,<ENDS>,24,24,0
8869,0,<START>,0,0,0
8869,1,home,0,6,6
8869,2,work,6,13,7
8869,3,home,13,24,11
8869,4,<ENDS>,24,24,0
8870,0,<START>,0,0,0
8870,1,home,0,6,6
8870,2,shop,6,7,1
8870,3,home,7,9,2
8870,4,education,9,12,3
8870,5,home,12,18,6
8870,6,shop,18,19,1
8870,7,home,19,24,5
8870,8,<ENDS>,24,24,0
8871,0,<START>,0,0,0
8871,1,home,0,6,6
8871,2,shop,6,7,1
8871,3,home,7,10,3
8871,4,education,10,12,2
8871,5,home,12,19,7
8871,6,shop,19,20,1
8871,7,home,20,24,4
8871,8,<ENDS>,24,24,0
8872,0,<START>,0,0,0
8872,1,home,0,8,8
8872,2,work,8,14,6
8872,3,home,14,24,10
8872,4,<ENDS>,24,24,0
8873,0,<START>,0,0,0
8873,1,home,0,7,7
8873,2,work,7,14,7
8873,3,home,14,22,8
8873,4,work,22,23,1
8873,5,home,23,24,1
8873,6,<ENDS>,24,24,0
8874,0,<START>,0,0,0
8874,1,home,0,7,7
8874,2,work,7,9,2
8874,3,home,9,14,5
8874,4,work,14,17,3
8874,5,home,17,23,6
8874,6,work,23,24,1
8874,7,<ENDS>,24,24,0
8875,0,<START>,0,0,0
8875,1,home,0,6,6
8875,2,work,6,14,8
8875,3,shop,14,15,1
8875,4,home,15,21,6
8875,5,shop,21,22,1
8875,6,home,22,24,2
8875,7,<ENDS>,24,24,0
8876,0,<START>,0,0,0
8876,1,home,0,7,7
8876,2,work,7,8,1
8876,3,home,8,14,6
8876,4,work,14,17,3
8876,5,home,17,21,4
8876,6,work,21,22,1
8876,7,home,22,24,2
8876,8,<ENDS>,24,24,0
8877,0,<START>,0,0,0
8877,1,home,0,7,7
8877,2,work,7,14,7
8877,3,home,14,24,10
8877,4,<ENDS>,24,24,0
8878,0,<START>,0,0,0
8878,1,home,0,6,6
8878,2,shop,6,7,1
8878,3,home,7,9,2
8878,4,education,9,13,4
8878,5,shop,13,14,1
8878,6,education,14,16,2
8878,7,home,16,24,8
8878,8,<ENDS>,24,24,0
8879,0,<START>,0,0,0
8879,1,home,0,6,6
8879,2,work,6,13,7
8879,3,home,13,17,4
8879,4,work,17,20,3
8879,5,home,20,24,4
8879,6,<ENDS>,24,24,0
8880,0,<START>,0,0,0
8880,1,home,0,8,8
8880,2,work,8,14,6
8880,3,home,14,24,10
8880,4,<ENDS>,24,24,0
8881,0,<START>,0,0,0
8881,1,home,0,6,6
8881,2,work,6,13,7
8881,3,shop,13,14,1
8881,4,work,14,20,6
8881,5,home,20,24,4
8881,6,<ENDS>,24,24,0
8882,0,<START>,0,0,0
8882,1,home,0,7,7
8882,2,work,7,14,7
8882,3,shop,14,15,1
8882,4,home,15,24,9
8882,5,<ENDS>,24,24,0
8883,0,<START>,0,0,0
8883,1,home,0,7,7
8883,2,education,7,11,4
8883,3,home,11,19,8
8883,4,shop,19,21,2
8883,5,home,21,24,3
8883,6,<ENDS>,24,24,0
8884,0,<START>,0,0,0
8884,1,home,0,9,9
8884,2,work,9,16,7
8884,3,home,16,24,8
8884,4,<ENDS>,24,24,0
8885,0,<START>,0,0,0
8885,1,home,0,6,6
8885,2,work,6,8,2
8885,3,home,8,14,6
8885,4,work,14,16,2
8885,5,home,16,24,8
8885,6,<ENDS>,24,24,0
8886,0,<START>,0,0,0
8886,1,home,0,7,7
8886,2,education,7,11,4
8886,3,home,11,17,6
8886,4,shop,17,19,2
8886,5,home,19,24,5
8886,6,<ENDS>,24,24,0
8887,0,<START>,0,0,0
8887,1,home,0,7,7
8887,2,shop,7,9,2
8887,3,education,9,11,2
8887,4,home,11,17,6
8887,5,shop,17,18,1
8887,6,home,18,24,6
8887,7,<ENDS>,24,24,0
8888,0,<START>,0,0,0
8888,1,home,0,7,7
8888,2,work,7,14,7
8888,3,home,14,23,9
8888,4,work,23,24,1
8888,5,<ENDS>,24,24,0
8889,0,<START>,0,0,0
8889,1,home,0,6,6
8889,2,work,6,13,7
8889,3,shop,13,14,1
8889,4,work,14,20,6
8889,5,home,20,24,4
8889,6,<ENDS>,24,24,0
8890,0,<START>,0,0,0
8890,1,home,0,6,6
8890,2,shop,6,7,1
8890,3,home,7,9,2
8890,4,education,9,11,2
8890,5,home,11,19,8
8890,6,shop,19,20,1
8890,7,home,20,24,4
8890,8,<ENDS>,24,24,0
8891,0,<START>,0,0,0
8891,1,home,0,7,7
8891,2,work,7,15,8
8891,3,home,15,24,9
8891,4,<ENDS>,24,24,0
8892,0,<START>,0,0,0
8892,1,home,0,7,7
8892,2,education,7,11,4
8892,3,home,11,18,7
8892,4,shop,18,19,1
8892,5,home,19,24,5
8892,6,<ENDS>,24,24,0
8893,0,<START>,0,0,0
8893,1,home,0,6,6
8893,2,work,6,13,7
8893,3,home,13,18,5
8893,4,work,18,19,1
8893,5,home,19,24,5
8893,6,<ENDS>,24,24,0
8894,0,<START>,0,0,0
8894,1,home,0,6,6
8894,2,shop,6,7,1
8894,3,home,7,9,2
8894,4,education,9,12,3
8894,5,home,12,17,5
8894,6,shop,17,18,1
8894,7,home,18,24,6
8894,8,<ENDS>,24,24,0
8895,0,<START>,0,0,0
8895,1,home,0,6,6
8895,2,work,6,14,8
8895,3,home,14,24,10
8895,4,<ENDS>,24,24,0
8896,0,<START>,0,0,0
8896,1,home,0,6,6
8896,2,work,6,13,7
8896,3,shop,13,14,1
8896,4,work,14,19,5
8896,5,home,19,24,5
8896,6,<ENDS>,24,24,0
8897,0,<START>,0,0,0
8897,1,home,0,7,7
8897,2,work,7,9,2
8897,3,home,9,13,4
8897,4,work,13,15,2
8897,5,home,15,24,9
8897,6,<ENDS>,24,24,0
8898,0,<START>,0,0,0
8898,1,home,0,6,6
8898,2,shop,6,7,1
8898,3,home,7,8,1
8898,4,work,8,13,5
8898,5,home,13,24,11
8898,6,<ENDS>,24,24,0
8899,0,<START>,0,0,0
8899,1,home,0,7,7
8899,2,shop,7,8,1
8899,3,work,8,15,7
8899,4,home,15,24,9
8899,5,<ENDS>,24,24,0
8900,0,<START>,0,0,0
8900,1,home,0,8,8
8900,2,shop,8,9,1
8900,3,work,9,16,7
8900,4,home,16,22,6
8900,5,work,22,23,1
8900,6,home,23,24,1
8900,7,<ENDS>,24,24,0
8901,0,<START>,0,0,0
8901,1,home,0,6,6
8901,2,work,6,8,2
8901,3,home,8,12,4
8901,4,work,12,14,2
8901,5,home,14,21,7
8901,6,work,21,22,1
8901,7,home,22,24,2
8901,8,<ENDS>,24,24,0
8902,0,<START>,0,0,0
8902,1,home,0,8,8
8902,2,shop,8,9,1
8902,3,work,9,16,7
8902,4,home,16,24,8
8902,5,<ENDS>,24,24,0
8903,0,<START>,0,0,0
8903,1,home,0,8,8
8903,2,work,8,14,6
8903,3,home,14,24,10
8903,4,<ENDS>,24,24,0
8904,0,<START>,0,0,0
8904,1,home,0,8,8
8904,2,work,8,15,7
8904,3,shop,15,16,1
8904,4,work,16,20,4
8904,5,home,20,24,4
8904,6,<ENDS>,24,24,0
8905,0,<START>,0,0,0
8905,1,home,0,6,6
8905,2,work,6,8,2
8905,3,home,8,9,1
8905,4,work,9,11,2
8905,5,home,11,14,3
8905,6,work,14,16,2
8905,7,home,16,23,7
8905,8,work,23,24,1
8905,9,<ENDS>,24,24,0
8906,0,<START>,0,0,0
8906,1,home,0,6,6
8906,2,work,6,13,7
8906,3,shop,13,15,2
8906,4,work,15,19,4
8906,5,education,19,20,1
8906,6,home,20,24,4
8906,7,<ENDS>,24,24,0
8907,0,<START>,0,0,0
8907,1,home,0,6,6
8907,2,shop,6,7,1
8907,3,home,7,13,6
8907,4,education,13,16,3
8907,5,home,16,24,8
8907,6,<ENDS>,24,24,0
8908,0,<START>,0,0,0
8908,1,home,0,7,7
8908,2,work,7,13,6
8908,3,home,13,23,10
8908,4,work,23,24,1
8908,5,<ENDS>,24,24,0
8909,0,<START>,0,0,0
8909,1,home,0,9,9
8909,2,work,9,16,7
8909,3,home,16,21,5
8909,4,work,21,22,1
8909,5,home,22,24,2
8909,6,<ENDS>,24,24,0
8910,0,<START>,0,0,0
8910,1,home,0,8,8
8910,2,work,8,15,7
8910,3,home,15,22,7
8910,4,work,22,23,1
8910,5,home,23,24,1
8910,6,<ENDS>,24,24,0
8911,0,<START>,0,0,0
8911,1,home,0,6,6
8911,2,shop,6,8,2
8911,3,home,8,21,13
8911,4,work,21,22,1
8911,5,home,22,24,2
8911,6,<ENDS>,24,24,0
8912,0,<START>,0,0,0
8912,1,home,0,8,8
8912,2,work,8,15,7
8912,3,shop,15,16,1
8912,4,home,16,23,7
8912,5,work,23,24,1
8912,6,<ENDS>,24,24,0
8913,0,<START>,0,0,0
8913,1,home,0,7,7
8913,2,shop,7,9,2
8913,3,education,9,13,4
8913,4,home,13,21,8
8913,5,shop,21,22,1
8913,6,home,22,24,2
8913,7,<ENDS>,24,24,0
8914,0,<START>,0,0,0
8914,1,home,0,8,8
8914,2,work,8,13,5
8914,3,home,13,15,2
8914,4,work,15,20,5
8914,5,home,20,24,4
8914,6,<ENDS>,24,24,0
8915,0,<START>,0,0,0
8915,1,home,0,8,8
8915,2,education,8,14,6
8915,3,shop,14,15,1
8915,4,home,15,22,7
8915,5,work,22,23,1
8915,6,home,23,24,1
8915,7,<ENDS>,24,24,0
8916,0,<START>,0,0,0
8916,1,home,0,6,6
8916,2,work,6,8,2
8916,3,home,8,12,4
8916,4,work,12,14,2
8916,5,home,14,21,7
8916,6,work,21,22,1
8916,7,home,22,24,2
8916,8,<ENDS>,24,24,0
8917,0,<START>,0,0,0
8917,1,home,0,8,8
8917,2,work,8,14,6
8917,3,shop,14,15,1
8917,4,work,15,20,5
8917,5,home,20,24,4
8917,6,<ENDS>,24,24,0
8918,0,<START>,0,0,0
8918,1,home,0,7,7
8918,2,work,7,13,6
8918,3,shop,13,14,1
8918,4,home,14,24,10
8918,5,<ENDS>,24,24,0
8919,0,<START>,0,0,0
8919,1,home,0,6,6
8919,2,work,6,8,2
8919,3,home,8,13,5
8919,4,work,13,15,2
8919,5,home,15,21,6
8919,6,work,21,22,1
8919,7,home,22,24,2
8919,8,<ENDS>,24,24,0
8920,0,<START>,0,0,0
8920,1,home,0,6,6
8920,2,work,6,13,7
8920,3,home,13,24,11
8920,4,<ENDS>,24,24,0
8921,0,<START>,0,0,0
8921,1,home,0,6,6
8921,2,shop,6,7,1
8921,3,home,7,9,2
8921,4,education,9,12,3
8921,5,home,12,19,7
8921,6,shop,19,20,1
8921,7,home,20,24,4
8921,8,<ENDS>,24,24,0
8922,0,<START>,0,0,0
8922,1,home,0,7,7
8922,2,work,7,13,6
8922,3,home,13,24,11
8922,4,<ENDS>,24,24,0
8923,0,<START>,0,0,0
8923,1,home,0,7,7
8923,2,shop,7,9,2
8923,3,education,9,11,2
8923,4,home,11,20,9
8923,5,shop,20,21,1
8923,6,home,21,24,3
8923,7,<ENDS>,24,24,0
8924,0,<START>,0,0,0
8924,1,home,0,6,6
8924,2,work,6,15,9
8924,3,shop,15,16,1
8924,4,home,16,23,7
8924,5,work,23,24,1
8924,6,<ENDS>,24,24,0
8925,0,<START>,0,0,0
8925,1,home,0,7,7
8925,2,shop,7,8,1
8925,3,education,8,12,4
8925,4,home,12,19,7
8925,5,shop,19,21,2
8925,6,home,21,24,3
8925,7,<ENDS>,24,24,0
8926,0,<START>,0,0,0
8926,1,home,0,7,7
8926,2,work,7,13,6
8926,3,home,13,17,4
8926,4,work,17,20,3
8926,5,home,20,24,4
8926,6,<ENDS>,24,24,0
8927,0,<START>,0,0,0
8927,1,home,0,8,8
8927,2,education,8,12,4
8927,3,home,12,16,4
8927,4,work,16,20,4
8927,5,home,20,24,4
8927,6,<ENDS>,24,24,0
8928,0,<START>,0,0,0
8928,1,home,0,6,6
8928,2,work,6,13,7
8928,3,home,13,24,11
8928,4,<ENDS>,24,24,0
8929,0,<START>,0,0,0
8929,1,home,0,7,7
8929,2,work,7,14,7
8929,3,shop,14,15,1
8929,4,home,15,24,9
8929,5,<ENDS>,24,24,0
8930,0,<START>,0,0,0
8930,1,home,0,8,8
8930,2,work,8,14,6
8930,3,shop,14,15,1
8930,4,home,15,21,6
8930,5,work,21,22,1
8930,6,home,22,24,2
8930,7,<ENDS>,24,24,0
8931,0,<START>,0,0,0
8931,1,home,0,6,6
8931,2,shop,6,7,1
8931,3,home,7,13,6
8931,4,education,13,16,3
8931,5,shop,16,18,2
8931,6,home,18,24,6
8931,7,<ENDS>,24,24,0
8932,0,<START>,0,0,0
8932,1,home,0,7,7
8932,2,shop,7,8,1
8932,3,work,8,13,5
8932,4,home,13,24,11
8932,5,<ENDS>,24,24,0
8933,0,<START>,0,0,0
8933,1,home,0,6,6
8933,2,work,6,14,8
8933,3,home,14,24,10
8933,4,<ENDS>,24,24,0
8934,0,<START>,0,0,0
8934,1,home,0,7,7
8934,2,work,7,14,7
8934,3,home,14,24,10
8934,4,<ENDS>,24,24,0
8935,0,<START>,0,0,0
8935,1,home,0,9,9
8935,2,work,9,16,7
8935,3,home,16,24,8
8935,4,<ENDS>,24,24,0
8936,0,<START>,0,0,0
8936,1,home,0,7,7
8936,2,work,7,14,7
8936,3,shop,14,15,1
8936,4,home,15,24,9
8936,5,<ENDS>,24,24,0
8937,0,<START>,0,0,0
8937,1,home,0,7,7
8937,2,work,7,13,6
8937,3,home,13,24,11
8937,4,<ENDS>,24,24,0
8938,0,<START>,0,0,0
8938,1,home,0,6,6
8938,2,shop,6,7,1
8938,3,home,7,10,3
8938,4,education,10,16,6
8938,5,home,16,24,8
8938,6,<ENDS>,24,24,0
8939,0,<START>,0,0,0
8939,1,home,0,6,6
8939,2,shop,6,7,1
8939,3,home,7,10,3
8939,4,education,10,11,1
8939,5,home,11,18,7
8939,6,shop,18,19,1
8939,7,home,19,24,5
8939,8,<ENDS>,24,24,0
8940,0,<START>,0,0,0
8940,1,home,0,6,6
8940,2,work,6,13,7
8940,3,home,13,24,11
8940,4,<ENDS>,24,24,0
8941,0,<START>,0,0,0
8941,1,home,0,6,6
8941,2,work,6,13,7
8941,3,shop,13,14,1
8941,4,home,14,24,10
8941,5,<ENDS>,24,24,0
8942,0,<START>,0,0,0
8942,1,home,0,8,8
8942,2,education,8,11,3
8942,3,home,11,18,7
8942,4,shop,18,19,1
8942,5,home,19,24,5
8942,6,<ENDS>,24,24,0
8943,0,<START>,0,0,0
8943,1,home,0,7,7
8943,2,work,7,14,7
8943,3,shop,14,15,1
8943,4,work,15,20,5
8943,5,home,20,24,4
8943,6,<ENDS>,24,24,0
8944,0,<START>,0,0,0
8944,1,home,0,6,6
8944,2,work,6,7,1
8944,3,home,7,9,2
8944,4,work,9,11,2
8944,5,home,11,17,6
8944,6,work,17,19,2
8944,7,home,19,24,5
8944,8,<ENDS>,24,24,0
8945,0,<START>,0,0,0
8945,1,home,0,7,7
8945,2,work,7,14,7
8945,3,home,14,17,3
8945,4,work,17,20,3
8945,5,home,20,24,4
8945,6,<ENDS>,24,24,0
8946,0,<START>,0,0,0
8946,1,home,0,8,8
8946,2,work,8,16,8
8946,3,home,16,24,8
8946,4,<ENDS>,24,24,0
8947,0,<START>,0,0,0
8947,1,work,0,9,9
8947,2,shop,9,10,1
8947,3,work,10,17,7
8947,4,home,17,24,7
8947,5,<ENDS>,24,24,0
8948,0,<START>,0,0,0
8948,1,home,0,7,7
8948,2,work,7,13,6
8948,3,home,13,24,11
8948,4,<ENDS>,24,24,0
8949,0,<START>,0,0,0
8949,1,home,0,8,8
8949,2,work,8,16,8
8949,3,home,16,20,4
8949,4,shop,20,21,1
8949,5,home,21,24,3
8949,6,<ENDS>,24,24,0
8950,0,<START>,0,0,0
8950,1,home,0,8,8
8950,2,education,8,12,4
8950,3,home,12,17,5
8950,4,work,17,20,3
8950,5,home,20,24,4
8950,6,<ENDS>,24,24,0
8951,0,<START>,0,0,0
8951,1,home,0,6,6
8951,2,work,6,7,1
8951,3,home,7,11,4
8951,4,work,11,12,1
8951,5,home,12,17,5
8951,6,work,17,19,2
8951,7,home,19,24,5
8951,8,<ENDS>,24,24,0
8952,0,<START>,0,0,0
8952,1,home,0,9,9
8952,2,work,9,16,7
8952,3,shop,16,17,1
8952,4,home,17,24,7
8952,5,<ENDS>,24,24,0
8953,0,<START>,0,0,0
8953,1,home,0,7,7
8953,2,work,7,14,7
8953,3,shop,14,15,1
8953,4,home,15,24,9
8953,5,<ENDS>,24,24,0
8954,0,<START>,0,0,0
8954,1,home,0,8,8
8954,2,work,8,15,7
8954,3,home,15,24,9
8954,4,<ENDS>,24,24,0
8955,0,<START>,0,0,0
8955,1,home,0,7,7
8955,2,work,7,13,6
8955,3,shop,13,14,1
8955,4,home,14,18,4
8955,5,work,18,20,2
8955,6,home,20,24,4
8955,7,<ENDS>,24,24,0
8956,0,<START>,0,0,0
8956,1,home,0,8,8
8956,2,work,8,15,7
8956,3,home,15,24,9
8956,4,<ENDS>,24,24,0
8957,0,<START>,0,0,0
8957,1,home,0,7,7
8957,2,work,7,14,7
8957,3,shop,14,15,1
8957,4,work,15,19,4
8957,5,home,19,24,5
8957,6,<ENDS>,24,24,0
8958,0,<START>,0,0,0
8958,1,home,0,6,6
8958,2,work,6,13,7
8958,3,shop,13,14,1
8958,4,home,14,21,7
8958,5,shop,21,22,1
8958,6,home,22,24,2
8958,7,<ENDS>,24,24,0
8959,0,<START>,0,0,0
8959,1,home,0,6,6
8959,2,shop,6,7,1
8959,3,work,7,15,8
8959,4,shop,15,16,1
8959,5,work,16,20,4
8959,6,home,20,24,4
8959,7,<ENDS>,24,24,0
8960,0,<START>,0,0,0
8960,1,home,0,8,8
8960,2,work,8,14,6
8960,3,shop,14,15,1
8960,4,work,15,20,5
8960,5,home,20,24,4
8960,6,<ENDS>,24,24,0
8961,0,<START>,0,0,0
8961,1,home,0,7,7
8961,2,work,7,14,7
8961,3,home,14,24,10
8961,4,<ENDS>,24,24,0
8962,0,<START>,0,0,0
8962,1,home,0,7,7
8962,2,education,7,11,4
8962,3,home,11,17,6
8962,4,shop,17,18,1
8962,5,home,18,24,6
8962,6,<ENDS>,24,24,0
8963,0,<START>,0,0,0
8963,1,home,0,9,9
8963,2,work,9,15,6
8963,3,shop,15,16,1
8963,4,work,16,20,4
8963,5,home,20,24,4
8963,6,<ENDS>,24,24,0
8964,0,<START>,0,0,0
8964,1,home,0,9,9
8964,2,work,9,16,7
8964,3,home,16,24,8
8964,4,<ENDS>,24,24,0
8965,0,<START>,0,0,0
8965,1,home,0,8,8
8965,2,work,8,16,8
8965,3,home,16,23,7
8965,4,work,23,24,1
8965,5,<ENDS>,24,24,0
8966,0,<START>,0,0,0
8966,1,home,0,8,8
8966,2,education,8,14,6
8966,3,shop,14,15,1
8966,4,work,15,19,4
8966,5,home,19,24,5
8966,6,<ENDS>,24,24,0
8967,0,<START>,0,0,0
8967,1,home,0,7,7
8967,2,work,7,13,6
8967,3,shop,13,14,1
8967,4,home,14,23,9
8967,5,work,23,24,1
8967,6,<ENDS>,24,24,0
8968,0,<START>,0,0,0
8968,1,home,0,8,8
8968,2,education,8,14,6
8968,3,shop,14,15,1
8968,4,home,15,24,9
8968,5,<ENDS>,24,24,0
8969,0,<START>,0,0,0
8969,1,home,0,7,7
8969,2,education,7,12,5
8969,3,home,12,20,8
8969,4,shop,20,21,1
8969,5,home,21,24,3
8969,6,<ENDS>,24,24,0
8970,0,<START>,0,0,0
8970,1,home,0,7,7
8970,2,work,7,13,6
8970,3,shop,13,14,1
8970,4,work,14,20,6
8970,5,home,20,24,4
8970,6,<ENDS>,24,24,0
8971,0,<START>,0,0,0
8971,1,home,0,6,6
8971,2,shop,6,7,1
8971,3,home,7,8,1
8971,4,education,8,12,4
8971,5,home,12,20,8
8971,6,shop,20,21,1
8971,7,home,21,24,3
8971,8,<ENDS>,24,24,0
8972,0,<START>,0,0,0
8972,1,home,0,7,7
8972,2,education,7,11,4
8972,3,home,11,19,8
8972,4,shop,19,20,1
8972,5,home,20,24,4
8972,6,<ENDS>,24,24,0
8973,0,<START>,0,0,0
8973,1,home,0,8,8
8973,2,work,8,15,7
8973,3,home,15,24,9
8973,4,<ENDS>,24,24,0
8974,0,<START>,0,0,0
8974,1,home,0,6,6
8974,2,work,6,8,2
8974,3,home,8,15,7
8974,4,work,15,17,2
8974,5,home,17,23,6
8974,6,work,23,24,1
8974,7,<ENDS>,24,24,0
8975,0,<START>,0,0,0
8975,1,home,0,7,7
8975,2,work,7,13,6
8975,3,home,13,24,11
8975,4,<ENDS>,24,24,0
8976,0,<START>,0,0,0
8976,1,home,0,8,8
8976,2,work,8,14,6
8976,3,home,14,21,7
8976,4,work,21,22,1
8976,5,home,22,24,2
8976,6,<ENDS>,24,24,0
8977,0,<START>,0,0,0
8977,1,home,0,7,7
8977,2,work,7,13,6
8977,3,home,13,16,3
8977,4,work,16,19,3
8977,5,home,19,24,5
8977,6,<ENDS>,24,24,0
8978,0,<START>,0,0,0
8978,1,home,0,7,7
8978,2,shop,7,8,1
8978,3,work,8,14,6
8978,4,home,14,17,3
8978,5,shop,17,18,1
8978,6,home,18,24,6
8978,7,<ENDS>,24,24,0
8979,0,<START>,0,0,0
8979,1,home,0,8,8
8979,2,work,8,13,5
8979,3,shop,13,14,1
8979,4,work,14,19,5
8979,5,home,19,24,5
8979,6,<ENDS>,24,24,0
8980,0,<START>,0,0,0
8980,1,home,0,7,7
8980,2,work,7,13,6
8980,3,home,13,17,4
8980,4,shop,17,18,1
8980,5,home,18,24,6
8980,6,<ENDS>,24,24,0
8981,0,<START>,0,0,0
8981,1,home,0,9,9
8981,2,work,9,17,8
8981,3,home,17,24,7
8981,4,<ENDS>,24,24,0
8982,0,<START>,0,0,0
8982,1,home,0,7,7
8982,2,work,7,14,7
8982,3,home,14,23,9
8982,4,work,23,24,1
8982,5,<ENDS>,24,24,0
8983,0,<START>,0,0,0
8983,1,home,0,6,6
8983,2,work,6,13,7
8983,3,home,13,20,7
8983,4,shop,20,21,1
8983,5,home,21,24,3
8983,6,<ENDS>,24,24,0
8984,0,<START>,0,0,0
8984,1,home,0,7,7
8984,2,work,7,13,6
8984,3,shop,13,14,1
8984,4,work,14,19,5
8984,5,home,19,24,5
8984,6,<ENDS>,24,24,0
8985,0,<START>,0,0,0
8985,1,home,0,9,9
8985,2,education,9,12,3
8985,3,home,12,24,12
8985,4,<ENDS>,24,24,0
8986,0,<START>,0,0,0
8986,1,home,0,7,7
8986,2,work,7,13,6
8986,3,shop,13,14,1
8986,4,work,14,19,5
8986,5,home,19,24,5
8986,6,<ENDS>,24,24,0
8987,0,<START>,0,0,0
8987,1,home,0,7,7
8987,2,work,7,14,7
8987,3,home,14,22,8
8987,4,work,22,23,1
8987,5,home,23,24,1
8987,6,<ENDS>,24,24,0
8988,0,<START>,0,0,0
8988,1,home,0,7,7
8988,2,shop,7,8,1
8988,3,education,8,12,4
8988,4,home,12,16,4
8988,5,shop,16,17,1
8988,6,home,17,21,4
8988,7,shop,21,22,1
8988,8,home,22,24,2
8988,9,<ENDS>,24,24,0
8989,0,<START>,0,0,0
8989,1,home,0,8,8
8989,2,work,8,13,5
8989,3,home,13,18,5
8989,4,work,18,20,2
8989,5,home,20,24,4
8989,6,<ENDS>,24,24,0
8990,0,<START>,0,0,0
8990,1,home,0,6,6
8990,2,shop,6,7,1
8990,3,work,7,13,6
8990,4,home,13,24,11
8990,5,<ENDS>,24,24,0
8991,0,<START>,0,0,0
8991,1,home,0,8,8
8991,2,work,8,15,7
8991,3,shop,15,16,1
8991,4,home,16,24,8
8991,5,<ENDS>,24,24,0
8992,0,<START>,0,0,0
8992,1,home,0,6,6
8992,2,work,6,13,7
8992,3,shop,13,14,1
8992,4,home,14,24,10
8992,5,<ENDS>,24,24,0
8993,0,<START>,0,0,0
8993,1,home,0,7,7
8993,2,work,7,14,7
8993,3,home,14,24,10
8993,4,<ENDS>,24,24,0
8994,0,<START>,0,0,0
8994,1,home,0,7,7
8994,2,education,7,12,5
8994,3,shop,12,13,1
8994,4,home,13,24,11
8994,5,<ENDS>,24,24,0
8995,0,<START>,0,0,0
8995,1,home,0,7,7
8995,2,shop,7,8,1
8995,3,home,8,9,1
8995,4,work,9,13,4
8995,5,home,13,24,11
8995,6,<ENDS>,24,24,0
8996,0,<START>,0,0,0
8996,1,home,0,6,6
8996,2,work,6,13,7
8996,3,home,13,17,4
8996,4,work,17,20,3
8996,5,home,20,24,4
8996,6,<ENDS>,24,24,0
8997,0,<START>,0,0,0
8997,1,home,0,6,6
8997,2,work,6,13,7
8997,3,shop,13,14,1
8997,4,education,14,16,2
8997,5,shop,16,17,1
8997,6,home,17,24,7
8997,7,<ENDS>,24,24,0
8998,0,<START>,0,0,0
8998,1,home,0,8,8
8998,2,work,8,15,7
8998,3,shop,15,16,1
8998,4,work,16,19,3
8998,5,home,19,24,5
8998,6,<ENDS>,24,24,0
8999,0,<START>,0,0,0
8999,1,home,0,7,7
8999,2,work,7,13,6
8999,3,home,13,22,9
8999,4,work,22,23,1
8999,5,home,23,24,1
8999,6,<ENDS>,24,24,0
9000,0,<START>,0,0,0
9000,1,home,0,6,6
9000,2,shop,6,7,1
9000,3,home,7,9,2
9000,4,education,9,12,3
9000,5,shop,12,13,1
9000,6,education,13,16,3
9000,7,home,16,24,8
9000,8,<ENDS>,24,24,0
9001,0,<START>,0,0,0
9001,1,home,0,7,7
9001,2,work,7,13,6
9001,3,home,13,24,11
9001,4,<ENDS>,24,24,0
9002,0,<START>,0,0,0
9002,1,home,0,7,7
9002,2,education,7,11,4
9002,3,home,11,19,8
9002,4,shop,19,20,1
9002,5,home,20,24,4
9002,6,<ENDS>,24,24,0
9003,0,<START>,0,0,0
9003,1,home,0,7,7
9003,2,education,7,12,5
9003,3,home,12,19,7
9003,4,shop,19,20,1
9003,5,home,20,24,4
9003,6,<ENDS>,24,24,0
9004,0,<START>,0,0,0
9004,1,home,0,7,7
9004,2,work,7,14,7
9004,3,home,14,24,10
9004,4,<ENDS>,24,24,0
9005,0,<START>,0,0,0
9005,1,home,0,7,7
9005,2,work,7,14,7
9005,3,shop,14,16,2
9005,4,work,16,20,4
9005,5,home,20,24,4
9005,6,<ENDS>,24,24,0
9006,0,<START>,0,0,0
9006,1,home,0,7,7
9006,2,education,7,12,5
9006,3,home,12,21,9
9006,4,shop,21,22,1
9006,5,home,22,24,2
9006,6,<ENDS>,24,24,0
9007,0,<START>,0,0,0
9007,1,home,0,8,8
9007,2,work,8,14,6
9007,3,shop,14,15,1
9007,4,home,15,24,9
9007,5,<ENDS>,24,24,0
9008,0,<START>,0,0,0
9008,1,home,0,9,9
9008,2,work,9,16,7
9008,3,home,16,22,6
9008,4,work,22,23,1
9008,5,home,23,24,1
9008,6,<ENDS>,24,24,0
9009,0,<START>,0,0,0
9009,1,home,0,7,7
9009,2,work,7,13,6
9009,3,shop,13,14,1
9009,4,home,14,21,7
9009,5,work,21,22,1
9009,6,home,22,24,2
9009,7,<ENDS>,24,24,0
9010,0,<START>,0,0,0
9010,1,home,0,8,8
9010,2,education,8,12,4
9010,3,home,12,24,12
9010,4,<ENDS>,24,24,0
9011,0,<START>,0,0,0
9011,1,home,0,7,7
9011,2,work,7,9,2
9011,3,home,9,14,5
9011,4,work,14,16,2
9011,5,home,16,22,6
9011,6,work,22,23,1
9011,7,home,23,24,1
9011,8,<ENDS>,24,24,0
9012,0,<START>,0,0,0
9012,1,home,0,8,8
9012,2,work,8,15,7
9012,3,shop,15,16,1
9012,4,home,16,24,8
9012,5,<ENDS>,24,24,0
9013,0,<START>,0,0,0
9013,1,home,0,7,7
9013,2,work,7,13,6
9013,3,home,13,24,11
9013,4,<ENDS>,24,24,0
9014,0,<START>,0,0,0
9014,1,home,0,6,6
9014,2,shop,6,7,1
9014,3,home,7,10,3
9014,4,education,10,13,3
9014,5,shop,13,15,2
9014,6,home,15,20,5
9014,7,shop,20,21,1
9014,8,home,21,24,3
9014,9,<ENDS>,24,24,0
9015,0,<START>,0,0,0
9015,1,home,0,7,7
9015,2,work,7,9,2
9015,3,home,9,13,4
9015,4,work,13,15,2
9015,5,shop,15,16,1
9015,6,work,16,19,3
9015,7,home,19,24,5
9015,8,<ENDS>,24,24,0
9016,0,<START>,0,0,0
9016,1,home,0,6,6
9016,2,shop,6,7,1
9016,3,home,7,9,2
9016,4,education,9,12,3
9016,5,shop,12,13,1
9016,6,home,13,19,6
9016,7,shop,19,20,1
9016,8,home,20,24,4
9016,9,<ENDS>,24,24,0
9017,0,<START>,0,0,0
9017,1,home,0,7,7
9017,2,work,7,13,6
9017,3,shop,13,14,1
9017,4,work,14,20,6
9017,5,home,20,24,4
9017,6,<ENDS>,24,24,0
9018,0,<START>,0,0,0
9018,1,home,0,8,8
9018,2,work,8,15,7
9018,3,home,15,19,4
9018,4,shop,19,20,1
9018,5,home,20,24,4
9018,6,<ENDS>,24,24,0
9019,0,<START>,0,0,0
9019,1,home,0,8,8
9019,2,work,8,15,7
9019,3,shop,15,16,1
9019,4,work,16,19,3
9019,5,home,19,24,5
9019,6,<ENDS>,24,24,0
9020,0,<START>,0,0,0
9020,1,home,0,7,7
9020,2,shop,7,8,1
9020,3,home,8,9,1
9020,4,work,9,17,8
9020,5,home,17,22,5
9020,6,work,22,23,1
9020,7,home,23,24,1
9020,8,<ENDS>,24,24,0
9021,0,<START>,0,0,0
9021,1,home,0,7,7
9021,2,work,7,14,7
9021,3,home,14,21,7
9021,4,work,21,22,1
9021,5,home,22,24,2
9021,6,<ENDS>,24,24,0
9022,0,<START>,0,0,0
9022,1,home,0,6,6
9022,2,work,6,13,7
9022,3,home,13,17,4
9022,4,work,17,20,3
9022,5,home,20,24,4
9022,6,<ENDS>,24,24,0
9023,0,<START>,0,0,0
9023,1,home,0,7,7
9023,2,work,7,13,6
9023,3,shop,13,14,1
9023,4,work,14,19,5
9023,5,home,19,24,5
9023,6,<ENDS>,24,24,0
9024,0,<START>,0,0,0
9024,1,home,0,6,6
9024,2,shop,6,7,1
9024,3,home,7,13,6
9024,4,education,13,16,3
9024,5,shop,16,17,1
9024,6,home,17,24,7
9024,7,<ENDS>,24,24,0
9025,0,<START>,0,0,0
9025,1,home,0,8,8
9025,2,education,8,12,4
9025,3,work,12,19,7
9025,4,home,19,23,4
9025,5,work,23,24,1
9025,6,<ENDS>,24,24,0
9026,0,<START>,0,0,0
9026,1,home,0,6,6
9026,2,work,6,13,7
9026,3,home,13,24,11
9026,4,<ENDS>,24,24,0
9027,0,<START>,0,0,0
9027,1,home,0,9,9
9027,2,work,9,18,9
9027,3,home,18,24,6
9027,4,<ENDS>,24,24,0
9028,0,<START>,0,0,0
9028,1,home,0,7,7
9028,2,work,7,13,6
9028,3,home,13,16,3
9028,4,work,16,20,4
9028,5,home,20,24,4
9028,6,<ENDS>,24,24,0
9029,0,<START>,0,0,0
9029,1,home,0,7,7
9029,2,work,7,14,7
9029,3,shop,14,15,1
9029,4,home,15,24,9
9029,5,<ENDS>,24,24,0
9030,0,<START>,0,0,0
9030,1,home,0,8,8
9030,2,work,8,15,7
9030,3,home,15,21,6
9030,4,work,21,22,1
9030,5,home,22,24,2
9030,6,<ENDS>,24,24,0
9031,0,<START>,0,0,0
9031,1,home,0,6,6
9031,2,shop,6,7,1
9031,3,home,7,10,3
9031,4,education,10,12,2
9031,5,home,12,21,9
9031,6,shop,21,22,1
9031,7,home,22,24,2
9031,8,<ENDS>,24,24,0
9032,0,<START>,0,0,0
9032,1,home,0,6,6
9032,2,work,6,7,1
9032,3,home,7,11,4
9032,4,work,11,12,1
9032,5,home,12,16,4
9032,6,work,16,19,3
9032,7,home,19,24,5
9032,8,<ENDS>,24,24,0
9033,0,<START>,0,0,0
9033,1,home,0,8,8
9033,2,work,8,15,7
9033,3,home,15,24,9
9033,4,<ENDS>,24,24,0
9034,0,<START>,0,0,0
9034,1,home,0,7,7
9034,2,education,7,12,5
9034,3,home,12,18,6
9034,4,shop,18,19,1
9034,5,home,19,24,5
9034,6,<ENDS>,24,24,0
9035,0,<START>,0,0,0
9035,1,home,0,7,7
9035,2,work,7,13,6
9035,3,home,13,24,11
9035,4,<ENDS>,24,24,0
9036,0,<START>,0,0,0
9036,1,home,0,7,7
9036,2,work,7,9,2
9036,3,home,9,13,4
9036,4,work,13,15,2
9036,5,home,15,22,7
9036,6,work,22,23,1
9036,7,home,23,24,1
9036,8,<ENDS>,24,24,0
9037,0,<START>,0,0,0
9037,1,home,0,6,6
9037,2,work,6,8,2
9037,3,home,8,15,7
9037,4,work,15,17,2
9037,5,home,17,23,6
9037,6,work,23,24,1
9037,7,<ENDS>,24,24,0
9038,0,<START>,0,0,0
9038,1,home,0,7,7
9038,2,shop,7,8,1
9038,3,education,8,11,3
9038,4,home,11,18,7
9038,5,shop,18,20,2
9038,6,home,20,24,4
9038,7,<ENDS>,24,24,0
9039,0,<START>,0,0,0
9039,1,home,0,8,8
9039,2,work,8,15,7
9039,3,home,15,19,4
9039,4,shop,19,20,1
9039,5,home,20,24,4
9039,6,<ENDS>,24,24,0
9040,0,<START>,0,0,0
9040,1,home,0,8,8
9040,2,work,8,13,5
9040,3,home,13,24,11
9040,4,<ENDS>,24,24,0
9041,0,<START>,0,0,0
9041,1,home,0,7,7
9041,2,work,7,13,6
9041,3,home,13,19,6
9041,4,shop,19,20,1
9041,5,home,20,24,4
9041,6,<ENDS>,24,24,0
9042,0,<START>,0,0,0
9042,1,home,0,9,9
9042,2,work,9,16,7
9042,3,shop,16,17,1
9042,4,home,17,22,5
9042,5,work,22,23,1
9042,6,home,23,24,1
9042,7,<ENDS>,24,24,0
9043,0,<START>,0,0,0
9043,1,home,0,7,7
9043,2,work,7,14,7
9043,3,home,14,24,10
9043,4,<ENDS>,24,24,0
9044,0,<START>,0,0,0
9044,1,home,0,6,6
9044,2,work,6,8,2
9044,3,home,8,13,5
9044,4,work,13,15,2
9044,5,home,15,21,6
9044,6,work,21,22,1
9044,7,home,22,24,2
9044,8,<ENDS>,24,24,0
9045,0,<START>,0,0,0
9045,1,home,0,7,7
9045,2,work,7,9,2
9045,3,home,9,13,4
9045,4,work,13,15,2
9045,5,home,15,22,7
9045,6,work,22,23,1
9045,7,home,23,24,1
9045,8,<ENDS>,24,24,0
9046,0,<START>,0,0,0
9046,1,home,0,7,7
9046,2,education,7,10,3
9046,3,home,10,16,6
9046,4,shop,16,17,1
9046,5,home,17,24,7
9046,6,<ENDS>,24,24,0
9047,0,<START>,0,0,0
9047,1,home,0,7,7
9047,2,education,7,11,4
9047,3,home,11,19,8
9047,4,shop,19,20,1
9047,5,home,20,24,4
9047,6,<ENDS>,24,24,0
9048,0,<START>,0,0,0
9048,1,home,0,6,6
9048,2,work,6,13,7
9048,3,home,13,18,5
9048,4,shop,18,19,1
9048,5,home,19,24,5
9048,6,<ENDS>,24,24,0
9049,0,<START>,0,0,0
9049,1,home,0,6,6
9049,2,shop,6,7,1
9049,3,home,7,10,3
9049,4,education,10,13,3
9049,5,shop,13,14,1
9049,6,education,14,16,2
9049,7,shop,16,17,1
9049,8,home,17,24,7
9049,9,<ENDS>,24,24,0
9050,0,<START>,0,0,0
9050,1,home,0,9,9
9050,2,work,9,17,8
9050,3,home,17,21,4
9050,4,work,21,22,1
9050,5,home,22,24,2
9050,6,<ENDS>,24,24,0
9051,0,<START>,0,0,0
9051,1,home,0,8,8
9051,2,work,8,14,6
9051,3,home,14,24,10
9051,4,<ENDS>,24,24,0
9052,0,<START>,0,0,0
9052,1,home,0,7,7
9052,2,work,7,14,7
9052,3,home,14,24,10
9052,4,<ENDS>,24,24,0
9053,0,<START>,0,0,0
9053,1,home,0,6,6
9053,2,work,6,7,1
9053,3,home,7,9,2
9053,4,work,9,10,1
9053,5,home,10,14,4
9053,6,work,14,16,2
9053,7,home,16,22,6
9053,8,work,22,23,1
9053,9,home,23,24,1
9053,10,<ENDS>,24,24,0
9054,0,<START>,0,0,0
9054,1,home,0,7,7
9054,2,shop,7,8,1
9054,3,home,8,12,4
9054,4,work,12,18,6
9054,5,education,18,19,1
9054,6,home,19,22,3
9054,7,work,22,23,1
9054,8,home,23,24,1
9054,9,<ENDS>,24,24,0
9055,0,<START>,0,0,0
9055,1,home,0,6,6
9055,2,shop,6,7,1
9055,3,work,7,14,7
9055,4,home,14,18,4
9055,5,work,18,20,2
9055,6,home,20,24,4
9055,7,<ENDS>,24,24,0
9056,0,<START>,0,0,0
9056,1,home,0,7,7
9056,2,work,7,13,6
9056,3,home,13,17,4
9056,4,shop,17,18,1
9056,5,home,18,24,6
9056,6,<ENDS>,24,24,0
9057,0,<START>,0,0,0
9057,1,work,0,9,9
9057,2,shop,9,10,1
9057,3,work,10,17,7
9057,4,home,17,24,7
9057,5,<ENDS>,24,24,0
9058,0,<START>,0,0,0
9058,1,home,0,8,8
9058,2,work,8,14,6
9058,3,home,14,23,9
9058,4,work,23,24,1
9058,5,<ENDS>,24,24,0
9059,0,<START>,0,0,0
9059,1,home,0,6,6
9059,2,work,6,13,7
9059,3,shop,13,14,1
9059,4,home,14,22,8
9059,5,work,22,23,1
9059,6,home,23,24,1
9059,7,<ENDS>,24,24,0
9060,0,<START>,0,0,0
9060,1,home,0,8,8
9060,2,work,8,13,5
9060,3,shop,13,14,1
9060,4,work,14,20,6
9060,5,home,20,24,4
9060,6,<ENDS>,24,24,0
9061,0,<START>,0,0,0
9061,1,home,0,8,8
9061,2,work,8,14,6
9061,3,home,14,18,4
9061,4,shop,18,19,1
9061,5,home,19,24,5
9061,6,<ENDS>,24,24,0
9062,0,<START>,0,0,0
9062,1,home,0,6,6
9062,2,shop,6,7,1
9062,3,home,7,9,2
9062,4,education,9,11,2
9062,5,home,11,17,6
9062,6,shop,17,19,2
9062,7,home,19,24,5
9062,8,<ENDS>,24,24,0
9063,0,<START>,0,0,0
9063,1,home,0,6,6
9063,2,work,6,13,7
9063,3,shop,13,15,2
9063,4,home,15,24,9
9063,5,<ENDS>,24,24,0
9064,0,<START>,0,0,0
9064,1,home,0,8,8
9064,2,education,8,11,3
9064,3,home,11,16,5
9064,4,work,16,20,4
9064,5,home,20,24,4
9064,6,<ENDS>,24,24,0
9065,0,<START>,0,0,0
9065,1,home,0,8,8
9065,2,work,8,15,7
9065,3,shop,15,16,1
9065,4,home,16,23,7
9065,5,work,23,24,1
9065,6,<ENDS>,24,24,0
9066,0,<START>,0,0,0
9066,1,home,0,7,7
9066,2,work,7,14,7
9066,3,home,14,21,7
9066,4,work,21,22,1
9066,5,home,22,24,2
9066,6,<ENDS>,24,24,0
9067,0,<START>,0,0,0
9067,1,home,0,7,7
9067,2,work,7,13,6
9067,3,home,13,21,8
9067,4,shop,21,22,1
9067,5,home,22,24,2
9067,6,<ENDS>,24,24,0
9068,0,<START>,0,0,0
9068,1,home,0,6,6
9068,2,shop,6,7,1
9068,3,home,7,10,3
9068,4,education,10,12,2
9068,5,home,12,18,6
9068,6,shop,18,19,1
9068,7,home,19,24,5
9068,8,<ENDS>,24,24,0
9069,0,<START>,0,0,0
9069,1,home,0,7,7
9069,2,work,7,13,6
9069,3,shop,13,14,1
9069,4,work,14,20,6
9069,5,home,20,24,4
9069,6,<ENDS>,24,24,0
9070,0,<START>,0,0,0
9070,1,home,0,8,8
9070,2,work,8,14,6
9070,3,home,14,24,10
9070,4,<ENDS>,24,24,0
9071,0,<START>,0,0,0
9071,1,home,0,7,7
9071,2,work,7,14,7
9071,3,home,14,24,10
9071,4,<ENDS>,24,24,0
9072,0,<START>,0,0,0
9072,1,home,0,8,8
9072,2,education,8,14,6
9072,3,shop,14,15,1
9072,4,home,15,21,6
9072,5,shop,21,22,1
9072,6,home,22,24,2
9072,7,<ENDS>,24,24,0
9073,0,<START>,0,0,0
9073,1,home,0,6,6
9073,2,shop,6,7,1
9073,3,home,7,13,6
9073,4,education,13,16,3
9073,5,home,16,24,8
9073,6,<ENDS>,24,24,0
9074,0,<START>,0,0,0
9074,1,home,0,6,6
9074,2,work,6,13,7
9074,3,shop,13,14,1
9074,4,home,14,24,10
9074,5,<ENDS>,24,24,0
9075,0,<START>,0,0,0
9075,1,home,0,7,7
9075,2,work,7,13,6
9075,3,shop,13,14,1
9075,4,home,14,24,10
9075,5,<ENDS>,24,24,0
9076,0,<START>,0,0,0
9076,1,home,0,6,6
9076,2,shop,6,7,1
9076,3,home,7,10,3
9076,4,education,10,12,2
9076,5,shop,12,13,1
9076,6,home,13,20,7
9076,7,shop,20,21,1
9076,8,home,21,24,3
9076,9,<ENDS>,24,24,0
9077,0,<START>,0,0,0
9077,1,home,0,7,7
9077,2,work,7,13,6
9077,3,home,13,18,5
9077,4,work,18,20,2
9077,5,home,20,24,4
9077,6,<ENDS>,24,24,0
9078,0,<START>,0,0,0
9078,1,home,0,7,7
9078,2,shop,7,8,1
9078,3,education,8,13,5
9078,4,shop,13,15,2
9078,5,home,15,24,9
9078,6,<ENDS>,24,24,0
9079,0,<START>,0,0,0
9079,1,home,0,7,7
9079,2,work,7,14,7
9079,3,home,14,24,10
9079,4,<ENDS>,24,24,0
9080,0,<START>,0,0,0
9080,1,home,0,7,7
9080,2,shop,7,8,1
9080,3,education,8,11,3
9080,4,home,11,14,3
9080,5,education,14,16,2
9080,6,shop,16,17,1
9080,7,home,17,24,7
9080,8,<ENDS>,24,24,0
9081,0,<START>,0,0,0
9081,1,home,0,6,6
9081,2,work,6,13,7
9081,3,home,13,24,11
9081,4,<ENDS>,24,24,0
9082,0,<START>,0,0,0
9082,1,home,0,7,7
9082,2,work,7,14,7
9082,3,shop,14,15,1
9082,4,work,15,20,5
9082,5,home,20,24,4
9082,6,<ENDS>,24,24,0
9083,0,<START>,0,0,0
9083,1,home,0,7,7
9083,2,work,7,13,6
9083,3,home,13,24,11
9083,4,<ENDS>,24,24,0
9084,0,<START>,0,0,0
9084,1,home,0,8,8
9084,2,work,8,16,8
9084,3,shop,16,17,1
9084,4,work,17,20,3
9084,5,home,20,24,4
9084,6,<ENDS>,24,24,0
9085,0,<START>,0,0,0
9085,1,home,0,8,8
9085,2,work,8,15,7
9085,3,home,15,24,9
9085,4,<ENDS>,24,24,0
9086,0,<START>,0,0,0
9086,1,home,0,6,6
9086,2,work,6,13,7
9086,3,shop,13,14,1
9086,4,home,14,22,8
9086,5,work,22,23,1
9086,6,home,23,24,1
9086,7,<ENDS>,24,24,0
9087,0,<START>,0,0,0
9087,1,home,0,7,7
9087,2,education,7,11,4
9087,3,home,11,13,2
9087,4,education,13,15,2
9087,5,shop,15,16,1
9087,6,home,16,24,8
9087,7,<ENDS>,24,24,0
9088,0,<START>,0,0,0
9088,1,home,0,6,6
9088,2,work,6,8,2
9088,3,home,8,14,6
9088,4,work,14,16,2
9088,5,home,16,21,5
9088,6,work,21,22,1
9088,7,home,22,24,2
9088,8,<ENDS>,24,24,0
9089,0,<START>,0,0,0
9089,1,home,0,8,8
9089,2,work,8,16,8
9089,3,home,16,24,8
9089,4,<ENDS>,24,24,0
9090,0,<START>,0,0,0
9090,1,home,0,7,7
9090,2,work,7,10,3
9090,3,home,10,20,10
9090,4,shop,20,21,1
9090,5,home,21,24,3
9090,6,<ENDS>,24,24,0
9091,0,<START>,0,0,0
9091,1,home,0,6,6
9091,2,work,6,8,2
9091,3,home,8,12,4
9091,4,work,12,13,1
9091,5,shop,13,14,1
9091,6,home,14,17,3
9091,7,work,17,19,2
9091,8,home,19,24,5
9091,9,<ENDS>,24,24,0
9092,0,<START>,0,0,0
9092,1,home,0,7,7
9092,2,shop,7,8,1
9092,3,education,8,11,3
9092,4,home,11,18,7
9092,5,shop,18,19,1
9092,6,home,19,24,5
9092,7,<ENDS>,24,24,0
9093,0,<START>,0,0,0
9093,1,home,0,7,7
9093,2,work,7,14,7
9093,3,home,14,22,8
9093,4,work,22,23,1
9093,5,home,23,24,1
9093,6,<ENDS>,24,24,0
9094,0,<START>,0,0,0
9094,1,home,0,8,8
9094,2,work,8,15,7
9094,3,home,15,24,9
9094,4,<ENDS>,24,24,0
9095,0,<START>,0,0,0
9095,1,home,0,7,7
9095,2,education,7,11,4
9095,3,home,11,17,6
9095,4,shop,17,18,1
9095,5,home,18,24,6
9095,6,<ENDS>,24,24,0
9096,0,<START>,0,0,0
9096,1,home,0,8,8
9096,2,work,8,13,5
9096,3,shop,13,14,1
9096,4,education,14,18,4
9096,5,home,18,24,6
9096,6,<ENDS>,24,24,0
9097,0,<START>,0,0,0
9097,1,home,0,8,8
9097,2,work,8,14,6
9097,3,home,14,24,10
9097,4,<ENDS>,24,24,0
9098,0,<START>,0,0,0
9098,1,home,0,7,7
9098,2,work,7,13,6
9098,3,home,13,17,4
9098,4,work,17,20,3
9098,5,home,20,24,4
9098,6,<ENDS>,24,24,0
9099,0,<START>,0,0,0
9099,1,home,0,7,7
9099,2,education,7,12,5
9099,3,shop,12,13,1
9099,4,home,13,19,6
9099,5,shop,19,20,1
9099,6,home,20,24,4
9099,7,<ENDS>,24,24,0
9100,0,<START>,0,0,0
9100,1,home,0,7,7
9100,2,education,7,11,4
9100,3,home,11,17,6
9100,4,shop,17,19,2
9100,5,home,19,24,5
9100,6,<ENDS>,24,24,0
9101,0,<START>,0,0,0
9101,1,home,0,7,7
9101,2,education,7,11,4
9101,3,home,11,14,3
9101,4,education,14,15,1
9101,5,shop,15,17,2
9101,6,home,17,24,7
9101,7,<ENDS>,24,24,0
9102,0,<START>,0,0,0
9102,1,home,0,7,7
9102,2,work,7,14,7
9102,3,shop,14,15,1
9102,4,work,15,19,4
9102,5,home,19,24,5
9102,6,<ENDS>,24,24,0
9103,0,<START>,0,0,0
9103,1,home,0,6,6
9103,2,work,6,8,2
9103,3,home,8,12,4
9103,4,work,12,14,2
9103,5,home,14,21,7
9103,6,work,21,22,1
9103,7,home,22,24,2
9103,8,<ENDS>,24,24,0
9104,0,<START>,0,0,0
9104,1,home,0,6,6
9104,2,work,6,8,2
9104,3,home,8,14,6
9104,4,work,14,16,2
9104,5,home,16,22,6
9104,6,work,22,23,1
9104,7,home,23,24,1
9104,8,<ENDS>,24,24,0
9105,0,<START>,0,0,0
9105,1,home,0,7,7
9105,2,work,7,13,6
9105,3,home,13,17,4
9105,4,shop,17,18,1
9105,5,home,18,23,5
9105,6,work,23,24,1
9105,7,<ENDS>,24,24,0
9106,0,<START>,0,0,0
9106,1,home,0,8,8
9106,2,work,8,14,6
9106,3,home,14,24,10
9106,4,<ENDS>,24,24,0
9107,0,<START>,0,0,0
9107,1,home,0,7,7
9107,2,work,7,13,6
9107,3,home,13,21,8
9107,4,shop,21,22,1
9107,5,home,22,24,2
9107,6,<ENDS>,24,24,0
9108,0,<START>,0,0,0
9108,1,home,0,8,8
9108,2,work,8,15,7
9108,3,home,15,22,7
9108,4,work,22,23,1
9108,5,home,23,24,1
9108,6,<ENDS>,24,24,0
9109,0,<START>,0,0,0
9109,1,home,0,8,8
9109,2,work,8,14,6
9109,3,home,14,18,4
9109,4,shop,18,19,1
9109,5,home,19,24,5
9109,6,<ENDS>,24,24,0
9110,0,<START>,0,0,0
9110,1,home,0,7,7
9110,2,work,7,15,8
9110,3,home,15,24,9
9110,4,<ENDS>,24,24,0
9111,0,<START>,0,0,0
9111,1,home,0,7,7
9111,2,work,7,14,7
9111,3,shop,14,15,1
9111,4,work,15,19,4
9111,5,home,19,24,5
9111,6,<ENDS>,24,24,0
9112,0,<START>,0,0,0
9112,1,home,0,6,6
9112,2,work,6,13,7
9112,3,home,13,17,4
9112,4,work,17,20,3
9112,5,home,20,24,4
9112,6,<ENDS>,24,24,0
9113,0,<START>,0,0,0
9113,1,home,0,8,8
9113,2,work,8,14,6
9113,3,shop,14,15,1
9113,4,home,15,24,9
9113,5,<ENDS>,24,24,0
9114,0,<START>,0,0,0
9114,1,home,0,8,8
9114,2,work,8,15,7
9114,3,home,15,24,9
9114,4,<ENDS>,24,24,0
9115,0,<START>,0,0,0
9115,1,home,0,7,7
9115,2,work,7,13,6
9115,3,home,13,18,5
9115,4,work,18,20,2
9115,5,home,20,24,4
9115,6,<ENDS>,24,24,0
9116,0,<START>,0,0,0
9116,1,home,0,6,6
9116,2,work,6,13,7
9116,3,home,13,24,11
9116,4,<ENDS>,24,24,0
9117,0,<START>,0,0,0
9117,1,home,0,6,6
9117,2,work,6,13,7
9117,3,home,13,18,5
9117,4,work,18,20,2
9117,5,home,20,24,4
9117,6,<ENDS>,24,24,0
9118,0,<START>,0,0,0
9118,1,home,0,6,6
9118,2,work,6,13,7
9118,3,home,13,16,3
9118,4,work,16,20,4
9118,5,home,20,24,4
9118,6,<ENDS>,24,24,0
9119,0,<START>,0,0,0
9119,1,home,0,7,7
9119,2,work,7,13,6
9119,3,home,13,24,11
9119,4,<ENDS>,24,24,0
9120,0,<START>,0,0,0
9120,1,home,0,6,6
9120,2,work,6,13,7
9120,3,shop,13,14,1
9120,4,home,14,24,10
9120,5,<ENDS>,24,24,0
9121,0,<START>,0,0,0
9121,1,home,0,6,6
9121,2,shop,6,7,1
9121,3,work,7,13,6
9121,4,shop,13,14,1
9121,5,home,14,24,10
9121,6,<ENDS>,24,24,0
9122,0,<START>,0,0,0
9122,1,home,0,8,8
9122,2,work,8,14,6
9122,3,shop,14,15,1
9122,4,home,15,17,2
9122,5,work,17,20,3
9122,6,home,20,24,4
9122,7,<ENDS>,24,24,0
9123,0,<START>,0,0,0
9123,1,home,0,7,7
9123,2,education,7,10,3
9123,3,home,10,14,4
9123,4,education,14,15,1
9123,5,shop,15,18,3
9123,6,home,18,24,6
9123,7,<ENDS>,24,24,0
9124,0,<START>,0,0,0
9124,1,home,0,6,6
9124,2,shop,6,7,1
9124,3,home,7,13,6
9124,4,education,13,16,3
9124,5,home,16,24,8
9124,6,<ENDS>,24,24,0
9125,0,<START>,0,0,0
9125,1,home,0,7,7
9125,2,work,7,9,2
9125,3,home,9,14,5
9125,4,work,14,16,2
9125,5,home,16,21,5
9125,6,work,21,22,1
9125,7,home,22,24,2
9125,8,<ENDS>,24,24,0
9126,0,<START>,0,0,0
9126,1,home,0,7,7
9126,2,work,7,15,8
9126,3,home,15,24,9
9126,4,<ENDS>,24,24,0
9127,0,<START>,0,0,0
9127,1,home,0,7,7
9127,2,work,7,15,8
9127,3,shop,15,16,1
9127,4,home,16,24,8
9127,5,<ENDS>,24,24,0
9128,0,<START>,0,0,0
9128,1,home,0,7,7
9128,2,shop,7,9,2
9128,3,education,9,12,3
9128,4,shop,12,14,2
9128,5,home,14,20,6
9128,6,shop,20,21,1
9128,7,home,21,24,3
9128,8,<ENDS>,24,24,0
9129,0,<START>,0,0,0
9129,1,home,0,7,7
9129,2,education,7,11,4
9129,3,home,11,18,7
9129,4,shop,18,20,2
9129,5,home,20,24,4
9129,6,<ENDS>,24,24,0
9130,0,<START>,0,0,0
9130,1,home,0,7,7
9130,2,work,7,10,3
9130,3,home,10,14,4
9130,4,work,14,16,2
9130,5,home,16,23,7
9130,6,work,23,24,1
9130,7,<ENDS>,24,24,0
9131,0,<START>,0,0,0
9131,1,home,0,7,7
9131,2,work,7,13,6
9131,3,shop,13,14,1
9131,4,work,14,20,6
9131,5,home,20,24,4
9131,6,<ENDS>,24,24,0
9132,0,<START>,0,0,0
9132,1,home,0,7,7
9132,2,work,7,14,7
9132,3,home,14,21,7
9132,4,shop,21,22,1
9132,5,home,22,24,2
9132,6,<ENDS>,24,24,0
9133,0,<START>,0,0,0
9133,1,home,0,6,6
9133,2,shop,6,7,1
9133,3,home,7,13,6
9133,4,education,13,16,3
9133,5,shop,16,17,1
9133,6,home,17,24,7
9133,7,<ENDS>,24,24,0
9134,0,<START>,0,0,0
9134,1,home,0,7,7
9134,2,work,7,14,7
9134,3,home,14,24,10
9134,4,<ENDS>,24,24,0
9135,0,<START>,0,0,0
9135,1,home,0,6,6
9135,2,work,6,13,7
9135,3,home,13,17,4
9135,4,work,17,20,3
9135,5,home,20,24,4
9135,6,<ENDS>,24,24,0
9136,0,<START>,0,0,0
9136,1,home,0,7,7
9136,2,work,7,13,6
9136,3,home,13,16,3
9136,4,work,16,20,4
9136,5,home,20,24,4
9136,6,<ENDS>,24,24,0
9137,0,<START>,0,0,0
9137,1,home,0,7,7
9137,2,education,7,11,4
9137,3,home,11,19,8
9137,4,shop,19,20,1
9137,5,home,20,24,4
9137,6,<ENDS>,24,24,0
9138,0,<START>,0,0,0
9138,1,home,0,8,8
9138,2,work,8,15,7
9138,3,shop,15,16,1
9138,4,home,16,22,6
9138,5,work,22,23,1
9138,6,home,23,24,1
9138,7,<ENDS>,24,24,0
9139,0,<START>,0,0,0
9139,1,home,0,7,7
9139,2,work,7,13,6
9139,3,shop,13,14,1
9139,4,work,14,20,6
9139,5,home,20,24,4
9139,6,<ENDS>,24,24,0
9140,0,<START>,0,0,0
9140,1,home,0,6,6
9140,2,work,6,13,7
9140,3,shop,13,14,1
9140,4,work,14,19,5
9140,5,home,19,24,5
9140,6,<ENDS>,24,24,0
9141,0,<START>,0,0,0
9141,1,home,0,7,7
9141,2,work,7,14,7
9141,3,home,14,24,10
9141,4,<ENDS>,24,24,0
9142,0,<START>,0,0,0
9142,1,home,0,8,8
9142,2,work,8,15,7
9142,3,home,15,24,9
9142,4,<ENDS>,24,24,0
9143,0,<START>,0,0,0
9143,1,home,0,8,8
9143,2,work,8,14,6
9143,3,home,14,18,4
9143,4,shop,18,19,1
9143,5,home,19,24,5
9143,6,<ENDS>,24,24,0
9144,0,<START>,0,0,0
9144,1,home,0,7,7
9144,2,shop,7,8,1
9144,3,education,8,11,3
9144,4,home,11,19,8
9144,5,shop,19,20,1
9144,6,home,20,24,4
9144,7,<ENDS>,24,24,0
9145,0,<START>,0,0,0
9145,1,home,0,6,6
9145,2,shop,6,7,1
9145,3,home,7,13,6
9145,4,education,13,16,3
9145,5,shop,16,18,2
9145,6,home,18,24,6
9145,7,<ENDS>,24,24,0
9146,0,<START>,0,0,0
9146,1,home,0,7,7
9146,2,work,7,15,8
9146,3,shop,15,16,1
9146,4,home,16,24,8
9146,5,<ENDS>,24,24,0
9147,0,<START>,0,0,0
9147,1,home,0,8,8
9147,2,work,8,15,7
9147,3,home,15,24,9
9147,4,<ENDS>,24,24,0
9148,0,<START>,0,0,0
9148,1,home,0,6,6
9148,2,work,6,13,7
9148,3,shop,13,15,2
9148,4,home,15,22,7
9148,5,work,22,23,1
9148,6,home,23,24,1
9148,7,<ENDS>,24,24,0
9149,0,<START>,0,0,0
9149,1,home,0,7,7
9149,2,work,7,13,6
9149,3,home,13,24,11
9149,4,<ENDS>,24,24,0
9150,0,<START>,0,0,0
9150,1,home,0,8,8
9150,2,work,8,15,7
9150,3,shop,15,16,1
9150,4,home,16,24,8
9150,5,<ENDS>,24,24,0
9151,0,<START>,0,0,0
9151,1,work,0,9,9
9151,2,shop,9,10,1
9151,3,work,10,17,7
9151,4,home,17,24,7
9151,5,<ENDS>,24,24,0
9152,0,<START>,0,0,0
9152,1,home,0,6,6
9152,2,shop,6,7,1
9152,3,home,7,10,3
9152,4,education,10,12,2
9152,5,home,12,16,4
9152,6,shop,16,17,1
9152,7,home,17,24,7
9152,8,<ENDS>,24,24,0
9153,0,<START>,0,0,0
9153,1,home,0,7,7
9153,2,shop,7,9,2
9153,3,home,9,13,4
9153,4,education,13,16,3
9153,5,home,16,24,8
9153,6,<ENDS>,24,24,0
9154,0,<START>,0,0,0
9154,1,home,0,6,6
9154,2,work,6,13,7
9154,3,home,13,24,11
9154,4,<ENDS>,24,24,0
9155,0,<START>,0,0,0
9155,1,home,0,8,8
9155,2,work,8,15,7
9155,3,home,15,24,9
9155,4,<ENDS>,24,24,0
9156,0,<START>,0,0,0
9156,1,home,0,7,7
9156,2,work,7,14,7
9156,3,home,14,23,9
9156,4,work,23,24,1
9156,5,<ENDS>,24,24,0
9157,0,<START>,0,0,0
9157,1,home,0,7,7
9157,2,work,7,13,6
9157,3,home,13,17,4
9157,4,work,17,20,3
9157,5,home,20,24,4
9157,6,<ENDS>,24,24,0
9158,0,<START>,0,0,0
9158,1,home,0,8,8
9158,2,education,8,11,3
9158,3,home,11,16,5
9158,4,work,16,20,4
9158,5,home,20,24,4
9158,6,<ENDS>,24,24,0
9159,0,<START>,0,0,0
9159,1,home,0,6,6
9159,2,work,6,13,7
9159,3,shop,13,14,1
9159,4,work,14,19,5
9159,5,home,19,24,5
9159,6,<ENDS>,24,24,0
9160,0,<START>,0,0,0
9160,1,home,0,7,7
9160,2,education,7,11,4
9160,3,home,11,20,9
9160,4,shop,20,21,1
9160,5,home,21,24,3
9160,6,<ENDS>,24,24,0
9161,0,<START>,0,0,0
9161,1,home,0,8,8
9161,2,work,8,15,7
9161,3,home,15,24,9
9161,4,<ENDS>,24,24,0
9162,0,<START>,0,0,0
9162,1,home,0,6,6
9162,2,work,6,13,7
9162,3,shop,13,14,1
9162,4,work,14,19,5
9162,5,home,19,24,5
9162,6,<ENDS>,24,24,0
9163,0,<START>,0,0,0
9163,1,home,0,8,8
9163,2,shop,8,9,1
9163,3,education,9,12,3
9163,4,shop,12,14,2
9163,5,education,14,16,2
9163,6,home,16,24,8
9163,7,<ENDS>,24,24,0
9164,0,<START>,0,0,0
9164,1,home,0,7,7
9164,2,shop,7,8,1
9164,3,home,8,12,4
9164,4,shop,12,13,1
9164,5,work,13,19,6
9164,6,home,19,24,5
9164,7,<ENDS>,24,24,0
9165,0,<START>,0,0,0
9165,1,home,0,7,7
9165,2,work,7,13,6
9165,3,shop,13,14,1
9165,4,work,14,20,6
9165,5,home,20,24,4
9165,6,<ENDS>,24,24,0
9166,0,<START>,0,0,0
9166,1,home,0,7,7
9166,2,work,7,8,1
9166,3,home,8,11,3
9166,4,work,11,14,3
9166,5,home,14,21,7
9166,6,work,21,22,1
9166,7,home,22,24,2
9166,8,<ENDS>,24,24,0
9167,0,<START>,0,0,0
9167,1,home,0,8,8
9167,2,work,8,15,7
9167,3,home,15,19,4
9167,4,shop,19,20,1
9167,5,home,20,24,4
9167,6,<ENDS>,24,24,0
9168,0,<START>,0,0,0
9168,1,home,0,8,8
9168,2,shop,8,9,1
9168,3,work,9,17,8
9168,4,home,17,24,7
9168,5,<ENDS>,24,24,0
9169,0,<START>,0,0,0
9169,1,home,0,7,7
9169,2,education,7,13,6
9169,3,shop,13,15,2
9169,4,home,15,24,9
9169,5,<ENDS>,24,24,0
9170,0,<START>,0,0,0
9170,1,home,0,7,7
9170,2,work,7,13,6
9170,3,shop,13,14,1
9170,4,work,14,17,3
9170,5,home,17,24,7
9170,6,<ENDS>,24,24,0
9171,0,<START>,0,0,0
9171,1,home,0,8,8
9171,2,education,8,12,4
9171,3,home,12,19,7
9171,4,shop,19,20,1
9171,5,home,20,24,4
9171,6,<ENDS>,24,24,0
9172,0,<START>,0,0,0
9172,1,home,0,6,6
9172,2,work,6,9,3
9172,3,home,9,14,5
9172,4,work,14,15,1
9172,5,home,15,21,6
9172,6,work,21,22,1
9172,7,home,22,24,2
9172,8,<ENDS>,24,24,0
9173,0,<START>,0,0,0
9173,1,home,0,7,7
9173,2,work,7,12,5
9173,3,shop,12,13,1
9173,4,work,13,19,6
9173,5,home,19,24,5
9173,6,<ENDS>,24,24,0
9174,0,<START>,0,0,0
9174,1,home,0,8,8
9174,2,work,8,13,5
9174,3,home,13,21,8
9174,4,work,21,22,1
9174,5,home,22,24,2
9174,6,<ENDS>,24,24,0
9175,0,<START>,0,0,0
9175,1,home,0,8,8
9175,2,work,8,15,7
9175,3,shop,15,16,1
9175,4,home,16,24,8
9175,5,<ENDS>,24,24,0
9176,0,<START>,0,0,0
9176,1,home,0,6,6
9176,2,work,6,8,2
9176,3,home,8,9,1
9176,4,work,9,11,2
9176,5,home,11,15,4
9176,6,work,15,17,2
9176,7,home,17,21,4
9176,8,work,21,22,1
9176,9,home,22,24,2
9176,10,<ENDS>,24,24,0
9177,0,<START>,0,0,0
9177,1,home,0,8,8
9177,2,shop,8,9,1
9177,3,work,9,15,6
9177,4,home,15,24,9
9177,5,<ENDS>,24,24,0
9178,0,<START>,0,0,0
9178,1,home,0,6,6
9178,2,work,6,13,7
9178,3,home,13,16,3
9178,4,work,16,20,4
9178,5,home,20,24,4
9178,6,<ENDS>,24,24,0
9179,0,<START>,0,0,0
9179,1,home,0,7,7
9179,2,work,7,14,7
9179,3,shop,14,15,1
9179,4,work,15,20,5
9179,5,home,20,24,4
9179,6,<ENDS>,24,24,0
9180,0,<START>,0,0,0
9180,1,home,0,7,7
9180,2,shop,7,9,2
9180,3,education,9,12,3
9180,4,home,12,19,7
9180,5,shop,19,20,1
9180,6,home,20,24,4
9180,7,<ENDS>,24,24,0
9181,0,<START>,0,0,0
9181,1,home,0,7,7
9181,2,work,7,13,6
9181,3,shop,13,14,1
9181,4,home,14,24,10
9181,5,<ENDS>,24,24,0
9182,0,<START>,0,0,0
9182,1,home,0,6,6
9182,2,work,6,13,7
9182,3,home,13,24,11
9182,4,<ENDS>,24,24,0
9183,0,<START>,0,0,0
9183,1,home,0,8,8
9183,2,work,8,15,7
9183,3,home,15,24,9
9183,4,<ENDS>,24,24,0
9184,0,<START>,0,0,0
9184,1,home,0,8,8
9184,2,work,8,15,7
9184,3,shop,15,16,1
9184,4,work,16,20,4
9184,5,home,20,24,4
9184,6,<ENDS>,24,24,0
9185,0,<START>,0,0,0
9185,1,home,0,6,6
9185,2,shop,6,7,1
9185,3,work,7,13,6
9185,4,home,13,24,11
9185,5,<ENDS>,24,24,0
9186,0,<START>,0,0,0
9186,1,home,0,6,6
9186,2,work,6,13,7
9186,3,home,13,24,11
9186,4,<ENDS>,24,24,0
9187,0,<START>,0,0,0
9187,1,home,0,7,7
9187,2,education,7,12,5
9187,3,shop,12,14,2
9187,4,education,14,16,2
9187,5,home,16,24,8
9187,6,<ENDS>,24,24,0
9188,0,<START>,0,0,0
9188,1,home,0,6,6
9188,2,work,6,13,7
9188,3,shop,13,14,1
9188,4,home,14,24,10
9188,5,<ENDS>,24,24,0
9189,0,<START>,0,0,0
9189,1,home,0,9,9
9189,2,work,9,16,7
9189,3,home,16,24,8
9189,4,<ENDS>,24,24,0
9190,0,<START>,0,0,0
9190,1,home,0,7,7
9190,2,work,7,14,7
9190,3,shop,14,15,1
9190,4,work,15,19,4
9190,5,home,19,24,5
9190,6,<ENDS>,24,24,0
9191,0,<START>,0,0,0
9191,1,home,0,7,7
9191,2,work,7,13,6
9191,3,shop,13,14,1
9191,4,work,14,19,5
9191,5,home,19,24,5
9191,6,<ENDS>,24,24,0
9192,0,<START>,0,0,0
9192,1,home,0,9,9
9192,2,work,9,16,7
9192,3,home,16,19,3
9192,4,shop,19,20,1
9192,5,home,20,24,4
9192,6,<ENDS>,24,24,0
9193,0,<START>,0,0,0
9193,1,home,0,8,8
9193,2,work,8,14,6
9193,3,home,14,18,4
9193,4,shop,18,19,1
9193,5,home,19,24,5
9193,6,<ENDS>,24,24,0
9194,0,<START>,0,0,0
9194,1,home,0,7,7
9194,2,work,7,13,6
9194,3,home,13,17,4
9194,4,shop,17,19,2
9194,5,home,19,24,5
9194,6,<ENDS>,24,24,0
9195,0,<START>,0,0,0
9195,1,home,0,8,8
9195,2,work,8,15,7
9195,3,shop,15,16,1
9195,4,home,16,23,7
9195,5,work,23,24,1
9195,6,<ENDS>,24,24,0
9196,0,<START>,0,0,0
9196,1,home,0,8,8
9196,2,education,8,12,4
9196,3,home,12,18,6
9196,4,shop,18,19,1
9196,5,home,19,24,5
9196,6,<ENDS>,24,24,0
9197,0,<START>,0,0,0
9197,1,home,0,6,6
9197,2,work,6,12,6
9197,3,shop,12,13,1
9197,4,work,13,19,6
9197,5,home,19,24,5
9197,6,<ENDS>,24,24,0
9198,0,<START>,0,0,0
9198,1,home,0,6,6
9198,2,work,6,13,7
9198,3,home,13,18,5
9198,4,work,18,19,1
9198,5,home,19,24,5
9198,6,<ENDS>,24,24,0
9199,0,<START>,0,0,0
9199,1,home,0,8,8
9199,2,work,8,16,8
9199,3,shop,16,17,1
9199,4,work,17,20,3
9199,5,home,20,24,4
9199,6,<ENDS>,24,24,0
9200,0,<START>,0,0,0
9200,1,home,0,6,6
9200,2,work,6,13,7
9200,3,home,13,21,8
9200,4,shop,21,22,1
9200,5,home,22,24,2
9200,6,<ENDS>,24,24,0
9201,0,<START>,0,0,0
9201,1,home,0,8,8
9201,2,education,8,11,3
9201,3,home,11,15,4
9201,4,work,15,20,5
9201,5,home,20,24,4
9201,6,<ENDS>,24,24,0
9202,0,<START>,0,0,0
9202,1,home,0,7,7
9202,2,work,7,13,6
9202,3,home,13,24,11
9202,4,<ENDS>,24,24,0
9203,0,<START>,0,0,0
9203,1,home,0,8,8
9203,2,work,8,14,6
9203,3,home,14,24,10
9203,4,<ENDS>,24,24,0
9204,0,<START>,0,0,0
9204,1,home,0,8,8
9204,2,work,8,15,7
9204,3,shop,15,16,1
9204,4,home,16,24,8
9204,5,<ENDS>,24,24,0
9205,0,<START>,0,0,0
9205,1,home,0,8,8
9205,2,work,8,15,7
9205,3,shop,15,16,1
9205,4,work,16,20,4
9205,5,home,20,24,4
9205,6,<ENDS>,24,24,0
9206,0,<START>,0,0,0
9206,1,home,0,6,6
9206,2,shop,6,7,1
9206,3,home,7,10,3
9206,4,education,10,12,2
9206,5,home,12,16,4
9206,6,shop,16,17,1
9206,7,home,17,21,4
9206,8,shop,21,22,1
9206,9,home,22,24,2
9206,10,<ENDS>,24,24,0
9207,0,<START>,0,0,0
9207,1,home,0,6,6
9207,2,shop,6,7,1
9207,3,home,7,14,7
9207,4,work,14,19,5
9207,5,home,19,24,5
9207,6,<ENDS>,24,24,0
9208,0,<START>,0,0,0
9208,1,home,0,6,6
9208,2,work,6,13,7
9208,3,home,13,17,4
9208,4,work,17,20,3
9208,5,home,20,24,4
9208,6,<ENDS>,24,24,0
9209,0,<START>,0,0,0
9209,1,home,0,6,6
9209,2,work,6,13,7
9209,3,home,13,17,4
9209,4,work,17,20,3
9209,5,home,20,24,4
9209,6,<ENDS>,24,24,0
9210,0,<START>,0,0,0
9210,1,home,0,7,7
9210,2,work,7,8,1
9210,3,home,8,14,6
9210,4,work,14,16,2
9210,5,home,16,23,7
9210,6,work,23,24,1
9210,7,<ENDS>,24,24,0
9211,0,<START>,0,0,0
9211,1,home,0,7,7
9211,2,work,7,14,7
9211,3,shop,14,15,1
9211,4,home,15,24,9
9211,5,<ENDS>,24,24,0
9212,0,<START>,0,0,0
9212,1,home,0,8,8
9212,2,education,8,12,4
9212,3,home,12,24,12
9212,4,<ENDS>,24,24,0
9213,0,<START>,0,0,0
9213,1,home,0,6,6
9213,2,work,6,13,7
9213,3,shop,13,14,1
9213,4,home,14,24,10
9213,5,<ENDS>,24,24,0
9214,0,<START>,0,0,0
9214,1,home,0,8,8
9214,2,work,8,15,7
9214,3,home,15,22,7
9214,4,work,22,23,1
9214,5,home,23,24,1
9214,6,<ENDS>,24,24,0
9215,0,<START>,0,0,0
9215,1,home,0,8,8
9215,2,work,8,15,7
9215,3,home,15,24,9
9215,4,<ENDS>,24,24,0
9216,0,<START>,0,0,0
9216,1,home,0,6,6
9216,2,work,6,13,7
9216,3,home,13,24,11
9216,4,<ENDS>,24,24,0
9217,0,<START>,0,0,0
9217,1,home,0,6,6
9217,2,work,6,9,3
9217,3,home,9,15,6
9217,4,work,15,17,2
9217,5,home,17,23,6
9217,6,work,23,24,1
9217,7,<ENDS>,24,24,0
9218,0,<START>,0,0,0
9218,1,home,0,8,8
9218,2,education,8,11,3
9218,3,home,11,17,6
9218,4,shop,17,18,1
9218,5,home,18,21,3
9218,6,work,21,22,1
9218,7,home,22,24,2
9218,8,<ENDS>,24,24,0
9219,0,<START>,0,0,0
9219,1,home,0,7,7
9219,2,shop,7,8,1
9219,3,home,8,10,2
9219,4,education,10,13,3
9219,5,work,13,19,6
9219,6,home,19,24,5
9219,7,<ENDS>,24,24,0
9220,0,<START>,0,0,0
9220,1,home,0,7,7
9220,2,work,7,14,7
9220,3,shop,14,15,1
9220,4,work,15,20,5
9220,5,home,20,24,4
9220,6,<ENDS>,24,24,0
9221,0,<START>,0,0,0
9221,1,home,0,6,6
9221,2,shop,6,7,1
9221,3,work,7,14,7
9221,4,home,14,24,10
9221,5,<ENDS>,24,24,0
9222,0,<START>,0,0,0
9222,1,home,0,8,8
9222,2,work,8,15,7
9222,3,home,15,24,9
9222,4,<ENDS>,24,24,0
9223,0,<START>,0,0,0
9223,1,home,0,6,6
9223,2,work,6,13,7
9223,3,home,13,17,4
9223,4,shop,17,18,1
9223,5,work,18,20,2
9223,6,home,20,24,4
9223,7,<ENDS>,24,24,0
9224,0,<START>,0,0,0
9224,1,home,0,6,6
9224,2,shop,6,7,1
9224,3,home,7,9,2
9224,4,education,9,12,3
9224,5,shop,12,14,2
9224,6,home,14,24,10
9224,7,<ENDS>,24,24,0
9225,0,<START>,0,0,0
9225,1,home,0,7,7
9225,2,work,7,14,7
9225,3,home,14,24,10
9225,4,<ENDS>,24,24,0
9226,0,<START>,0,0,0
9226,1,home,0,7,7
9226,2,work,7,9,2
9226,3,home,9,15,6
9226,4,work,15,19,4
9226,5,home,19,24,5
9226,6,<ENDS>,24,24,0
9227,0,<START>,0,0,0
9227,1,home,0,6,6
9227,2,work,6,13,7
9227,3,home,13,24,11
9227,4,<ENDS>,24,24,0
9228,0,<START>,0,0,0
9228,1,home,0,8,8
9228,2,work,8,14,6
9228,3,home,14,24,10
9228,4,<ENDS>,24,24,0
9229,0,<START>,0,0,0
9229,1,home,0,8,8
9229,2,work,8,15,7
9229,3,home,15,22,7
9229,4,work,22,23,1
9229,5,home,23,24,1
9229,6,<ENDS>,24,24,0
9230,0,<START>,0,0,0
9230,1,home,0,7,7
9230,2,shop,7,8,1
9230,3,education,8,12,4
9230,4,shop,12,14,2
9230,5,education,14,16,2
9230,6,shop,16,17,1
9230,7,home,17,24,7
9230,8,<ENDS>,24,24,0
9231,0,<START>,0,0,0
9231,1,home,0,8,8
9231,2,work,8,15,7
9231,3,home,15,24,9
9231,4,<ENDS>,24,24,0
9232,0,<START>,0,0,0
9232,1,home,0,6,6
9232,2,work,6,13,7
9232,3,shop,13,14,1
9232,4,work,14,19,5
9232,5,home,19,24,5
9232,6,<ENDS>,24,24,0
9233,0,<START>,0,0,0
9233,1,home,0,8,8
9233,2,work,8,16,8
9233,3,shop,16,17,1
9233,4,work,17,20,3
9233,5,home,20,24,4
9233,6,<ENDS>,24,24,0
9234,0,<START>,0,0,0
9234,1,home,0,8,8
9234,2,education,8,14,6
9234,3,shop,14,16,2
9234,4,home,16,21,5
9234,5,shop,21,22,1
9234,6,home,22,24,2
9234,7,<ENDS>,24,24,0
9235,0,<START>,0,0,0
9235,1,home,0,7,7
9235,2,work,7,14,7
9235,3,shop,14,15,1
9235,4,home,15,23,8
9235,5,work,23,24,1
9235,6,<ENDS>,24,24,0
9236,0,<START>,0,0,0
9236,1,home,0,8,8
9236,2,work,8,15,7
9236,3,shop,15,16,1
9236,4,work,16,20,4
9236,5,home,20,24,4
9236,6,<ENDS>,24,24,0
9237,0,<START>,0,0,0
9237,1,home,0,7,7
9237,2,education,7,11,4
9237,3,home,11,17,6
9237,4,shop,17,18,1
9237,5,home,18,24,6
9237,6,<ENDS>,24,24,0
9238,0,<START>,0,0,0
9238,1,home,0,8,8
9238,2,work,8,15,7
9238,3,home,15,24,9
9238,4,<ENDS>,24,24,0
9239,0,<START>,0,0,0
9239,1,home,0,9,9
9239,2,work,9,16,7
9239,3,shop,16,17,1
9239,4,home,17,21,4
9239,5,work,21,22,1
9239,6,home,22,24,2
9239,7,<ENDS>,24,24,0
9240,0,<START>,0,0,0
9240,1,home,0,7,7
9240,2,shop,7,9,2
9240,3,education,9,12,3
9240,4,home,12,18,6
9240,5,shop,18,19,1
9240,6,home,19,24,5
9240,7,<ENDS>,24,24,0
9241,0,<START>,0,0,0
9241,1,home,0,8,8
9241,2,work,8,15,7
9241,3,shop,15,16,1
9241,4,home,16,24,8
9241,5,<ENDS>,24,24,0
9242,0,<START>,0,0,0
9242,1,home,0,8,8
9242,2,work,8,15,7
9242,3,home,15,21,6
9242,4,work,21,22,1
9242,5,home,22,24,2
9242,6,<ENDS>,24,24,0
9243,0,<START>,0,0,0
9243,1,home,0,7,7
9243,2,work,7,13,6
9243,3,shop,13,14,1
9243,4,work,14,19,5
9243,5,home,19,24,5
9243,6,<ENDS>,24,24,0
9244,0,<START>,0,0,0
9244,1,home,0,7,7
9244,2,shop,7,8,1
9244,3,work,8,16,8
9244,4,home,16,24,8
9244,5,<ENDS>,24,24,0
9245,0,<START>,0,0,0
9245,1,home,0,7,7
9245,2,education,7,12,5
9245,3,shop,12,14,2
9245,4,education,14,16,2
9245,5,shop,16,17,1
9245,6,home,17,20,3
9245,7,shop,20,21,1
9245,8,home,21,24,3
9245,9,<ENDS>,24,24,0
9246,0,<START>,0,0,0
9246,1,home,0,7,7
9246,2,work,7,13,6
9246,3,home,13,24,11
9246,4,<ENDS>,24,24,0
9247,0,<START>,0,0,0
9247,1,home,0,8,8
9247,2,work,8,15,7
9247,3,home,15,24,9
9247,4,<ENDS>,24,24,0
9248,0,<START>,0,0,0
9248,1,home,0,6,6
9248,2,work,6,13,7
9248,3,shop,13,14,1
9248,4,home,14,18,4
9248,5,work,18,20,2
9248,6,home,20,24,4
9248,7,<ENDS>,24,24,0
9249,0,<START>,0,0,0
9249,1,home,0,6,6
9249,2,work,6,8,2
9249,3,home,8,10,2
9249,4,work,10,12,2
9249,5,home,12,18,6
9249,6,work,18,19,1
9249,7,home,19,23,4
9249,8,work,23,24,1
9249,9,<ENDS>,24,24,0
9250,0,<START>,0,0,0
9250,1,home,0,6,6
9250,2,work,6,13,7
9250,3,shop,13,14,1
9250,4,education,14,17,3
9250,5,home,17,24,7
9250,6,<ENDS>,24,24,0
9251,0,<START>,0,0,0
9251,1,home,0,7,7
9251,2,work,7,14,7
9251,3,home,14,24,10
9251,4,<ENDS>,24,24,0
9252,0,<START>,0,0,0
9252,1,home,0,7,7
9252,2,work,7,14,7
9252,3,home,14,24,10
9252,4,<ENDS>,24,24,0
9253,0,<START>,0,0,0
9253,1,home,0,6,6
9253,2,shop,6,7,1
9253,3,home,7,10,3
9253,4,education,10,12,2
9253,5,shop,12,14,2
9253,6,education,14,16,2
9253,7,shop,16,17,1
9253,8,home,17,21,4
9253,9,shop,21,22,1
9253,10,home,22,24,2
9253,11,<ENDS>,24,24,0
9254,0,<START>,0,0,0
9254,1,home,0,7,7
9254,2,work,7,14,7
9254,3,shop,14,15,1
9254,4,home,15,24,9
9254,5,<ENDS>,24,24,0
9255,0,<START>,0,0,0
9255,1,home,0,7,7
9255,2,work,7,14,7
9255,3,home,14,24,10
9255,4,<ENDS>,24,24,0
9256,0,<START>,0,0,0
9256,1,home,0,7,7
9256,2,education,7,12,5
9256,3,shop,12,13,1
9256,4,education,13,16,3
9256,5,home,16,24,8
9256,6,<ENDS>,24,24,0
9257,0,<START>,0,0,0
9257,1,home,0,6,6
9257,2,work,6,9,3
9257,3,home,9,15,6
9257,4,work,15,17,2
9257,5,home,17,22,5
9257,6,work,22,23,1
9257,7,home,23,24,1
9257,8,<ENDS>,24,24,0
9258,0,<START>,0,0,0
9258,1,home,0,8,8
9258,2,education,8,12,4
9258,3,home,12,16,4
9258,4,shop,16,17,1
9258,5,home,17,24,7
9258,6,<ENDS>,24,24,0
9259,0,<START>,0,0,0
9259,1,home,0,7,7
9259,2,education,7,11,4
9259,3,home,11,14,3
9259,4,education,14,17,3
9259,5,home,17,24,7
9259,6,<ENDS>,24,24,0
9260,0,<START>,0,0,0
9260,1,home,0,7,7
9260,2,work,7,14,7
9260,3,shop,14,15,1
9260,4,home,15,18,3
9260,5,work,18,20,2
9260,6,home,20,24,4
9260,7,<ENDS>,24,24,0
9261,0,<START>,0,0,0
9261,1,home,0,9,9
9261,2,work,9,15,6
9261,3,home,15,21,6
9261,4,work,21,22,1
9261,5,home,22,24,2
9261,6,<ENDS>,24,24,0
9262,0,<START>,0,0,0
9262,1,home,0,7,7
9262,2,education,7,11,4
9262,3,home,11,18,7
9262,4,shop,18,19,1
9262,5,home,19,24,5
9262,6,<ENDS>,24,24,0
9263,0,<START>,0,0,0
9263,1,home,0,7,7
9263,2,work,7,13,6
9263,3,home,13,18,5
9263,4,shop,18,19,1
9263,5,home,19,23,4
9263,6,work,23,24,1
9263,7,<ENDS>,24,24,0
9264,0,<START>,0,0,0
9264,1,home,0,6,6
9264,2,shop,6,7,1
9264,3,work,7,14,7
9264,4,home,14,24,10
9264,5,<ENDS>,24,24,0
9265,0,<START>,0,0,0
9265,1,home,0,7,7
9265,2,shop,7,8,1
9265,3,home,8,12,4
9265,4,education,12,15,3
9265,5,home,15,22,7
9265,6,work,22,23,1
9265,7,home,23,24,1
9265,8,<ENDS>,24,24,0
9266,0,<START>,0,0,0
9266,1,home,0,7,7
9266,2,shop,7,9,2
9266,3,work,9,16,7
9266,4,home,16,24,8
9266,5,<ENDS>,24,24,0
9267,0,<START>,0,0,0
9267,1,home,0,7,7
9267,2,work,7,14,7
9267,3,shop,14,15,1
9267,4,work,15,20,5
9267,5,home,20,24,4
9267,6,<ENDS>,24,24,0
9268,0,<START>,0,0,0
9268,1,home,0,6,6
9268,2,work,6,8,2
9268,3,home,8,12,4
9268,4,work,12,14,2
9268,5,home,14,21,7
9268,6,work,21,22,1
9268,7,home,22,24,2
9268,8,<ENDS>,24,24,0
9269,0,<START>,0,0,0
9269,1,home,0,6,6
9269,2,work,6,8,2
9269,3,home,8,12,4
9269,4,work,12,13,1
9269,5,home,13,23,10
9269,6,work,23,24,1
9269,7,<ENDS>,24,24,0
9270,0,<START>,0,0,0
9270,1,home,0,7,7
9270,2,work,7,13,6
9270,3,home,13,16,3
9270,4,work,16,20,4
9270,5,home,20,24,4
9270,6,<ENDS>,24,24,0
9271,0,<START>,0,0,0
9271,1,home,0,6,6
9271,2,shop,6,7,1
9271,3,home,7,13,6
9271,4,education,13,17,4
9271,5,shop,17,19,2
9271,6,home,19,24,5
9271,7,<ENDS>,24,24,0
9272,0,<START>,0,0,0
9272,1,home,0,6,6
9272,2,work,6,13,7
9272,3,shop,13,14,1
9272,4,home,14,24,10
9272,5,<ENDS>,24,24,0
9273,0,<START>,0,0,0
9273,1,home,0,7,7
9273,2,work,7,13,6
9273,3,home,13,24,11
9273,4,<ENDS>,24,24,0
9274,0,<START>,0,0,0
9274,1,home,0,7,7
9274,2,work,7,14,7
9274,3,home,14,18,4
9274,4,shop,18,19,1
9274,5,home,19,24,5
9274,6,<ENDS>,24,24,0
9275,0,<START>,0,0,0
9275,1,home,0,8,8
9275,2,work,8,16,8
9275,3,home,16,24,8
9275,4,<ENDS>,24,24,0
9276,0,<START>,0,0,0
9276,1,home,0,8,8
9276,2,work,8,15,7
9276,3,shop,15,16,1
9276,4,home,16,24,8
9276,5,<ENDS>,24,24,0
9277,0,<START>,0,0,0
9277,1,home,0,7,7
9277,2,work,7,13,6
9277,3,home,13,17,4
9277,4,work,17,20,3
9277,5,home,20,24,4
9277,6,<ENDS>,24,24,0
9278,0,<START>,0,0,0
9278,1,home,0,7,7
9278,2,work,7,14,7
9278,3,home,14,24,10
9278,4,<ENDS>,24,24,0
9279,0,<START>,0,0,0
9279,1,home,0,7,7
9279,2,work,7,13,6
9279,3,shop,13,14,1
9279,4,work,14,19,5
9279,5,home,19,24,5
9279,6,<ENDS>,24,24,0
9280,0,<START>,0,0,0
9280,1,home,0,7,7
9280,2,work,7,14,7
9280,3,home,14,21,7
9280,4,shop,21,22,1
9280,5,home,22,24,2
9280,6,<ENDS>,24,24,0
9281,0,<START>,0,0,0
9281,1,home,0,8,8
9281,2,shop,8,10,2
9281,3,work,10,17,7
9281,4,home,17,24,7
9281,5,<ENDS>,24,24,0
9282,0,<START>,0,0,0
9282,1,home,0,7,7
9282,2,education,7,12,5
9282,3,home,12,16,4
9282,4,shop,16,17,1
9282,5,home,17,24,7
9282,6,<ENDS>,24,24,0
9283,0,<START>,0,0,0
9283,1,home,0,8,8
9283,2,work,8,14,6
9283,3,shop,14,15,1
9283,4,home,15,23,8
9283,5,work,23,24,1
9283,6,<ENDS>,24,24,0
9284,0,<START>,0,0,0
9284,1,home,0,7,7
9284,2,work,7,14,7
9284,3,shop,14,16,2
9284,4,home,16,24,8
9284,5,<ENDS>,24,24,0
9285,0,<START>,0,0,0
9285,1,home,0,8,8
9285,2,work,8,15,7
9285,3,shop,15,16,1
9285,4,home,16,21,5
9285,5,shop,21,22,1
9285,6,home,22,24,2
9285,7,<ENDS>,24,24,0
9286,0,<START>,0,0,0
9286,1,home,0,7,7
9286,2,work,7,14,7
9286,3,home,14,19,5
9286,4,shop,19,20,1
9286,5,home,20,24,4
9286,6,<ENDS>,24,24,0
9287,0,<START>,0,0,0
9287,1,home,0,7,7
9287,2,work,7,13,6
9287,3,shop,13,14,1
9287,4,work,14,19,5
9287,5,home,19,24,5
9287,6,<ENDS>,24,24,0
9288,0,<START>,0,0,0
9288,1,home,0,6,6
9288,2,work,6,9,3
9288,3,home,9,13,4
9288,4,work,13,15,2
9288,5,home,15,20,5
9288,6,shop,20,21,1
9288,7,home,21,24,3
9288,8,<ENDS>,24,24,0
9289,0,<START>,0,0,0
9289,1,home,0,7,7
9289,2,work,7,13,6
9289,3,home,13,23,10
9289,4,work,23,24,1
9289,5,<ENDS>,24,24,0
9290,0,<START>,0,0,0
9290,1,home,0,8,8
9290,2,work,8,15,7
9290,3,home,15,24,9
9290,4,<ENDS>,24,24,0
9291,0,<START>,0,0,0
9291,1,home,0,7,7
9291,2,work,7,8,1
9291,3,home,8,15,7
9291,4,work,15,17,2
9291,5,home,17,24,7
9291,6,<ENDS>,24,24,0
9292,0,<START>,0,0,0
9292,1,home,0,8,8
9292,2,education,8,11,3
9292,3,home,11,18,7
9292,4,shop,18,19,1
9292,5,home,19,24,5
9292,6,<ENDS>,24,24,0
9293,0,<START>,0,0,0
9293,1,home,0,7,7
9293,2,work,7,14,7
9293,3,home,14,24,10
9293,4,<ENDS>,24,24,0
9294,0,<START>,0,0,0
9294,1,home,0,7,7
9294,2,education,7,12,5
9294,3,shop,12,14,2
9294,4,education,14,16,2
9294,5,home,16,24,8
9294,6,<ENDS>,24,24,0
9295,0,<START>,0,0,0
9295,1,home,0,8,8
9295,2,education,8,11,3
9295,3,home,11,17,6
9295,4,shop,17,18,1
9295,5,home,18,24,6
9295,6,<ENDS>,24,24,0
9296,0,<START>,0,0,0
9296,1,home,0,7,7
9296,2,shop,7,9,2
9296,3,education,9,12,3
9296,4,shop,12,13,1
9296,5,home,13,20,7
9296,6,shop,20,21,1
9296,7,home,21,24,3
9296,8,<ENDS>,24,24,0
9297,0,<START>,0,0,0
9297,1,home,0,7,7
9297,2,work,7,14,7
9297,3,home,14,22,8
9297,4,work,22,23,1
9297,5,home,23,24,1
9297,6,<ENDS>,24,24,0
9298,0,<START>,0,0,0
9298,1,home,0,7,7
9298,2,shop,7,8,1
9298,3,work,8,15,7
9298,4,home,15,23,8
9298,5,work,23,24,1
9298,6,<ENDS>,24,24,0
9299,0,<START>,0,0,0
9299,1,home,0,6,6
9299,2,shop,6,7,1
9299,3,home,7,8,1
9299,4,education,8,11,3
9299,5,home,11,18,7
9299,6,shop,18,19,1
9299,7,home,19,24,5
9299,8,<ENDS>,24,24,0
9300,0,<START>,0,0,0
9300,1,home,0,6,6
9300,2,work,6,7,1
9300,3,home,7,13,6
9300,4,work,13,15,2
9300,5,home,15,22,7
9300,6,work,22,23,1
9300,7,home,23,24,1
9300,8,<ENDS>,24,24,0
9301,0,<START>,0,0,0
9301,1,home,0,8,8
9301,2,work,8,14,6
9301,3,shop,14,15,1
9301,4,work,15,19,4
9301,5,home,19,24,5
9301,6,<ENDS>,24,24,0
9302,0,<START>,0,0,0
9302,1,home,0,7,7
9302,2,work,7,14,7
9302,3,shop,14,15,1
9302,4,work,15,20,5
9302,5,home,20,24,4
9302,6,<ENDS>,24,24,0
9303,0,<START>,0,0,0
9303,1,home,0,7,7
9303,2,work,7,13,6
9303,3,home,13,24,11
9303,4,<ENDS>,24,24,0
9304,0,<START>,0,0,0
9304,1,home,0,7,7
9304,2,work,7,13,6
9304,3,home,13,22,9
9304,4,work,22,23,1
9304,5,home,23,24,1
9304,6,<ENDS>,24,24,0
9305,0,<START>,0,0,0
9305,1,home,0,7,7
9305,2,work,7,9,2
9305,3,home,9,13,4
9305,4,work,13,15,2
9305,5,home,15,22,7
9305,6,work,22,23,1
9305,7,home,23,24,1
9305,8,<ENDS>,24,24,0
9306,0,<START>,0,0,0
9306,1,home,0,6,6
9306,2,shop,6,7,1
9306,3,home,7,10,3
9306,4,education,10,13,3
9306,5,shop,13,15,2
9306,6,home,15,21,6
9306,7,shop,21,22,1
9306,8,home,22,24,2
9306,9,<ENDS>,24,24,0
9307,0,<START>,0,0,0
9307,1,home,0,6,6
9307,2,shop,6,7,1
9307,3,work,7,14,7
9307,4,home,14,15,1
9307,5,work,15,20,5
9307,6,home,20,24,4
9307,7,<ENDS>,24,24,0
9308,0,<START>,0,0,0
9308,1,home,0,7,7
9308,2,work,7,13,6
9308,3,home,13,20,7
9308,4,shop,20,21,1
9308,5,home,21,24,3
9308,6,<ENDS>,24,24,0
9309,0,<START>,0,0,0
9309,1,home,0,7,7
9309,2,shop,7,9,2
9309,3,education,9,11,2
9309,4,home,11,18,7
9309,5,shop,18,19,1
9309,6,home,19,24,5
9309,7,<ENDS>,24,24,0
9310,0,<START>,0,0,0
9310,1,home,0,9,9
9310,2,work,9,16,7
9310,3,home,16,21,5
9310,4,shop,21,22,1
9310,5,home,22,24,2
9310,6,<ENDS>,24,24,0
9311,0,<START>,0,0,0
9311,1,home,0,7,7
9311,2,education,7,11,4
9311,3,home,11,14,3
9311,4,education,14,16,2
9311,5,home,16,24,8
9311,6,<ENDS>,24,24,0
9312,0,<START>,0,0,0
9312,1,home,0,7,7
9312,2,work,7,14,7
9312,3,home,14,21,7
9312,4,shop,21,22,1
9312,5,home,22,24,2
9312,6,<ENDS>,24,24,0
9313,0,<START>,0,0,0
9313,1,home,0,8,8
9313,2,work,8,14,6
9313,3,shop,14,15,1
9313,4,home,15,21,6
9313,5,work,21,22,1
9313,6,home,22,24,2
9313,7,<ENDS>,24,24,0
9314,0,<START>,0,0,0
9314,1,home,0,6,6
9314,2,work,6,8,2
9314,3,home,8,15,7
9314,4,work,15,17,2
9314,5,home,17,24,7
9314,6,<ENDS>,24,24,0
9315,0,<START>,0,0,0
9315,1,home,0,8,8
9315,2,work,8,15,7
9315,3,home,15,21,6
9315,4,shop,21,22,1
9315,5,home,22,24,2
9315,6,<ENDS>,24,24,0
9316,0,<START>,0,0,0
9316,1,home,0,6,6
9316,2,work,6,13,7
9316,3,shop,13,14,1
9316,4,home,14,24,10
9316,5,<ENDS>,24,24,0
9317,0,<START>,0,0,0
9317,1,home,0,7,7
9317,2,work,7,14,7
9317,3,shop,14,15,1
9317,4,home,15,24,9
9317,5,<ENDS>,24,24,0
9318,0,<START>,0,0,0
9318,1,home,0,7,7
9318,2,work,7,14,7
9318,3,home,14,24,10
9318,4,<ENDS>,24,24,0
9319,0,<START>,0,0,0
9319,1,home,0,7,7
9319,2,work,7,13,6
9319,3,shop,13,14,1
9319,4,work,14,19,5
9319,5,home,19,24,5
9319,6,<ENDS>,24,24,0
9320,0,<START>,0,0,0
9320,1,home,0,6,6
9320,2,work,6,8,2
9320,3,home,8,11,3
9320,4,work,11,13,2
9320,5,home,13,21,8
9320,6,work,21,22,1
9320,7,home,22,24,2
9320,8,<ENDS>,24,24,0
9321,0,<START>,0,0,0
9321,1,home,0,6,6
9321,2,work,6,13,7
9321,3,home,13,15,2
9321,4,work,15,19,4
9321,5,home,19,24,5
9321,6,<ENDS>,24,24,0
9322,0,<START>,0,0,0
9322,1,home,0,6,6
9322,2,work,6,13,7
9322,3,shop,13,14,1
9322,4,work,14,19,5
9322,5,home,19,24,5
9322,6,<ENDS>,24,24,0
9323,0,<START>,0,0,0
9323,1,home,0,6,6
9323,2,work,6,13,7
9323,3,home,13,23,10
9323,4,work,23,24,1
9323,5,<ENDS>,24,24,0
9324,0,<START>,0,0,0
9324,1,home,0,6,6
9324,2,work,6,8,2
9324,3,home,8,9,1
9324,4,work,9,11,2
9324,5,home,11,17,6
9324,6,work,17,19,2
9324,7,home,19,24,5
9324,8,<ENDS>,24,24,0
9325,0,<START>,0,0,0
9325,1,home,0,7,7
9325,2,work,7,13,6
9325,3,home,13,24,11
9325,4,<ENDS>,24,24,0
9326,0,<START>,0,0,0
9326,1,home,0,8,8
9326,2,work,8,15,7
9326,3,shop,15,16,1
9326,4,home,16,22,6
9326,5,work,22,23,1
9326,6,home,23,24,1
9326,7,<ENDS>,24,24,0
9327,0,<START>,0,0,0
9327,1,home,0,7,7
9327,2,education,7,12,5
9327,3,shop,12,14,2
9327,4,education,14,16,2
9327,5,shop,16,17,1
9327,6,home,17,24,7
9327,7,<ENDS>,24,24,0
9328,0,<START>,0,0,0
9328,1,home,0,8,8
9328,2,work,8,15,7
9328,3,home,15,24,9
9328,4,<ENDS>,24,24,0
9329,0,<START>,0,0,0
9329,1,home,0,7,7
9329,2,work,7,13,6
9329,3,shop,13,14,1
9329,4,home,14,22,8
9329,5,work,22,23,1
9329,6,home,23,24,1
9329,7,<ENDS>,24,24,0
9330,0,<START>,0,0,0
9330,1,home,0,7,7
9330,2,work,7,13,6
9330,3,home,13,17,4
9330,4,work,17,20,3
9330,5,home,20,24,4
9330,6,<ENDS>,24,24,0
9331,0,<START>,0,0,0
9331,1,home,0,7,7
9331,2,work,7,13,6
9331,3,home,13,22,9
9331,4,work,22,23,1
9331,5,home,23,24,1
9331,6,<ENDS>,24,24,0
9332,0,<START>,0,0,0
9332,1,home,0,7,7
9332,2,education,7,12,5
9332,3,shop,12,14,2
9332,4,home,14,21,7
9332,5,shop,21,22,1
9332,6,home,22,24,2
9332,7,<ENDS>,24,24,0
9333,0,<START>,0,0,0
9333,1,home,0,6,6
9333,2,shop,6,7,1
9333,3,home,7,10,3
9333,4,education,10,14,4
9333,5,shop,14,15,1
9333,6,home,15,24,9
9333,7,<ENDS>,24,24,0
9334,0,<START>,0,0,0
9334,1,home,0,6,6
9334,2,work,6,13,7
9334,3,home,13,24,11
9334,4,<ENDS>,24,24,0
9335,0,<START>,0,0,0
9335,1,home,0,6,6
9335,2,shop,6,7,1
9335,3,home,7,13,6
9335,4,education,13,16,3
9335,5,home,16,24,8
9335,6,<ENDS>,24,24,0
9336,0,<START>,0,0,0
9336,1,home,0,7,7
9336,2,work,7,14,7
9336,3,shop,14,15,1
9336,4,home,15,24,9
9336,5,<ENDS>,24,24,0
9337,0,<START>,0,0,0
9337,1,home,0,7,7
9337,2,work,7,14,7
9337,3,home,14,21,7
9337,4,work,21,22,1
9337,5,home,22,24,2
9337,6,<ENDS>,24,24,0
9338,0,<START>,0,0,0
9338,1,home,0,8,8
9338,2,work,8,14,6
9338,3,home,14,23,9
9338,4,work,23,24,1
9338,5,<ENDS>,24,24,0
9339,0,<START>,0,0,0
9339,1,home,0,7,7
9339,2,education,7,12,5
9339,3,shop,12,13,1
9339,4,education,13,16,3
9339,5,shop,16,17,1
9339,6,home,17,21,4
9339,7,shop,21,22,1
9339,8,home,22,24,2
9339,9,<ENDS>,24,24,0
9340,0,<START>,0,0,0
9340,1,home,0,7,7
9340,2,work,7,13,6
9340,3,shop,13,14,1
9340,4,home,14,22,8
9340,5,work,22,23,1
9340,6,home,23,24,1
9340,7,<ENDS>,24,24,0
9341,0,<START>,0,0,0
9341,1,home,0,8,8
9341,2,work,8,15,7
9341,3,home,15,17,2
9341,4,work,17,19,2
9341,5,home,19,24,5
9341,6,<ENDS>,24,24,0
9342,0,<START>,0,0,0
9342,1,home,0,7,7
9342,2,work,7,13,6
9342,3,shop,13,14,1
9342,4,work,14,19,5
9342,5,home,19,24,5
9342,6,<ENDS>,24,24,0
9343,0,<START>,0,0,0
9343,1,home,0,7,7
9343,2,work,7,13,6
9343,3,home,13,15,2
9343,4,work,15,19,4
9343,5,home,19,24,5
9343,6,<ENDS>,24,24,0
9344,0,<START>,0,0,0
9344,1,home,0,7,7
9344,2,work,7,13,6
9344,3,home,13,15,2
9344,4,work,15,20,5
9344,5,home,20,24,4
9344,6,<ENDS>,24,24,0
9345,0,<START>,0,0,0
9345,1,home,0,7,7
9345,2,work,7,13,6
9345,3,shop,13,14,1
9345,4,work,14,20,6
9345,5,home,20,24,4
9345,6,<ENDS>,24,24,0
9346,0,<START>,0,0,0
9346,1,home,0,8,8
9346,2,work,8,15,7
9346,3,home,15,24,9
9346,4,<ENDS>,24,24,0
9347,0,<START>,0,0,0
9347,1,home,0,6,6
9347,2,shop,6,7,1
9347,3,home,7,9,2
9347,4,work,9,16,7
9347,5,home,16,24,8
9347,6,<ENDS>,24,24,0
9348,0,<START>,0,0,0
9348,1,home,0,6,6
9348,2,work,6,12,6
9348,3,shop,12,13,1
9348,4,work,13,19,6
9348,5,home,19,24,5
9348,6,<ENDS>,24,24,0
9349,0,<START>,0,0,0
9349,1,home,0,7,7
9349,2,work,7,14,7
9349,3,shop,14,15,1
9349,4,work,15,20,5
9349,5,home,20,24,4
9349,6,<ENDS>,24,24,0
9350,0,<START>,0,0,0
9350,1,home,0,7,7
9350,2,education,7,12,5
9350,3,home,12,19,7
9350,4,shop,19,20,1
9350,5,home,20,24,4
9350,6,<ENDS>,24,24,0
9351,0,<START>,0,0,0
9351,1,home,0,8,8
9351,2,work,8,14,6
9351,3,shop,14,15,1
9351,4,home,15,24,9
9351,5,<ENDS>,24,24,0
9352,0,<START>,0,0,0
9352,1,home,0,6,6
9352,2,work,6,13,7
9352,3,shop,13,14,1
9352,4,home,14,24,10
9352,5,<ENDS>,24,24,0
9353,0,<START>,0,0,0
9353,1,home,0,7,7
9353,2,work,7,13,6
9353,3,shop,13,15,2
9353,4,home,15,24,9
9353,5,<ENDS>,24,24,0
9354,0,<START>,0,0,0
9354,1,home,0,8,8
9354,2,work,8,16,8
9354,3,shop,16,17,1
9354,4,home,17,23,6
9354,5,work,23,24,1
9354,6,<ENDS>,24,24,0
9355,0,<START>,0,0,0
9355,1,home,0,7,7
9355,2,education,7,11,4
9355,3,home,11,18,7
9355,4,shop,18,20,2
9355,5,home,20,24,4
9355,6,<ENDS>,24,24,0
9356,0,<START>,0,0,0
9356,1,home,0,7,7
9356,2,work,7,14,7
9356,3,home,14,23,9
9356,4,work,23,24,1
9356,5,<ENDS>,24,24,0
9357,0,<START>,0,0,0
9357,1,home,0,8,8
9357,2,shop,8,9,1
9357,3,work,9,17,8
9357,4,home,17,24,7
9357,5,<ENDS>,24,24,0
9358,0,<START>,0,0,0
9358,1,home,0,7,7
9358,2,work,7,13,6
9358,3,home,13,21,8
9358,4,work,21,22,1
9358,5,home,22,24,2
9358,6,<ENDS>,24,24,0
9359,0,<START>,0,0,0
9359,1,home,0,6,6
9359,2,shop,6,7,1
9359,3,home,7,9,2
9359,4,education,9,12,3
9359,5,shop,12,14,2
9359,6,education,14,16,2
9359,7,home,16,24,8
9359,8,<ENDS>,24,24,0
9360,0,<START>,0,0,0
9360,1,home,0,7,7
9360,2,education,7,11,4
9360,3,home,11,15,4
9360,4,shop,15,16,1
9360,5,home,16,21,5
9360,6,shop,21,22,1
9360,7,home,22,24,2
9360,8,<ENDS>,24,24,0
9361,0,<START>,0,0,0
9361,1,home,0,6,6
9361,2,work,6,8,2
9361,3,home,8,12,4
9361,4,work,12,15,3
9361,5,home,15,23,8
9361,6,work,23,24,1
9361,7,<ENDS>,24,24,0
9362,0,<START>,0,0,0
9362,1,home,0,6,6
9362,2,work,6,8,2
9362,3,home,8,9,1
9362,4,work,9,11,2
9362,5,home,11,16,5
9362,6,work,16,18,2
9362,7,home,18,24,6
9362,8,<ENDS>,24,24,0
9363,0,<START>,0,0,0
9363,1,home,0,7,7
9363,2,shop,7,8,1
9363,3,work,8,15,7
9363,4,home,15,24,9
9363,5,<ENDS>,24,24,0
9364,0,<START>,0,0,0
9364,1,home,0,7,7
9364,2,work,7,12,5
9364,3,shop,12,13,1
9364,4,work,13,19,6
9364,5,home,19,24,5
9364,6,<ENDS>,24,24,0
9365,0,<START>,0,0,0
9365,1,home,0,7,7
9365,2,work,7,13,6
9365,3,home,13,16,3
9365,4,work,16,20,4
9365,5,home,20,24,4
9365,6,<ENDS>,24,24,0
9366,0,<START>,0,0,0
9366,1,home,0,8,8
9366,2,shop,8,9,1
9366,3,education,9,11,2
9366,4,home,11,14,3
9366,5,education,14,16,2
9366,6,home,16,24,8
9366,7,<ENDS>,24,24,0
9367,0,<START>,0,0,0
9367,1,home,0,8,8
9367,2,work,8,15,7
9367,3,shop,15,16,1
9367,4,home,16,21,5
9367,5,work,21,22,1
9367,6,home,22,24,2
9367,7,<ENDS>,24,24,0
9368,0,<START>,0,0,0
9368,1,home,0,8,8
9368,2,work,8,15,7
9368,3,home,15,22,7
9368,4,work,22,23,1
9368,5,home,23,24,1
9368,6,<ENDS>,24,24,0
9369,0,<START>,0,0,0
9369,1,home,0,7,7
9369,2,work,7,14,7
9369,3,home,14,24,10
9369,4,<ENDS>,24,24,0
9370,0,<START>,0,0,0
9370,1,home,0,9,9
9370,2,education,9,13,4
9370,3,work,13,20,7
9370,4,home,20,24,4
9370,5,<ENDS>,24,24,0
9371,0,<START>,0,0,0
9371,1,home,0,7,7
9371,2,work,7,14,7
9371,3,home,14,20,6
9371,4,shop,20,21,1
9371,5,home,21,24,3
9371,6,<ENDS>,24,24,0
9372,0,<START>,0,0,0
9372,1,home,0,7,7
9372,2,shop,7,8,1
9372,3,home,8,14,6
9372,4,education,14,17,3
9372,5,home,17,21,4
9372,6,work,21,22,1
9372,7,home,22,24,2
9372,8,<ENDS>,24,24,0
9373,0,<START>,0,0,0
9373,1,home,0,6,6
9373,2,work,6,13,7
9373,3,home,13,24,11
9373,4,<ENDS>,24,24,0
9374,0,<START>,0,0,0
9374,1,home,0,6,6
9374,2,work,6,13,7
9374,3,home,13,24,11
9374,4,<ENDS>,24,24,0
9375,0,<START>,0,0,0
9375,1,home,0,6,6
9375,2,work,6,13,7
9375,3,home,13,24,11
9375,4,<ENDS>,24,24,0
9376,0,<START>,0,0,0
9376,1,home,0,8,8
9376,2,work,8,14,6
9376,3,home,14,21,7
9376,4,work,21,22,1
9376,5,home,22,24,2
9376,6,<ENDS>,24,24,0
9377,0,<START>,0,0,0
9377,1,home,0,8,8
9377,2,work,8,15,7
9377,3,home,15,24,9
9377,4,<ENDS>,24,24,0
9378,0,<START>,0,0,0
9378,1,home,0,7,7
9378,2,education,7,12,5
9378,3,home,12,14,2
9378,4,education,14,16,2
9378,5,home,16,24,8
9378,6,<ENDS>,24,24,0
9379,0,<START>,0,0,0
9379,1,home,0,8,8
9379,2,education,8,11,3
9379,3,home,11,17,6
9379,4,shop,17,18,1
9379,5,home,18,24,6
9379,6,<ENDS>,24,24,0
9380,0,<START>,0,0,0
9380,1,home,0,6,6
9380,2,work,6,8,2
9380,3,home,8,12,4
9380,4,work,12,14,2
9380,5,home,14,21,7
9380,6,work,21,22,1
9380,7,home,22,24,2
9380,8,<ENDS>,24,24,0
9381,0,<START>,0,0,0
9381,1,home,0,7,7
9381,2,work,7,14,7
9381,3,shop,14,15,1
9381,4,work,15,18,3
9381,5,home,18,24,6
9381,6,<ENDS>,24,24,0
9382,0,<START>,0,0,0
9382,1,home,0,7,7
9382,2,work,7,14,7
9382,3,home,14,21,7
9382,4,work,21,22,1
9382,5,home,22,24,2
9382,6,<ENDS>,24,24,0
9383,0,<START>,0,0,0
9383,1,home,0,6,6
9383,2,work,6,13,7
9383,3,home,13,17,4
9383,4,shop,17,18,1
9383,5,home,18,24,6
9383,6,<ENDS>,24,24,0
9384,0,<START>,0,0,0
9384,1,home,0,6,6
9384,2,work,6,8,2
9384,3,home,8,12,4
9384,4,work,12,14,2
9384,5,home,14,21,7
9384,6,shop,21,22,1
9384,7,home,22,24,2
9384,8,<ENDS>,24,24,0
9385,0,<START>,0,0,0
9385,1,home,0,7,7
9385,2,work,7,13,6
9385,3,shop,13,14,1
9385,4,work,14,20,6
9385,5,home,20,24,4
9385,6,<ENDS>,24,24,0
9386,0,<START>,0,0,0
9386,1,home,0,6,6
9386,2,work,6,7,1
9386,3,home,7,13,6
9386,4,work,13,16,3
9386,5,home,16,24,8
9386,6,<ENDS>,24,24,0
9387,0,<START>,0,0,0
9387,1,home,0,8,8
9387,2,work,8,14,6
9387,3,home,14,24,10
9387,4,<ENDS>,24,24,0
9388,0,<START>,0,0,0
9388,1,home,0,7,7
9388,2,shop,7,8,1
9388,3,education,8,11,3
9388,4,home,11,17,6
9388,5,shop,17,19,2
9388,6,home,19,24,5
9388,7,<ENDS>,24,24,0
9389,0,<START>,0,0,0
9389,1,home,0,7,7
9389,2,work,7,13,6
9389,3,home,13,14,1
9389,4,shop,14,15,1
9389,5,work,15,19,4
9389,6,home,19,24,5
9389,7,<ENDS>,24,24,0
9390,0,<START>,0,0,0
9390,1,home,0,7,7
9390,2,education,7,11,4
9390,3,home,11,18,7
9390,4,shop,18,19,1
9390,5,home,19,24,5
9390,6,<ENDS>,24,24,0
9391,0,<START>,0,0,0
9391,1,home,0,8,8
9391,2,work,8,14,6
9391,3,shop,14,15,1
9391,4,home,15,21,6
9391,5,work,21,22,1
9391,6,home,22,24,2
9391,7,<ENDS>,24,24,0
9392,0,<START>,0,0,0
9392,1,home,0,8,8
9392,2,work,8,14,6
9392,3,home,14,18,4
9392,4,shop,18,19,1
9392,5,home,19,24,5
9392,6,<ENDS>,24,24,0
9393,0,<START>,0,0,0
9393,1,home,0,7,7
9393,2,work,7,13,6
9393,3,shop,13,14,1
9393,4,home,14,18,4
9393,5,work,18,20,2
9393,6,home,20,24,4
9393,7,<ENDS>,24,24,0
9394,0,<START>,0,0,0
9394,1,home,0,8,8
9394,2,work,8,14,6
9394,3,shop,14,15,1
9394,4,home,15,24,9
9394,5,<ENDS>,24,24,0
9395,0,<START>,0,0,0
9395,1,home,0,6,6
9395,2,work,6,13,7
9395,3,shop,13,14,1
9395,4,home,14,23,9
9395,5,work,23,24,1
9395,6,<ENDS>,24,24,0
9396,0,<START>,0,0,0
9396,1,home,0,8,8
9396,2,education,8,11,3
9396,3,home,11,16,5
9396,4,work,16,20,4
9396,5,home,20,24,4
9396,6,<ENDS>,24,24,0
9397,0,<START>,0,0,0
9397,1,home,0,7,7
9397,2,work,7,14,7
9397,3,home,14,20,6
9397,4,shop,20,21,1
9397,5,home,21,24,3
9397,6,<ENDS>,24,24,0
9398,0,<START>,0,0,0
9398,1,home,0,6,6
9398,2,work,6,13,7
9398,3,shop,13,14,1
9398,4,work,14,19,5
9398,5,home,19,24,5
9398,6,<ENDS>,24,24,0
9399,0,<START>,0,0,0
9399,1,home,0,6,6
9399,2,work,6,8,2
9399,3,shop,8,9,1
9399,4,home,9,15,6
9399,5,work,15,17,2
9399,6,home,17,22,5
9399,7,work,22,23,1
9399,8,home,23,24,1
9399,9,<ENDS>,24,24,0
9400,0,<START>,0,0,0
9400,1,home,0,7,7
9400,2,work,7,12,5
9400,3,shop,12,13,1
9400,4,work,13,17,4
9400,5,home,17,24,7
9400,6,<ENDS>,24,24,0
9401,0,<START>,0,0,0
9401,1,home,0,7,7
9401,2,education,7,13,6
9401,3,home,13,20,7
9401,4,shop,20,21,1
9401,5,home,21,24,3
9401,6,<ENDS>,24,24,0
9402,0,<START>,0,0,0
9402,1,home,0,6,6
9402,2,work,6,13,7
9402,3,shop,13,14,1
9402,4,home,14,15,1
9402,5,work,15,20,5
9402,6,home,20,24,4
9402,7,<ENDS>,24,24,0
9403,0,<START>,0,0,0
9403,1,home,0,7,7
9403,2,work,7,13,6
9403,3,shop,13,14,1
9403,4,work,14,19,5
9403,5,home,19,24,5
9403,6,<ENDS>,24,24,0
9404,0,<START>,0,0,0
9404,1,home,0,7,7
9404,2,work,7,14,7
9404,3,home,14,24,10
9404,4,<ENDS>,24,24,0
9405,0,<START>,0,0,0
9405,1,home,0,6,6
9405,2,shop,6,7,1
9405,3,home,7,13,6
9405,4,education,13,16,3
9405,5,home,16,24,8
9405,6,<ENDS>,24,24,0
9406,0,<START>,0,0,0
9406,1,home,0,8,8
9406,2,work,8,15,7
9406,3,home,15,21,6
9406,4,shop,21,22,1
9406,5,home,22,24,2
9406,6,<ENDS>,24,24,0
9407,0,<START>,0,0,0
9407,1,home,0,7,7
9407,2,work,7,13,6
9407,3,shop,13,14,1
9407,4,work,14,19,5
9407,5,home,19,24,5
9407,6,<ENDS>,24,24,0
9408,0,<START>,0,0,0
9408,1,home,0,6,6
9408,2,work,6,13,7
9408,3,shop,13,14,1
9408,4,work,14,19,5
9408,5,home,19,24,5
9408,6,<ENDS>,24,24,0
9409,0,<START>,0,0,0
9409,1,home,0,6,6
9409,2,work,6,8,2
9409,3,home,8,11,3
9409,4,work,11,13,2
9409,5,home,13,21,8
9409,6,work,21,22,1
9409,7,home,22,24,2
9409,8,<ENDS>,24,24,0
9410,0,<START>,0,0,0
9410,1,home,0,8,8
9410,2,education,8,11,3
9410,3,shop,11,12,1
9410,4,home,12,24,12
9410,5,<ENDS>,24,24,0
9411,0,<START>,0,0,0
9411,1,home,0,8,8
9411,2,education,8,11,3
9411,3,home,11,14,3
9411,4,education,14,16,2
9411,5,home,16,24,8
9411,6,<ENDS>,24,24,0
9412,0,<START>,0,0,0
9412,1,home,0,6,6
9412,2,shop,6,7,1
9412,3,home,7,10,3
9412,4,education,10,13,3
9412,5,shop,13,15,2
9412,6,home,15,19,4
9412,7,shop,19,20,1
9412,8,home,20,24,4
9412,9,<ENDS>,24,24,0
9413,0,<START>,0,0,0
9413,1,home,0,6,6
9413,2,shop,6,7,1
9413,3,work,7,13,6
9413,4,home,13,17,4
9413,5,work,17,20,3
9413,6,home,20,24,4
9413,7,<ENDS>,24,24,0
9414,0,<START>,0,0,0
9414,1,home,0,6,6
9414,2,work,6,13,7
9414,3,home,13,24,11
9414,4,<ENDS>,24,24,0
9415,0,<START>,0,0,0
9415,1,home,0,7,7
9415,2,shop,7,9,2
9415,3,education,9,12,3
9415,4,home,12,18,6
9415,5,shop,18,19,1
9415,6,home,19,24,5
9415,7,<ENDS>,24,24,0
9416,0,<START>,0,0,0
9416,1,home,0,7,7
9416,2,work,7,13,6
9416,3,home,13,24,11
9416,4,<ENDS>,24,24,0
9417,0,<START>,0,0,0
9417,1,home,0,7,7
9417,2,work,7,9,2
9417,3,home,9,14,5
9417,4,work,14,16,2
9417,5,home,16,22,6
9417,6,work,22,23,1
9417,7,home,23,24,1
9417,8,<ENDS>,24,24,0
9418,0,<START>,0,0,0
9418,1,home,0,8,8
9418,2,work,8,15,7
9418,3,home,15,20,5
9418,4,shop,20,21,1
9418,5,home,21,24,3
9418,6,<ENDS>,24,24,0
9419,0,<START>,0,0,0
9419,1,home,0,7,7
9419,2,work,7,14,7
9419,3,home,14,23,9
9419,4,work,23,24,1
9419,5,<ENDS>,24,24,0
9420,0,<START>,0,0,0
9420,1,home,0,7,7
9420,2,work,7,13,6
9420,3,home,13,17,4
9420,4,shop,17,18,1
9420,5,home,18,24,6
9420,6,<ENDS>,24,24,0
9421,0,<START>,0,0,0
9421,1,home,0,6,6
9421,2,work,6,12,6
9421,3,shop,12,13,1
9421,4,work,13,19,6
9421,5,home,19,24,5
9421,6,<ENDS>,24,24,0
9422,0,<START>,0,0,0
9422,1,home,0,7,7
9422,2,work,7,13,6
9422,3,shop,13,14,1
9422,4,work,14,19,5
9422,5,home,19,24,5
9422,6,<ENDS>,24,24,0
9423,0,<START>,0,0,0
9423,1,home,0,6,6
9423,2,work,6,8,2
9423,3,home,8,13,5
9423,4,work,13,15,2
9423,5,home,15,21,6
9423,6,work,21,22,1
9423,7,home,22,24,2
9423,8,<ENDS>,24,24,0
9424,0,<START>,0,0,0
9424,1,home,0,7,7
9424,2,work,7,12,5
9424,3,shop,12,13,1
9424,4,work,13,19,6
9424,5,home,19,24,5
9424,6,<ENDS>,24,24,0
9425,0,<START>,0,0,0
9425,1,home,0,7,7
9425,2,shop,7,9,2
9425,3,education,9,12,3
9425,4,home,12,19,7
9425,5,shop,19,20,1
9425,6,home,20,24,4
9425,7,<ENDS>,24,24,0
9426,0,<START>,0,0,0
9426,1,home,0,6,6
9426,2,work,6,8,2
9426,3,home,8,13,5
9426,4,work,13,14,1
9426,5,home,14,22,8
9426,6,work,22,23,1
9426,7,home,23,24,1
9426,8,<ENDS>,24,24,0
9427,0,<START>,0,0,0
9427,1,home,0,7,7
9427,2,education,7,12,5
9427,3,shop,12,14,2
9427,4,education,14,16,2
9427,5,shop,16,18,2
9427,6,home,18,24,6
9427,7,<ENDS>,24,24,0
9428,0,<START>,0,0,0
9428,1,home,0,8,8
9428,2,education,8,12,4
9428,3,home,12,16,4
9428,4,shop,16,17,1
9428,5,home,17,21,4
9428,6,shop,21,22,1
9428,7,home,22,24,2
9428,8,<ENDS>,24,24,0
9429,0,<START>,0,0,0
9429,1,home,0,8,8
9429,2,education,8,12,4
9429,3,home,12,20,8
9429,4,shop,20,21,1
9429,5,home,21,24,3
9429,6,<ENDS>,24,24,0
9430,0,<START>,0,0,0
9430,1,home,0,8,8
9430,2,work,8,15,7
9430,3,shop,15,16,1
9430,4,home,16,24,8
9430,5,<ENDS>,24,24,0
9431,0,<START>,0,0,0
9431,1,home,0,8,8
9431,2,work,8,15,7
9431,3,home,15,24,9
9431,4,<ENDS>,24,24,0
9432,0,<START>,0,0,0
9432,1,home,0,6,6
9432,2,work,6,13,7
9432,3,home,13,17,4
9432,4,work,17,18,1
9432,5,home,18,24,6
9432,6,<ENDS>,24,24,0
9433,0,<START>,0,0,0
9433,1,home,0,7,7
9433,2,education,7,11,4
9433,3,home,11,17,6
9433,4,shop,17,18,1
9433,5,home,18,24,6
9433,6,<ENDS>,24,24,0
9434,0,<START>,0,0,0
9434,1,home,0,6,6
9434,2,shop,6,7,1
9434,3,home,7,13,6
9434,4,work,13,19,6
9434,5,home,19,24,5
9434,6,<ENDS>,24,24,0
9435,0,<START>,0,0,0
9435,1,home,0,6,6
9435,2,shop,6,7,1
9435,3,home,7,10,3
9435,4,education,10,12,2
9435,5,home,12,18,6
9435,6,shop,18,20,2
9435,7,home,20,24,4
9435,8,<ENDS>,24,24,0
9436,0,<START>,0,0,0
9436,1,home,0,8,8
9436,2,work,8,15,7
9436,3,home,15,22,7
9436,4,work,22,23,1
9436,5,home,23,24,1
9436,6,<ENDS>,24,24,0
9437,0,<START>,0,0,0
9437,1,home,0,7,7
9437,2,work,7,13,6
9437,3,home,13,17,4
9437,4,shop,17,18,1
9437,5,home,18,24,6
9437,6,<ENDS>,24,24,0
9438,0,<START>,0,0,0
9438,1,home,0,8,8
9438,2,work,8,15,7
9438,3,shop,15,16,1
9438,4,work,16,20,4
9438,5,home,20,24,4
9438,6,<ENDS>,24,24,0
9439,0,<START>,0,0,0
9439,1,home,0,7,7
9439,2,education,7,12,5
9439,3,shop,12,13,1
9439,4,education,13,16,3
9439,5,shop,16,17,1
9439,6,home,17,24,7
9439,7,<ENDS>,24,24,0
9440,0,<START>,0,0,0
9440,1,home,0,8,8
9440,2,education,8,11,3
9440,3,home,11,18,7
9440,4,shop,18,19,1
9440,5,home,19,24,5
9440,6,<ENDS>,24,24,0
9441,0,<START>,0,0,0
9441,1,home,0,8,8
9441,2,work,8,16,8
9441,3,home,16,23,7
9441,4,work,23,24,1
9441,5,<ENDS>,24,24,0
9442,0,<START>,0,0,0
9442,1,home,0,7,7
9442,2,work,7,15,8
9442,3,home,15,21,6
9442,4,work,21,22,1
9442,5,home,22,24,2
9442,6,<ENDS>,24,24,0
9443,0,<START>,0,0,0
9443,1,home,0,7,7
9443,2,work,7,9,2
9443,3,home,9,13,4
9443,4,work,13,16,3
9443,5,home,16,22,6
9443,6,work,22,23,1
9443,7,home,23,24,1
9443,8,<ENDS>,24,24,0
9444,0,<START>,0,0,0
9444,1,home,0,7,7
9444,2,work,7,13,6
9444,3,home,13,14,1
9444,4,education,14,16,2
9444,5,home,16,24,8
9444,6,<ENDS>,24,24,0
9445,0,<START>,0,0,0
9445,1,home,0,7,7
9445,2,work,7,13,6
9445,3,home,13,20,7
9445,4,shop,20,21,1
9445,5,home,21,24,3
9445,6,<ENDS>,24,24,0
9446,0,<START>,0,0,0
9446,1,home,0,8,8
9446,2,work,8,15,7
9446,3,home,15,24,9
9446,4,<ENDS>,24,24,0
9447,0,<START>,0,0,0
9447,1,home,0,7,7
9447,2,shop,7,8,1
9447,3,education,8,12,4
9447,4,home,12,19,7
9447,5,shop,19,20,1
9447,6,home,20,24,4
9447,7,<ENDS>,24,24,0
9448,0,<START>,0,0,0
9448,1,home,0,8,8
9448,2,work,8,14,6
9448,3,shop,14,15,1
9448,4,work,15,19,4
9448,5,home,19,24,5
9448,6,<ENDS>,24,24,0
9449,0,<START>,0,0,0
9449,1,home,0,8,8
9449,2,education,8,11,3
9449,3,home,11,15,4
9449,4,work,15,20,5
9449,5,home,20,23,3
9449,6,work,23,24,1
9449,7,<ENDS>,24,24,0
9450,0,<START>,0,0,0
9450,1,home,0,6,6
9450,2,shop,6,7,1
9450,3,home,7,10,3
9450,4,education,10,12,2
9450,5,home,12,19,7
9450,6,shop,19,21,2
9450,7,home,21,24,3
9450,8,<ENDS>,24,24,0
9451,0,<START>,0,0,0
9451,1,home,0,8,8
9451,2,work,8,15,7
9451,3,shop,15,16,1
9451,4,work,16,19,3
9451,5,home,19,24,5
9451,6,<ENDS>,24,24,0
9452,0,<START>,0,0,0
9452,1,home,0,8,8
9452,2,work,8,15,7
9452,3,home,15,24,9
9452,4,<ENDS>,24,24,0
9453,0,<START>,0,0,0
9453,1,home,0,8,8
9453,2,education,8,12,4
9453,3,work,12,19,7
9453,4,home,19,24,5
9453,5,<ENDS>,24,24,0
9454,0,<START>,0,0,0
9454,1,home,0,8,8
9454,2,work,8,15,7
9454,3,home,15,24,9
9454,4,<ENDS>,24,24,0
9455,0,<START>,0,0,0
9455,1,home,0,8,8
9455,2,education,8,12,4
9455,3,home,12,17,5
9455,4,work,17,20,3
9455,5,home,20,24,4
9455,6,<ENDS>,24,24,0
9456,0,<START>,0,0,0
9456,1,home,0,6,6
9456,2,shop,6,7,1
9456,3,home,7,9,2
9456,4,education,9,11,2
9456,5,home,11,19,8
9456,6,shop,19,20,1
9456,7,home,20,24,4
9456,8,<ENDS>,24,24,0
9457,0,<START>,0,0,0
9457,1,home,0,6,6
9457,2,work,6,13,7
9457,3,home,13,24,11
9457,4,<ENDS>,24,24,0
9458,0,<START>,0,0,0
9458,1,home,0,7,7
9458,2,work,7,14,7
9458,3,shop,14,15,1
9458,4,home,15,24,9
9458,5,<ENDS>,24,24,0
9459,0,<START>,0,0,0
9459,1,home,0,7,7
9459,2,education,7,12,5
9459,3,shop,12,14,2
9459,4,education,14,16,2
9459,5,home,16,24,8
9459,6,<ENDS>,24,24,0
9460,0,<START>,0,0,0
9460,1,home,0,6,6
9460,2,work,6,9,3
9460,3,home,9,12,3
9460,4,work,12,14,2
9460,5,home,14,21,7
9460,6,work,21,22,1
9460,7,home,22,24,2
9460,8,<ENDS>,24,24,0
9461,0,<START>,0,0,0
9461,1,home,0,6,6
9461,2,work,6,13,7
9461,3,home,13,20,7
9461,4,shop,20,21,1
9461,5,home,21,24,3
9461,6,<ENDS>,24,24,0
9462,0,<START>,0,0,0
9462,1,home,0,6,6
9462,2,work,6,13,7
9462,3,shop,13,14,1
9462,4,home,14,24,10
9462,5,<ENDS>,24,24,0
9463,0,<START>,0,0,0
9463,1,home,0,7,7
9463,2,shop,7,9,2
9463,3,education,9,14,5
9463,4,shop,14,15,1
9463,5,home,15,24,9
9463,6,<ENDS>,24,24,0
9464,0,<START>,0,0,0
9464,1,home,0,6,6
9464,2,shop,6,7,1
9464,3,work,7,13,6
9464,4,shop,13,15,2
9464,5,home,15,24,9
9464,6,<ENDS>,24,24,0
9465,0,<START>,0,0,0
9465,1,home,0,8,8
9465,2,work,8,15,7
9465,3,home,15,17,2
9465,4,work,17,20,3
9465,5,home,20,24,4
9465,6,<ENDS>,24,24,0
9466,0,<START>,0,0,0
9466,1,home,0,7,7
9466,2,work,7,13,6
9466,3,home,13,22,9
9466,4,work,22,23,1
9466,5,home,23,24,1
9466,6,<ENDS>,24,24,0
9467,0,<START>,0,0,0
9467,1,home,0,7,7
9467,2,shop,7,8,1
9467,3,education,8,11,3
9467,4,home,11,14,3
9467,5,education,14,16,2
9467,6,home,16,24,8
9467,7,<ENDS>,24,24,0
9468,0,<START>,0,0,0
9468,1,home,0,6,6
9468,2,work,6,8,2
9468,3,home,8,12,4
9468,4,work,12,14,2
9468,5,home,14,20,6
9468,6,shop,20,21,1
9468,7,home,21,24,3
9468,8,<ENDS>,24,24,0
9469,0,<START>,0,0,0
9469,1,home,0,7,7
9469,2,work,7,9,2
9469,3,home,9,12,3
9469,4,work,12,15,3
9469,5,home,15,21,6
9469,6,work,21,22,1
9469,7,home,22,24,2
9469,8,<ENDS>,24,24,0
9470,0,<START>,0,0,0
9470,1,home,0,6,6
9470,2,shop,6,7,1
9470,3,home,7,8,1
9470,4,work,8,14,6
9470,5,home,14,24,10
9470,6,<ENDS>,24,24,0
9471,0,<START>,0,0,0
9471,1,home,0,8,8
9471,2,work,8,15,7
9471,3,home,15,23,8
9471,4,work,23,24,1
9471,5,<ENDS>,24,24,0
9472,0,<START>,0,0,0
9472,1,home,0,6,6
9472,2,work,6,13,7
9472,3,home,13,21,8
9472,4,work,21,22,1
9472,5,home,22,24,2
9472,6,<ENDS>,24,24,0
9473,0,<START>,0,0,0
9473,1,home,0,7,7
9473,2,education,7,13,6
9473,3,shop,13,15,2
9473,4,home,15,19,4
9473,5,shop,19,20,1
9473,6,home,20,24,4
9473,7,<ENDS>,24,24,0
9474,0,<START>,0,0,0
9474,1,home,0,6,6
9474,2,work,6,13,7
9474,3,home,13,17,4
9474,4,work,17,20,3
9474,5,home,20,24,4
9474,6,<ENDS>,24,24,0
9475,0,<START>,0,0,0
9475,1,home,0,6,6
9475,2,shop,6,7,1
9475,3,home,7,10,3
9475,4,education,10,14,4
9475,5,shop,14,15,1
9475,6,home,15,24,9
9475,7,<ENDS>,24,24,0
9476,0,<START>,0,0,0
9476,1,home,0,8,8
9476,2,work,8,15,7
9476,3,home,15,18,3
9476,4,shop,18,19,1
9476,5,home,19,24,5
9476,6,<ENDS>,24,24,0
9477,0,<START>,0,0,0
9477,1,home,0,8,8
9477,2,work,8,15,7
9477,3,home,15,22,7
9477,4,work,22,23,1
9477,5,home,23,24,1
9477,6,<ENDS>,24,24,0
9478,0,<START>,0,0,0
9478,1,home,0,7,7
9478,2,work,7,13,6
9478,3,home,13,16,3
9478,4,work,16,20,4
9478,5,home,20,24,4
9478,6,<ENDS>,24,24,0
9479,0,<START>,0,0,0
9479,1,home,0,6,6
9479,2,work,6,8,2
9479,3,home,8,9,1
9479,4,work,9,11,2
9479,5,home,11,16,5
9479,6,work,16,19,3
9479,7,home,19,23,4
9479,8,work,23,24,1
9479,9,<ENDS>,24,24,0
9480,0,<START>,0,0,0
9480,1,home,0,7,7
9480,2,work,7,14,7
9480,3,home,14,23,9
9480,4,work,23,24,1
9480,5,<ENDS>,24,24,0
9481,0,<START>,0,0,0
9481,1,home,0,6,6
9481,2,work,6,8,2
9481,3,home,8,9,1
9481,4,work,9,11,2
9481,5,home,11,17,6
9481,6,work,17,19,2
9481,7,home,19,24,5
9481,8,<ENDS>,24,24,0
9482,0,<START>,0,0,0
9482,1,home,0,6,6
9482,2,shop,6,7,1
9482,3,work,7,13,6
9482,4,home,13,24,11
9482,5,<ENDS>,24,24,0
9483,0,<START>,0,0,0
9483,1,home,0,6,6
9483,2,work,6,13,7
9483,3,shop,13,14,1
9483,4,work,14,19,5
9483,5,home,19,24,5
9483,6,<ENDS>,24,24,0
9484,0,<START>,0,0,0
9484,1,home,0,8,8
9484,2,work,8,15,7
9484,3,home,15,21,6
9484,4,work,21,22,1
9484,5,home,22,24,2
9484,6,<ENDS>,24,24,0
9485,0,<START>,0,0,0
9485,1,home,0,7,7
9485,2,work,7,13,6
9485,3,home,13,24,11
9485,4,<ENDS>,24,24,0
9486,0,<START>,0,0,0
9486,1,home,0,6,6
9486,2,shop,6,7,1
9486,3,home,7,13,6
9486,4,education,13,16,3
9486,5,home,16,24,8
9486,6,<ENDS>,24,24,0
9487,0,<START>,0,0,0
9487,1,home,0,6,6
9487,2,shop,6,7,1
9487,3,home,7,11,4
9487,4,education,11,15,4
9487,5,shop,15,16,1
9487,6,home,16,24,8
9487,7,<ENDS>,24,24,0
9488,0,<START>,0,0,0
9488,1,work,0,8,8
9488,2,shop,8,9,1
9488,3,work,9,15,6
9488,4,home,15,24,9
9488,5,<ENDS>,24,24,0
9489,0,<START>,0,0,0
9489,1,home,0,7,7
9489,2,education,7,12,5
9489,3,shop,12,14,2
9489,4,home,14,20,6
9489,5,shop,20,21,1
9489,6,home,21,24,3
9489,7,<ENDS>,24,24,0
9490,0,<START>,0,0,0
9490,1,home,0,8,8
9490,2,work,8,14,6
9490,3,home,14,20,6
9490,4,shop,20,21,1
9490,5,home,21,24,3
9490,6,<ENDS>,24,24,0
9491,0,<START>,0,0,0
9491,1,home,0,7,7
9491,2,work,7,13,6
9491,3,shop,13,14,1
9491,4,home,14,24,10
9491,5,<ENDS>,24,24,0
9492,0,<START>,0,0,0
9492,1,home,0,6,6
9492,2,shop,6,7,1
9492,3,home,7,13,6
9492,4,education,13,16,3
9492,5,home,16,24,8
9492,6,<ENDS>,24,24,0
9493,0,<START>,0,0,0
9493,1,home,0,8,8
9493,2,work,8,14,6
9493,3,shop,14,15,1
9493,4,home,15,22,7
9493,5,work,22,23,1
9493,6,home,23,24,1
9493,7,<ENDS>,24,24,0
9494,0,<START>,0,0,0
9494,1,home,0,7,7
9494,2,work,7,14,7
9494,3,home,14,18,4
9494,4,shop,18,19,1
9494,5,home,19,24,5
9494,6,<ENDS>,24,24,0
9495,0,<START>,0,0,0
9495,1,home,0,7,7
9495,2,work,7,13,6
9495,3,shop,13,14,1
9495,4,work,14,20,6
9495,5,home,20,24,4
9495,6,<ENDS>,24,24,0
9496,0,<START>,0,0,0
9496,1,home,0,7,7
9496,2,work,7,13,6
9496,3,home,13,18,5
9496,4,work,18,19,1
9496,5,home,19,24,5
9496,6,<ENDS>,24,24,0
9497,0,<START>,0,0,0
9497,1,home,0,6,6
9497,2,shop,6,7,1
9497,3,work,7,13,6
9497,4,shop,13,14,1
9497,5,home,14,21,7
9497,6,work,21,22,1
9497,7,home,22,24,2
9497,8,<ENDS>,24,24,0
9498,0,<START>,0,0,0
9498,1,home,0,8,8
9498,2,work,8,13,5
9498,3,shop,13,14,1
9498,4,home,14,24,10
9498,5,<ENDS>,24,24,0
9499,0,<START>,0,0,0
9499,1,home,0,7,7
9499,2,shop,7,8,1
9499,3,work,8,15,7
9499,4,home,15,24,9
9499,5,<ENDS>,24,24,0
9500,0,<START>,0,0,0
9500,1,home,0,6,6
9500,2,work,6,13,7
9500,3,shop,13,14,1
9500,4,home,14,17,3
9500,5,work,17,20,3
9500,6,home,20,24,4
9500,7,<ENDS>,24,24,0
9501,0,<START>,0,0,0
9501,1,home,0,6,6
9501,2,shop,6,7,1
9501,3,home,7,13,6
9501,4,education,13,16,3
9501,5,home,16,20,4
9501,6,shop,20,21,1
9501,7,home,21,24,3
9501,8,<ENDS>,24,24,0
9502,0,<START>,0,0,0
9502,1,home,0,6,6
9502,2,work,6,8,2
9502,3,home,8,12,4
9502,4,work,12,14,2
9502,5,home,14,21,7
9502,6,work,21,22,1
9502,7,home,22,24,2
9502,8,<ENDS>,24,24,0
9503,0,<START>,0,0,0
9503,1,home,0,8,8
9503,2,work,8,15,7
9503,3,home,15,24,9
9503,4,<ENDS>,24,24,0
9504,0,<START>,0,0,0
9504,1,home,0,8,8
9504,2,work,8,13,5
9504,3,shop,13,14,1
9504,4,home,14,24,10
9504,5,<ENDS>,24,24,0
9505,0,<START>,0,0,0
9505,1,home,0,7,7
9505,2,shop,7,8,1
9505,3,work,8,15,7
9505,4,home,15,24,9
9505,5,<ENDS>,24,24,0
9506,0,<START>,0,0,0
9506,1,home,0,8,8
9506,2,work,8,16,8
9506,3,home,16,22,6
9506,4,work,22,23,1
9506,5,home,23,24,1
9506,6,<ENDS>,24,24,0
9507,0,<START>,0,0,0
9507,1,home,0,7,7
9507,2,shop,7,8,1
9507,3,education,8,11,3
9507,4,home,11,17,6
9507,5,shop,17,19,2
9507,6,home,19,24,5
9507,7,<ENDS>,24,24,0
9508,0,<START>,0,0,0
9508,1,home,0,6,6
9508,2,work,6,7,1
9508,3,home,7,13,6
9508,4,work,13,15,2
9508,5,home,15,21,6
9508,6,work,21,22,1
9508,7,home,22,24,2
9508,8,<ENDS>,24,24,0
9509,0,<START>,0,0,0
9509,1,home,0,7,7
9509,2,shop,7,8,1
9509,3,home,8,13,5
9509,4,work,13,20,7
9509,5,home,20,24,4
9509,6,<ENDS>,24,24,0
9510,0,<START>,0,0,0
9510,1,home,0,8,8
9510,2,work,8,14,6
9510,3,home,14,24,10
9510,4,<ENDS>,24,24,0
9511,0,<START>,0,0,0
9511,1,home,0,7,7
9511,2,work,7,14,7
9511,3,home,14,24,10
9511,4,<ENDS>,24,24,0
9512,0,<START>,0,0,0
9512,1,home,0,6,6
9512,2,work,6,13,7
9512,3,home,13,21,8
9512,4,shop,21,22,1
9512,5,home,22,24,2
9512,6,<ENDS>,24,24,0
9513,0,<START>,0,0,0
9513,1,home,0,6,6
9513,2,work,6,14,8
9513,3,shop,14,15,1
9513,4,work,15,20,5
9513,5,home,20,24,4
9513,6,<ENDS>,24,24,0
9514,0,<START>,0,0,0
9514,1,home,0,8,8
9514,2,education,8,11,3
9514,3,home,11,14,3
9514,4,education,14,17,3
9514,5,shop,17,18,1
9514,6,home,18,24,6
9514,7,<ENDS>,24,24,0
9515,0,<START>,0,0,0
9515,1,home,0,7,7
9515,2,work,7,13,6
9515,3,home,13,17,4
9515,4,work,17,20,3
9515,5,home,20,24,4
9515,6,<ENDS>,24,24,0
9516,0,<START>,0,0,0
9516,1,home,0,6,6
9516,2,shop,6,7,1
9516,3,home,7,10,3
9516,4,education,10,13,3
9516,5,shop,13,14,1
9516,6,education,14,16,2
9516,7,home,16,24,8
9516,8,<ENDS>,24,24,0
9517,0,<START>,0,0,0
9517,1,home,0,8,8
9517,2,work,8,15,7
9517,3,home,15,21,6
9517,4,work,21,22,1
9517,5,home,22,24,2
9517,6,<ENDS>,24,24,0
9518,0,<START>,0,0,0
9518,1,home,0,7,7
9518,2,education,7,11,4
9518,3,home,11,18,7
9518,4,shop,18,19,1
9518,5,home,19,24,5
9518,6,<ENDS>,24,24,0
9519,0,<START>,0,0,0
9519,1,home,0,7,7
9519,2,work,7,15,8
9519,3,home,15,24,9
9519,4,<ENDS>,24,24,0
9520,0,<START>,0,0,0
9520,1,home,0,8,8
9520,2,shop,8,10,2
9520,3,home,10,15,5
9520,4,work,15,20,5
9520,5,home,20,24,4
9520,6,<ENDS>,24,24,0
9521,0,<START>,0,0,0
9521,1,home,0,6,6
9521,2,work,6,13,7
9521,3,home,13,24,11
9521,4,<ENDS>,24,24,0
9522,0,<START>,0,0,0
9522,1,home,0,6,6
9522,2,work,6,8,2
9522,3,home,8,14,6
9522,4,work,14,17,3
9522,5,home,17,24,7
9522,6,<ENDS>,24,24,0
9523,0,<START>,0,0,0
9523,1,home,0,6,6
9523,2,work,6,13,7
9523,3,shop,13,14,1
9523,4,work,14,20,6
9523,5,home,20,24,4
9523,6,<ENDS>,24,24,0
9524,0,<START>,0,0,0
9524,1,home,0,8,8
9524,2,shop,8,10,2
9524,3,work,10,16,6
9524,4,home,16,21,5
9524,5,work,21,22,1
9524,6,home,22,24,2
9524,7,<ENDS>,24,24,0
9525,0,<START>,0,0,0
9525,1,home,0,8,8
9525,2,work,8,15,7
9525,3,home,15,24,9
9525,4,<ENDS>,24,24,0
9526,0,<START>,0,0,0
9526,1,home,0,8,8
9526,2,shop,8,9,1
9526,3,work,9,17,8
9526,4,home,17,24,7
9526,5,<ENDS>,24,24,0
9527,0,<START>,0,0,0
9527,1,home,0,6,6
9527,2,shop,6,7,1
9527,3,home,7,9,2
9527,4,education,9,12,3
9527,5,shop,12,13,1
9527,6,education,13,16,3
9527,7,home,16,24,8
9527,8,<ENDS>,24,24,0
9528,0,<START>,0,0,0
9528,1,home,0,7,7
9528,2,work,7,14,7
9528,3,home,14,18,4
9528,4,shop,18,19,1
9528,5,home,19,23,4
9528,6,work,23,24,1
9528,7,<ENDS>,24,24,0
9529,0,<START>,0,0,0
9529,1,home,0,6,6
9529,2,work,6,12,6
9529,3,shop,12,13,1
9529,4,work,13,19,6
9529,5,home,19,24,5
9529,6,<ENDS>,24,24,0
9530,0,<START>,0,0,0
9530,1,home,0,9,9
9530,2,work,9,15,6
9530,3,shop,15,16,1
9530,4,home,16,22,6
9530,5,work,22,23,1
9530,6,home,23,24,1
9530,7,<ENDS>,24,24,0
9531,0,<START>,0,0,0
9531,1,home,0,6,6
9531,2,work,6,13,7
9531,3,shop,13,14,1
9531,4,work,14,19,5
9531,5,home,19,24,5
9531,6,<ENDS>,24,24,0
9532,0,<START>,0,0,0
9532,1,home,0,6,6
9532,2,work,6,7,1
9532,3,home,7,9,2
9532,4,work,9,11,2
9532,5,home,11,18,7
9532,6,work,18,20,2
9532,7,home,20,24,4
9532,8,<ENDS>,24,24,0
9533,0,<START>,0,0,0
9533,1,home,0,8,8
9533,2,education,8,11,3
9533,3,home,11,18,7
9533,4,shop,18,19,1
9533,5,home,19,24,5
9533,6,<ENDS>,24,24,0
9534,0,<START>,0,0,0
9534,1,home,0,6,6
9534,2,work,6,13,7
9534,3,shop,13,14,1
9534,4,home,14,24,10
9534,5,<ENDS>,24,24,0
9535,0,<START>,0,0,0
9535,1,home,0,7,7
9535,2,work,7,14,7
9535,3,shop,14,15,1
9535,4,home,15,24,9
9535,5,<ENDS>,24,24,0
9536,0,<START>,0,0,0
9536,1,home,0,7,7
9536,2,shop,7,8,1
9536,3,education,8,11,3
9536,4,home,11,18,7
9536,5,shop,18,19,1
9536,6,home,19,24,5
9536,7,<ENDS>,24,24,0
9537,0,<START>,0,0,0
9537,1,home,0,8,8
9537,2,work,8,15,7
9537,3,home,15,24,9
9537,4,<ENDS>,24,24,0
9538,0,<START>,0,0,0
9538,1,home,0,6,6
9538,2,work,6,13,7
9538,3,home,13,19,6
9538,4,shop,19,20,1
9538,5,home,20,23,3
9538,6,work,23,24,1
9538,7,<ENDS>,24,24,0
9539,0,<START>,0,0,0
9539,1,home,0,8,8
9539,2,work,8,15,7
9539,3,shop,15,16,1
9539,4,work,16,20,4
9539,5,home,20,24,4
9539,6,<ENDS>,24,24,0
9540,0,<START>,0,0,0
9540,1,home,0,6,6
9540,2,shop,6,7,1
9540,3,home,7,10,3
9540,4,education,10,12,2
9540,5,home,12,21,9
9540,6,shop,21,22,1
9540,7,home,22,24,2
9540,8,<ENDS>,24,24,0
9541,0,<START>,0,0,0
9541,1,home,0,8,8
9541,2,work,8,14,6
9541,3,home,14,24,10
9541,4,<ENDS>,24,24,0
9542,0,<START>,0,0,0
9542,1,home,0,6,6
9542,2,work,6,13,7
9542,3,home,13,22,9
9542,4,work,22,23,1
9542,5,home,23,24,1
9542,6,<ENDS>,24,24,0
9543,0,<START>,0,0,0
9543,1,home,0,7,7
9543,2,shop,7,9,2
9543,3,education,9,12,3
9543,4,home,12,19,7
9543,5,shop,19,21,2
9543,6,home,21,24,3
9543,7,<ENDS>,24,24,0
9544,0,<START>,0,0,0
9544,1,home,0,8,8
9544,2,work,8,14,6
9544,3,home,14,18,4
9544,4,work,18,19,1
9544,5,home,19,24,5
9544,6,<ENDS>,24,24,0
9545,0,<START>,0,0,0
9545,1,home,0,6,6
9545,2,work,6,13,7
9545,3,shop,13,15,2
9545,4,home,15,21,6
9545,5,work,21,22,1
9545,6,home,22,24,2
9545,7,<ENDS>,24,24,0
9546,0,<START>,0,0,0
9546,1,home,0,7,7
9546,2,work,7,9,2
9546,3,home,9,13,4
9546,4,work,13,15,2
9546,5,home,15,21,6
9546,6,work,21,22,1
9546,7,home,22,24,2
9546,8,<ENDS>,24,24,0
9547,0,<START>,0,0,0
9547,1,home,0,7,7
9547,2,work,7,14,7
9547,3,home,14,18,4
9547,4,shop,18,19,1
9547,5,home,19,24,5
9547,6,<ENDS>,24,24,0
9548,0,<START>,0,0,0
9548,1,home,0,6,6
9548,2,work,6,13,7
9548,3,home,13,24,11
9548,4,<ENDS>,24,24,0
9549,0,<START>,0,0,0
9549,1,home,0,7,7
9549,2,work,7,14,7
9549,3,shop,14,15,1
9549,4,work,15,20,5
9549,5,home,20,24,4
9549,6,<ENDS>,24,24,0
9550,0,<START>,0,0,0
9550,1,home,0,6,6
9550,2,work,6,13,7
9550,3,home,13,24,11
9550,4,<ENDS>,24,24,0
9551,0,<START>,0,0,0
9551,1,home,0,8,8
9551,2,education,8,11,3
9551,3,home,11,18,7
9551,4,shop,18,20,2
9551,5,home,20,24,4
9551,6,<ENDS>,24,24,0
9552,0,<START>,0,0,0
9552,1,home,0,8,8
9552,2,work,8,14,6
9552,3,home,14,18,4
9552,4,work,18,20,2
9552,5,home,20,24,4
9552,6,<ENDS>,24,24,0
9553,0,<START>,0,0,0
9553,1,home,0,7,7
9553,2,work,7,13,6
9553,3,home,13,24,11
9553,4,<ENDS>,24,24,0
9554,0,<START>,0,0,0
9554,1,home,0,7,7
9554,2,work,7,14,7
9554,3,home,14,18,4
9554,4,work,18,20,2
9554,5,home,20,24,4
9554,6,<ENDS>,24,24,0
9555,0,<START>,0,0,0
9555,1,home,0,7,7
9555,2,work,7,14,7
9555,3,home,14,18,4
9555,4,shop,18,19,1
9555,5,home,19,23,4
9555,6,work,23,24,1
9555,7,<ENDS>,24,24,0
9556,0,<START>,0,0,0
9556,1,home,0,8,8
9556,2,work,8,13,5
9556,3,shop,13,14,1
9556,4,work,14,19,5
9556,5,home,19,24,5
9556,6,<ENDS>,24,24,0
9557,0,<START>,0,0,0
9557,1,home,0,7,7
9557,2,education,7,11,4
9557,3,home,11,14,3
9557,4,education,14,16,2
9557,5,home,16,24,8
9557,6,<ENDS>,24,24,0
9558,0,<START>,0,0,0
9558,1,home,0,7,7
9558,2,work,7,14,7
9558,3,shop,14,16,2
9558,4,home,16,24,8
9558,5,<ENDS>,24,24,0
9559,0,<START>,0,0,0
9559,1,home,0,7,7
9559,2,work,7,14,7
9559,3,shop,14,15,1
9559,4,home,15,24,9
9559,5,<ENDS>,24,24,0
9560,0,<START>,0,0,0
9560,1,home,0,6,6
9560,2,shop,6,7,1
9560,3,home,7,9,2
9560,4,work,9,16,7
9560,5,shop,16,17,1
9560,6,home,17,24,7
9560,7,<ENDS>,24,24,0
9561,0,<START>,0,0,0
9561,1,home,0,6,6
9561,2,work,6,8,2
9561,3,home,8,14,6
9561,4,work,14,17,3
9561,5,home,17,24,7
9561,6,<ENDS>,24,24,0
9562,0,<START>,0,0,0
9562,1,home,0,8,8
9562,2,education,8,12,4
9562,3,home,12,16,4
9562,4,work,16,20,4
9562,5,home,20,24,4
9562,6,<ENDS>,24,24,0
9563,0,<START>,0,0,0
9563,1,home,0,8,8
9563,2,education,8,14,6
9563,3,shop,14,15,1
9563,4,home,15,24,9
9563,5,<ENDS>,24,24,0
9564,0,<START>,0,0,0
9564,1,home,0,8,8
9564,2,work,8,15,7
9564,3,home,15,24,9
9564,4,<ENDS>,24,24,0
9565,0,<START>,0,0,0
9565,1,home,0,7,7
9565,2,work,7,14,7
9565,3,home,14,17,3
9565,4,work,17,19,2
9565,5,home,19,24,5
9565,6,<ENDS>,24,24,0
9566,0,<START>,0,0,0
9566,1,home,0,8,8
9566,2,work,8,14,6
9566,3,home,14,21,7
9566,4,work,21,22,1
9566,5,home,22,24,2
9566,6,<ENDS>,24,24,0
9567,0,<START>,0,0,0
9567,1,home,0,6,6
9567,2,work,6,13,7
9567,3,home,13,16,3
9567,4,work,16,20,4
9567,5,home,20,24,4
9567,6,<ENDS>,24,24,0
9568,0,<START>,0,0,0
9568,1,home,0,6,6
9568,2,work,6,8,2
9568,3,home,8,9,1
9568,4,work,9,12,3
9568,5,home,12,18,6
9568,6,work,18,19,1
9568,7,home,19,24,5
9568,8,<ENDS>,24,24,0
9569,0,<START>,0,0,0
9569,1,home,0,6,6
9569,2,work,6,13,7
9569,3,shop,13,14,1
9569,4,work,14,19,5
9569,5,home,19,24,5
9569,6,<ENDS>,24,24,0
9570,0,<START>,0,0,0
9570,1,home,0,8,8
9570,2,shop,8,9,1
9570,3,home,9,21,12
9570,4,work,21,22,1
9570,5,home,22,24,2
9570,6,<ENDS>,24,24,0
9571,0,<START>,0,0,0
9571,1,home,0,8,8
9571,2,work,8,15,7
9571,3,home,15,24,9
9571,4,<ENDS>,24,24,0
9572,0,<START>,0,0,0
9572,1,home,0,7,7
9572,2,work,7,13,6
9572,3,shop,13,14,1
9572,4,home,14,18,4
9572,5,work,18,20,2
9572,6,home,20,24,4
9572,7,<ENDS>,24,24,0
9573,0,<START>,0,0,0
9573,1,home,0,6,6
9573,2,work,6,13,7
9573,3,shop,13,14,1
9573,4,work,14,20,6
9573,5,home,20,24,4
9573,6,<ENDS>,24,24,0
9574,0,<START>,0,0,0
9574,1,home,0,8,8
9574,2,work,8,14,6
9574,3,shop,14,15,1
9574,4,home,15,20,5
9574,5,shop,20,21,1
9574,6,home,21,24,3
9574,7,<ENDS>,24,24,0
9575,0,<START>,0,0,0
9575,1,home,0,6,6
9575,2,shop,6,7,1
9575,3,home,7,13,6
9575,4,work,13,20,7
9575,5,home,20,24,4
9575,6,<ENDS>,24,24,0
9576,0,<START>,0,0,0
9576,1,home,0,7,7
9576,2,work,7,14,7
9576,3,shop,14,15,1
9576,4,work,15,20,5
9576,5,home,20,24,4
9576,6,<ENDS>,24,24,0
9577,0,<START>,0,0,0
9577,1,home,0,7,7
9577,2,shop,7,8,1
9577,3,education,8,11,3
9577,4,home,11,19,8
9577,5,shop,19,21,2
9577,6,home,21,24,3
9577,7,<ENDS>,24,24,0
9578,0,<START>,0,0,0
9578,1,home,0,7,7
9578,2,education,7,11,4
9578,3,home,11,17,6
9578,4,shop,17,18,1
9578,5,home,18,24,6
9578,6,<ENDS>,24,24,0
9579,0,<START>,0,0,0
9579,1,home,0,8,8
9579,2,work,8,14,6
9579,3,home,14,18,4
9579,4,work,18,19,1
9579,5,home,19,24,5
9579,6,<ENDS>,24,24,0
9580,0,<START>,0,0,0
9580,1,home,0,8,8
9580,2,shop,8,9,1
9580,3,work,9,15,6
9580,4,shop,15,16,1
9580,5,work,16,20,4
9580,6,home,20,24,4
9580,7,<ENDS>,24,24,0
9581,0,<START>,0,0,0
9581,1,home,0,6,6
9581,2,shop,6,7,1
9581,3,home,7,14,7
9581,4,work,14,20,6
9581,5,home,20,24,4
9581,6,<ENDS>,24,24,0
9582,0,<START>,0,0,0
9582,1,home,0,7,7
9582,2,education,7,11,4
9582,3,home,11,13,2
9582,4,education,13,15,2
9582,5,shop,15,17,2
9582,6,home,17,24,7
9582,7,<ENDS>,24,24,0
9583,0,<START>,0,0,0
9583,1,home,0,7,7
9583,2,shop,7,8,1
9583,3,home,8,13,5
9583,4,education,13,16,3
9583,5,shop,16,17,1
9583,6,home,17,24,7
9583,7,<ENDS>,24,24,0
9584,0,<START>,0,0,0
9584,1,home,0,8,8
9584,2,work,8,14,6
9584,3,home,14,19,5
9584,4,shop,19,20,1
9584,5,home,20,24,4
9584,6,<ENDS>,24,24,0
9585,0,<START>,0,0,0
9585,1,home,0,7,7
9585,2,work,7,13,6
9585,3,shop,13,14,1
9585,4,work,14,19,5
9585,5,home,19,24,5
9585,6,<ENDS>,24,24,0
9586,0,<START>,0,0,0
9586,1,home,0,8,8
9586,2,education,8,16,8
9586,3,shop,16,17,1
9586,4,work,17,20,3
9586,5,home,20,24,4
9586,6,<ENDS>,24,24,0
9587,0,<START>,0,0,0
9587,1,home,0,6,6
9587,2,work,6,13,7
9587,3,shop,13,14,1
9587,4,home,14,24,10
9587,5,<ENDS>,24,24,0
9588,0,<START>,0,0,0
9588,1,home,0,9,9
9588,2,work,9,16,7
9588,3,shop,16,17,1
9588,4,home,17,24,7
9588,5,<ENDS>,24,24,0
9589,0,<START>,0,0,0
9589,1,home,0,7,7
9589,2,work,7,14,7
9589,3,shop,14,15,1
9589,4,work,15,20,5
9589,5,home,20,24,4
9589,6,<ENDS>,24,24,0
9590,0,<START>,0,0,0
9590,1,home,0,7,7
9590,2,work,7,13,6
9590,3,home,13,17,4
9590,4,work,17,20,3
9590,5,home,20,24,4
9590,6,<ENDS>,24,24,0
9591,0,<START>,0,0,0
9591,1,home,0,8,8
9591,2,work,8,13,5
9591,3,shop,13,14,1
9591,4,work,14,19,5
9591,5,home,19,24,5
9591,6,<ENDS>,24,24,0
9592,0,<START>,0,0,0
9592,1,home,0,7,7
9592,2,work,7,13,6
9592,3,home,13,24,11
9592,4,<ENDS>,24,24,0
9593,0,<START>,0,0,0
9593,1,home,0,7,7
9593,2,work,7,14,7
9593,3,home,14,22,8
9593,4,work,22,23,1
9593,5,home,23,24,1
9593,6,<ENDS>,24,24,0
9594,0,<START>,0,0,0
9594,1,home,0,6,6
9594,2,shop,6,7,1
9594,3,home,7,10,3
9594,4,education,10,13,3
9594,5,home,13,19,6
9594,6,shop,19,20,1
9594,7,home,20,24,4
9594,8,<ENDS>,24,24,0
9595,0,<START>,0,0,0
9595,1,home,0,7,7
9595,2,education,7,13,6
9595,3,shop,13,15,2
9595,4,home,15,24,9
9595,5,<ENDS>,24,24,0
9596,0,<START>,0,0,0
9596,1,home,0,8,8
9596,2,education,8,14,6
9596,3,shop,14,15,1
9596,4,work,15,20,5
9596,5,home,20,24,4
9596,6,<ENDS>,24,24,0
9597,0,<START>,0,0,0
9597,1,home,0,8,8
9597,2,work,8,15,7
9597,3,home,15,24,9
9597,4,<ENDS>,24,24,0
9598,0,<START>,0,0,0
9598,1,home,0,7,7
9598,2,shop,7,8,1
9598,3,home,8,14,6
9598,4,work,14,20,6
9598,5,home,20,24,4
9598,6,<ENDS>,24,24,0
9599,0,<START>,0,0,0
9599,1,home,0,7,7
9599,2,work,7,13,6
9599,3,shop,13,14,1
9599,4,work,14,19,5
9599,5,home,19,24,5
9599,6,<ENDS>,24,24,0
9600,0,<START>,0,0,0
9600,1,home,0,7,7
9600,2,work,7,9,2
9600,3,home,9,14,5
9600,4,shop,14,15,1
9600,5,work,15,17,2
9600,6,home,17,23,6
9600,7,work,23,24,1
9600,8,<ENDS>,24,24,0
9601,0,<START>,0,0,0
9601,1,home,0,8,8
9601,2,work,8,15,7
9601,3,home,15,21,6
9601,4,work,21,22,1
9601,5,home,22,24,2
9601,6,<ENDS>,24,24,0
9602,0,<START>,0,0,0
9602,1,home,0,7,7
9602,2,work,7,13,6
9602,3,home,13,24,11
9602,4,<ENDS>,24,24,0
9603,0,<START>,0,0,0
9603,1,home,0,7,7
9603,2,work,7,14,7
9603,3,home,14,24,10
9603,4,<ENDS>,24,24,0
9604,0,<START>,0,0,0
9604,1,home,0,6,6
9604,2,work,6,13,7
9604,3,shop,13,14,1
9604,4,home,14,22,8
9604,5,work,22,23,1
9604,6,home,23,24,1
9604,7,<ENDS>,24,24,0
9605,0,<START>,0,0,0
9605,1,home,0,6,6
9605,2,shop,6,7,1
9605,3,home,7,10,3
9605,4,education,10,12,2
9605,5,shop,12,13,1
9605,6,education,13,16,3
9605,7,shop,16,17,1
9605,8,home,17,24,7
9605,9,<ENDS>,24,24,0
9606,0,<START>,0,0,0
9606,1,home,0,6,6
9606,2,work,6,8,2
9606,3,home,8,14,6
9606,4,work,14,17,3
9606,5,home,17,23,6
9606,6,work,23,24,1
9606,7,<ENDS>,24,24,0
9607,0,<START>,0,0,0
9607,1,home,0,7,7
9607,2,work,7,14,7
9607,3,home,14,21,7
9607,4,work,21,22,1
9607,5,home,22,24,2
9607,6,<ENDS>,24,24,0
9608,0,<START>,0,0,0
9608,1,home,0,6,6
9608,2,shop,6,7,1
9608,3,work,7,14,7
9608,4,home,14,24,10
9608,5,<ENDS>,24,24,0
9609,0,<START>,0,0,0
9609,1,home,0,6,6
9609,2,work,6,13,7
9609,3,home,13,24,11
9609,4,<ENDS>,24,24,0
9610,0,<START>,0,0,0
9610,1,home,0,8,8
9610,2,work,8,15,7
9610,3,home,15,24,9
9610,4,<ENDS>,24,24,0
9611,0,<START>,0,0,0
9611,1,home,0,8,8
9611,2,work,8,15,7
9611,3,home,15,19,4
9611,4,shop,19,20,1
9611,5,home,20,24,4
9611,6,<ENDS>,24,24,0
9612,0,<START>,0,0,0
9612,1,home,0,7,7
9612,2,shop,7,8,1
9612,3,education,8,12,4
9612,4,home,12,18,6
9612,5,shop,18,19,1
9612,6,home,19,24,5
9612,7,<ENDS>,24,24,0
9613,0,<START>,0,0,0
9613,1,home,0,8,8
9613,2,work,8,14,6
9613,3,home,14,18,4
9613,4,work,18,20,2
9613,5,home,20,24,4
9613,6,<ENDS>,24,24,0
9614,0,<START>,0,0,0
9614,1,home,0,9,9
9614,2,education,9,12,3
9614,3,shop,12,14,2
9614,4,education,14,16,2
9614,5,home,16,24,8
9614,6,<ENDS>,24,24,0
9615,0,<START>,0,0,0
9615,1,home,0,6,6
9615,2,work,6,8,2
9615,3,home,8,14,6
9615,4,work,14,16,2
9615,5,home,16,22,6
9615,6,work,22,23,1
9615,7,home,23,24,1
9615,8,<ENDS>,24,24,0
9616,0,<START>,0,0,0
9616,1,home,0,7,7
9616,2,work,7,13,6
9616,3,shop,13,14,1
9616,4,education,14,18,4
9616,5,home,18,24,6
9616,6,<ENDS>,24,24,0
9617,0,<START>,0,0,0
9617,1,home,0,7,7
9617,2,education,7,11,4
9617,3,home,11,20,9
9617,4,shop,20,21,1
9617,5,home,21,24,3
9617,6,<ENDS>,24,24,0
9618,0,<START>,0,0,0
9618,1,home,0,6,6
9618,2,work,6,13,7
9618,3,shop,13,14,1
9618,4,work,14,19,5
9618,5,home,19,24,5
9618,6,<ENDS>,24,24,0
9619,0,<START>,0,0,0
9619,1,home,0,7,7
9619,2,work,7,13,6
9619,3,shop,13,14,1
9619,4,home,14,18,4
9619,5,work,18,20,2
9619,6,home,20,24,4
9619,7,<ENDS>,24,24,0
9620,0,<START>,0,0,0
9620,1,home,0,7,7
9620,2,work,7,13,6
9620,3,shop,13,14,1
9620,4,work,14,19,5
9620,5,home,19,24,5
9620,6,<ENDS>,24,24,0
9621,0,<START>,0,0,0
9621,1,home,0,6,6
9621,2,shop,6,7,1
9621,3,home,7,10,3
9621,4,education,10,12,2
9621,5,home,12,18,6
9621,6,shop,18,19,1
9621,7,home,19,24,5
9621,8,<ENDS>,24,24,0
9622,0,<START>,0,0,0
9622,1,home,0,7,7
9622,2,work,7,9,2
9622,3,home,9,12,3
9622,4,work,12,15,3
9622,5,home,15,21,6
9622,6,work,21,22,1
9622,7,home,22,24,2
9622,8,<ENDS>,24,24,0
9623,0,<START>,0,0,0
9623,1,home,0,7,7
9623,2,shop,7,8,1
9623,3,home,8,15,7
9623,4,work,15,20,5
9623,5,home,20,24,4
9623,6,<ENDS>,24,24,0
9624,0,<START>,0,0,0
9624,1,home,0,7,7
9624,2,education,7,12,5
9624,3,shop,12,14,2
9624,4,education,14,16,2
9624,5,home,16,24,8
9624,6,<ENDS>,24,24,0
9625,0,<START>,0,0,0
9625,1,home,0,6,6
9625,2,work,6,13,7
9625,3,home,13,17,4
9625,4,shop,17,18,1
9625,5,home,18,23,5
9625,6,work,23,24,1
9625,7,<ENDS>,24,24,0
9626,0,<START>,0,0,0
9626,1,home,0,6,6
9626,2,shop,6,7,1
9626,3,home,7,10,3
9626,4,education,10,13,3
9626,5,home,13,19,6
9626,6,shop,19,21,2
9626,7,home,21,24,3
9626,8,<ENDS>,24,24,0
9627,0,<START>,0,0,0
9627,1,home,0,7,7
9627,2,shop,7,8,1
9627,3,work,8,14,6
9627,4,home,14,24,10
9627,5,<ENDS>,24,24,0
9628,0,<START>,0,0,0
9628,1,home,0,6,6
9628,2,shop,6,7,1
9628,3,home,7,8,1
9628,4,work,8,15,7
9628,5,home,15,24,9
9628,6,<ENDS>,24,24,0
9629,0,<START>,0,0,0
9629,1,home,0,7,7
9629,2,work,7,13,6
9629,3,home,13,24,11
9629,4,<ENDS>,24,24,0
9630,0,<START>,0,0,0
9630,1,home,0,7,7
9630,2,shop,7,8,1
9630,3,work,8,15,7
9630,4,home,15,18,3
9630,5,work,18,19,1
9630,6,education,19,20,1
9630,7,home,20,24,4
9630,8,<ENDS>,24,24,0
9631,0,<START>,0,0,0
9631,1,home,0,8,8
9631,2,education,8,12,4
9631,3,work,12,19,7
9631,4,home,19,24,5
9631,5,<ENDS>,24,24,0
9632,0,<START>,0,0,0
9632,1,home,0,7,7
9632,2,shop,7,8,1
9632,3,education,8,11,3
9632,4,home,11,19,8
9632,5,shop,19,21,2
9632,6,home,21,24,3
9632,7,<ENDS>,24,24,0
9633,0,<START>,0,0,0
9633,1,home,0,6,6
9633,2,work,6,13,7
9633,3,shop,13,14,1
9633,4,home,14,24,10
9633,5,<ENDS>,24,24,0
9634,0,<START>,0,0,0
9634,1,home,0,6,6
9634,2,work,6,13,7
9634,3,shop,13,14,1
9634,4,work,14,20,6
9634,5,home,20,24,4
9634,6,<ENDS>,24,24,0
9635,0,<START>,0,0,0
9635,1,home,0,7,7
9635,2,education,7,10,3
9635,3,home,10,17,7
9635,4,shop,17,18,1
9635,5,home,18,21,3
9635,6,shop,21,22,1
9635,7,home,22,24,2
9635,8,<ENDS>,24,24,0
9636,0,<START>,0,0,0
9636,1,home,0,7,7
9636,2,work,7,14,7
9636,3,shop,14,15,1
9636,4,home,15,21,6
9636,5,work,21,22,1
9636,6,home,22,24,2
9636,7,<ENDS>,24,24,0
9637,0,<START>,0,0,0
9637,1,home,0,7,7
9637,2,work,7,14,7
9637,3,home,14,24,10
9637,4,<ENDS>,24,24,0
9638,0,<START>,0,0,0
9638,1,home,0,8,8
9638,2,work,8,16,8
9638,3,home,16,23,7
9638,4,work,23,24,1
9638,5,<ENDS>,24,24,0
9639,0,<START>,0,0,0
9639,1,home,0,7,7
9639,2,work,7,8,1
9639,3,shop,8,9,1
9639,4,home,9,17,8
9639,5,work,17,20,3
9639,6,home,20,24,4
9639,7,<ENDS>,24,24,0
9640,0,<START>,0,0,0
9640,1,home,0,6,6
9640,2,work,6,13,7
9640,3,home,13,24,11
9640,4,<ENDS>,24,24,0
9641,0,<START>,0,0,0
9641,1,work,0,10,10
9641,2,shop,10,11,1
9641,3,work,11,13,2
9641,4,home,13,17,4
9641,5,shop,17,18,1
9641,6,home,18,24,6
9641,7,<ENDS>,24,24,0
9642,0,<START>,0,0,0
9642,1,home,0,6,6
9642,2,shop,6,7,1
9642,3,work,7,14,7
9642,4,home,14,24,10
9642,5,<ENDS>,24,24,0
9643,0,<START>,0,0,0
9643,1,home,0,6,6
9643,2,shop,6,7,1
9643,3,home,7,10,3
9643,4,education,10,13,3
9643,5,shop,13,14,1
9643,6,education,14,16,2
9643,7,home,16,24,8
9643,8,<ENDS>,24,24,0
9644,0,<START>,0,0,0
9644,1,home,0,7,7
9644,2,education,7,11,4
9644,3,home,11,17,6
9644,4,shop,17,18,1
9644,5,home,18,24,6
9644,6,<ENDS>,24,24,0
9645,0,<START>,0,0,0
9645,1,home,0,8,8
9645,2,work,8,15,7
9645,3,shop,15,16,1
9645,4,work,16,20,4
9645,5,home,20,24,4
9645,6,<ENDS>,24,24,0
9646,0,<START>,0,0,0
9646,1,home,0,6,6
9646,2,work,6,9,3
9646,3,home,9,14,5
9646,4,work,14,16,2
9646,5,home,16,22,6
9646,6,work,22,23,1
9646,7,home,23,24,1
9646,8,<ENDS>,24,24,0
9647,0,<START>,0,0,0
9647,1,home,0,8,8
9647,2,education,8,11,3
9647,3,home,11,12,1
9647,4,work,12,19,7
9647,5,home,19,24,5
9647,6,<ENDS>,24,24,0
9648,0,<START>,0,0,0
9648,1,home,0,7,7
9648,2,work,7,13,6
9648,3,home,13,24,11
9648,4,<ENDS>,24,24,0
9649,0,<START>,0,0,0
9649,1,home,0,7,7
9649,2,work,7,13,6
9649,3,home,13,18,5
9649,4,work,18,20,2
9649,5,home,20,24,4
9649,6,<ENDS>,24,24,0
9650,0,<START>,0,0,0
9650,1,home,0,7,7
9650,2,work,7,14,7
9650,3,shop,14,15,1
9650,4,home,15,23,8
9650,5,work,23,24,1
9650,6,<ENDS>,24,24,0
9651,0,<START>,0,0,0
9651,1,home,0,6,6
9651,2,shop,6,7,1
9651,3,home,7,10,3
9651,4,education,10,12,2
9651,5,home,12,14,2
9651,6,education,14,16,2
9651,7,shop,16,17,1
9651,8,home,17,24,7
9651,9,<ENDS>,24,24,0
9652,0,<START>,0,0,0
9652,1,home,0,7,7
9652,2,education,7,10,3
9652,3,home,10,14,4
9652,4,education,14,16,2
9652,5,home,16,24,8
9652,6,<ENDS>,24,24,0
9653,0,<START>,0,0,0
9653,1,home,0,8,8
9653,2,work,8,14,6
9653,3,shop,14,15,1
9653,4,home,15,24,9
9653,5,<ENDS>,24,24,0
9654,0,<START>,0,0,0
9654,1,home,0,7,7
9654,2,shop,7,8,1
9654,3,education,8,11,3
9654,4,home,11,18,7
9654,5,shop,18,19,1
9654,6,home,19,24,5
9654,7,<ENDS>,24,24,0
9655,0,<START>,0,0,0
9655,1,home,0,7,7
9655,2,work,7,13,6
9655,3,home,13,18,5
9655,4,work,18,20,2
9655,5,home,20,24,4
9655,6,<ENDS>,24,24,0
9656,0,<START>,0,0,0
9656,1,home,0,6,6
9656,2,shop,6,7,1
9656,3,home,7,9,2
9656,4,education,9,12,3
9656,5,home,12,16,4
9656,6,work,16,20,4
9656,7,home,20,24,4
9656,8,<ENDS>,24,24,0
9657,0,<START>,0,0,0
9657,1,home,0,8,8
9657,2,work,8,15,7
9657,3,home,15,24,9
9657,4,<ENDS>,24,24,0
9658,0,<START>,0,0,0
9658,1,home,0,6,6
9658,2,work,6,8,2
9658,3,home,8,9,1
9658,4,work,9,11,2
9658,5,home,11,13,2
9658,6,work,13,15,2
9658,7,home,15,22,7
9658,8,work,22,23,1
9658,9,home,23,24,1
9658,10,<ENDS>,24,24,0
9659,0,<START>,0,0,0
9659,1,home,0,6,6
9659,2,work,6,8,2
9659,3,home,8,15,7
9659,4,work,15,17,2
9659,5,home,17,23,6
9659,6,work,23,24,1
9659,7,<ENDS>,24,24,0
9660,0,<START>,0,0,0
9660,1,home,0,8,8
9660,2,work,8,15,7
9660,3,shop,15,16,1
9660,4,home,16,21,5
9660,5,work,21,22,1
9660,6,home,22,24,2
9660,7,<ENDS>,24,24,0
9661,0,<START>,0,0,0
9661,1,home,0,6,6
9661,2,work,6,13,7
9661,3,shop,13,14,1
9661,4,home,14,21,7
9661,5,work,21,22,1
9661,6,home,22,24,2
9661,7,<ENDS>,24,24,0
9662,0,<START>,0,0,0
9662,1,home,0,7,7
9662,2,work,7,14,7
9662,3,shop,14,15,1
9662,4,home,15,24,9
9662,5,<ENDS>,24,24,0
9663,0,<START>,0,0,0
9663,1,home,0,7,7
9663,2,education,7,12,5
9663,3,shop,12,14,2
9663,4,education,14,16,2
9663,5,home,16,24,8
9663,6,<ENDS>,24,24,0
9664,0,<START>,0,0,0
9664,1,home,0,8,8
9664,2,work,8,16,8
9664,3,home,16,24,8
9664,4,<ENDS>,24,24,0
9665,0,<START>,0,0,0
9665,1,home,0,6,6
9665,2,work,6,8,2
9665,3,home,8,14,6
9665,4,work,14,16,2
9665,5,home,16,24,8
9665,6,<ENDS>,24,24,0
9666,0,<START>,0,0,0
9666,1,home,0,7,7
9666,2,work,7,13,6
9666,3,shop,13,14,1
9666,4,home,14,21,7
9666,5,work,21,22,1
9666,6,home,22,24,2
9666,7,<ENDS>,24,24,0
9667,0,<START>,0,0,0
9667,1,home,0,6,6
9667,2,shop,6,7,1
9667,3,home,7,9,2
9667,4,education,9,12,3
9667,5,shop,12,14,2
9667,6,education,14,16,2
9667,7,home,16,20,4
9667,8,shop,20,21,1
9667,9,home,21,24,3
9667,10,<ENDS>,24,24,0
9668,0,<START>,0,0,0
9668,1,home,0,6,6
9668,2,work,6,13,7
9668,3,home,13,17,4
9668,4,work,17,20,3
9668,5,home,20,24,4
9668,6,<ENDS>,24,24,0
9669,0,<START>,0,0,0
9669,1,home,0,7,7
9669,2,work,7,13,6
9669,3,shop,13,15,2
9669,4,home,15,24,9
9669,5,<ENDS>,24,24,0
9670,0,<START>,0,0,0
9670,1,home,0,8,8
9670,2,work,8,15,7
9670,3,home,15,21,6
9670,4,work,21,22,1
9670,5,home,22,24,2
9670,6,<ENDS>,24,24,0
9671,0,<START>,0,0,0
9671,1,home,0,7,7
9671,2,work,7,14,7
9671,3,shop,14,15,1
9671,4,work,15,19,4
9671,5,home,19,24,5
9671,6,<ENDS>,24,24,0
9672,0,<START>,0,0,0
9672,1,home,0,8,8
9672,2,work,8,15,7
9672,3,home,15,24,9
9672,4,<ENDS>,24,24,0
9673,0,<START>,0,0,0
9673,1,home,0,8,8
9673,2,work,8,14,6
9673,3,home,14,17,3
9673,4,shop,17,18,1
9673,5,home,18,24,6
9673,6,<ENDS>,24,24,0
9674,0,<START>,0,0,0
9674,1,home,0,7,7
9674,2,work,7,14,7
9674,3,home,14,18,4
9674,4,work,18,20,2
9674,5,home,20,24,4
9674,6,<ENDS>,24,24,0
9675,0,<START>,0,0,0
9675,1,home,0,6,6
9675,2,work,6,13,7
9675,3,home,13,24,11
9675,4,<ENDS>,24,24,0
9676,0,<START>,0,0,0
9676,1,home,0,7,7
9676,2,education,7,11,4
9676,3,home,11,18,7
9676,4,shop,18,20,2
9676,5,home,20,24,4
9676,6,<ENDS>,24,24,0
9677,0,<START>,0,0,0
9677,1,home,0,6,6
9677,2,work,6,8,2
9677,3,home,8,12,4
9677,4,work,12,14,2
9677,5,home,14,22,8
9677,6,work,22,23,1
9677,7,home,23,24,1
9677,8,<ENDS>,24,24,0
9678,0,<START>,0,0,0
9678,1,home,0,7,7
9678,2,shop,7,9,2
9678,3,education,9,15,6
9678,4,shop,15,17,2
9678,5,home,17,24,7
9678,6,<ENDS>,24,24,0
9679,0,<START>,0,0,0
9679,1,home,0,7,7
9679,2,work,7,9,2
9679,3,home,9,15,6
9679,4,work,15,18,3
9679,5,home,18,24,6
9679,6,<ENDS>,24,24,0
9680,0,<START>,0,0,0
9680,1,home,0,7,7
9680,2,work,7,14,7
9680,3,home,14,18,4
9680,4,shop,18,19,1
9680,5,home,19,24,5
9680,6,<ENDS>,24,24,0
9681,0,<START>,0,0,0
9681,1,home,0,8,8
9681,2,education,8,11,3
9681,3,home,11,15,4
9681,4,shop,15,16,1
9681,5,home,16,24,8
9681,6,<ENDS>,24,24,0
9682,0,<START>,0,0,0
9682,1,home,0,6,6
9682,2,shop,6,7,1
9682,3,work,7,14,7
9682,4,home,14,23,9
9682,5,work,23,24,1
9682,6,<ENDS>,24,24,0
9683,0,<START>,0,0,0
9683,1,home,0,8,8
9683,2,work,8,14,6
9683,3,home,14,24,10
9683,4,<ENDS>,24,24,0
9684,0,<START>,0,0,0
9684,1,home,0,7,7
9684,2,shop,7,8,1
9684,3,education,8,12,4
9684,4,home,12,18,6
9684,5,shop,18,19,1
9684,6,home,19,24,5
9684,7,<ENDS>,24,24,0
9685,0,<START>,0,0,0
9685,1,home,0,8,8
9685,2,work,8,14,6
9685,3,home,14,22,8
9685,4,work,22,23,1
9685,5,home,23,24,1
9685,6,<ENDS>,24,24,0
9686,0,<START>,0,0,0
9686,1,home,0,7,7
9686,2,work,7,13,6
9686,3,shop,13,14,1
9686,4,home,14,24,10
9686,5,<ENDS>,24,24,0
9687,0,<START>,0,0,0
9687,1,home,0,7,7
9687,2,work,7,13,6
9687,3,home,13,24,11
9687,4,<ENDS>,24,24,0
9688,0,<START>,0,0,0
9688,1,home,0,6,6
9688,2,work,6,13,7
9688,3,shop,13,14,1
9688,4,home,14,18,4
9688,5,work,18,20,2
9688,6,home,20,24,4
9688,7,<ENDS>,24,24,0
9689,0,<START>,0,0,0
9689,1,home,0,8,8
9689,2,work,8,10,2
9689,3,home,10,16,6
9689,4,work,16,18,2
9689,5,home,18,24,6
9689,6,<ENDS>,24,24,0
9690,0,<START>,0,0,0
9690,1,home,0,7,7
9690,2,shop,7,8,1
9690,3,work,8,14,6
9690,4,home,14,22,8
9690,5,work,22,23,1
9690,6,home,23,24,1
9690,7,<ENDS>,24,24,0
9691,0,<START>,0,0,0
9691,1,home,0,7,7
9691,2,work,7,14,7
9691,3,home,14,24,10
9691,4,<ENDS>,24,24,0
9692,0,<START>,0,0,0
9692,1,home,0,7,7
9692,2,work,7,14,7
9692,3,home,14,23,9
9692,4,work,23,24,1
9692,5,<ENDS>,24,24,0
9693,0,<START>,0,0,0
9693,1,home,0,6,6
9693,2,work,6,13,7
9693,3,shop,13,14,1
9693,4,work,14,19,5
9693,5,home,19,24,5
9693,6,<ENDS>,24,24,0
9694,0,<START>,0,0,0
9694,1,home,0,6,6
9694,2,shop,6,7,1
9694,3,home,7,9,2
9694,4,education,9,11,2
9694,5,home,11,17,6
9694,6,shop,17,19,2
9694,7,home,19,24,5
9694,8,<ENDS>,24,24,0
9695,0,<START>,0,0,0
9695,1,home,0,7,7
9695,2,work,7,14,7
9695,3,home,14,24,10
9695,4,<ENDS>,24,24,0
9696,0,<START>,0,0,0
9696,1,home,0,7,7
9696,2,work,7,13,6
9696,3,home,13,17,4
9696,4,work,17,20,3
9696,5,home,20,24,4
9696,6,<ENDS>,24,24,0
9697,0,<START>,0,0,0
9697,1,home,0,7,7
9697,2,work,7,14,7
9697,3,shop,14,15,1
9697,4,work,15,20,5
9697,5,home,20,24,4
9697,6,<ENDS>,24,24,0
9698,0,<START>,0,0,0
9698,1,home,0,7,7
9698,2,shop,7,8,1
9698,3,work,8,15,7
9698,4,shop,15,16,1
9698,5,home,16,24,8
9698,6,<ENDS>,24,24,0
9699,0,<START>,0,0,0
9699,1,home,0,7,7
9699,2,shop,7,9,2
9699,3,work,9,17,8
9699,4,home,17,21,4
9699,5,shop,21,22,1
9699,6,home,22,24,2
9699,7,<ENDS>,24,24,0
9700,0,<START>,0,0,0
9700,1,home,0,6,6
9700,2,work,6,13,7
9700,3,home,13,21,8
9700,4,shop,21,22,1
9700,5,home,22,24,2
9700,6,<ENDS>,24,24,0
9701,0,<START>,0,0,0
9701,1,home,0,7,7
9701,2,work,7,13,6
9701,3,shop,13,15,2
9701,4,home,15,24,9
9701,5,<ENDS>,24,24,0
9702,0,<START>,0,0,0
9702,1,home,0,6,6
9702,2,work,6,12,6
9702,3,shop,12,13,1
9702,4,work,13,19,6
9702,5,home,19,24,5
9702,6,<ENDS>,24,24,0
9703,0,<START>,0,0,0
9703,1,home,0,7,7
9703,2,work,7,13,6
9703,3,home,13,24,11
9703,4,<ENDS>,24,24,0
9704,0,<START>,0,0,0
9704,1,home,0,7,7
9704,2,education,7,10,3
9704,3,home,10,18,8
9704,4,shop,18,20,2
9704,5,home,20,24,4
9704,6,<ENDS>,24,24,0
9705,0,<START>,0,0,0
9705,1,home,0,7,7
9705,2,work,7,13,6
9705,3,home,13,15,2
9705,4,work,15,19,4
9705,5,home,19,24,5
9705,6,<ENDS>,24,24,0
9706,0,<START>,0,0,0
9706,1,home,0,6,6
9706,2,shop,6,7,1
9706,3,home,7,10,3
9706,4,education,10,12,2
9706,5,shop,12,15,3
9706,6,home,15,24,9
9706,7,<ENDS>,24,24,0
9707,0,<START>,0,0,0
9707,1,home,0,8,8
9707,2,shop,8,9,1
9707,3,home,9,18,9
9707,4,shop,18,19,1
9707,5,home,19,24,5
9707,6,<ENDS>,24,24,0
9708,0,<START>,0,0,0
9708,1,home,0,8,8
9708,2,work,8,15,7
9708,3,home,15,23,8
9708,4,work,23,24,1
9708,5,<ENDS>,24,24,0
9709,0,<START>,0,0,0
9709,1,home,0,9,9
9709,2,work,9,15,6
9709,3,home,15,24,9
9709,4,<ENDS>,24,24,0
9710,0,<START>,0,0,0
9710,1,home,0,7,7
9710,2,shop,7,8,1
9710,3,work,8,15,7
9710,4,home,15,24,9
9710,5,<ENDS>,24,24,0
9711,0,<START>,0,0,0
9711,1,home,0,7,7
9711,2,work,7,14,7
9711,3,home,14,20,6
9711,4,shop,20,21,1
9711,5,home,21,24,3
9711,6,<ENDS>,24,24,0
9712,0,<START>,0,0,0
9712,1,home,0,7,7
9712,2,work,7,14,7
9712,3,shop,14,15,1
9712,4,work,15,20,5
9712,5,home,20,24,4
9712,6,<ENDS>,24,24,0
9713,0,<START>,0,0,0
9713,1,home,0,6,6
9713,2,work,6,13,7
9713,3,home,13,24,11
9713,4,<ENDS>,24,24,0
9714,0,<START>,0,0,0
9714,1,home,0,7,7
9714,2,shop,7,8,1
9714,3,work,8,15,7
9714,4,home,15,24,9
9714,5,<ENDS>,24,24,0
9715,0,<START>,0,0,0
9715,1,home,0,7,7
9715,2,work,7,8,1
9715,3,home,8,12,4
9715,4,work,12,14,2
9715,5,home,14,17,3
9715,6,work,17,19,2
9715,7,home,19,24,5
9715,8,<ENDS>,24,24,0
9716,0,<START>,0,0,0
9716,1,home,0,6,6
9716,2,work,6,13,7
9716,3,home,13,21,8
9716,4,work,21,22,1
9716,5,home,22,24,2
9716,6,<ENDS>,24,24,0
9717,0,<START>,0,0,0
9717,1,home,0,6,6
9717,2,work,6,13,7
9717,3,shop,13,14,1
9717,4,work,14,20,6
9717,5,home,20,24,4
9717,6,<ENDS>,24,24,0
9718,0,<START>,0,0,0
9718,1,home,0,6,6
9718,2,work,6,13,7
9718,3,shop,13,14,1
9718,4,work,14,19,5
9718,5,home,19,24,5
9718,6,<ENDS>,24,24,0
9719,0,<START>,0,0,0
9719,1,home,0,7,7
9719,2,education,7,13,6
9719,3,shop,13,15,2
9719,4,home,15,24,9
9719,5,<ENDS>,24,24,0
9720,0,<START>,0,0,0
9720,1,home,0,7,7
9720,2,shop,7,8,1
9720,3,work,8,14,6
9720,4,home,14,24,10
9720,5,<ENDS>,24,24,0
9721,0,<START>,0,0,0
9721,1,home,0,7,7
9721,2,work,7,13,6
9721,3,shop,13,14,1
9721,4,home,14,24,10
9721,5,<ENDS>,24,24,0
9722,0,<START>,0,0,0
9722,1,home,0,6,6
9722,2,work,6,13,7
9722,3,home,13,16,3
9722,4,work,16,20,4
9722,5,home,20,24,4
9722,6,<ENDS>,24,24,0
9723,0,<START>,0,0,0
9723,1,home,0,6,6
9723,2,shop,6,7,1
9723,3,home,7,13,6
9723,4,education,13,16,3
9723,5,home,16,24,8
9723,6,<ENDS>,24,24,0
9724,0,<START>,0,0,0
9724,1,home,0,6,6
9724,2,work,6,8,2
9724,3,home,8,9,1
9724,4,work,9,11,2
9724,5,home,11,18,7
9724,6,work,18,19,1
9724,7,home,19,23,4
9724,8,work,23,24,1
9724,9,<ENDS>,24,24,0
9725,0,<START>,0,0,0
9725,1,home,0,8,8
9725,2,work,8,17,9
9725,3,home,17,24,7
9725,4,<ENDS>,24,24,0
9726,0,<START>,0,0,0
9726,1,home,0,7,7
9726,2,work,7,14,7
9726,3,home,14,18,4
9726,4,work,18,20,2
9726,5,home,20,24,4
9726,6,<ENDS>,24,24,0
9727,0,<START>,0,0,0
9727,1,home,0,8,8
9727,2,education,8,12,4
9727,3,home,12,18,6
9727,4,shop,18,19,1
9727,5,home,19,24,5
9727,6,<ENDS>,24,24,0
9728,0,<START>,0,0,0
9728,1,home,0,7,7
9728,2,work,7,10,3
9728,3,home,10,16,6
9728,4,work,16,19,3
9728,5,home,19,24,5
9728,6,<ENDS>,24,24,0
9729,0,<START>,0,0,0
9729,1,home,0,5,5
9729,2,work,5,13,8
9729,3,home,13,24,11
9729,4,<ENDS>,24,24,0
9730,0,<START>,0,0,0
9730,1,home,0,8,8
9730,2,work,8,15,7
9730,3,home,15,19,4
9730,4,shop,19,20,1
9730,5,home,20,24,4
9730,6,<ENDS>,24,24,0
9731,0,<START>,0,0,0
9731,1,home,0,6,6
9731,2,work,6,13,7
9731,3,shop,13,14,1
9731,4,work,14,19,5
9731,5,home,19,24,5
9731,6,<ENDS>,24,24,0
9732,0,<START>,0,0,0
9732,1,home,0,10,10
9732,2,work,10,18,8
9732,3,home,18,24,6
9732,4,<ENDS>,24,24,0
9733,0,<START>,0,0,0
9733,1,home,0,7,7
9733,2,work,7,14,7
9733,3,shop,14,16,2
9733,4,work,16,20,4
9733,5,home,20,24,4
9733,6,<ENDS>,24,24,0
9734,0,<START>,0,0,0
9734,1,home,0,7,7
9734,2,education,7,12,5
9734,3,home,12,19,7
9734,4,shop,19,20,1
9734,5,home,20,24,4
9734,6,<ENDS>,24,24,0
9735,0,<START>,0,0,0
9735,1,home,0,8,8
9735,2,work,8,15,7
9735,3,home,15,24,9
9735,4,<ENDS>,24,24,0
9736,0,<START>,0,0,0
9736,1,home,0,7,7
9736,2,work,7,14,7
9736,3,shop,14,15,1
9736,4,work,15,20,5
9736,5,home,20,24,4
9736,6,<ENDS>,24,24,0
9737,0,<START>,0,0,0
9737,1,home,0,8,8
9737,2,work,8,14,6
9737,3,shop,14,15,1
9737,4,home,15,24,9
9737,5,<ENDS>,24,24,0
9738,0,<START>,0,0,0
9738,1,home,0,7,7
9738,2,work,7,13,6
9738,3,shop,13,14,1
9738,4,home,14,24,10
9738,5,<ENDS>,24,24,0
9739,0,<START>,0,0,0
9739,1,home,0,7,7
9739,2,work,7,14,7
9739,3,shop,14,15,1
9739,4,home,15,24,9
9739,5,<ENDS>,24,24,0
9740,0,<START>,0,0,0
9740,1,home,0,7,7
9740,2,work,7,14,7
9740,3,shop,14,15,1
9740,4,home,15,24,9
9740,5,<ENDS>,24,24,0
9741,0,<START>,0,0,0
9741,1,home,0,6,6
9741,2,work,6,13,7
9741,3,shop,13,14,1
9741,4,work,14,19,5
9741,5,home,19,24,5
9741,6,<ENDS>,24,24,0
9742,0,<START>,0,0,0
9742,1,home,0,7,7
9742,2,work,7,14,7
9742,3,home,14,21,7
9742,4,work,21,22,1
9742,5,home,22,24,2
9742,6,<ENDS>,24,24,0
9743,0,<START>,0,0,0
9743,1,home,0,8,8
9743,2,work,8,14,6
9743,3,shop,14,15,1
9743,4,home,15,22,7
9743,5,work,22,23,1
9743,6,home,23,24,1
9743,7,<ENDS>,24,24,0
9744,0,<START>,0,0,0
9744,1,home,0,7,7
9744,2,work,7,13,6
9744,3,home,13,24,11
9744,4,<ENDS>,24,24,0
9745,0,<START>,0,0,0
9745,1,home,0,6,6
9745,2,work,6,9,3
9745,3,home,9,10,1
9745,4,work,10,12,2
9745,5,home,12,17,5
9745,6,work,17,18,1
9745,7,home,18,24,6
9745,8,<ENDS>,24,24,0
9746,0,<START>,0,0,0
9746,1,home,0,7,7
9746,2,work,7,14,7
9746,3,home,14,17,3
9746,4,work,17,18,1
9746,5,education,18,19,1
9746,6,home,19,24,5
9746,7,<ENDS>,24,24,0
9747,0,<START>,0,0,0
9747,1,home,0,7,7
9747,2,work,7,14,7
9747,3,shop,14,15,1
9747,4,home,15,24,9
9747,5,<ENDS>,24,24,0
9748,0,<START>,0,0,0
9748,1,home,0,6,6
9748,2,shop,6,7,1
9748,3,home,7,13,6
9748,4,education,13,16,3
9748,5,home,16,24,8
9748,6,<ENDS>,24,24,0
9749,0,<START>,0,0,0
9749,1,home,0,8,8
9749,2,work,8,14,6
9749,3,home,14,17,3
9749,4,work,17,20,3
9749,5,home,20,24,4
9749,6,<ENDS>,24,24,0
9750,0,<START>,0,0,0
9750,1,home,0,7,7
9750,2,work,7,14,7
9750,3,home,14,24,10
9750,4,<ENDS>,24,24,0
9751,0,<START>,0,0,0
9751,1,home,0,7,7
9751,2,work,7,14,7
9751,3,shop,14,15,1
9751,4,home,15,24,9
9751,5,<ENDS>,24,24,0
9752,0,<START>,0,0,0
9752,1,home,0,7,7
9752,2,shop,7,9,2
9752,3,education,9,12,3
9752,4,home,12,18,6
9752,5,shop,18,19,1
9752,6,home,19,24,5
9752,7,<ENDS>,24,24,0
9753,0,<START>,0,0,0
9753,1,home,0,7,7
9753,2,work,7,13,6
9753,3,home,13,15,2
9753,4,work,15,20,5
9753,5,home,20,24,4
9753,6,<ENDS>,24,24,0
9754,0,<START>,0,0,0
9754,1,home,0,8,8
9754,2,work,8,14,6
9754,3,shop,14,15,1
9754,4,work,15,20,5
9754,5,home,20,24,4
9754,6,<ENDS>,24,24,0
9755,0,<START>,0,0,0
9755,1,home,0,6,6
9755,2,work,6,13,7
9755,3,home,13,18,5
9755,4,shop,18,19,1
9755,5,home,19,24,5
9755,6,<ENDS>,24,24,0
9756,0,<START>,0,0,0
9756,1,home,0,6,6
9756,2,work,6,8,2
9756,3,home,8,12,4
9756,4,work,12,13,1
9756,5,home,13,17,4
9756,6,work,17,19,2
9756,7,home,19,24,5
9756,8,<ENDS>,24,24,0
9757,0,<START>,0,0,0
9757,1,home,0,7,7
9757,2,work,7,16,9
9757,3,home,16,22,6
9757,4,work,22,23,1
9757,5,home,23,24,1
9757,6,<ENDS>,24,24,0
9758,0,<START>,0,0,0
9758,1,home,0,8,8
9758,2,work,8,15,7
9758,3,shop,15,16,1
9758,4,home,16,21,5
9758,5,shop,21,22,1
9758,6,home,22,24,2
9758,7,<ENDS>,24,24,0
9759,0,<START>,0,0,0
9759,1,home,0,7,7
9759,2,work,7,9,2
9759,3,home,9,13,4
9759,4,work,13,15,2
9759,5,home,15,22,7
9759,6,work,22,23,1
9759,7,home,23,24,1
9759,8,<ENDS>,24,24,0
9760,0,<START>,0,0,0
9760,1,home,0,6,6
9760,2,work,6,8,2
9760,3,home,8,12,4
9760,4,work,12,14,2
9760,5,home,14,18,4
9760,6,work,18,20,2
9760,7,home,20,24,4
9760,8,<ENDS>,24,24,0
9761,0,<START>,0,0,0
9761,1,home,0,8,8
9761,2,work,8,15,7
9761,3,shop,15,16,1
9761,4,home,16,23,7
9761,5,work,23,24,1
9761,6,<ENDS>,24,24,0
9762,0,<START>,0,0,0
9762,1,home,0,8,8
9762,2,work,8,13,5
9762,3,home,13,23,10
9762,4,work,23,24,1
9762,5,<ENDS>,24,24,0
9763,0,<START>,0,0,0
9763,1,home,0,6,6
9763,2,work,6,13,7
9763,3,shop,13,14,1
9763,4,education,14,16,2
9763,5,shop,16,17,1
9763,6,home,17,24,7
9763,7,<ENDS>,24,24,0
9764,0,<START>,0,0,0
9764,1,home,0,8,8
9764,2,work,8,14,6
9764,3,shop,14,15,1
9764,4,work,15,20,5
9764,5,home,20,24,4
9764,6,<ENDS>,24,24,0
9765,0,<START>,0,0,0
9765,1,home,0,6,6
9765,2,work,6,13,7
9765,3,home,13,24,11
9765,4,<ENDS>,24,24,0
9766,0,<START>,0,0,0
9766,1,home,0,7,7
9766,2,work,7,14,7
9766,3,home,14,18,4
9766,4,work,18,20,2
9766,5,home,20,24,4
9766,6,<ENDS>,24,24,0
9767,0,<START>,0,0,0
9767,1,home,0,8,8
9767,2,education,8,12,4
9767,3,work,12,19,7
9767,4,home,19,24,5
9767,5,<ENDS>,24,24,0
9768,0,<START>,0,0,0
9768,1,home,0,6,6
9768,2,shop,6,7,1
9768,3,work,7,14,7
9768,4,home,14,21,7
9768,5,work,21,22,1
9768,6,home,22,24,2
9768,7,<ENDS>,24,24,0
9769,0,<START>,0,0,0
9769,1,home,0,7,7
9769,2,shop,7,8,1
9769,3,education,8,11,3
9769,4,home,11,14,3
9769,5,education,14,17,3
9769,6,shop,17,18,1
9769,7,home,18,24,6
9769,8,<ENDS>,24,24,0
9770,0,<START>,0,0,0
9770,1,home,0,8,8
9770,2,education,8,11,3
9770,3,home,11,15,4
9770,4,work,15,20,5
9770,5,home,20,24,4
9770,6,<ENDS>,24,24,0
9771,0,<START>,0,0,0
9771,1,home,0,6,6
9771,2,shop,6,7,1
9771,3,home,7,9,2
9771,4,work,9,16,7
9771,5,home,16,24,8
9771,6,<ENDS>,24,24,0
9772,0,<START>,0,0,0
9772,1,home,0,9,9
9772,2,work,9,17,8
9772,3,home,17,24,7
9772,4,<ENDS>,24,24,0
9773,0,<START>,0,0,0
9773,1,home,0,6,6
9773,2,work,6,7,1
9773,3,home,7,10,3
9773,4,work,10,12,2
9773,5,home,12,18,6
9773,6,work,18,20,2
9773,7,home,20,24,4
9773,8,<ENDS>,24,24,0
9774,0,<START>,0,0,0
9774,1,home,0,7,7
9774,2,education,7,11,4
9774,3,home,11,16,5
9774,4,shop,16,17,1
9774,5,home,17,24,7
9774,6,<ENDS>,24,24,0
9775,0,<START>,0,0,0
9775,1,home,0,8,8
9775,2,work,8,14,6
9775,3,home,14,24,10
9775,4,<ENDS>,24,24,0
9776,0,<START>,0,0,0
9776,1,home,0,7,7
9776,2,work,7,14,7
9776,3,home,14,24,10
9776,4,<ENDS>,24,24,0
9777,0,<START>,0,0,0
9777,1,home,0,8,8
9777,2,education,8,12,4
9777,3,shop,12,13,1
9777,4,work,13,19,6
9777,5,home,19,24,5
9777,6,<ENDS>,24,24,0
9778,0,<START>,0,0,0
9778,1,home,0,8,8
9778,2,work,8,15,7
9778,3,home,15,23,8
9778,4,work,23,24,1
9778,5,<ENDS>,24,24,0
9779,0,<START>,0,0,0
9779,1,home,0,6,6
9779,2,work,6,13,7
9779,3,home,13,18,5
9779,4,work,18,20,2
9779,5,home,20,24,4
9779,6,<ENDS>,24,24,0
9780,0,<START>,0,0,0
9780,1,home,0,7,7
9780,2,education,7,11,4
9780,3,home,11,17,6
9780,4,shop,17,18,1
9780,5,home,18,24,6
9780,6,<ENDS>,24,24,0
9781,0,<START>,0,0,0
9781,1,home,0,7,7
9781,2,work,7,13,6
9781,3,home,13,24,11
9781,4,<ENDS>,24,24,0
9782,0,<START>,0,0,0
9782,1,home,0,6,6
9782,2,work,6,8,2
9782,3,home,8,13,5
9782,4,work,13,15,2
9782,5,home,15,21,6
9782,6,shop,21,22,1
9782,7,home,22,24,2
9782,8,<ENDS>,24,24,0
9783,0,<START>,0,0,0
9783,1,home,0,7,7
9783,2,work,7,14,7
9783,3,shop,14,15,1
9783,4,home,15,21,6
9783,5,work,21,22,1
9783,6,home,22,24,2
9783,7,<ENDS>,24,24,0
9784,0,<START>,0,0,0
9784,1,home,0,7,7
9784,2,work,7,13,6
9784,3,home,13,16,3
9784,4,work,16,20,4
9784,5,home,20,24,4
9784,6,<ENDS>,24,24,0
9785,0,<START>,0,0,0
9785,1,home,0,8,8
9785,2,education,8,12,4
9785,3,home,12,19,7
9785,4,shop,19,20,1
9785,5,home,20,24,4
9785,6,<ENDS>,24,24,0
9786,0,<START>,0,0,0
9786,1,home,0,7,7
9786,2,education,7,14,7
9786,3,shop,14,16,2
9786,4,home,16,24,8
9786,5,<ENDS>,24,24,0
9787,0,<START>,0,0,0
9787,1,home,0,7,7
9787,2,work,7,13,6
9787,3,shop,13,14,1
9787,4,work,14,19,5
9787,5,home,19,24,5
9787,6,<ENDS>,24,24,0
9788,0,<START>,0,0,0
9788,1,home,0,7,7
9788,2,shop,7,8,1
9788,3,work,8,13,5
9788,4,home,13,17,4
9788,5,work,17,20,3
9788,6,home,20,24,4
9788,7,<ENDS>,24,24,0
9789,0,<START>,0,0,0
9789,1,home,0,7,7
9789,2,work,7,13,6
9789,3,shop,13,14,1
9789,4,home,14,17,3
9789,5,work,17,20,3
9789,6,home,20,24,4
9789,7,<ENDS>,24,24,0
9790,0,<START>,0,0,0
9790,1,home,0,8,8
9790,2,work,8,14,6
9790,3,shop,14,15,1
9790,4,home,15,24,9
9790,5,<ENDS>,24,24,0
9791,0,<START>,0,0,0
9791,1,home,0,6,6
9791,2,work,6,13,7
9791,3,shop,13,15,2
9791,4,home,15,24,9
9791,5,<ENDS>,24,24,0
9792,0,<START>,0,0,0
9792,1,home,0,7,7
9792,2,work,7,13,6
9792,3,home,13,24,11
9792,4,<ENDS>,24,24,0
9793,0,<START>,0,0,0
9793,1,home,0,7,7
9793,2,work,7,14,7
9793,3,home,14,22,8
9793,4,work,22,23,1
9793,5,home,23,24,1
9793,6,<ENDS>,24,24,0
9794,0,<START>,0,0,0
9794,1,home,0,8,8
9794,2,work,8,14,6
9794,3,shop,14,15,1
9794,4,home,15,24,9
9794,5,<ENDS>,24,24,0
9795,0,<START>,0,0,0
9795,1,home,0,7,7
9795,2,education,7,12,5
9795,3,shop,12,14,2
9795,4,home,14,24,10
9795,5,<ENDS>,24,24,0
9796,0,<START>,0,0,0
9796,1,home,0,8,8
9796,2,work,8,13,5
9796,3,shop,13,14,1
9796,4,work,14,19,5
9796,5,home,19,24,5
9796,6,<ENDS>,24,24,0
9797,0,<START>,0,0,0
9797,1,home,0,6,6
9797,2,work,6,13,7
9797,3,home,13,17,4
9797,4,work,17,20,3
9797,5,home,20,24,4
9797,6,<ENDS>,24,24,0
9798,0,<START>,0,0,0
9798,1,home,0,7,7
9798,2,education,7,11,4
9798,3,home,11,19,8
9798,4,shop,19,20,1
9798,5,home,20,24,4
9798,6,<ENDS>,24,24,0
9799,0,<START>,0,0,0
9799,1,home,0,6,6
9799,2,shop,6,7,1
9799,3,home,7,13,6
9799,4,education,13,16,3
9799,5,home,16,24,8
9799,6,<ENDS>,24,24,0
9800,0,<START>,0,0,0
9800,1,home,0,7,7
9800,2,shop,7,8,1
9800,3,work,8,15,7
9800,4,home,15,24,9
9800,5,<ENDS>,24,24,0
9801,0,<START>,0,0,0
9801,1,home,0,4,4
9801,2,work,4,5,1
9801,3,home,5,8,3
9801,4,work,8,9,1
9801,5,home,9,10,1
9801,6,work,10,12,2
9801,7,home,12,18,6
9801,8,work,18,19,1
9801,9,home,19,24,5
9801,10,<ENDS>,24,24,0
9802,0,<START>,0,0,0
9802,1,home,0,6,6
9802,2,work,6,13,7
9802,3,shop,13,14,1
9802,4,home,14,23,9
9802,5,work,23,24,1
9802,6,<ENDS>,24,24,0
9803,0,<START>,0,0,0
9803,1,home,0,6,6
9803,2,work,6,13,7
9803,3,home,13,24,11
9803,4,<ENDS>,24,24,0
9804,0,<START>,0,0,0
9804,1,home,0,7,7
9804,2,work,7,13,6
9804,3,home,13,24,11
9804,4,<ENDS>,24,24,0
9805,0,<START>,0,0,0
9805,1,home,0,6,6
9805,2,shop,6,7,1
9805,3,home,7,9,2
9805,4,education,9,12,3
9805,5,home,12,18,6
9805,6,shop,18,19,1
9805,7,home,19,24,5
9805,8,<ENDS>,24,24,0
9806,0,<START>,0,0,0
9806,1,home,0,6,6
9806,2,work,6,8,2
9806,3,home,8,14,6
9806,4,work,14,16,2
9806,5,home,16,23,7
9806,6,work,23,24,1
9806,7,<ENDS>,24,24,0
9807,0,<START>,0,0,0
9807,1,home,0,8,8
9807,2,work,8,17,9
9807,3,home,17,24,7
9807,4,<ENDS>,24,24,0
9808,0,<START>,0,0,0
9808,1,home,0,7,7
9808,2,work,7,14,7
9808,3,shop,14,15,1
9808,4,home,15,24,9
9808,5,<ENDS>,24,24,0
9809,0,<START>,0,0,0
9809,1,home,0,7,7
9809,2,work,7,13,6
9809,3,home,13,24,11
9809,4,<ENDS>,24,24,0
9810,0,<START>,0,0,0
9810,1,home,0,7,7
9810,2,education,7,11,4
9810,3,home,11,14,3
9810,4,education,14,16,2
9810,5,shop,16,17,1
9810,6,home,17,24,7
9810,7,<ENDS>,24,24,0
9811,0,<START>,0,0,0
9811,1,home,0,7,7
9811,2,work,7,13,6
9811,3,shop,13,14,1
9811,4,home,14,18,4
9811,5,work,18,20,2
9811,6,home,20,24,4
9811,7,<ENDS>,24,24,0
9812,0,<START>,0,0,0
9812,1,work,0,10,10
9812,2,shop,10,11,1
9812,3,work,11,17,6
9812,4,home,17,24,7
9812,5,<ENDS>,24,24,0
9813,0,<START>,0,0,0
9813,1,home,0,7,7
9813,2,work,7,14,7
9813,3,home,14,24,10
9813,4,<ENDS>,24,24,0
9814,0,<START>,0,0,0
9814,1,home,0,7,7
9814,2,education,7,11,4
9814,3,home,11,19,8
9814,4,shop,19,20,1
9814,5,home,20,24,4
9814,6,<ENDS>,24,24,0
9815,0,<START>,0,0,0
9815,1,home,0,9,9
9815,2,work,9,16,7
9815,3,home,16,17,1
9815,4,work,17,19,2
9815,5,home,19,24,5
9815,6,<ENDS>,24,24,0
9816,0,<START>,0,0,0
9816,1,home,0,8,8
9816,2,work,8,14,6
9816,3,home,14,22,8
9816,4,work,22,23,1
9816,5,home,23,24,1
9816,6,<ENDS>,24,24,0
9817,0,<START>,0,0,0
9817,1,home,0,6,6
9817,2,work,6,13,7
9817,3,home,13,17,4
9817,4,shop,17,18,1
9817,5,home,18,24,6
9817,6,<ENDS>,24,24,0
9818,0,<START>,0,0,0
9818,1,home,0,6,6
9818,2,work,6,13,7
9818,3,home,13,24,11
9818,4,<ENDS>,24,24,0
9819,0,<START>,0,0,0
9819,1,home,0,7,7
9819,2,work,7,9,2
9819,3,home,9,13,4
9819,4,work,13,15,2
9819,5,home,15,22,7
9819,6,work,22,23,1
9819,7,home,23,24,1
9819,8,<ENDS>,24,24,0
9820,0,<START>,0,0,0
9820,1,home,0,9,9
9820,2,work,9,17,8
9820,3,home,17,24,7
9820,4,<ENDS>,24,24,0
9821,0,<START>,0,0,0
9821,1,home,0,7,7
9821,2,work,7,13,6
9821,3,home,13,15,2
9821,4,work,15,19,4
9821,5,home,19,24,5
9821,6,<ENDS>,24,24,0
9822,0,<START>,0,0,0
9822,1,home,0,9,9
9822,2,work,9,16,7
9822,3,home,16,24,8
9822,4,<ENDS>,24,24,0
9823,0,<START>,0,0,0
9823,1,home,0,7,7
9823,2,shop,7,9,2
9823,3,education,9,13,4
9823,4,home,13,24,11
9823,5,<ENDS>,24,24,0
9824,0,<START>,0,0,0
9824,1,home,0,9,9
9824,2,work,9,16,7
9824,3,home,16,20,4
9824,4,shop,20,21,1
9824,5,home,21,24,3
9824,6,<ENDS>,24,24,0
9825,0,<START>,0,0,0
9825,1,home,0,8,8
9825,2,work,8,15,7
9825,3,home,15,22,7
9825,4,work,22,23,1
9825,5,home,23,24,1
9825,6,<ENDS>,24,24,0
9826,0,<START>,0,0,0
9826,1,home,0,8,8
9826,2,education,8,11,3
9826,3,home,11,19,8
9826,4,shop,19,20,1
9826,5,home,20,24,4
9826,6,<ENDS>,24,24,0
9827,0,<START>,0,0,0
9827,1,home,0,7,7
9827,2,education,7,11,4
9827,3,home,11,18,7
9827,4,shop,18,19,1
9827,5,home,19,24,5
9827,6,<ENDS>,24,24,0
9828,0,<START>,0,0,0
9828,1,home,0,6,6
9828,2,work,6,13,7
9828,3,shop,13,14,1
9828,4,home,14,18,4
9828,5,work,18,20,2
9828,6,home,20,24,4
9828,7,<ENDS>,24,24,0
9829,0,<START>,0,0,0
9829,1,home,0,8,8
9829,2,work,8,15,7
9829,3,home,15,24,9
9829,4,<ENDS>,24,24,0
9830,0,<START>,0,0,0
9830,1,home,0,6,6
9830,2,work,6,13,7
9830,3,shop,13,14,1
9830,4,home,14,24,10
9830,5,<ENDS>,24,24,0
9831,0,<START>,0,0,0
9831,1,home,0,8,8
9831,2,work,8,15,7
9831,3,home,15,24,9
9831,4,<ENDS>,24,24,0
9832,0,<START>,0,0,0
9832,1,home,0,7,7
9832,2,work,7,9,2
9832,3,home,9,15,6
9832,4,work,15,17,2
9832,5,home,17,23,6
9832,6,work,23,24,1
9832,7,<ENDS>,24,24,0
9833,0,<START>,0,0,0
9833,1,home,0,7,7
9833,2,work,7,15,8
9833,3,home,15,24,9
9833,4,<ENDS>,24,24,0
9834,0,<START>,0,0,0
9834,1,home,0,8,8
9834,2,work,8,16,8
9834,3,shop,16,17,1
9834,4,home,17,24,7
9834,5,<ENDS>,24,24,0
9835,0,<START>,0,0,0
9835,1,home,0,6,6
9835,2,work,6,13,7
9835,3,home,13,24,11
9835,4,<ENDS>,24,24,0
9836,0,<START>,0,0,0
9836,1,home,0,6,6
9836,2,work,6,13,7
9836,3,home,13,19,6
9836,4,shop,19,20,1
9836,5,home,20,24,4
9836,6,<ENDS>,24,24,0
9837,0,<START>,0,0,0
9837,1,home,0,7,7
9837,2,education,7,11,4
9837,3,home,11,17,6
9837,4,shop,17,19,2
9837,5,home,19,24,5
9837,6,<ENDS>,24,24,0
9838,0,<START>,0,0,0
9838,1,home,0,7,7
9838,2,work,7,13,6
9838,3,home,13,24,11
9838,4,<ENDS>,24,24,0
9839,0,<START>,0,0,0
9839,1,home,0,6,6
9839,2,work,6,13,7
9839,3,home,13,16,3
9839,4,work,16,19,3
9839,5,home,19,24,5
9839,6,<ENDS>,24,24,0
9840,0,<START>,0,0,0
9840,1,home,0,7,7
9840,2,education,7,11,4
9840,3,home,11,18,7
9840,4,shop,18,19,1
9840,5,home,19,24,5
9840,6,<ENDS>,24,24,0
9841,0,<START>,0,0,0
9841,1,home,0,7,7
9841,2,education,7,11,4
9841,3,home,11,20,9
9841,4,shop,20,21,1
9841,5,home,21,24,3
9841,6,<ENDS>,24,24,0
9842,0,<START>,0,0,0
9842,1,home,0,8,8
9842,2,work,8,14,6
9842,3,shop,14,15,1
9842,4,work,15,20,5
9842,5,home,20,24,4
9842,6,<ENDS>,24,24,0
9843,0,<START>,0,0,0
9843,1,home,0,7,7
9843,2,work,7,14,7
9843,3,home,14,20,6
9843,4,shop,20,21,1
9843,5,home,21,24,3
9843,6,<ENDS>,24,24,0
9844,0,<START>,0,0,0
9844,1,home,0,9,9
9844,2,shop,9,10,1
9844,3,home,10,13,3
9844,4,work,13,19,6
9844,5,home,19,24,5
9844,6,<ENDS>,24,24,0
9845,0,<START>,0,0,0
9845,1,home,0,8,8
9845,2,work,8,13,5
9845,3,home,13,22,9
9845,4,work,22,23,1
9845,5,home,23,24,1
9845,6,<ENDS>,24,24,0
9846,0,<START>,0,0,0
9846,1,home,0,6,6
9846,2,work,6,8,2
9846,3,home,8,12,4
9846,4,work,12,14,2
9846,5,home,14,21,7
9846,6,work,21,22,1
9846,7,home,22,24,2
9846,8,<ENDS>,24,24,0
9847,0,<START>,0,0,0
9847,1,home,0,8,8
9847,2,work,8,15,7
9847,3,shop,15,16,1
9847,4,home,16,22,6
9847,5,work,22,23,1
9847,6,home,23,24,1
9847,7,<ENDS>,24,24,0
9848,0,<START>,0,0,0
9848,1,home,0,6,6
9848,2,shop,6,7,1
9848,3,home,7,9,2
9848,4,work,9,17,8
9848,5,home,17,24,7
9848,6,<ENDS>,24,24,0
9849,0,<START>,0,0,0
9849,1,home,0,6,6
9849,2,shop,6,7,1
9849,3,home,7,13,6
9849,4,education,13,16,3
9849,5,home,16,24,8
9849,6,<ENDS>,24,24,0
9850,0,<START>,0,0,0
9850,1,home,0,7,7
9850,2,education,7,12,5
9850,3,home,12,20,8
9850,4,shop,20,21,1
9850,5,home,21,24,3
9850,6,<ENDS>,24,24,0
9851,0,<START>,0,0,0
9851,1,home,0,8,8
9851,2,education,8,11,3
9851,3,home,11,17,6
9851,4,shop,17,18,1
9851,5,home,18,24,6
9851,6,<ENDS>,24,24,0
9852,0,<START>,0,0,0
9852,1,home,0,7,7
9852,2,work,7,14,7
9852,3,home,14,18,4
9852,4,work,18,20,2
9852,5,home,20,24,4
9852,6,<ENDS>,24,24,0
9853,0,<START>,0,0,0
9853,1,home,0,7,7
9853,2,work,7,9,2
9853,3,home,9,15,6
9853,4,work,15,18,3
9853,5,home,18,24,6
9853,6,<ENDS>,24,24,0
9854,0,<START>,0,0,0
9854,1,home,0,7,7
9854,2,work,7,14,7
9854,3,home,14,20,6
9854,4,shop,20,21,1
9854,5,home,21,24,3
9854,6,<ENDS>,24,24,0
9855,0,<START>,0,0,0
9855,1,home,0,6,6
9855,2,work,6,13,7
9855,3,home,13,16,3
9855,4,work,16,19,3
9855,5,home,19,24,5
9855,6,<ENDS>,24,24,0
9856,0,<START>,0,0,0
9856,1,home,0,6,6
9856,2,shop,6,7,1
9856,3,home,7,9,2
9856,4,work,9,15,6
9856,5,home,15,24,9
9856,6,<ENDS>,24,24,0
9857,0,<START>,0,0,0
9857,1,home,0,6,6
9857,2,work,6,13,7
9857,3,home,13,24,11
9857,4,<ENDS>,24,24,0
9858,0,<START>,0,0,0
9858,1,home,0,7,7
9858,2,work,7,13,6
9858,3,home,13,24,11
9858,4,<ENDS>,24,24,0
9859,0,<START>,0,0,0
9859,1,home,0,7,7
9859,2,work,7,13,6
9859,3,home,13,24,11
9859,4,<ENDS>,24,24,0
9860,0,<START>,0,0,0
9860,1,home,0,9,9
9860,2,shop,9,10,1
9860,3,home,10,14,4
9860,4,education,14,16,2
9860,5,home,16,24,8
9860,6,<ENDS>,24,24,0
9861,0,<START>,0,0,0
9861,1,home,0,9,9
9861,2,education,9,12,3
9861,3,work,12,19,7
9861,4,home,19,24,5
9861,5,<ENDS>,24,24,0
9862,0,<START>,0,0,0
9862,1,home,0,7,7
9862,2,education,7,12,5
9862,3,shop,12,14,2
9862,4,home,14,24,10
9862,5,<ENDS>,24,24,0
9863,0,<START>,0,0,0
9863,1,home,0,7,7
9863,2,work,7,14,7
9863,3,home,14,24,10
9863,4,<ENDS>,24,24,0
9864,0,<START>,0,0,0
9864,1,home,0,6,6
9864,2,work,6,13,7
9864,3,home,13,17,4
9864,4,shop,17,19,2
9864,5,home,19,24,5
9864,6,<ENDS>,24,24,0
9865,0,<START>,0,0,0
9865,1,home,0,7,7
9865,2,work,7,8,1
9865,3,home,8,9,1
9865,4,work,9,10,1
9865,5,home,10,16,6
9865,6,work,16,18,2
9865,7,home,18,23,5
9865,8,work,23,24,1
9865,9,<ENDS>,24,24,0
9866,0,<START>,0,0,0
9866,1,home,0,7,7
9866,2,work,7,9,2
9866,3,home,9,15,6
9866,4,work,15,17,2
9866,5,home,17,24,7
9866,6,<ENDS>,24,24,0
9867,0,<START>,0,0,0
9867,1,home,0,7,7
9867,2,work,7,13,6
9867,3,shop,13,14,1
9867,4,work,14,19,5
9867,5,home,19,24,5
9867,6,<ENDS>,24,24,0
9868,0,<START>,0,0,0
9868,1,home,0,7,7
9868,2,shop,7,8,1
9868,3,education,8,12,4
9868,4,shop,12,14,2
9868,5,education,14,16,2
9868,6,home,16,24,8
9868,7,<ENDS>,24,24,0
9869,0,<START>,0,0,0
9869,1,home,0,6,6
9869,2,work,6,9,3
9869,3,home,9,14,5
9869,4,work,14,16,2
9869,5,home,16,22,6
9869,6,work,22,23,1
9869,7,home,23,24,1
9869,8,<ENDS>,24,24,0
9870,0,<START>,0,0,0
9870,1,home,0,8,8
9870,2,work,8,15,7
9870,3,shop,15,16,1
9870,4,work,16,20,4
9870,5,home,20,24,4
9870,6,<ENDS>,24,24,0
9871,0,<START>,0,0,0
9871,1,home,0,6,6
9871,2,shop,6,7,1
9871,3,home,7,10,3
9871,4,education,10,14,4
9871,5,shop,14,16,2
9871,6,home,16,24,8
9871,7,<ENDS>,24,24,0
9872,0,<START>,0,0,0
9872,1,home,0,7,7
9872,2,education,7,11,4
9872,3,home,11,15,4
9872,4,shop,15,16,1
9872,5,home,16,24,8
9872,6,<ENDS>,24,24,0
9873,0,<START>,0,0,0
9873,1,home,0,7,7
9873,2,education,7,11,4
9873,3,home,11,16,5
9873,4,shop,16,18,2
9873,5,home,18,24,6
9873,6,<ENDS>,24,24,0
9874,0,<START>,0,0,0
9874,1,home,0,8,8
9874,2,education,8,12,4
9874,3,shop,12,13,1
9874,4,work,13,19,6
9874,5,home,19,24,5
9874,6,<ENDS>,24,24,0
9875,0,<START>,0,0,0
9875,1,home,0,7,7
9875,2,education,7,11,4
9875,3,home,11,18,7
9875,4,shop,18,19,1
9875,5,home,19,24,5
9875,6,<ENDS>,24,24,0
9876,0,<START>,0,0,0
9876,1,home,0,7,7
9876,2,work,7,14,7
9876,3,shop,14,15,1
9876,4,home,15,24,9
9876,5,<ENDS>,24,24,0
9877,0,<START>,0,0,0
9877,1,home,0,6,6
9877,2,work,6,13,7
9877,3,shop,13,14,1
9877,4,work,14,19,5
9877,5,home,19,24,5
9877,6,<ENDS>,24,24,0
9878,0,<START>,0,0,0
9878,1,home,0,8,8
9878,2,work,8,15,7
9878,3,home,15,24,9
9878,4,<ENDS>,24,24,0
9879,0,<START>,0,0,0
9879,1,home,0,7,7
9879,2,work,7,14,7
9879,3,home,14,19,5
9879,4,shop,19,20,1
9879,5,home,20,24,4
9879,6,<ENDS>,24,24,0
9880,0,<START>,0,0,0
9880,1,home,0,6,6
9880,2,shop,6,7,1
9880,3,home,7,9,2
9880,4,education,9,12,3
9880,5,shop,12,14,2
9880,6,education,14,16,2
9880,7,shop,16,17,1
9880,8,home,17,24,7
9880,9,<ENDS>,24,24,0
9881,0,<START>,0,0,0
9881,1,home,0,8,8
9881,2,education,8,11,3
9881,3,home,11,18,7
9881,4,shop,18,20,2
9881,5,home,20,24,4
9881,6,<ENDS>,24,24,0
9882,0,<START>,0,0,0
9882,1,home,0,7,7
9882,2,education,7,11,4
9882,3,home,11,18,7
9882,4,shop,18,20,2
9882,5,home,20,24,4
9882,6,<ENDS>,24,24,0
9883,0,<START>,0,0,0
9883,1,home,0,8,8
9883,2,work,8,15,7
9883,3,home,15,24,9
9883,4,<ENDS>,24,24,0
9884,0,<START>,0,0,0
9884,1,home,0,6,6
9884,2,work,6,8,2
9884,3,home,8,11,3
9884,4,work,11,13,2
9884,5,home,13,20,7
9884,6,shop,20,21,1
9884,7,home,21,24,3
9884,8,<ENDS>,24,24,0
9885,0,<START>,0,0,0
9885,1,home,0,6,6
9885,2,work,6,8,2
9885,3,home,8,12,4
9885,4,work,12,14,2
9885,5,home,14,22,8
9885,6,work,22,23,1
9885,7,home,23,24,1
9885,8,<ENDS>,24,24,0
9886,0,<START>,0,0,0
9886,1,home,0,6,6
9886,2,work,6,13,7
9886,3,shop,13,14,1
9886,4,work,14,19,5
9886,5,home,19,24,5
9886,6,<ENDS>,24,24,0
9887,0,<START>,0,0,0
9887,1,home,0,7,7
9887,2,work,7,13,6
9887,3,home,13,24,11
9887,4,<ENDS>,24,24,0
9888,0,<START>,0,0,0
9888,1,home,0,7,7
9888,2,education,7,12,5
9888,3,home,12,18,6
9888,4,shop,18,19,1
9888,5,home,19,24,5
9888,6,<ENDS>,24,24,0
9889,0,<START>,0,0,0
9889,1,home,0,6,6
9889,2,work,6,14,8
9889,3,home,14,24,10
9889,4,<ENDS>,24,24,0
9890,0,<START>,0,0,0
9890,1,home,0,6,6
9890,2,work,6,13,7
9890,3,shop,13,14,1
9890,4,work,14,19,5
9890,5,home,19,24,5
9890,6,<ENDS>,24,24,0
9891,0,<START>,0,0,0
9891,1,home,0,7,7
9891,2,shop,7,8,1
9891,3,home,8,13,5
9891,4,work,13,19,6
9891,5,home,19,24,5
9891,6,<ENDS>,24,24,0
9892,0,<START>,0,0,0
9892,1,home,0,7,7
9892,2,education,7,11,4
9892,3,home,11,14,3
9892,4,education,14,17,3
9892,5,home,17,24,7
9892,6,<ENDS>,24,24,0
9893,0,<START>,0,0,0
9893,1,home,0,7,7
9893,2,work,7,14,7
9893,3,home,14,18,4
9893,4,work,18,20,2
9893,5,home,20,24,4
9893,6,<ENDS>,24,24,0
9894,0,<START>,0,0,0
9894,1,home,0,8,8
9894,2,work,8,14,6
9894,3,shop,14,15,1
9894,4,work,15,20,5
9894,5,home,20,24,4
9894,6,<ENDS>,24,24,0
9895,0,<START>,0,0,0
9895,1,home,0,8,8
9895,2,work,8,14,6
9895,3,home,14,21,7
9895,4,work,21,22,1
9895,5,home,22,24,2
9895,6,<ENDS>,24,24,0
9896,0,<START>,0,0,0
9896,1,home,0,7,7
9896,2,work,7,13,6
9896,3,shop,13,14,1
9896,4,work,14,20,6
9896,5,home,20,24,4
9896,6,<ENDS>,24,24,0
9897,0,<START>,0,0,0
9897,1,home,0,6,6
9897,2,shop,6,7,1
9897,3,home,7,9,2
9897,4,work,9,15,6
9897,5,home,15,21,6
9897,6,work,21,22,1
9897,7,home,22,24,2
9897,8,<ENDS>,24,24,0
9898,0,<START>,0,0,0
9898,1,home,0,7,7
9898,2,work,7,14,7
9898,3,home,14,19,5
9898,4,shop,19,20,1
9898,5,home,20,24,4
9898,6,<ENDS>,24,24,0
9899,0,<START>,0,0,0
9899,1,home,0,6,6
9899,2,work,6,13,7
9899,3,home,13,24,11
9899,4,<ENDS>,24,24,0
9900,0,<START>,0,0,0
9900,1,home,0,6,6
9900,2,work,6,13,7
9900,3,home,13,24,11
9900,4,<ENDS>,24,24,0
9901,0,<START>,0,0,0
9901,1,home,0,7,7
9901,2,work,7,13,6
9901,3,home,13,24,11
9901,4,<ENDS>,24,24,0
9902,0,<START>,0,0,0
9902,1,home,0,7,7
9902,2,shop,7,8,1
9902,3,education,8,12,4
9902,4,shop,12,14,2
9902,5,education,14,16,2
9902,6,shop,16,17,1
9902,7,home,17,24,7
9902,8,<ENDS>,24,24,0
9903,0,<START>,0,0,0
9903,1,home,0,7,7
9903,2,work,7,14,7
9903,3,shop,14,15,1
9903,4,work,15,19,4
9903,5,home,19,24,5
9903,6,<ENDS>,24,24,0
9904,0,<START>,0,0,0
9904,1,home,0,7,7
9904,2,work,7,13,6
9904,3,shop,13,14,1
9904,4,work,14,20,6
9904,5,home,20,24,4
9904,6,<ENDS>,24,24,0
9905,0,<START>,0,0,0
9905,1,home,0,8,8
9905,2,education,8,12,4
9905,3,home,12,24,12
9905,4,<ENDS>,24,24,0
9906,0,<START>,0,0,0
9906,1,home,0,8,8
9906,2,work,8,14,6
9906,3,shop,14,15,1
9906,4,home,15,18,3
9906,5,work,18,20,2
9906,6,home,20,24,4
9906,7,<ENDS>,24,24,0
9907,0,<START>,0,0,0
9907,1,home,0,7,7
9907,2,education,7,11,4
9907,3,home,11,18,7
9907,4,shop,18,19,1
9907,5,home,19,24,5
9907,6,<ENDS>,24,24,0
9908,0,<START>,0,0,0
9908,1,home,0,8,8
9908,2,work,8,17,9
9908,3,home,17,24,7
9908,4,<ENDS>,24,24,0
9909,0,<START>,0,0,0
9909,1,home,0,7,7
9909,2,work,7,13,6
9909,3,home,13,17,4
9909,4,work,17,20,3
9909,5,home,20,22,2
9909,6,work,22,23,1
9909,7,home,23,24,1
9909,8,<ENDS>,24,24,0
9910,0,<START>,0,0,0
9910,1,home,0,9,9
9910,2,work,9,17,8
9910,3,home,17,23,6
9910,4,work,23,24,1
9910,5,<ENDS>,24,24,0
9911,0,<START>,0,0,0
9911,1,home,0,6,6
9911,2,shop,6,7,1
9911,3,home,7,9,2
9911,4,education,9,12,3
9911,5,home,12,19,7
9911,6,shop,19,20,1
9911,7,home,20,24,4
9911,8,<ENDS>,24,24,0
9912,0,<START>,0,0,0
9912,1,home,0,8,8
9912,2,work,8,15,7
9912,3,home,15,21,6
9912,4,work,21,22,1
9912,5,home,22,24,2
9912,6,<ENDS>,24,24,0
9913,0,<START>,0,0,0
9913,1,home,0,6,6
9913,2,work,6,8,2
9913,3,home,8,14,6
9913,4,work,14,16,2
9913,5,home,16,21,5
9913,6,work,21,22,1
9913,7,home,22,24,2
9913,8,<ENDS>,24,24,0
9914,0,<START>,0,0,0
9914,1,home,0,6,6
9914,2,work,6,13,7
9914,3,home,13,18,5
9914,4,work,18,20,2
9914,5,home,20,24,4
9914,6,<ENDS>,24,24,0
9915,0,<START>,0,0,0
9915,1,home,0,7,7
9915,2,work,7,14,7
9915,3,home,14,24,10
9915,4,<ENDS>,24,24,0
9916,0,<START>,0,0,0
9916,1,home,0,8,8
9916,2,work,8,15,7
9916,3,shop,15,16,1
9916,4,work,16,20,4
9916,5,home,20,24,4
9916,6,<ENDS>,24,24,0
9917,0,<START>,0,0,0
9917,1,home,0,8,8
9917,2,work,8,15,7
9917,3,home,15,21,6
9917,4,shop,21,22,1
9917,5,home,22,24,2
9917,6,<ENDS>,24,24,0
9918,0,<START>,0,0,0
9918,1,home,0,6,6
9918,2,work,6,13,7
9918,3,home,13,24,11
9918,4,<ENDS>,24,24,0
9919,0,<START>,0,0,0
9919,1,home,0,7,7
9919,2,work,7,13,6
9919,3,home,13,24,11
9919,4,<ENDS>,24,24,0
9920,0,<START>,0,0,0
9920,1,home,0,7,7
9920,2,work,7,14,7
9920,3,home,14,24,10
9920,4,<ENDS>,24,24,0
9921,0,<START>,0,0,0
9921,1,home,0,7,7
9921,2,work,7,13,6
9921,3,home,13,18,5
9921,4,shop,18,19,1
9921,5,home,19,24,5
9921,6,<ENDS>,24,24,0
9922,0,<START>,0,0,0
9922,1,home,0,6,6
9922,2,work,6,13,7
9922,3,shop,13,14,1
9922,4,work,14,19,5
9922,5,home,19,24,5
9922,6,<ENDS>,24,24,0
9923,0,<START>,0,0,0
9923,1,home,0,8,8
9923,2,education,8,12,4
9923,3,home,12,23,11
9923,4,work,23,24,1
9923,5,<ENDS>,24,24,0
9924,0,<START>,0,0,0
9924,1,home,0,7,7
9924,2,shop,7,8,1
9924,3,education,8,11,3
9924,4,home,11,16,5
9924,5,shop,16,17,1
9924,6,home,17,24,7
9924,7,<ENDS>,24,24,0
9925,0,<START>,0,0,0
9925,1,home,0,7,7
9925,2,work,7,14,7
9925,3,home,14,24,10
9925,4,<ENDS>,24,24,0
9926,0,<START>,0,0,0
9926,1,home,0,7,7
9926,2,work,7,14,7
9926,3,home,14,21,7
9926,4,shop,21,22,1
9926,5,home,22,24,2
9926,6,<ENDS>,24,24,0
9927,0,<START>,0,0,0
9927,1,home,0,7,7
9927,2,work,7,14,7
9927,3,home,14,22,8
9927,4,work,22,23,1
9927,5,home,23,24,1
9927,6,<ENDS>,24,24,0
9928,0,<START>,0,0,0
9928,1,home,0,7,7
9928,2,shop,7,8,1
9928,3,work,8,15,7
9928,4,home,15,24,9
9928,5,<ENDS>,24,24,0
9929,0,<START>,0,0,0
9929,1,home,0,8,8
9929,2,work,8,14,6
9929,3,home,14,24,10
9929,4,<ENDS>,24,24,0
9930,0,<START>,0,0,0
9930,1,home,0,6,6
9930,2,shop,6,7,1
9930,3,home,7,10,3
9930,4,education,10,12,2
9930,5,home,12,20,8
9930,6,shop,20,21,1
9930,7,home,21,24,3
9930,8,<ENDS>,24,24,0
9931,0,<START>,0,0,0
9931,1,home,0,6,6
9931,2,work,6,13,7
9931,3,shop,13,14,1
9931,4,work,14,20,6
9931,5,home,20,24,4
9931,6,<ENDS>,24,24,0
9932,0,<START>,0,0,0
9932,1,home,0,7,7
9932,2,education,7,11,4
9932,3,home,11,18,7
9932,4,shop,18,19,1
9932,5,home,19,24,5
9932,6,<ENDS>,24,24,0
9933,0,<START>,0,0,0
9933,1,home,0,6,6
9933,2,work,6,13,7
9933,3,home,13,24,11
9933,4,<ENDS>,24,24,0
9934,0,<START>,0,0,0
9934,1,home,0,7,7
9934,2,work,7,14,7
9934,3,shop,14,15,1
9934,4,home,15,21,6
9934,5,work,21,22,1
9934,6,home,22,24,2
9934,7,<ENDS>,24,24,0
9935,0,<START>,0,0,0
9935,1,home,0,7,7
9935,2,work,7,13,6
9935,3,shop,13,14,1
9935,4,work,14,19,5
9935,5,home,19,24,5
9935,6,<ENDS>,24,24,0
9936,0,<START>,0,0,0
9936,1,home,0,7,7
9936,2,work,7,14,7
9936,3,shop,14,15,1
9936,4,work,15,19,4
9936,5,home,19,24,5
9936,6,<ENDS>,24,24,0
9937,0,<START>,0,0,0
9937,1,home,0,7,7
9937,2,education,7,12,5
9937,3,home,12,18,6
9937,4,shop,18,19,1
9937,5,home,19,24,5
9937,6,<ENDS>,24,24,0
9938,0,<START>,0,0,0
9938,1,home,0,8,8
9938,2,shop,8,9,1
9938,3,home,9,13,4
9938,4,education,13,16,3
9938,5,shop,16,17,1
9938,6,home,17,24,7
9938,7,<ENDS>,24,24,0
9939,0,<START>,0,0,0
9939,1,home,0,6,6
9939,2,work,6,13,7
9939,3,home,13,24,11
9939,4,<ENDS>,24,24,0
9940,0,<START>,0,0,0
9940,1,home,0,6,6
9940,2,work,6,13,7
9940,3,home,13,24,11
9940,4,<ENDS>,24,24,0
9941,0,<START>,0,0,0
9941,1,home,0,7,7
9941,2,work,7,13,6
9941,3,home,13,24,11
9941,4,<ENDS>,24,24,0
9942,0,<START>,0,0,0
9942,1,home,0,7,7
9942,2,shop,7,8,1
9942,3,home,8,12,4
9942,4,work,12,19,7
9942,5,home,19,24,5
9942,6,<ENDS>,24,24,0
9943,0,<START>,0,0,0
9943,1,home,0,7,7
9943,2,shop,7,8,1
9943,3,work,8,14,6
9943,4,home,14,24,10
9943,5,<ENDS>,24,24,0
9944,0,<START>,0,0,0
9944,1,home,0,6,6
9944,2,work,6,8,2
9944,3,home,8,13,5
9944,4,work,13,15,2
9944,5,home,15,21,6
9944,6,work,21,22,1
9944,7,home,22,24,2
9944,8,<ENDS>,24,24,0
9945,0,<START>,0,0,0
9945,1,home,0,7,7
9945,2,education,7,11,4
9945,3,home,11,17,6
9945,4,shop,17,19,2
9945,5,home,19,24,5
9945,6,<ENDS>,24,24,0
9946,0,<START>,0,0,0
9946,1,home,0,9,9
9946,2,shop,9,10,1
9946,3,work,10,17,7
9946,4,home,17,24,7
9946,5,<ENDS>,24,24,0
9947,0,<START>,0,0,0
9947,1,home,0,8,8
9947,2,work,8,14,6
9947,3,home,14,21,7
9947,4,work,21,22,1
9947,5,home,22,24,2
9947,6,<ENDS>,24,24,0
9948,0,<START>,0,0,0
9948,1,home,0,7,7
9948,2,education,7,11,4
9948,3,home,11,18,7
9948,4,shop,18,20,2
9948,5,home,20,24,4
9948,6,<ENDS>,24,24,0
9949,0,<START>,0,0,0
9949,1,home,0,7,7
9949,2,work,7,13,6
9949,3,home,13,24,11
9949,4,<ENDS>,24,24,0
9950,0,<START>,0,0,0
9950,1,home,0,6,6
9950,2,work,6,8,2
9950,3,home,8,15,7
9950,4,work,15,17,2
9950,5,home,17,24,7
9950,6,<ENDS>,24,24,0
9951,0,<START>,0,0,0
9951,1,home,0,8,8
9951,2,work,8,14,6
9951,3,home,14,21,7
9951,4,shop,21,22,1
9951,5,home,22,24,2
9951,6,<ENDS>,24,24,0
9952,0,<START>,0,0,0
9952,1,home,0,6,6
9952,2,work,6,7,1
9952,3,home,7,9,2
9952,4,work,9,12,3
9952,5,home,12,13,1
9952,6,work,13,15,2
9952,7,home,15,21,6
9952,8,work,21,22,1
9952,9,home,22,24,2
9952,10,<ENDS>,24,24,0
9953,0,<START>,0,0,0
9953,1,home,0,6,6
9953,2,work,6,7,1
9953,3,home,7,13,6
9953,4,work,13,15,2
9953,5,home,15,21,6
9953,6,work,21,22,1
9953,7,home,22,24,2
9953,8,<ENDS>,24,24,0
9954,0,<START>,0,0,0
9954,1,home,0,6,6
9954,2,work,6,8,2
9954,3,home,8,15,7
9954,4,work,15,16,1
9954,5,shop,16,17,1
9954,6,work,17,19,2
9954,7,home,19,23,4
9954,8,work,23,24,1
9954,9,<ENDS>,24,24,0
9955,0,<START>,0,0,0
9955,1,home,0,6,6
9955,2,work,6,13,7
9955,3,shop,13,14,1
9955,4,work,14,19,5
9955,5,home,19,24,5
9955,6,<ENDS>,24,24,0
9956,0,<START>,0,0,0
9956,1,home,0,7,7
9956,2,education,7,11,4
9956,3,home,11,16,5
9956,4,shop,16,17,1
9956,5,home,17,24,7
9956,6,<ENDS>,24,24,0
9957,0,<START>,0,0,0
9957,1,home,0,7,7
9957,2,shop,7,8,1
9957,3,work,8,15,7
9957,4,home,15,23,8
9957,5,work,23,24,1
9957,6,<ENDS>,24,24,0
9958,0,<START>,0,0,0
9958,1,home,0,8,8
9958,2,education,8,11,3
9958,3,home,11,17,6
9958,4,shop,17,18,1
9958,5,home,18,24,6
9958,6,<ENDS>,24,24,0
9959,0,<START>,0,0,0
9959,1,home,0,6,6
9959,2,work,6,13,7
9959,3,home,13,21,8
9959,4,work,21,22,1
9959,5,home,22,24,2
9959,6,<ENDS>,24,24,0
9960,0,<START>,0,0,0
9960,1,home,0,7,7
9960,2,shop,7,9,2
9960,3,work,9,15,6
9960,4,home,15,21,6
9960,5,work,21,22,1
9960,6,home,22,24,2
9960,7,<ENDS>,24,24,0
9961,0,<START>,0,0,0
9961,1,home,0,6,6
9961,2,work,6,13,7
9961,3,shop,13,14,1
9961,4,home,14,24,10
9961,5,<ENDS>,24,24,0
9962,0,<START>,0,0,0
9962,1,home,0,6,6
9962,2,shop,6,7,1
9962,3,work,7,13,6
9962,4,home,13,17,4
9962,5,work,17,20,3
9962,6,home,20,24,4
9962,7,<ENDS>,24,24,0
9963,0,<START>,0,0,0
9963,1,home,0,7,7
9963,2,work,7,13,6
9963,3,home,13,18,5
9963,4,work,18,20,2
9963,5,home,20,24,4
9963,6,<ENDS>,24,24,0
9964,0,<START>,0,0,0
9964,1,home,0,6,6
9964,2,work,6,13,7
9964,3,shop,13,14,1
9964,4,home,14,24,10
9964,5,<ENDS>,24,24,0
9965,0,<START>,0,0,0
9965,1,home,0,9,9
9965,2,work,9,15,6
9965,3,home,15,23,8
9965,4,work,23,24,1
9965,5,<ENDS>,24,24,0
9966,0,<START>,0,0,0
9966,1,home,0,7,7
9966,2,work,7,13,6
9966,3,home,13,19,6
9966,4,shop,19,20,1
9966,5,home,20,24,4
9966,6,<ENDS>,24,24,0
9967,0,<START>,0,0,0
9967,1,home,0,7,7
9967,2,work,7,14,7
9967,3,shop,14,15,1
9967,4,home,15,22,7
9967,5,work,22,23,1
9967,6,home,23,24,1
9967,7,<ENDS>,24,24,0
9968,0,<START>,0,0,0
9968,1,home,0,8,8
9968,2,work,8,15,7
9968,3,home,15,24,9
9968,4,<ENDS>,24,24,0
9969,0,<START>,0,0,0
9969,1,home,0,6,6
9969,2,work,6,13,7
9969,3,shop,13,14,1
9969,4,home,14,18,4
9969,5,work,18,20,2
9969,6,home,20,24,4
9969,7,<ENDS>,24,24,0
9970,0,<START>,0,0,0
9970,1,home,0,7,7
9970,2,work,7,13,6
9970,3,shop,13,14,1
9970,4,home,14,22,8
9970,5,work,22,23,1
9970,6,home,23,24,1
9970,7,<ENDS>,24,24,0
9971,0,<START>,0,0,0
9971,1,home,0,8,8
9971,2,work,8,15,7
9971,3,shop,15,16,1
9971,4,work,16,20,4
9971,5,home,20,24,4
9971,6,<ENDS>,24,24,0
9972,0,<START>,0,0,0
9972,1,home,0,8,8
9972,2,work,8,15,7
9972,3,home,15,22,7
9972,4,work,22,23,1
9972,5,home,23,24,1
9972,6,<ENDS>,24,24,0
9973,0,<START>,0,0,0
9973,1,home,0,7,7
9973,2,work,7,13,6
9973,3,home,13,24,11
9973,4,<ENDS>,24,24,0
9974,0,<START>,0,0,0
9974,1,home,0,8,8
9974,2,work,8,13,5
9974,3,home,13,17,4
9974,4,work,17,20,3
9974,5,home,20,24,4
9974,6,<ENDS>,24,24,0
9975,0,<START>,0,0,0
9975,1,home,0,6,6
9975,2,shop,6,7,1
9975,3,work,7,15,8
9975,4,home,15,22,7
9975,5,work,22,23,1
9975,6,home,23,24,1
9975,7,<ENDS>,24,24,0
9976,0,<START>,0,0,0
9976,1,home,0,7,7
9976,2,education,7,12,5
9976,3,home,12,19,7
9976,4,shop,19,20,1
9976,5,home,20,24,4
9976,6,<ENDS>,24,24,0
9977,0,<START>,0,0,0
9977,1,home,0,7,7
9977,2,work,7,13,6
9977,3,home,13,17,4
9977,4,shop,17,18,1
9977,5,home,18,24,6
9977,6,<ENDS>,24,24,0
9978,0,<START>,0,0,0
9978,1,home,0,6,6
9978,2,work,6,13,7
9978,3,home,13,17,4
9978,4,shop,17,18,1
9978,5,home,18,24,6
9978,6,<ENDS>,24,24,0
9979,0,<START>,0,0,0
9979,1,home,0,6,6
9979,2,shop,6,7,1
9979,3,home,7,9,2
9979,4,education,9,15,6
9979,5,shop,15,16,1
9979,6,home,16,24,8
9979,7,<ENDS>,24,24,0
9980,0,<START>,0,0,0
9980,1,home,0,7,7
9980,2,work,7,14,7
9980,3,home,14,24,10
9980,4,<ENDS>,24,24,0
9981,0,<START>,0,0,0
9981,1,home,0,8,8
9981,2,work,8,12,4
9981,3,shop,12,13,1
9981,4,work,13,19,6
9981,5,home,19,24,5
9981,6,<ENDS>,24,24,0
9982,0,<START>,0,0,0
9982,1,home,0,8,8
9982,2,work,8,15,7
9982,3,home,15,21,6
9982,4,work,21,22,1
9982,5,home,22,24,2
9982,6,<ENDS>,24,24,0
9983,0,<START>,0,0,0
9983,1,home,0,7,7
9983,2,education,7,11,4
9983,3,home,11,14,3
9983,4,education,14,16,2
9983,5,home,16,24,8
9983,6,<ENDS>,24,24,0
9984,0,<START>,0,0,0
9984,1,home,0,7,7
9984,2,work,7,13,6
9984,3,shop,13,14,1
9984,4,home,14,21,7
9984,5,work,21,22,1
9984,6,home,22,24,2
9984,7,<ENDS>,24,24,0
9985,0,<START>,0,0,0
9985,1,home,0,7,7
9985,2,work,7,13,6
9985,3,home,13,15,2
9985,4,work,15,20,5
9985,5,home,20,24,4
9985,6,<ENDS>,24,24,0
9986,0,<START>,0,0,0
9986,1,home,0,7,7
9986,2,education,7,11,4
9986,3,home,11,18,7
9986,4,shop,18,20,2
9986,5,home,20,24,4
9986,6,<ENDS>,24,24,0
9987,0,<START>,0,0,0
9987,1,home,0,8,8
9987,2,work,8,15,7
9987,3,home,15,24,9
9987,4,<ENDS>,24,24,0
9988,0,<START>,0,0,0
9988,1,home,0,7,7
9988,2,work,7,9,2
9988,3,home,9,15,6
9988,4,shop,15,16,1
9988,5,home,16,22,6
9988,6,work,22,23,1
9988,7,home,23,24,1
9988,8,<ENDS>,24,24,0
9989,0,<START>,0,0,0
9989,1,home,0,7,7
9989,2,work,7,14,7
9989,3,home,14,18,4
9989,4,work,18,19,1
9989,5,home,19,24,5
9989,6,<ENDS>,24,24,0
9990,0,<START>,0,0,0
9990,1,home,0,6,6
9990,2,work,6,13,7
9990,3,shop,13,14,1
9990,4,work,14,19,5
9990,5,home,19,24,5
9990,6,<ENDS>,24,24,0
9991,0,<START>,0,0,0
9991,1,home,0,6,6
9991,2,work,6,13,7
9991,3,home,13,17,4
9991,4,work,17,20,3
9991,5,home,20,24,4
9991,6,<ENDS>,24,24,0
9992,0,<START>,0,0,0
9992,1,home,0,6,6
9992,2,work,6,13,7
9992,3,home,13,24,11
9992,4,<ENDS>,24,24,0
9993,0,<START>,0,0,0
9993,1,home,0,7,7
9993,2,work,7,13,6
9993,3,home,13,17,4
9993,4,shop,17,18,1
9993,5,home,18,24,6
9993,6,<ENDS>,24,24,0
9994,0,<START>,0,0,0
9994,1,home,0,6,6
9994,2,work,6,13,7
9994,3,home,13,24,11
9994,4,<ENDS>,24,24,0
9995,0,<START>,0,0,0
9995,1,home,0,6,6
9995,2,work,6,13,7
9995,3,shop,13,14,1
9995,4,home,14,24,10
9995,5,<ENDS>,24,24,0
9996,0,<START>,0,0,0
9996,1,home,0,6,6
9996,2,work,6,8,2
9996,3,home,8,14,6
9996,4,work,14,16,2
9996,5,home,16,23,7
9996,6,work,23,24,1
9996,7,<ENDS>,24,24,0
9997,0,<START>,0,0,0
9997,1,home,0,7,7
9997,2,education,7,11,4
9997,3,home,11,18,7
9997,4,shop,18,19,1
9997,5,home,19,24,5
9997,6,<ENDS>,24,24,0
9998,0,<START>,0,0,0
9998,1,home,0,7,7
9998,2,work,7,9,2
9998,3,home,9,13,4
9998,4,work,13,16,3
9998,5,home,16,23,7
9998,6,work,23,24,1
9998,7,<ENDS>,24,24,0
9999,0,<START>,0,0,0
9999,1,home,0,9,9
9999,2,work,9,18,9
9999,3,home,18,24,6
9999,4,<ENDS>,24,24,0
