pid,seq,act,start,end,duration
0,1,home,0,9,9
0,2,work,9,16,7
0,3,home,16,21,5
0,4,work,21,22,1
0,5,home,22,24,2
1,1,home,0,8,8
1,2,education,8,14,6
1,3,shop,14,15,1
1,4,home,15,24,9
2,1,home,0,8,8
2,2,shop,8,9,1
2,3,work,9,16,7
2,4,shop,16,17,1
2,5,work,17,19,2
2,6,home,19,24,5
3,1,home,0,8,8
3,2,work,8,13,5
3,3,shop,13,14,1
3,4,work,14,19,5
3,5,home,19,24,5
4,1,home,0,6,6
4,2,work,6,13,7
4,3,home,13,24,11
5,1,home,0,7,7
5,2,shop,7,8,1
5,3,education,8,11,3
5,4,home,11,17,6
5,5,shop,17,19,2
5,6,home,19,24,5
6,1,home,0,7,7
6,2,education,7,11,4
6,3,home,11,18,7
6,4,shop,18,19,1
6,5,home,19,24,5
7,1,home,0,6,6
7,2,work,6,13,7
7,3,shop,13,14,1
7,4,work,14,19,5
7,5,education,19,20,1
7,6,home,20,24,4
8,1,home,0,6,6
8,2,shop,6,7,1
8,3,home,7,10,3
8,4,education,10,13,3
8,5,home,13,17,4
8,6,shop,17,18,1
8,7,home,18,24,6
9,1,home,0,8,8
9,2,work,8,15,7
9,3,shop,15,16,1
9,4,home,16,24,8
10,1,home,0,7,7
10,2,work,7,14,7
10,3,shop,14,15,1
10,4,home,15,24,9
11,1,home,0,7,7
11,2,work,7,13,6
11,3,home,13,17,4
11,4,work,17,20,3
11,5,home,20,24,4
12,1,home,0,6,6
12,2,shop,6,7,1
12,3,home,7,10,3
12,4,education,10,16,6
12,5,home,16,24,8
13,1,home,0,7,7
13,2,work,7,9,2
13,3,home,9,15,6
13,4,work,15,17,2
13,5,home,17,23,6
13,6,work,23,24,1
14,1,home,0,7,7
14,2,work,7,14,7
14,3,home,14,24,10
15,1,home,0,6,6
15,2,work,6,13,7
15,3,home,13,21,8
15,4,shop,21,22,1
15,5,home,22,24,2
16,1,home,0,7,7
16,2,work,7,13,6
16,3,home,13,17,4
16,4,shop,17,18,1
16,5,home,18,24,6
17,1,home,0,7,7
17,2,work,7,14,7
17,3,home,14,24,10
18,1,home,0,7,7
18,2,work,7,13,6
18,3,home,13,18,5
18,4,shop,18,19,1
18,5,home,19,24,5
19,1,work,0,7,7
19,2,shop,7,8,1
19,3,home,8,13,5
19,4,work,13,19,6
19,5,home,19,24,5
20,1,home,0,8,8
20,2,work,8,13,5
20,3,shop,13,14,1
20,4,work,14,20,6
20,5,home,20,24,4
21,1,home,0,7,7
21,2,work,7,14,7
21,3,shop,14,15,1
21,4,home,15,24,9
22,1,home,0,8,8
22,2,work,8,15,7
22,3,shop,15,16,1
22,4,home,16,24,8
23,1,home,0,7,7
23,2,work,7,13,6
23,3,home,13,24,11
24,1,home,0,7,7
24,2,education,7,11,4
24,3,home,11,19,8
24,4,shop,19,20,1
24,5,home,20,24,4
25,1,home,0,7,7
25,2,work,7,13,6
25,3,home,13,22,9
25,4,work,22,23,1
25,5,home,23,24,1
26,1,home,0,8,8
26,2,work,8,14,6
26,3,shop,14,15,1
26,4,home,15,23,8
26,5,work,23,24,1
27,1,home,0,6,6
27,2,work,6,8,2
27,3,home,8,14,6
27,4,work,14,16,2
27,5,home,16,23,7
27,6,work,23,24,1
28,1,home,0,6,6
28,2,work,6,13,7
28,3,home,13,24,11
29,1,work,0,8,8
29,2,shop,8,9,1
29,3,home,9,13,4
29,4,work,13,15,2
29,5,home,15,24,9
30,1,home,0,6,6
30,2,shop,6,7,1
30,3,home,7,10,3
30,4,education,10,12,2
30,5,home,12,14,2
30,6,education,14,16,2
30,7,home,16,24,8
31,1,home,0,7,7
31,2,work,7,14,7
31,3,home,14,24,10
32,1,home,0,8,8
32,2,work,8,14,6
32,3,home,14,21,7
32,4,work,21,22,1
32,5,home,22,24,2
33,1,home,0,7,7
33,2,work,7,14,7
33,3,shop,14,15,1
33,4,home,15,23,8
33,5,work,23,24,1
34,1,home,0,7,7
34,2,work,7,14,7
34,3,shop,14,15,1
34,4,work,15,20,5
34,5,home,20,24,4
35,1,home,0,7,7
35,2,work,7,13,6
35,3,shop,13,14,1
35,4,work,14,20,6
35,5,home,20,24,4
36,1,home,0,8,8
36,2,education,8,11,3
36,3,home,11,18,7
36,4,shop,18,19,1
36,5,home,19,24,5
37,1,home,0,6,6
37,2,shop,6,7,1
37,3,home,7,10,3
37,4,education,10,12,2
37,5,shop,12,13,1
37,6,home,13,20,7
37,7,shop,20,21,1
37,8,home,21,24,3
38,1,home,0,7,7
38,2,work,7,13,6
38,3,home,13,24,11
39,1,home,0,7,7
39,2,work,7,14,7
39,3,home,14,24,10
40,1,home,0,6,6
40,2,work,6,13,7
40,3,shop,13,14,1
40,4,education,14,17,3
40,5,home,17,24,7
41,1,home,0,7,7
41,2,work,7,14,7
41,3,home,14,24,10
42,1,home,0,7,7
42,2,work,7,13,6
42,3,home,13,24,11
43,1,home,0,7,7
43,2,work,7,14,7
43,3,shop,14,15,1
43,4,home,15,22,7
43,5,work,22,23,1
43,6,home,23,24,1
44,1,home,0,7,7
44,2,work,7,14,7
44,3,shop,14,15,1
44,4,home,15,22,7
44,5,work,22,23,1
44,6,home,23,24,1
45,1,home,0,6,6
45,2,work,6,12,6
45,3,shop,12,13,1
45,4,work,13,19,6
45,5,home,19,24,5
46,1,home,0,7,7
46,2,work,7,14,7
46,3,shop,14,15,1
46,4,home,15,24,9
47,1,home,0,8,8
47,2,education,8,11,3
47,3,shop,11,12,1
47,4,home,12,16,4
47,5,work,16,20,4
47,6,home,20,24,4
48,1,home,0,7,7
48,2,shop,7,8,1
48,3,work,8,16,8
48,4,home,16,24,8
49,1,home,0,7,7
49,2,work,7,14,7
49,3,home,14,24,10
50,1,home,0,8,8
50,2,education,8,12,4
50,3,shop,12,13,1
50,4,work,13,19,6
50,5,home,19,24,5
51,1,home,0,6,6
51,2,shop,6,7,1
51,3,home,7,9,2
51,4,education,9,12,3
51,5,home,12,14,2
51,6,education,14,16,2
51,7,shop,16,17,1
51,8,home,17,21,4
51,9,shop,21,22,1
51,10,home,22,24,2
52,1,home,0,7,7
52,2,work,7,14,7
52,3,shop,14,15,1
52,4,home,15,24,9
53,1,home,0,7,7
53,2,work,7,13,6
53,3,home,13,24,11
54,1,home,0,7,7
54,2,education,7,12,5
54,3,home,12,18,6
54,4,shop,18,19,1
54,5,home,19,24,5
55,1,home,0,7,7
55,2,work,7,13,6
55,3,shop,13,14,1
55,4,home,14,21,7
55,5,work,21,22,1
55,6,home,22,24,2
56,1,home,0,6,6
56,2,shop,6,7,1
56,3,home,7,10,3
56,4,education,10,11,1
56,5,home,11,13,2
56,6,education,13,15,2
56,7,shop,15,16,1
56,8,home,16,24,8
57,1,home,0,7,7
57,2,shop,7,8,1
57,3,work,8,15,7
57,4,home,15,24,9
58,1,home,0,7,7
58,2,education,7,11,4
58,3,home,11,17,6
58,4,shop,17,19,2
58,5,home,19,24,5
59,1,home,0,7,7
59,2,education,7,11,4
59,3,home,11,13,2
59,4,education,13,16,3
59,5,shop,16,17,1
59,6,home,17,24,7
60,1,home,0,7,7
60,2,work,7,13,6
60,3,shop,13,14,1
60,4,work,14,19,5
60,5,home,19,24,5
61,1,home,0,6,6
61,2,work,6,8,2
61,3,home,8,14,6
61,4,work,14,16,2
61,5,home,16,22,6
61,6,work,22,23,1
61,7,home,23,24,1
62,1,home,0,7,7
62,2,work,7,14,7
62,3,home,14,24,10
63,1,home,0,7,7
63,2,work,7,9,2
63,3,home,9,13,4
63,4,work,13,15,2
63,5,home,15,22,7
63,6,work,22,23,1
63,7,home,23,24,1
64,1,home,0,7,7
64,2,work,7,8,1
64,3,home,8,9,1
64,4,work,9,11,2
64,5,home,11,16,5
64,6,work,16,18,2
64,7,home,18,23,5
64,8,work,23,24,1
65,1,home,0,7,7
65,2,shop,7,8,1
65,3,education,8,11,3
65,4,home,11,18,7
65,5,shop,18,20,2
65,6,home,20,24,4
66,1,home,0,8,8
66,2,work,8,14,6
66,3,home,14,24,10
67,1,home,0,7,7
67,2,work,7,13,6
67,3,shop,13,14,1
67,4,work,14,19,5
67,5,home,19,24,5
68,1,home,0,6,6
68,2,shop,6,7,1
68,3,home,7,10,3
68,4,education,10,13,3
68,5,shop,13,15,2
68,6,home,15,24,9
69,1,home,0,7,7
69,2,education,7,11,4
69,3,home,11,19,8
69,4,shop,19,20,1
69,5,home,20,24,4
70,1,home,0,6,6
70,2,work,6,13,7
70,3,home,13,24,11
71,1,home,0,6,6
71,2,work,6,8,2
71,3,home,8,11,3
71,4,education,11,12,1
71,5,home,12,19,7
71,6,shop,19,20,1
71,7,home,20,24,4
72,1,home,0,7,7
72,2,work,7,14,7
72,3,home,14,24,10
73,1,home,0,7,7
73,2,work,7,13,6
73,3,home,13,24,11
74,1,home,0,6,6
74,2,work,6,13,7
74,3,home,13,22,9
74,4,work,22,23,1
74,5,home,23,24,1
75,1,home,0,8,8
75,2,work,8,14,6
75,3,home,14,21,7
75,4,work,21,22,1
75,5,home,22,24,2
76,1,home,0,7,7
76,2,work,7,13,6
76,3,shop,13,14,1
76,4,work,14,19,5
76,5,home,19,24,5
77,1,home,0,9,9
77,2,education,9,12,3
77,3,shop,12,13,1
77,4,work,13,19,6
77,5,home,19,22,3
77,6,work,22,23,1
77,7,home,23,24,1
78,1,home,0,7,7
78,2,work,7,14,7
78,3,shop,14,15,1
78,4,work,15,20,5
78,5,home,20,24,4
79,1,home,0,7,7
79,2,education,7,12,5
79,3,home,12,20,8
79,4,shop,20,21,1
79,5,home,21,24,3
80,1,home,0,7,7
80,2,work,7,14,7
80,3,shop,14,15,1
80,4,home,15,24,9
81,1,home,0,8,8
81,2,work,8,16,8
81,3,shop,16,17,1
81,4,home,17,21,4
81,5,work,21,22,1
81,6,home,22,24,2
82,1,home,0,7,7
82,2,work,7,13,6
82,3,home,13,17,4
82,4,work,17,20,3
82,5,home,20,24,4
83,1,home,0,7,7
83,2,work,7,14,7
83,3,shop,14,15,1
83,4,home,15,22,7
83,5,work,22,23,1
83,6,home,23,24,1
84,1,home,0,6,6
84,2,work,6,8,2
84,3,home,8,9,1
84,4,work,9,11,2
84,5,home,11,18,7
84,6,work,18,20,2
84,7,home,20,23,3
84,8,work,23,24,1
85,1,home,0,6,6
85,2,work,6,13,7
85,3,home,13,24,11
86,1,home,0,7,7
86,2,work,7,13,6
86,3,home,13,17,4
86,4,work,17,20,3
86,5,home,20,24,4
87,1,home,0,8,8
87,2,work,8,16,8
87,3,home,16,24,8
88,1,home,0,8,8
88,2,work,8,14,6
88,3,shop,14,15,1
88,4,work,15,19,4
88,5,education,19,20,1
88,6,home,20,24,4
89,1,home,0,6,6
89,2,shop,6,7,1
89,3,home,7,10,3
89,4,education,10,11,1
89,5,home,11,18,7
89,6,shop,18,20,2
89,7,home,20,24,4
90,1,home,0,6,6
90,2,work,6,8,2
90,3,home,8,12,4
90,4,work,12,14,2
90,5,home,14,19,5
90,6,shop,19,20,1
90,7,home,20,21,1
90,8,work,21,22,1
90,9,home,22,24,2
91,1,home,0,9,9
91,2,work,9,16,7
91,3,shop,16,17,1
91,4,home,17,24,7
92,1,home,0,9,9
92,2,education,9,12,3
92,3,shop,12,13,1
92,4,work,13,20,7
92,5,home,20,24,4
93,1,home,0,6,6
93,2,work,6,13,7
93,3,shop,13,14,1
93,4,work,14,20,6
93,5,home,20,24,4
94,1,home,0,6,6
94,2,shop,6,7,1
94,3,home,7,8,1
94,4,education,8,12,4
94,5,home,12,17,5
94,6,work,17,20,3
94,7,home,20,24,4
95,1,home,0,7,7
95,2,work,7,9,2
95,3,home,9,17,8
95,4,work,17,19,2
95,5,home,19,24,5
96,1,home,0,8,8
96,2,work,8,15,7
96,3,home,15,24,9
97,1,home,0,7,7
97,2,education,7,11,4
97,3,home,11,17,6
97,4,shop,17,18,1
97,5,home,18,24,6
98,1,home,0,6,6
98,2,work,6,12,6
98,3,shop,12,13,1
98,4,work,13,19,6
98,5,home,19,24,5
99,1,home,0,7,7
99,2,work,7,13,6
99,3,home,13,15,2
99,4,shop,15,16,1
99,5,home,16,24,8
100,1,home,0,7,7
100,2,work,7,14,7
100,3,home,14,24,10
101,1,home,0,7,7
101,2,shop,7,8,1
101,3,work,8,14,6
101,4,home,14,21,7
101,5,work,21,22,1
101,6,home,22,24,2
102,1,home,0,6,6
102,2,work,6,13,7
102,3,home,13,15,2
102,4,work,15,20,5
102,5,home,20,24,4
103,1,home,0,7,7
103,2,education,7,11,4
103,3,home,11,17,6
103,4,shop,17,19,2
103,5,home,19,24,5
104,1,home,0,7,7
104,2,education,7,11,4
104,3,home,11,18,7
104,4,shop,18,19,1
104,5,home,19,24,5
105,1,home,0,9,9
105,2,work,9,15,6
105,3,home,15,24,9
106,1,home,0,7,7
106,2,work,7,14,7
106,3,shop,14,15,1
106,4,work,15,20,5
106,5,home,20,24,4
107,1,home,0,7,7
107,2,education,7,12,5
107,3,shop,12,14,2
107,4,home,14,24,10
108,1,home,0,6,6
108,2,shop,6,7,1
108,3,home,7,13,6
108,4,education,13,16,3
108,5,home,16,24,8
109,1,home,0,6,6
109,2,work,6,8,2
109,3,home,8,9,1
109,4,work,9,11,2
109,5,home,11,17,6
109,6,work,17,19,2
109,7,home,19,24,5
110,1,home,0,7,7
110,2,work,7,14,7
110,3,shop,14,15,1
110,4,home,15,24,9
111,1,home,0,7,7
111,2,work,7,13,6
111,3,shop,13,14,1
111,4,home,14,24,10
112,1,home,0,6,6
112,2,work,6,13,7
112,3,shop,13,14,1
112,4,work,14,19,5
112,5,home,19,24,5
113,1,home,0,7,7
113,2,work,7,14,7
113,3,home,14,15,1
113,4,work,15,19,4
113,5,home,19,24,5
114,1,home,0,8,8
114,2,work,8,14,6
114,3,home,14,24,10
115,1,home,0,6,6
115,2,work,6,13,7
115,3,home,13,24,11
116,1,home,0,7,7
116,2,education,7,11,4
116,3,home,11,13,2
116,4,education,13,16,3
116,5,shop,16,17,1
116,6,home,17,24,7
117,1,home,0,6,6
117,2,shop,6,7,1
117,3,home,7,13,6
117,4,education,13,16,3
117,5,home,16,24,8
118,1,home,0,7,7
118,2,work,7,13,6
118,3,shop,13,14,1
118,4,home,14,21,7
118,5,work,21,22,1
118,6,home,22,24,2
119,1,home,0,7,7
119,2,work,7,14,7
119,3,home,14,24,10
120,1,home,0,7,7
120,2,work,7,14,7
120,3,shop,14,16,2
120,4,work,16,20,4
120,5,home,20,24,4
121,1,home,0,8,8
121,2,work,8,15,7
121,3,shop,15,16,1
121,4,work,16,19,3
121,5,home,19,24,5
122,1,home,0,8,8
122,2,work,8,17,9
122,3,home,17,21,4
122,4,work,21,22,1
122,5,home,22,24,2
123,1,home,0,8,8
123,2,work,8,14,6
123,3,shop,14,15,1
123,4,home,15,23,8
123,5,work,23,24,1
124,1,home,0,6,6
124,2,work,6,8,2
124,3,home,8,13,5
124,4,work,13,16,3
124,5,home,16,23,7
124,6,work,23,24,1
125,1,home,0,6,6
125,2,work,6,13,7
125,3,shop,13,14,1
125,4,education,14,17,3
125,5,home,17,24,7
126,1,home,0,7,7
126,2,work,7,14,7
126,3,shop,14,16,2
126,4,home,16,24,8
127,1,home,0,7,7
127,2,work,7,14,7
127,3,shop,14,15,1
127,4,work,15,20,5
127,5,home,20,24,4
128,1,home,0,7,7
128,2,work,7,13,6
128,3,home,13,21,8
128,4,work,21,22,1
128,5,home,22,24,2
129,1,home,0,8,8
129,2,work,8,15,7
129,3,shop,15,16,1
129,4,work,16,20,4
129,5,home,20,24,4
130,1,home,0,8,8
130,2,work,8,15,7
130,3,home,15,24,9
131,1,home,0,6,6
131,2,work,6,13,7
131,3,home,13,16,3
131,4,work,16,20,4
131,5,home,20,24,4
132,1,home,0,7,7
132,2,education,7,10,3
132,3,home,10,13,3
132,4,education,13,15,2
132,5,shop,15,17,2
132,6,home,17,24,7
133,1,home,0,7,7
133,2,work,7,13,6
133,3,home,13,24,11
134,1,home,0,7,7
134,2,work,7,13,6
134,3,shop,13,14,1
134,4,work,14,20,6
134,5,home,20,24,4
135,1,home,0,6,6
135,2,work,6,8,2
135,3,home,8,15,7
135,4,work,15,17,2
135,5,home,17,23,6
135,6,work,23,24,1
136,1,home,0,8,8
136,2,work,8,15,7
136,3,shop,15,16,1
136,4,work,16,19,3
136,5,home,19,24,5
137,1,home,0,7,7
137,2,work,7,14,7
137,3,shop,14,15,1
137,4,home,15,24,9
138,1,home,0,8,8
138,2,work,8,14,6
138,3,shop,14,15,1
138,4,home,15,24,9
139,1,home,0,8,8
139,2,work,8,17,9
139,3,home,17,24,7
140,1,home,0,7,7
140,2,education,7,11,4
140,3,home,11,18,7
140,4,shop,18,19,1
140,5,home,19,24,5
141,1,home,0,6,6
141,2,work,6,13,7
141,3,home,13,17,4
141,4,work,17,19,2
141,5,home,19,24,5
142,1,home,0,6,6
142,2,work,6,13,7
142,3,home,13,17,4
142,4,work,17,20,3
142,5,home,20,24,4
143,1,home,0,8,8
143,2,education,8,11,3
143,3,home,11,17,6
143,4,shop,17,19,2
143,5,home,19,24,5
144,1,home,0,8,8
144,2,work,8,14,6
144,3,shop,14,15,1
144,4,work,15,20,5
144,5,home,20,24,4
145,1,home,0,7,7
145,2,work,7,14,7
145,3,home,14,24,10
146,1,home,0,6,6
146,2,work,6,8,2
146,3,home,8,12,4
146,4,work,12,14,2
146,5,home,14,21,7
146,6,work,21,22,1
146,7,home,22,24,2
147,1,home,0,7,7
147,2,work,7,13,6
147,3,home,13,18,5
147,4,work,18,20,2
147,5,home,20,24,4
148,1,home,0,8,8
148,2,work,8,15,7
148,3,shop,15,16,1
148,4,work,16,20,4
148,5,home,20,24,4
149,1,home,0,7,7
149,2,education,7,10,3
149,3,home,10,20,10
149,4,shop,20,21,1
149,5,home,21,24,3
150,1,home,0,7,7
150,2,shop,7,8,1
150,3,education,8,11,3
150,4,home,11,18,7
150,5,shop,18,20,2
150,6,home,20,24,4
151,1,home,0,6,6
151,2,shop,6,7,1
151,3,home,7,9,2
151,4,education,9,12,3
151,5,home,12,18,6
151,6,shop,18,20,2
151,7,home,20,24,4
152,1,home,0,6,6
152,2,work,6,13,7
152,3,shop,13,14,1
152,4,work,14,20,6
152,5,home,20,24,4
153,1,home,0,9,9
153,2,work,9,16,7
153,3,shop,16,17,1
153,4,home,17,24,7
154,1,home,0,6,6
154,2,shop,6,7,1
154,3,home,7,10,3
154,4,education,10,11,1
154,5,home,11,18,7
154,6,shop,18,20,2
154,7,home,20,24,4
155,1,home,0,8,8
155,2,work,8,15,7
155,3,home,15,24,9
156,1,home,0,6,6
156,2,work,6,13,7
156,3,shop,13,14,1
156,4,home,14,24,10
157,1,home,0,7,7
157,2,work,7,10,3
157,3,home,10,16,6
157,4,work,16,18,2
157,5,home,18,24,6
158,1,home,0,7,7
158,2,work,7,14,7
158,3,home,14,18,4
158,4,work,18,20,2
158,5,home,20,24,4
159,1,home,0,7,7
159,2,work,7,13,6
159,3,shop,13,14,1
159,4,work,14,20,6
159,5,home,20,24,4
160,1,home,0,6,6
160,2,work,6,13,7
160,3,home,13,17,4
160,4,work,17,19,2
160,5,home,19,24,5
161,1,home,0,7,7
161,2,education,7,13,6
161,3,shop,13,15,2
161,4,home,15,24,9
162,1,home,0,7,7
162,2,work,7,14,7
162,3,home,14,22,8
162,4,work,22,23,1
162,5,home,23,24,1
163,1,home,0,7,7
163,2,work,7,13,6
163,3,home,13,24,11
164,1,home,0,8,8
164,2,work,8,14,6
164,3,shop,14,15,1
164,4,home,15,24,9
165,1,home,0,6,6
165,2,work,6,13,7
165,3,shop,13,14,1
165,4,home,14,24,10
166,1,home,0,7,7
166,2,work,7,14,7
166,3,home,14,22,8
166,4,work,22,23,1
166,5,home,23,24,1
167,1,home,0,6,6
167,2,work,6,13,7
167,3,shop,13,14,1
167,4,home,14,24,10
168,1,home,0,6,6
168,2,work,6,8,2
168,3,home,8,13,5
168,4,shop,13,14,1
168,5,work,14,17,3
168,6,home,17,24,7
169,1,home,0,8,8
169,2,education,8,12,4
169,3,home,12,20,8
169,4,shop,20,21,1
169,5,home,21,24,3
170,1,home,0,9,9
170,2,work,9,15,6
170,3,home,15,22,7
170,4,work,22,23,1
170,5,home,23,24,1
171,1,home,0,8,8
171,2,work,8,16,8
171,3,shop,16,17,1
171,4,home,17,24,7
172,1,home,0,8,8
172,2,education,8,12,4
172,3,home,12,18,6
172,4,shop,18,19,1
172,5,home,19,24,5
173,1,work,0,7,7
173,2,shop,7,8,1
173,3,work,8,14,6
173,4,home,14,23,9
173,5,work,23,24,1
174,1,home,0,8,8
174,2,work,8,15,7
174,3,shop,15,16,1
174,4,home,16,24,8
175,1,home,0,7,7
175,2,shop,7,9,2
175,3,home,9,13,4
175,4,education,13,16,3
175,5,shop,16,18,2
175,6,home,18,24,6
176,1,home,0,6,6
176,2,work,6,7,1
176,3,home,7,12,5
176,4,work,12,14,2
176,5,home,14,18,4
176,6,work,18,20,2
176,7,home,20,24,4
177,1,home,0,6,6
177,2,shop,6,7,1
177,3,work,7,13,6
177,4,home,13,24,11
178,1,home,0,7,7
178,2,work,7,13,6
178,3,home,13,16,3
178,4,work,16,20,4
178,5,home,20,24,4
179,1,home,0,7,7
179,2,shop,7,8,1
179,3,home,8,9,1
179,4,education,9,11,2
179,5,home,11,19,8
179,6,shop,19,20,1
179,7,home,20,24,4
180,1,home,0,6,6
180,2,work,6,13,7
180,3,shop,13,15,2
180,4,work,15,18,3
180,5,home,18,24,6
181,1,home,0,7,7
181,2,work,7,15,8
181,3,home,15,24,9
182,1,home,0,6,6
182,2,work,6,7,1
182,3,home,7,13,6
182,4,work,13,15,2
182,5,home,15,22,7
182,6,work,22,23,1
182,7,home,23,24,1
183,1,home,0,9,9
183,2,work,9,16,7
183,3,home,16,24,8
184,1,home,0,6,6
184,2,work,6,13,7
184,3,shop,13,14,1
184,4,home,14,24,10
185,1,home,0,8,8
185,2,work,8,15,7
185,3,shop,15,16,1
185,4,work,16,20,4
185,5,home,20,24,4
186,1,home,0,8,8
186,2,education,8,11,3
186,3,home,11,18,7
186,4,shop,18,19,1
186,5,home,19,24,5
187,1,home,0,7,7
187,2,work,7,13,6
187,3,home,13,17,4
187,4,work,17,20,3
187,5,home,20,24,4
188,1,home,0,8,8
188,2,education,8,12,4
188,3,work,12,19,7
188,4,home,19,24,5
189,1,home,0,7,7
189,2,work,7,13,6
189,3,home,13,21,8
189,4,shop,21,22,1
189,5,home,22,24,2
190,1,home,0,7,7
190,2,shop,7,9,2
190,3,education,9,12,3
190,4,shop,12,14,2
190,5,education,14,16,2
190,6,home,16,24,8
191,1,home,0,8,8
191,2,work,8,14,6
191,3,home,14,22,8
191,4,work,22,23,1
191,5,home,23,24,1
192,1,home,0,6,6
192,2,work,6,13,7
192,3,home,13,18,5
192,4,shop,18,19,1
192,5,home,19,24,5
193,1,home,0,7,7
193,2,work,7,14,7
193,3,shop,14,15,1
193,4,work,15,19,4
193,5,home,19,24,5
194,1,home,0,6,6
194,2,work,6,13,7
194,3,home,13,16,3
194,4,shop,16,17,1
194,5,home,17,23,6
194,6,work,23,24,1
195,1,home,0,7,7
195,2,work,7,13,6
195,3,home,13,17,4
195,4,shop,17,18,1
195,5,home,18,24,6
196,1,home,0,7,7
196,2,work,7,14,7
196,3,shop,14,15,1
196,4,home,15,24,9
197,1,home,0,6,6
197,2,shop,6,7,1
197,3,home,7,10,3
197,4,education,10,11,1
197,5,home,11,16,5
197,6,shop,16,17,1
197,7,home,17,24,7
198,1,home,0,12,12
198,2,work,12,19,7
198,3,home,19,24,5
199,1,home,0,7,7
199,2,work,7,13,6
199,3,shop,13,14,1
199,4,work,14,19,5
199,5,home,19,24,5
200,1,home,0,6,6
200,2,work,6,13,7
200,3,home,13,17,4
200,4,work,17,20,3
200,5,home,20,24,4
201,1,home,0,8,8
201,2,work,8,15,7
201,3,home,15,24,9
202,1,home,0,6,6
202,2,work,6,13,7
202,3,shop,13,14,1
202,4,work,14,19,5
202,5,home,19,24,5
203,1,home,0,7,7
203,2,education,7,11,4
203,3,home,11,17,6
203,4,shop,17,18,1
203,5,home,18,24,6
204,1,home,0,6,6
204,2,shop,6,7,1
204,3,home,7,10,3
204,4,education,10,14,4
204,5,shop,14,15,1
204,6,home,15,21,6
204,7,shop,21,22,1
204,8,home,22,24,2
205,1,home,0,7,7
205,2,work,7,13,6
205,3,shop,13,14,1
205,4,home,14,22,8
205,5,work,22,23,1
205,6,home,23,24,1
206,1,home,0,7,7
206,2,work,7,13,6
206,3,shop,13,14,1
206,4,work,14,20,6
206,5,home,20,24,4
207,1,home,0,7,7
207,2,work,7,14,7
207,3,shop,14,15,1
207,4,home,15,24,9
208,1,home,0,7,7
208,2,work,7,14,7
208,3,home,14,18,4
208,4,work,18,20,2
208,5,home,20,24,4
209,1,home,0,9,9
209,2,work,9,16,7
209,3,home,16,21,5
209,4,work,21,22,1
209,5,home,22,24,2
210,1,home,0,6,6
210,2,shop,6,7,1
210,3,home,7,8,1
210,4,education,8,11,3
210,5,home,11,17,6
210,6,work,17,20,3
210,7,home,20,24,4
211,1,home,0,6,6
211,2,shop,6,7,1
211,3,home,7,10,3
211,4,education,10,13,3
211,5,shop,13,15,2
211,6,home,15,24,9
212,1,home,0,6,6
212,2,shop,6,7,1
212,3,home,7,13,6
212,4,education,13,16,3
212,5,shop,16,18,2
212,6,home,18,24,6
213,1,home,0,8,8
213,2,work,8,14,6
213,3,home,14,24,10
214,1,home,0,6,6
214,2,work,6,13,7
214,3,shop,13,14,1
214,4,work,14,19,5
214,5,home,19,24,5
215,1,home,0,8,8
215,2,work,8,10,2
215,3,home,10,16,6
215,4,work,16,18,2
215,5,home,18,24,6
216,1,home,0,8,8
216,2,work,8,15,7
216,3,home,15,24,9
217,1,home,0,9,9
217,2,education,9,11,2
217,3,home,11,15,4
217,4,work,15,20,5
217,5,home,20,24,4
218,1,home,0,6,6
218,2,work,6,13,7
218,3,home,13,24,11
219,1,home,0,6,6
219,2,work,6,13,7
219,3,home,13,22,9
219,4,work,22,23,1
219,5,home,23,24,1
220,1,home,0,9,9
220,2,work,9,15,6
220,3,home,15,24,9
221,1,home,0,6,6
221,2,work,6,8,2
221,3,home,8,12,4
221,4,shop,12,13,1
221,5,work,13,15,2
221,6,home,15,22,7
221,7,work,22,23,1
221,8,home,23,24,1
222,1,home,0,6,6
222,2,work,6,13,7
222,3,home,13,16,3
222,4,work,16,20,4
222,5,home,20,24,4
223,1,home,0,6,6
223,2,work,6,13,7
223,3,home,13,24,11
224,1,home,0,7,7
224,2,work,7,13,6
224,3,shop,13,14,1
224,4,home,14,24,10
225,1,home,0,9,9
225,2,work,9,15,6
225,3,home,15,24,9
226,1,home,0,7,7
226,2,shop,7,8,1
226,3,home,8,15,7
226,4,work,15,19,4
226,5,education,19,20,1
226,6,home,20,24,4
227,1,home,0,6,6
227,2,work,6,13,7
227,3,shop,13,14,1
227,4,home,14,21,7
227,5,work,21,22,1
227,6,home,22,24,2
228,1,home,0,7,7
228,2,work,7,14,7
228,3,home,14,24,10
229,1,home,0,8,8
229,2,work,8,14,6
229,3,home,14,15,1
229,4,work,15,20,5
229,5,home,20,24,4
230,1,home,0,6,6
230,2,shop,6,7,1
230,3,home,7,11,4
230,4,work,11,18,7
230,5,home,18,24,6
231,1,home,0,8,8
231,2,work,8,15,7
231,3,home,15,22,7
231,4,work,22,23,1
231,5,home,23,24,1
232,1,home,0,8,8
232,2,work,8,14,6
232,3,home,14,18,4
232,4,work,18,20,2
232,5,home,20,24,4
233,1,home,0,6,6
233,2,shop,6,7,1
233,3,home,7,9,2
233,4,education,9,12,3
233,5,shop,12,14,2
233,6,education,14,16,2
233,7,shop,16,17,1
233,8,home,17,24,7
234,1,home,0,6,6
234,2,work,6,13,7
234,3,shop,13,14,1
234,4,work,14,19,5
234,5,home,19,24,5
235,1,home,0,7,7
235,2,work,7,13,6
235,3,shop,13,14,1
235,4,work,14,19,5
235,5,home,19,24,5
236,1,home,0,7,7
236,2,work,7,9,2
236,3,home,9,13,4
236,4,work,13,16,3
236,5,home,16,21,5
236,6,work,21,22,1
236,7,home,22,24,2
237,1,home,0,8,8
237,2,work,8,15,7
237,3,home,15,22,7
237,4,work,22,23,1
237,5,home,23,24,1
238,1,home,0,7,7
238,2,work,7,14,7
238,3,home,14,18,4
238,4,shop,18,19,1
238,5,home,19,24,5
239,1,home,0,7,7
239,2,education,7,13,6
239,3,shop,13,15,2
239,4,home,15,24,9
240,1,home,0,7,7
240,2,work,7,14,7
240,3,home,14,19,5
240,4,shop,19,20,1
240,5,home,20,24,4
241,1,home,0,7,7
241,2,shop,7,8,1
241,3,home,8,12,4
241,4,work,12,19,7
241,5,home,19,23,4
241,6,work,23,24,1
242,1,home,0,8,8
242,2,work,8,14,6
242,3,home,14,24,10
243,1,home,0,7,7
243,2,work,7,8,1
243,3,home,8,9,1
243,4,work,9,11,2
243,5,home,11,16,5
243,6,work,16,18,2
243,7,home,18,24,6
244,1,home,0,8,8
244,2,education,8,13,5
244,3,work,13,19,6
244,4,home,19,24,5
245,1,home,0,8,8
245,2,work,8,13,5
245,3,home,13,17,4
245,4,work,17,20,3
245,5,home,20,24,4
246,1,home,0,6,6
246,2,shop,6,7,1
246,3,work,7,13,6
246,4,home,13,24,11
247,1,home,0,7,7
247,2,work,7,13,6
247,3,shop,13,14,1
247,4,home,14,24,10
248,1,home,0,6,6
248,2,work,6,13,7
248,3,home,13,24,11
249,1,home,0,6,6
249,2,work,6,13,7
249,3,home,13,17,4
249,4,work,17,19,2
249,5,home,19,24,5
250,1,home,0,7,7
250,2,work,7,14,7
250,3,home,14,15,1
250,4,shop,15,16,1
250,5,work,16,20,4
250,6,home,20,24,4
251,1,home,0,9,9
251,2,shop,9,10,1
251,3,home,10,15,5
251,4,work,15,20,5
251,5,home,20,24,4
252,1,home,0,6,6
252,2,work,6,8,2
252,3,home,8,13,5
252,4,work,13,15,2
252,5,home,15,21,6
252,6,work,21,22,1
252,7,home,22,24,2
253,1,home,0,7,7
253,2,work,7,13,6
253,3,shop,13,14,1
253,4,work,14,15,1
253,5,home,15,24,9
254,1,home,0,7,7
254,2,work,7,14,7
254,3,shop,14,15,1
254,4,work,15,20,5
254,5,home,20,24,4
255,1,home,0,6,6
255,2,work,6,13,7
255,3,shop,13,14,1
255,4,home,14,24,10
256,1,home,0,6,6
256,2,work,6,12,6
256,3,shop,12,13,1
256,4,work,13,19,6
256,5,home,19,24,5
257,1,home,0,7,7
257,2,shop,7,8,1
257,3,education,8,11,3
257,4,home,11,18,7
257,5,shop,18,20,2
257,6,home,20,24,4
258,1,home,0,7,7
258,2,shop,7,8,1
258,3,home,8,9,1
258,4,work,9,16,7
258,5,home,16,23,7
258,6,work,23,24,1
259,1,home,0,7,7
259,2,work,7,13,6
259,3,home,13,22,9
259,4,work,22,23,1
259,5,home,23,24,1
260,1,home,0,8,8
260,2,work,8,15,7
260,3,shop,15,16,1
260,4,home,16,24,8
261,1,home,0,7,7
261,2,work,7,14,7
261,3,home,14,24,10
262,1,home,0,7,7
262,2,education,7,12,5
262,3,shop,12,14,2
262,4,education,14,16,2
262,5,home,16,24,8
263,1,home,0,7,7
263,2,work,7,13,6
263,3,home,13,17,4
263,4,work,17,20,3
263,5,home,20,24,4
264,1,home,0,8,8
264,2,education,8,12,4
264,3,home,12,19,7
264,4,shop,19,20,1
264,5,home,20,24,4
265,1,home,0,7,7
265,2,education,7,11,4
265,3,home,11,20,9
265,4,shop,20,21,1
265,5,home,21,24,3
266,1,home,0,6,6
266,2,work,6,13,7
266,3,home,13,19,6
266,4,shop,19,20,1
266,5,home,20,24,4
267,1,home,0,7,7
267,2,education,7,12,5
267,3,shop,12,14,2
267,4,home,14,24,10
268,1,home,0,7,7
268,2,work,7,13,6
268,3,home,13,17,4
268,4,work,17,20,3
268,5,home,20,24,4
269,1,home,0,7,7
269,2,work,7,13,6
269,3,shop,13,14,1
269,4,home,14,18,4
269,5,work,18,20,2
269,6,home,20,24,4
270,1,home,0,8,8
270,2,work,8,14,6
270,3,home,14,21,7
270,4,work,21,22,1
270,5,home,22,24,2
271,1,home,0,6,6
271,2,shop,6,7,1
271,3,home,7,10,3
271,4,education,10,11,1
271,5,home,11,18,7
271,6,shop,18,19,1
271,7,home,19,24,5
272,1,home,0,6,6
272,2,work,6,13,7
272,3,shop,13,14,1
272,4,work,14,20,6
272,5,home,20,24,4
273,1,home,0,6,6
273,2,shop,6,7,1
273,3,work,7,13,6
273,4,home,13,17,4
273,5,work,17,20,3
273,6,home,20,24,4
274,1,home,0,7,7
274,2,shop,7,8,1
274,3,home,8,9,1
274,4,education,9,11,2
274,5,home,11,17,6
274,6,shop,17,18,1
274,7,home,18,24,6
275,1,home,0,7,7
275,2,work,7,14,7
275,3,home,14,22,8
275,4,work,22,23,1
275,5,home,23,24,1
276,1,home,0,8,8
276,2,shop,8,9,1
276,3,home,9,18,9
276,4,work,18,20,2
276,5,home,20,24,4
277,1,home,0,7,7
277,2,work,7,13,6
277,3,shop,13,14,1
277,4,work,14,20,6
277,5,home,20,24,4
278,1,home,0,6,6
278,2,shop,6,7,1
278,3,home,7,9,2
278,4,education,9,13,4
278,5,shop,13,15,2
278,6,home,15,21,6
278,7,shop,21,22,1
278,8,home,22,24,2
279,1,home,0,6,6
279,2,work,6,13,7
279,3,home,13,18,5
279,4,work,18,20,2
279,5,home,20,24,4
280,1,home,0,6,6
280,2,shop,6,7,1
280,3,home,7,9,2
280,4,education,9,12,3
280,5,shop,12,14,2
280,6,home,14,20,6
280,7,shop,20,21,1
280,8,home,21,24,3
281,1,home,0,6,6
281,2,shop,6,7,1
281,3,home,7,11,4
281,4,work,11,17,6
281,5,home,17,23,6
281,6,work,23,24,1
282,1,home,0,6,6
282,2,shop,6,7,1
282,3,home,7,12,5
282,4,education,12,15,3
282,5,shop,15,16,1
282,6,home,16,24,8
283,1,home,0,6,6
283,2,work,6,13,7
283,3,home,13,24,11
284,1,home,0,9,9
284,2,work,9,15,6
284,3,shop,15,16,1
284,4,work,16,20,4
284,5,home,20,24,4
285,1,home,0,7,7
285,2,shop,7,8,1
285,3,work,8,15,7
285,4,home,15,23,8
285,5,work,23,24,1
286,1,home,0,6,6
286,2,work,6,13,7
286,3,home,13,16,3
286,4,work,16,20,4
286,5,home,20,24,4
287,1,home,0,6,6
287,2,shop,6,7,1
287,3,home,7,13,6
287,4,work,13,20,7
287,5,home,20,24,4
288,1,home,0,8,8
288,2,work,8,15,7
288,3,home,15,23,8
288,4,work,23,24,1
289,1,home,0,8,8
289,2,work,8,15,7
289,3,shop,15,16,1
289,4,work,16,20,4
289,5,home,20,24,4
290,1,home,0,8,8
290,2,work,8,15,7
290,3,home,15,19,4
290,4,shop,19,20,1
290,5,home,20,24,4
291,1,home,0,8,8
291,2,work,8,14,6
291,3,home,14,24,10
292,1,home,0,7,7
292,2,work,7,13,6
292,3,home,13,18,5
292,4,work,18,20,2
292,5,home,20,24,4
293,1,home,0,8,8
293,2,work,8,15,7
293,3,home,15,24,9
294,1,home,0,7,7
294,2,work,7,13,6
294,3,shop,13,14,1
294,4,home,14,24,10
295,1,home,0,7,7
295,2,shop,7,8,1
295,3,work,8,15,7
295,4,shop,15,16,1
295,5,work,16,20,4
295,6,home,20,24,4
296,1,home,0,6,6
296,2,work,6,13,7
296,3,home,13,14,1
296,4,work,14,20,6
296,5,home,20,24,4
297,1,home,0,8,8
297,2,work,8,14,6
297,3,home,14,24,10
298,1,home,0,6,6
298,2,shop,6,7,1
298,3,home,7,10,3
298,4,education,10,13,3
298,5,shop,13,14,1
298,6,education,14,16,2
298,7,shop,16,17,1
298,8,home,17,24,7
299,1,home,0,8,8
299,2,work,8,15,7
299,3,home,15,24,9
300,1,home,0,7,7
300,2,shop,7,8,1
300,3,work,8,15,7
300,4,shop,15,16,1
300,5,home,16,24,8
301,1,home,0,7,7
301,2,education,7,11,4
301,3,home,11,18,7
301,4,shop,18,19,1
301,5,home,19,24,5
302,1,home,0,8,8
302,2,work,8,15,7
302,3,shop,15,16,1
302,4,work,16,20,4
302,5,home,20,24,4
303,1,home,0,7,7
303,2,shop,7,8,1
303,3,education,8,11,3
303,4,home,11,13,2
303,5,education,13,16,3
303,6,home,16,24,8
304,1,home,0,8,8
304,2,education,8,12,4
304,3,work,12,18,6
304,4,home,18,24,6
305,1,home,0,6,6
305,2,work,6,7,1
305,3,home,7,11,4
305,4,work,11,13,2
305,5,home,13,18,5
305,6,work,18,20,2
305,7,home,20,24,4
306,1,home,0,6,6
306,2,work,6,8,2
306,3,home,8,9,1
306,4,work,9,10,1
306,5,home,10,16,6
306,6,work,16,17,1
306,7,home,17,23,6
306,8,work,23,24,1
307,1,home,0,8,8
307,2,work,8,14,6
307,3,shop,14,15,1
307,4,home,15,24,9
308,1,home,0,7,7
308,2,education,7,11,4
308,3,home,11,19,8
308,4,shop,19,21,2
308,5,home,21,24,3
309,1,home,0,6,6
309,2,work,6,8,2
309,3,home,8,14,6
309,4,work,14,17,3
309,5,home,17,24,7
310,1,home,0,7,7
310,2,shop,7,9,2
310,3,education,9,15,6
310,4,shop,15,16,1
310,5,home,16,24,8
311,1,home,0,7,7
311,2,shop,7,9,2
311,3,education,9,12,3
311,4,home,12,19,7
311,5,shop,19,20,1
311,6,home,20,24,4
312,1,home,0,8,8
312,2,work,8,15,7
312,3,home,15,24,9
313,1,home,0,6,6
313,2,work,6,7,1
313,3,home,7,10,3
313,4,work,10,12,2
313,5,home,12,16,4
313,6,work,16,18,2
313,7,home,18,24,6
314,1,home,0,6,6
314,2,work,6,13,7
314,3,shop,13,14,1
314,4,work,14,20,6
314,5,home,20,24,4
315,1,home,0,6,6
315,2,work,6,13,7
315,3,home,13,17,4
315,4,work,17,19,2
315,5,home,19,24,5
316,1,home,0,7,7
316,2,work,7,14,7
316,3,home,14,18,4
316,4,work,18,20,2
316,5,home,20,24,4
317,1,home,0,6,6
317,2,shop,6,7,1
317,3,work,7,13,6
317,4,home,13,24,11
318,1,home,0,6,6
318,2,work,6,13,7
318,3,home,13,17,4
318,4,work,17,20,3
318,5,home,20,24,4
319,1,home,0,8,8
319,2,work,8,15,7
319,3,home,15,24,9
320,1,home,0,6,6
320,2,work,6,13,7
320,3,home,13,24,11
321,1,home,0,9,9
321,2,work,9,16,7
321,3,home,16,24,8
322,1,home,0,7,7
322,2,work,7,14,7
322,3,home,14,22,8
322,4,work,22,23,1
322,5,home,23,24,1
323,1,home,0,7,7
323,2,work,7,13,6
323,3,shop,13,14,1
323,4,home,14,24,10
324,1,home,0,7,7
324,2,education,7,11,4
324,3,home,11,17,6
324,4,shop,17,18,1
324,5,home,18,24,6
325,1,home,0,8,8
325,2,work,8,13,5
325,3,shop,13,14,1
325,4,work,14,20,6
325,5,home,20,24,4
326,1,home,0,7,7
326,2,work,7,13,6
326,3,home,13,17,4
326,4,work,17,20,3
326,5,home,20,24,4
327,1,home,0,8,8
327,2,work,8,15,7
327,3,home,15,23,8
327,4,work,23,24,1
328,1,home,0,7,7
328,2,work,7,13,6
328,3,home,13,17,4
328,4,shop,17,18,1
328,5,home,18,23,5
328,6,work,23,24,1
329,1,home,0,7,7
329,2,work,7,13,6
329,3,shop,13,14,1
329,4,home,14,24,10
330,1,home,0,6,6
330,2,work,6,7,1
330,3,home,7,11,4
330,4,work,11,12,1
330,5,home,12,17,5
330,6,work,17,18,1
330,7,home,18,22,4
330,8,work,22,23,1
330,9,home,23,24,1
331,1,home,0,7,7
331,2,education,7,12,5
331,3,shop,12,13,1
331,4,education,13,16,3
331,5,home,16,20,4
331,6,shop,20,21,1
331,7,home,21,24,3
332,1,home,0,9,9
332,2,work,9,15,6
332,3,shop,15,16,1
332,4,work,16,20,4
332,5,home,20,24,4
333,1,home,0,6,6
333,2,shop,6,7,1
333,3,home,7,13,6
333,4,education,13,16,3
333,5,home,16,24,8
334,1,home,0,6,6
334,2,work,6,12,6
334,3,shop,12,13,1
334,4,work,13,19,6
334,5,home,19,24,5
335,1,home,0,6,6
335,2,work,6,13,7
335,3,home,13,19,6
335,4,shop,19,20,1
335,5,home,20,24,4
336,1,home,0,7,7
336,2,education,7,10,3
336,3,home,10,13,3
336,4,education,13,17,4
336,5,home,17,24,7
337,1,home,0,7,7
337,2,shop,7,8,1
337,3,education,8,11,3
337,4,home,11,18,7
337,5,shop,18,20,2
337,6,home,20,24,4
338,1,home,0,6,6
338,2,shop,6,7,1
338,3,home,7,9,2
338,4,education,9,11,2
338,5,home,11,17,6
338,6,shop,17,19,2
338,7,home,19,24,5
339,1,home,0,6,6
339,2,work,6,13,7
339,3,shop,13,14,1
339,4,home,14,24,10
340,1,home,0,8,8
340,2,work,8,16,8
340,3,home,16,21,5
340,4,work,21,22,1
340,5,home,22,24,2
341,1,home,0,6,6
341,2,work,6,13,7
341,3,home,13,21,8
341,4,work,21,22,1
341,5,home,22,24,2
342,1,home,0,6,6
342,2,work,6,8,2
342,3,home,8,15,7
342,4,work,15,18,3
342,5,home,18,24,6
343,1,home,0,6,6
343,2,shop,6,7,1
343,3,home,7,9,2
343,4,education,9,12,3
343,5,shop,12,14,2
343,6,education,14,16,2
343,7,home,16,24,8
344,1,home,0,7,7
344,2,work,7,13,6
344,3,shop,13,14,1
344,4,home,14,24,10
345,1,home,0,7,7
345,2,work,7,14,7
345,3,shop,14,16,2
345,4,work,16,20,4
345,5,home,20,24,4
346,1,home,0,7,7
346,2,work,7,14,7
346,3,home,14,24,10
347,1,home,0,7,7
347,2,work,7,14,7
347,3,shop,14,15,1
347,4,work,15,20,5
347,5,home,20,24,4
348,1,home,0,8,8
348,2,work,8,15,7
348,3,home,15,23,8
348,4,work,23,24,1
349,1,home,0,8,8
349,2,education,8,11,3
349,3,home,11,14,3
349,4,education,14,16,2
349,5,home,16,24,8
350,1,home,0,7,7
350,2,work,7,14,7
350,3,shop,14,15,1
350,4,home,15,24,9
351,1,home,0,7,7
351,2,education,7,12,5
351,3,home,12,19,7
351,4,shop,19,20,1
351,5,home,20,24,4
352,1,home,0,7,7
352,2,work,7,9,2
352,3,home,9,15,6
352,4,work,15,17,2
352,5,home,17,23,6
352,6,work,23,24,1
353,1,home,0,6,6
353,2,shop,6,7,1
353,3,home,7,10,3
353,4,education,10,13,3
353,5,shop,13,14,1
353,6,education,14,15,1
353,7,shop,15,16,1
353,8,home,16,24,8
354,1,home,0,7,7
354,2,shop,7,8,1
354,3,education,8,11,3
354,4,home,11,18,7
354,5,shop,18,19,1
354,6,home,19,24,5
355,1,home,0,7,7
355,2,shop,7,8,1
355,3,work,8,15,7
355,4,home,15,24,9
356,1,home,0,7,7
356,2,education,7,12,5
356,3,home,12,19,7
356,4,shop,19,20,1
356,5,home,20,24,4
357,1,home,0,6,6
357,2,work,6,12,6
357,3,shop,12,13,1
357,4,work,13,20,7
357,5,home,20,24,4
358,1,home,0,8,8
358,2,work,8,13,5
358,3,home,13,24,11
359,1,home,0,9,9
359,2,work,9,15,6
359,3,home,15,24,9
360,1,home,0,7,7
360,2,work,7,14,7
360,3,home,14,24,10
361,1,home,0,6,6
361,2,work,6,13,7
361,3,shop,13,14,1
361,4,work,14,20,6
361,5,home,20,24,4
362,1,home,0,6,6
362,2,work,6,13,7
362,3,shop,13,14,1
362,4,home,14,24,10
363,1,home,0,7,7
363,2,work,7,13,6
363,3,home,13,24,11
364,1,home,0,6,6
364,2,work,6,13,7
364,3,home,13,24,11
365,1,home,0,6,6
365,2,work,6,13,7
365,3,home,13,24,11
366,1,home,0,7,7
366,2,work,7,13,6
366,3,home,13,19,6
366,4,shop,19,20,1
366,5,home,20,24,4
367,1,home,0,7,7
367,2,work,7,14,7
367,3,home,14,24,10
368,1,home,0,7,7
368,2,work,7,13,6
368,3,shop,13,14,1
368,4,work,14,19,5
368,5,home,19,24,5
369,1,home,0,8,8
369,2,education,8,12,4
369,3,home,12,20,8
369,4,shop,20,21,1
369,5,home,21,24,3
370,1,home,0,6,6
370,2,shop,6,7,1
370,3,home,7,10,3
370,4,education,10,15,5
370,5,shop,15,17,2
370,6,home,17,24,7
371,1,home,0,7,7
371,2,work,7,8,1
371,3,home,8,12,4
371,4,work,12,14,2
371,5,home,14,19,5
371,6,shop,19,20,1
371,7,home,20,24,4
372,1,home,0,6,6
372,2,shop,6,7,1
372,3,work,7,8,1
372,4,home,8,10,2
372,5,work,10,12,2
372,6,home,12,22,10
372,7,work,22,23,1
372,8,home,23,24,1
373,1,home,0,6,6
373,2,work,6,13,7
373,3,home,13,14,1
373,4,shop,14,15,1
373,5,home,15,24,9
374,1,home,0,6,6
374,2,work,6,13,7
374,3,shop,13,14,1
374,4,home,14,15,1
374,5,work,15,20,5
374,6,home,20,24,4
375,1,home,0,7,7
375,2,work,7,14,7
375,3,shop,14,15,1
375,4,home,15,23,8
375,5,work,23,24,1
376,1,home,0,7,7
376,2,work,7,13,6
376,3,home,13,17,4
376,4,work,17,19,2
376,5,home,19,24,5
377,1,home,0,7,7
377,2,work,7,13,6
377,3,shop,13,14,1
377,4,home,14,24,10
378,1,home,0,6,6
378,2,work,6,8,2
378,3,home,8,9,1
378,4,work,9,11,2
378,5,home,11,17,6
378,6,work,17,19,2
378,7,home,19,23,4
378,8,work,23,24,1
379,1,home,0,6,6
379,2,work,6,13,7
379,3,home,13,24,11
380,1,home,0,6,6
380,2,work,6,13,7
380,3,home,13,22,9
380,4,work,22,23,1
380,5,home,23,24,1
381,1,home,0,9,9
381,2,work,9,16,7
381,3,home,16,21,5
381,4,work,21,22,1
381,5,home,22,24,2
382,1,home,0,6,6
382,2,work,6,13,7
382,3,shop,13,14,1
382,4,home,14,24,10
383,1,home,0,7,7
383,2,shop,7,8,1
383,3,education,8,11,3
383,4,home,11,17,6
383,5,shop,17,18,1
383,6,home,18,24,6
384,1,home,0,9,9
384,2,work,9,17,8
384,3,home,17,21,4
384,4,shop,21,22,1
384,5,home,22,24,2
385,1,home,0,7,7
385,2,work,7,13,6
385,3,home,13,24,11
386,1,home,0,7,7
386,2,work,7,14,7
386,3,home,14,24,10
387,1,home,0,8,8
387,2,work,8,15,7
387,3,shop,15,16,1
387,4,work,16,19,3
387,5,home,19,24,5
388,1,home,0,6,6
388,2,shop,6,7,1
388,3,home,7,13,6
388,4,education,13,16,3
388,5,home,16,24,8
389,1,home,0,7,7
389,2,work,7,13,6
389,3,home,13,16,3
389,4,work,16,20,4
389,5,home,20,24,4
390,1,home,0,6,6
390,2,shop,6,7,1
390,3,home,7,9,2
390,4,education,9,14,5
390,5,shop,14,15,1
390,6,home,15,21,6
390,7,shop,21,22,1
390,8,home,22,24,2
391,1,home,0,7,7
391,2,shop,7,8,1
391,3,work,8,15,7
391,4,home,15,22,7
391,5,work,22,23,1
391,6,home,23,24,1
392,1,home,0,6,6
392,2,shop,6,7,1
392,3,home,7,10,3
392,4,education,10,16,6
392,5,home,16,24,8
393,1,home,0,6,6
393,2,work,6,13,7
393,3,home,13,17,4
393,4,work,17,20,3
393,5,home,20,24,4
394,1,work,0,11,11
394,2,shop,11,12,1
394,3,education,12,15,3
394,4,work,15,20,5
394,5,home,20,24,4
395,1,home,0,6,6
395,2,work,6,13,7
395,3,shop,13,14,1
395,4,work,14,19,5
395,5,home,19,24,5
396,1,home,0,8,8
396,2,work,8,13,5
396,3,home,13,15,2
396,4,work,15,19,4
396,5,education,19,20,1
396,6,home,20,24,4
397,1,home,0,6,6
397,2,shop,6,7,1
397,3,home,7,13,6
397,4,education,13,16,3
397,5,home,16,20,4
397,6,shop,20,21,1
397,7,home,21,24,3
398,1,home,0,7,7
398,2,work,7,13,6
398,3,shop,13,14,1
398,4,education,14,17,3
398,5,shop,17,18,1
398,6,home,18,23,5
398,7,work,23,24,1
399,1,home,0,6,6
399,2,shop,6,7,1
399,3,home,7,13,6
399,4,education,13,16,3
399,5,shop,16,18,2
399,6,home,18,24,6
400,1,home,0,6,6
400,2,work,6,13,7
400,3,shop,13,14,1
400,4,work,14,19,5
400,5,home,19,24,5
401,1,work,0,7,7
401,2,shop,7,8,1
401,3,work,8,13,5
401,4,home,13,24,11
402,1,home,0,8,8
402,2,work,8,15,7
402,3,home,15,24,9
403,1,home,0,8,8
403,2,work,8,15,7
403,3,home,15,24,9
404,1,home,0,7,7
404,2,shop,7,8,1
404,3,work,8,14,6
404,4,shop,14,15,1
404,5,work,15,20,5
404,6,home,20,24,4
405,1,home,0,6,6
405,2,work,6,13,7
405,3,home,13,23,10
405,4,work,23,24,1
406,1,home,0,6,6
406,2,work,6,8,2
406,3,home,8,9,1
406,4,work,9,11,2
406,5,home,11,16,5
406,6,work,16,18,2
406,7,home,18,24,6
407,1,home,0,8,8
407,2,work,8,15,7
407,3,home,15,24,9
408,1,home,0,8,8
408,2,work,8,14,6
408,3,home,14,18,4
408,4,work,18,20,2
408,5,home,20,24,4
409,1,home,0,8,8
409,2,education,8,12,4
409,3,shop,12,14,2
409,4,home,14,19,5
409,5,shop,19,20,1
409,6,home,20,24,4
410,1,home,0,6,6
410,2,work,6,12,6
410,3,shop,12,13,1
410,4,work,13,18,5
410,5,education,18,20,2
410,6,home,20,24,4
411,1,home,0,6,6
411,2,work,6,13,7
411,3,shop,13,14,1
411,4,work,14,19,5
411,5,home,19,24,5
412,1,home,0,7,7
412,2,work,7,14,7
412,3,shop,14,15,1
412,4,work,15,19,4
412,5,home,19,24,5
413,1,home,0,8,8
413,2,work,8,16,8
413,3,home,16,17,1
413,4,work,17,20,3
413,5,home,20,24,4
414,1,home,0,8,8
414,2,work,8,15,7
414,3,home,15,20,5
414,4,shop,20,21,1
414,5,home,21,24,3
415,1,home,0,6,6
415,2,work,6,13,7
415,3,shop,13,14,1
415,4,work,14,19,5
415,5,home,19,24,5
416,1,home,0,7,7
416,2,work,7,14,7
416,3,home,14,24,10
417,1,home,0,7,7
417,2,work,7,14,7
417,3,home,14,23,9
417,4,work,23,24,1
418,1,home,0,7,7
418,2,work,7,14,7
418,3,home,14,24,10
419,1,home,0,6,6
419,2,work,6,13,7
419,3,home,13,24,11
420,1,home,0,7,7
420,2,work,7,13,6
420,3,home,13,24,11
421,1,home,0,7,7
421,2,work,7,14,7
421,3,home,14,24,10
422,1,home,0,8,8
422,2,work,8,15,7
422,3,home,15,19,4
422,4,shop,19,20,1
422,5,home,20,24,4
423,1,home,0,7,7
423,2,work,7,13,6
423,3,shop,13,14,1
423,4,home,14,23,9
423,5,work,23,24,1
424,1,home,0,9,9
424,2,work,9,15,6
424,3,shop,15,16,1
424,4,home,16,24,8
425,1,home,0,6,6
425,2,shop,6,7,1
425,3,home,7,13,6
425,4,work,13,20,7
425,5,home,20,24,4
426,1,home,0,7,7
426,2,work,7,14,7
426,3,shop,14,15,1
426,4,home,15,22,7
426,5,work,22,23,1
426,6,home,23,24,1
427,1,home,0,7,7
427,2,shop,7,8,1
427,3,home,8,12,4
427,4,work,12,19,7
427,5,home,19,24,5
428,1,home,0,7,7
428,2,work,7,13,6
428,3,home,13,24,11
429,1,home,0,7,7
429,2,education,7,12,5
429,3,home,12,14,2
429,4,education,14,16,2
429,5,home,16,24,8
430,1,home,0,8,8
430,2,education,8,11,3
430,3,home,11,15,4
430,4,work,15,20,5
430,5,home,20,24,4
431,1,home,0,6,6
431,2,work,6,13,7
431,3,home,13,19,6
431,4,shop,19,20,1
431,5,home,20,24,4
432,1,home,0,8,8
432,2,work,8,15,7
432,3,home,15,24,9
433,1,home,0,6,6
433,2,work,6,8,2
433,3,home,8,13,5
433,4,work,13,15,2
433,5,home,15,22,7
433,6,work,22,23,1
433,7,home,23,24,1
434,1,home,0,7,7
434,2,work,7,13,6
434,3,home,13,18,5
434,4,shop,18,19,1
434,5,home,19,24,5
435,1,home,0,8,8
435,2,work,8,14,6
435,3,home,14,21,7
435,4,work,21,22,1
435,5,home,22,24,2
436,1,home,0,7,7
436,2,shop,7,8,1
436,3,home,8,12,4
436,4,work,12,19,7
436,5,home,19,24,5
437,1,home,0,8,8
437,2,work,8,15,7
437,3,home,15,24,9
438,1,home,0,8,8
438,2,work,8,15,7
438,3,home,15,24,9
439,1,home,0,6,6
439,2,work,6,13,7
439,3,home,13,17,4
439,4,work,17,20,3
439,5,home,20,24,4
440,1,home,0,7,7
440,2,education,7,11,4
440,3,home,11,19,8
440,4,shop,19,20,1
440,5,home,20,24,4
441,1,home,0,7,7
441,2,work,7,14,7
441,3,home,14,20,6
441,4,shop,20,21,1
441,5,home,21,24,3
442,1,home,0,9,9
442,2,work,9,15,6
442,3,shop,15,16,1
442,4,home,16,21,5
442,5,work,21,22,1
442,6,home,22,24,2
443,1,home,0,6,6
443,2,work,6,13,7
443,3,home,13,22,9
443,4,work,22,23,1
443,5,home,23,24,1
444,1,home,0,6,6
444,2,shop,6,7,1
444,3,home,7,12,5
444,4,education,12,15,3
444,5,work,15,20,5
444,6,home,20,24,4
445,1,home,0,6,6
445,2,work,6,13,7
445,3,home,13,18,5
445,4,shop,18,19,1
445,5,home,19,24,5
446,1,home,0,7,7
446,2,shop,7,8,1
446,3,home,8,12,4
446,4,work,12,19,7
446,5,education,19,20,1
446,6,home,20,24,4
447,1,home,0,8,8
447,2,work,8,14,6
447,3,shop,14,15,1
447,4,home,15,21,6
447,5,work,21,22,1
447,6,home,22,24,2
448,1,home,0,6,6
448,2,work,6,8,2
448,3,home,8,14,6
448,4,work,14,16,2
448,5,home,16,22,6
448,6,work,22,23,1
448,7,home,23,24,1
449,1,home,0,9,9
449,2,work,9,16,7
449,3,shop,16,17,1
449,4,work,17,20,3
449,5,home,20,24,4
450,1,home,0,7,7
450,2,work,7,14,7
450,3,home,14,24,10
451,1,home,0,7,7
451,2,work,7,14,7
451,3,home,14,24,10
452,1,home,0,6,6
452,2,work,6,8,2
452,3,home,8,12,4
452,4,work,12,14,2
452,5,home,14,21,7
452,6,work,21,22,1
452,7,home,22,24,2
453,1,home,0,6,6
453,2,shop,6,7,1
453,3,home,7,13,6
453,4,education,13,16,3
453,5,home,16,24,8
454,1,home,0,8,8
454,2,work,8,14,6
454,3,shop,14,15,1
454,4,home,15,21,6
454,5,shop,21,22,1
454,6,home,22,24,2
455,1,home,0,8,8
455,2,shop,8,9,1
455,3,work,9,16,7
455,4,home,16,24,8
456,1,home,0,6,6
456,2,work,6,13,7
456,3,shop,13,14,1
456,4,home,14,24,10
457,1,home,0,7,7
457,2,work,7,14,7
457,3,home,14,18,4
457,4,shop,18,19,1
457,5,home,19,24,5
458,1,home,0,8,8
458,2,education,8,11,3
458,3,home,11,16,5
458,4,shop,16,18,2
458,5,home,18,24,6
459,1,home,0,7,7
459,2,work,7,14,7
459,3,home,14,22,8
459,4,work,22,23,1
459,5,home,23,24,1
460,1,home,0,6,6
460,2,work,6,13,7
460,3,home,13,17,4
460,4,work,17,20,3
460,5,home,20,24,4
461,1,home,0,6,6
461,2,work,6,14,8
461,3,home,14,18,4
461,4,shop,18,19,1
461,5,home,19,24,5
462,1,home,0,9,9
462,2,work,9,16,7
462,3,home,16,21,5
462,4,shop,21,22,1
462,5,home,22,24,2
463,1,home,0,6,6
463,2,work,6,13,7
463,3,home,13,17,4
463,4,work,17,20,3
463,5,home,20,24,4
464,1,home,0,7,7
464,2,work,7,14,7
464,3,shop,14,15,1
464,4,work,15,20,5
464,5,home,20,24,4
465,1,home,0,9,9
465,2,work,9,15,6
465,3,home,15,19,4
465,4,shop,19,20,1
465,5,home,20,24,4
466,1,home,0,7,7
466,2,education,7,11,4
466,3,home,11,15,4
466,4,shop,15,17,2
466,5,home,17,24,7
467,1,home,0,7,7
467,2,work,7,13,6
467,3,shop,13,15,2
467,4,home,15,24,9
468,1,home,0,7,7
468,2,work,7,13,6
468,3,home,13,21,8
468,4,work,21,22,1
468,5,home,22,24,2
469,1,home,0,6,6
469,2,shop,6,7,1
469,3,home,7,9,2
469,4,work,9,16,7
469,5,home,16,23,7
469,6,work,23,24,1
470,1,home,0,6,6
470,2,work,6,8,2
470,3,home,8,13,5
470,4,work,13,15,2
470,5,home,15,21,6
470,6,work,21,22,1
470,7,home,22,24,2
471,1,home,0,7,7
471,2,work,7,14,7
471,3,home,14,18,4
471,4,work,18,20,2
471,5,home,20,24,4
472,1,home,0,7,7
472,2,education,7,11,4
472,3,home,11,17,6
472,4,shop,17,19,2
472,5,home,19,24,5
473,1,home,0,6,6
473,2,shop,6,7,1
473,3,home,7,8,1
473,4,work,8,15,7
473,5,home,15,21,6
473,6,work,21,22,1
473,7,home,22,24,2
474,1,home,0,7,7
474,2,work,7,13,6
474,3,shop,13,14,1
474,4,education,14,16,2
474,5,home,16,24,8
475,1,home,0,7,7
475,2,work,7,13,6
475,3,shop,13,14,1
475,4,work,14,20,6
475,5,home,20,24,4
476,1,home,0,8,8
476,2,work,8,14,6
476,3,shop,14,15,1
476,4,home,15,20,5
476,5,shop,20,21,1
476,6,home,21,24,3
477,1,home,0,8,8
477,2,education,8,12,4
477,3,work,12,19,7
477,4,home,19,24,5
478,1,home,0,6,6
478,2,work,6,8,2
478,3,home,8,12,4
478,4,education,12,14,2
478,5,home,14,21,7
478,6,work,21,22,1
478,7,home,22,24,2
479,1,home,0,8,8
479,2,work,8,14,6
479,3,shop,14,15,1
479,4,work,15,20,5
479,5,home,20,24,4
480,1,home,0,8,8
480,2,work,8,15,7
480,3,home,15,24,9
481,1,home,0,7,7
481,2,work,7,9,2
481,3,home,9,15,6
481,4,work,15,17,2
481,5,home,17,23,6
481,6,work,23,24,1
482,1,home,0,7,7
482,2,education,7,11,4
482,3,home,11,18,7
482,4,shop,18,19,1
482,5,home,19,24,5
483,1,home,0,8,8
483,2,education,8,11,3
483,3,shop,11,12,1
483,4,home,12,24,12
484,1,home,0,7,7
484,2,work,7,14,7
484,3,shop,14,15,1
484,4,work,15,20,5
484,5,home,20,24,4
485,1,home,0,7,7
485,2,shop,7,8,1
485,3,home,8,12,4
485,4,work,12,19,7
485,5,home,19,24,5
486,1,home,0,6,6
486,2,work,6,13,7
486,3,shop,13,14,1
486,4,home,14,24,10
487,1,home,0,7,7
487,2,education,7,11,4
487,3,home,11,19,8
487,4,shop,19,20,1
487,5,home,20,24,4
488,1,home,0,8,8
488,2,education,8,14,6
488,3,shop,14,15,1
488,4,home,15,19,4
488,5,shop,19,20,1
488,6,home,20,24,4
489,1,home,0,7,7
489,2,work,7,13,6
489,3,home,13,24,11
490,1,home,0,8,8
490,2,education,8,12,4
490,3,work,12,18,6
490,4,home,18,24,6
491,1,home,0,7,7
491,2,work,7,13,6
491,3,home,13,16,3
491,4,work,16,20,4
491,5,home,20,24,4
492,1,home,0,7,7
492,2,work,7,13,6
492,3,home,13,17,4
492,4,shop,17,18,1
492,5,home,18,24,6
493,1,home,0,6,6
493,2,work,6,7,1
493,3,home,7,12,5
493,4,work,12,14,2
493,5,home,14,21,7
493,6,work,21,22,1
493,7,home,22,24,2
494,1,home,0,7,7
494,2,work,7,13,6
494,3,shop,13,14,1
494,4,home,14,24,10
495,1,home,0,7,7
495,2,work,7,13,6
495,3,home,13,24,11
496,1,home,0,8,8
496,2,work,8,15,7
496,3,home,15,23,8
496,4,work,23,24,1
497,1,home,0,7,7
497,2,shop,7,9,2
497,3,education,9,12,3
497,4,home,12,20,8
497,5,shop,20,21,1
497,6,home,21,24,3
498,1,home,0,7,7
498,2,shop,7,8,1
498,3,education,8,11,3
498,4,home,11,19,8
498,5,shop,19,20,1
498,6,home,20,24,4
499,1,home,0,6,6
499,2,work,6,8,2
499,3,home,8,12,4
499,4,work,12,13,1
499,5,home,13,21,8
499,6,work,21,22,1
499,7,home,22,24,2
500,1,home,0,6,6
500,2,work,6,13,7
500,3,home,13,24,11
501,1,home,0,7,7
501,2,education,7,12,5
501,3,home,12,19,7
501,4,shop,19,20,1
501,5,home,20,24,4
502,1,home,0,7,7
502,2,shop,7,8,1
502,3,work,8,14,6
502,4,home,14,24,10
503,1,home,0,6,6
503,2,shop,6,7,1
503,3,home,7,13,6
503,4,education,13,16,3
503,5,home,16,21,5
503,6,shop,21,22,1
503,7,home,22,24,2
504,1,home,0,7,7
504,2,work,7,14,7
504,3,shop,14,15,1
504,4,home,15,23,8
504,5,work,23,24,1
505,1,home,0,7,7
505,2,work,7,13,6
505,3,home,13,16,3
505,4,work,16,19,3
505,5,home,19,24,5
506,1,home,0,7,7
506,2,education,7,13,6
506,3,shop,13,15,2
506,4,home,15,24,9
507,1,home,0,7,7
507,2,education,7,11,4
507,3,home,11,17,6
507,4,shop,17,18,1
507,5,home,18,24,6
508,1,home,0,7,7
508,2,work,7,14,7
508,3,home,14,24,10
509,1,home,0,6,6
509,2,work,6,13,7
509,3,home,13,22,9
509,4,work,22,23,1
509,5,home,23,24,1
510,1,home,0,7,7
510,2,work,7,13,6
510,3,shop,13,14,1
510,4,home,14,24,10
511,1,home,0,8,8
511,2,education,8,12,4
511,3,shop,12,14,2
511,4,home,14,18,4
511,5,shop,18,19,1
511,6,home,19,24,5
512,1,home,0,7,7
512,2,shop,7,8,1
512,3,education,8,11,3
512,4,home,11,19,8
512,5,shop,19,21,2
512,6,home,21,24,3
513,1,home,0,6,6
513,2,work,6,13,7
513,3,shop,13,14,1
513,4,home,14,22,8
513,5,work,22,23,1
513,6,home,23,24,1
514,1,home,0,6,6
514,2,work,6,13,7
514,3,home,13,18,5
514,4,work,18,20,2
514,5,home,20,24,4
515,1,home,0,7,7
515,2,work,7,13,6
515,3,home,13,16,3
515,4,work,16,20,4
515,5,home,20,24,4
516,1,home,0,6,6
516,2,shop,6,7,1
516,3,home,7,10,3
516,4,education,10,13,3
516,5,shop,13,15,2
516,6,home,15,24,9
517,1,home,0,8,8
517,2,education,8,12,4
517,3,home,12,19,7
517,4,shop,19,20,1
517,5,home,20,24,4
518,1,home,0,7,7
518,2,shop,7,8,1
518,3,education,8,11,3
518,4,home,11,18,7
518,5,shop,18,19,1
518,6,home,19,24,5
519,1,home,0,6,6
519,2,work,6,13,7
519,3,shop,13,14,1
519,4,home,14,16,2
519,5,work,16,20,4
519,6,home,20,24,4
520,1,home,0,6,6
520,2,work,6,7,1
520,3,home,7,8,1
520,4,work,8,10,2
520,5,home,10,16,6
520,6,work,16,18,2
520,7,home,18,24,6
521,1,home,0,7,7
521,2,education,7,10,3
521,3,home,10,15,5
521,4,shop,15,16,1
521,5,home,16,24,8
522,1,home,0,8,8
522,2,work,8,15,7
522,3,home,15,24,9
523,1,home,0,8,8
523,2,work,8,15,7
523,3,home,15,21,6
523,4,shop,21,22,1
523,5,home,22,24,2
524,1,home,0,7,7
524,2,work,7,13,6
524,3,home,13,20,7
524,4,shop,20,21,1
524,5,home,21,24,3
525,1,home,0,7,7
525,2,shop,7,8,1
525,3,work,8,16,8
525,4,home,16,24,8
526,1,home,0,7,7
526,2,work,7,14,7
526,3,shop,14,16,2
526,4,home,16,21,5
526,5,work,21,22,1
526,6,home,22,24,2
527,1,home,0,7,7
527,2,work,7,13,6
527,3,shop,13,14,1
527,4,work,14,19,5
527,5,home,19,24,5
528,1,home,0,7,7
528,2,shop,7,8,1
528,3,education,8,11,3
528,4,home,11,15,4
528,5,shop,15,16,1
528,6,home,16,24,8
529,1,home,0,7,7
529,2,work,7,13,6
529,3,home,13,21,8
529,4,shop,21,22,1
529,5,home,22,24,2
530,1,home,0,8,8
530,2,shop,8,9,1
530,3,education,9,12,3
530,4,home,12,18,6
530,5,shop,18,19,1
530,6,home,19,24,5
531,1,home,0,6,6
531,2,shop,6,7,1
531,3,home,7,14,7
531,4,work,14,20,6
531,5,home,20,24,4
532,1,home,0,7,7
532,2,education,7,11,4
532,3,home,11,14,3
532,4,education,14,15,1
532,5,shop,15,17,2
532,6,home,17,24,7
533,1,home,0,8,8
533,2,work,8,14,6
533,3,shop,14,15,1
533,4,home,15,24,9
534,1,home,0,8,8
534,2,education,8,11,3
534,3,home,11,16,5
534,4,shop,16,17,1
534,5,home,17,24,7
535,1,home,0,7,7
535,2,work,7,14,7
535,3,shop,14,15,1
535,4,home,15,20,5
535,5,shop,20,21,1
535,6,home,21,24,3
536,1,home,0,7,7
536,2,work,7,13,6
536,3,home,13,17,4
536,4,work,17,20,3
536,5,home,20,24,4
537,1,home,0,6,6
537,2,shop,6,7,1
537,3,work,7,13,6
537,4,home,13,21,8
537,5,work,21,22,1
537,6,home,22,24,2
538,1,home,0,6,6
538,2,work,6,13,7
538,3,home,13,24,11
539,1,home,0,7,7
539,2,education,7,11,4
539,3,home,11,16,5
539,4,shop,16,18,2
539,5,home,18,24,6
540,1,home,0,7,7
540,2,shop,7,8,1
540,3,education,8,11,3
540,4,home,11,20,9
540,5,shop,20,21,1
540,6,home,21,24,3
541,1,home,0,6,6
541,2,shop,6,7,1
541,3,home,7,13,6
541,4,education,13,16,3
541,5,shop,16,17,1
541,6,home,17,24,7
542,1,home,0,7,7
542,2,education,7,11,4
542,3,home,11,17,6
542,4,shop,17,18,1
542,5,home,18,24,6
543,1,home,0,7,7
543,2,education,7,13,6
543,3,shop,13,15,2
543,4,home,15,21,6
543,5,shop,21,22,1
543,6,home,22,24,2
544,1,home,0,6,6
544,2,work,6,13,7
544,3,home,13,24,11
545,1,home,0,7,7
545,2,work,7,14,7
545,3,home,14,24,10
546,1,home,0,7,7
546,2,education,7,11,4
546,3,home,11,19,8
546,4,shop,19,20,1
546,5,home,20,24,4
547,1,home,0,6,6
547,2,shop,6,7,1
547,3,home,7,13,6
547,4,education,13,16,3
547,5,shop,16,17,1
547,6,home,17,24,7
548,1,home,0,7,7
548,2,work,7,13,6
548,3,shop,13,14,1
548,4,work,14,20,6
548,5,home,20,24,4
549,1,home,0,6,6
549,2,work,6,8,2
549,3,home,8,9,1
549,4,work,9,11,2
549,5,home,11,16,5
549,6,work,16,18,2
549,7,home,18,24,6
550,1,home,0,6,6
550,2,shop,6,7,1
550,3,work,7,13,6
550,4,home,13,24,11
551,1,home,0,8,8
551,2,shop,8,9,1
551,3,home,9,14,5
551,4,work,14,20,6
551,5,home,20,24,4
552,1,home,0,8,8
552,2,work,8,14,6
552,3,shop,14,15,1
552,4,work,15,20,5
552,5,home,20,24,4
553,1,home,0,7,7
553,2,work,7,14,7
553,3,home,14,19,5
553,4,shop,19,20,1
553,5,home,20,24,4
554,1,home,0,7,7
554,2,education,7,9,2
554,3,home,9,14,5
554,4,education,14,16,2
554,5,home,16,24,8
555,1,home,0,7,7
555,2,work,7,13,6
555,3,home,13,24,11
556,1,home,0,6,6
556,2,shop,6,7,1
556,3,work,7,15,8
556,4,home,15,24,9
557,1,home,0,6,6
557,2,work,6,13,7
557,3,shop,13,14,1
557,4,home,14,17,3
557,5,work,17,20,3
557,6,home,20,24,4
558,1,home,0,8,8
558,2,shop,8,9,1
558,3,home,9,12,3
558,4,education,12,16,4
558,5,home,16,24,8
559,1,home,0,8,8
559,2,work,8,14,6
559,3,home,14,18,4
559,4,work,18,20,2
559,5,home,20,24,4
560,1,home,0,7,7
560,2,education,7,11,4
560,3,home,11,18,7
560,4,shop,18,19,1
560,5,home,19,24,5
561,1,home,0,8,8
561,2,work,8,13,5
561,3,home,13,24,11
562,1,home,0,9,9
562,2,work,9,15,6
562,3,shop,15,16,1
562,4,home,16,24,8
563,1,home,0,7,7
563,2,work,7,9,2
563,3,home,9,13,4
563,4,work,13,15,2
563,5,home,15,22,7
563,6,work,22,23,1
563,7,home,23,24,1
564,1,home,0,8,8
564,2,shop,8,9,1
564,3,education,9,16,7
564,4,home,16,24,8
565,1,home,0,7,7
565,2,work,7,13,6
565,3,home,13,18,5
565,4,work,18,20,2
565,5,home,20,24,4
566,1,home,0,7,7
566,2,work,7,13,6
566,3,shop,13,14,1
566,4,work,14,19,5
566,5,home,19,24,5
567,1,home,0,7,7
567,2,work,7,14,7
567,3,shop,14,15,1
567,4,home,15,24,9
568,1,home,0,6,6
568,2,work,6,12,6
568,3,shop,12,13,1
568,4,work,13,19,6
568,5,home,19,24,5
569,1,home,0,7,7
569,2,work,7,13,6
569,3,shop,13,14,1
569,4,work,14,20,6
569,5,home,20,24,4
570,1,home,0,6,6
570,2,work,6,13,7
570,3,shop,13,14,1
570,4,work,14,20,6
570,5,home,20,24,4
571,1,home,0,7,7
571,2,work,7,14,7
571,3,shop,14,15,1
571,4,work,15,20,5
571,5,home,20,24,4
572,1,home,0,7,7
572,2,education,7,11,4
572,3,home,11,18,7
572,4,shop,18,20,2
572,5,home,20,24,4
573,1,home,0,6,6
573,2,work,6,13,7
573,3,home,13,24,11
574,1,home,0,6,6
574,2,work,6,8,2
574,3,home,8,13,5
574,4,work,13,15,2
574,5,home,15,21,6
574,6,work,21,22,1
574,7,home,22,24,2
575,1,home,0,7,7
575,2,work,7,14,7
575,3,shop,14,15,1
575,4,work,15,20,5
575,5,home,20,24,4
576,1,home,0,6,6
576,2,shop,6,7,1
576,3,home,7,13,6
576,4,education,13,17,4
576,5,home,17,24,7
577,1,home,0,8,8
577,2,work,8,16,8
577,3,home,16,24,8
578,1,home,0,7,7
578,2,work,7,14,7
578,3,shop,14,15,1
578,4,home,15,23,8
578,5,work,23,24,1
579,1,home,0,7,7
579,2,work,7,13,6
579,3,shop,13,14,1
579,4,work,14,20,6
579,5,home,20,24,4
580,1,home,0,8,8
580,2,work,8,16,8
580,3,home,16,21,5
580,4,shop,21,22,1
580,5,home,22,24,2
581,1,home,0,6,6
581,2,work,6,13,7
581,3,home,13,22,9
581,4,work,22,23,1
581,5,home,23,24,1
582,1,home,0,6,6
582,2,work,6,8,2
582,3,home,8,9,1
582,4,work,9,10,1
582,5,home,10,14,4
582,6,work,14,16,2
582,7,home,16,22,6
582,8,work,22,23,1
582,9,home,23,24,1
583,1,home,0,8,8
583,2,work,8,14,6
583,3,home,14,24,10
584,1,home,0,7,7
584,2,education,7,12,5
584,3,shop,12,14,2
584,4,home,14,20,6
584,5,shop,20,21,1
584,6,home,21,24,3
585,1,home,0,8,8
585,2,work,8,14,6
585,3,home,14,24,10
586,1,home,0,6,6
586,2,work,6,13,7
586,3,shop,13,14,1
586,4,work,14,19,5
586,5,home,19,24,5
587,1,home,0,6,6
587,2,shop,6,7,1
587,3,home,7,9,2
587,4,education,9,13,4
587,5,home,13,20,7
587,6,shop,20,21,1
587,7,home,21,24,3
588,1,home,0,7,7
588,2,work,7,14,7
588,3,home,14,17,3
588,4,work,17,20,3
588,5,home,20,24,4
589,1,home,0,6,6
589,2,work,6,13,7
589,3,shop,13,14,1
589,4,work,14,17,3
589,5,home,17,24,7
590,1,home,0,7,7
590,2,shop,7,8,1
590,3,work,8,15,7
590,4,home,15,20,5
590,5,shop,20,21,1
590,6,home,21,24,3
591,1,home,0,6,6
591,2,work,6,13,7
591,3,home,13,22,9
591,4,work,22,23,1
591,5,home,23,24,1
592,1,home,0,7,7
592,2,education,7,11,4
592,3,home,11,18,7
592,4,shop,18,19,1
592,5,home,19,24,5
593,1,home,0,7,7
593,2,work,7,13,6
593,3,home,13,21,8
593,4,work,21,22,1
593,5,home,22,24,2
594,1,home,0,7,7
594,2,shop,7,8,1
594,3,work,8,15,7
594,4,home,15,24,9
595,1,home,0,8,8
595,2,work,8,14,6
595,3,shop,14,15,1
595,4,work,15,17,2
595,5,home,17,24,7
596,1,home,0,7,7
596,2,work,7,14,7
596,3,shop,14,15,1
596,4,work,15,20,5
596,5,home,20,24,4
597,1,home,0,7,7
597,2,work,7,14,7
597,3,home,14,21,7
597,4,work,21,22,1
597,5,home,22,24,2
598,1,home,0,6,6
598,2,work,6,13,7
598,3,home,13,24,11
599,1,home,0,6,6
599,2,work,6,8,2
599,3,home,8,9,1
599,4,work,9,11,2
599,5,home,11,14,3
599,6,work,14,17,3
599,7,home,17,23,6
599,8,work,23,24,1
600,1,home,0,6,6
600,2,shop,6,7,1
600,3,work,7,14,7
600,4,shop,14,15,1
600,5,work,15,20,5
600,6,home,20,24,4
601,1,home,0,7,7
601,2,work,7,9,2
601,3,home,9,15,6
601,4,work,15,17,2
601,5,home,17,22,5
601,6,work,22,23,1
601,7,home,23,24,1
602,1,home,0,8,8
602,2,work,8,15,7
602,3,shop,15,16,1
602,4,work,16,20,4
602,5,home,20,24,4
603,1,home,0,9,9
603,2,shop,9,10,1
603,3,work,10,18,8
603,4,home,18,24,6
604,1,home,0,6,6
604,2,work,6,8,2
604,3,home,8,12,4
604,4,work,12,14,2
604,5,home,14,21,7
604,6,shop,21,22,1
604,7,home,22,24,2
605,1,home,0,7,7
605,2,work,7,14,7
605,3,home,14,24,10
606,1,home,0,7,7
606,2,education,7,11,4
606,3,home,11,19,8
606,4,shop,19,20,1
606,5,home,20,24,4
607,1,home,0,9,9
607,2,work,9,18,9
607,3,home,18,24,6
608,1,home,0,8,8
608,2,education,8,12,4
608,3,home,12,14,2
608,4,work,14,20,6
608,5,home,20,24,4
609,1,home,0,8,8
609,2,work,8,14,6
609,3,shop,14,15,1
609,4,home,15,24,9
610,1,home,0,7,7
610,2,work,7,15,8
610,3,home,15,24,9
611,1,home,0,6,6
611,2,work,6,8,2
611,3,home,8,12,4
611,4,work,12,15,3
611,5,home,15,22,7
611,6,work,22,23,1
611,7,home,23,24,1
612,1,home,0,7,7
612,2,work,7,14,7
612,3,home,14,24,10
613,1,home,0,6,6
613,2,shop,6,7,1
613,3,work,7,13,6
613,4,shop,13,14,1
613,5,work,14,19,5
613,6,home,19,24,5
614,1,home,0,7,7
614,2,work,7,14,7
614,3,home,14,24,10
615,1,home,0,6,6
615,2,work,6,13,7
615,3,shop,13,14,1
615,4,home,14,24,10
616,1,home,0,6,6
616,2,work,6,13,7
616,3,shop,13,14,1
616,4,home,14,24,10
617,1,home,0,7,7
617,2,education,7,11,4
617,3,home,11,19,8
617,4,shop,19,20,1
617,5,home,20,24,4
618,1,home,0,7,7
618,2,work,7,14,7
618,3,shop,14,15,1
618,4,home,15,24,9
619,1,home,0,8,8
619,2,work,8,15,7
619,3,home,15,24,9
620,1,home,0,8,8
620,2,work,8,10,2
620,3,shop,10,11,1
620,4,home,11,16,5
620,5,work,16,20,4
620,6,home,20,24,4
621,1,home,0,6,6
621,2,work,6,13,7
621,3,home,13,24,11
622,1,home,0,6,6
622,2,work,6,13,7
622,3,home,13,17,4
622,4,work,17,20,3
622,5,home,20,24,4
623,1,home,0,8,8
623,2,work,8,14,6
623,3,home,14,23,9
623,4,work,23,24,1
624,1,home,0,8,8
624,2,work,8,15,7
624,3,home,15,24,9
625,1,home,0,7,7
625,2,work,7,13,6
625,3,home,13,20,7
625,4,shop,20,21,1
625,5,home,21,24,3
626,1,home,0,6,6
626,2,work,6,8,2
626,3,home,8,12,4
626,4,work,12,14,2
626,5,home,14,21,7
626,6,work,21,22,1
626,7,home,22,24,2
627,1,home,0,6,6
627,2,shop,6,7,1
627,3,home,7,10,3
627,4,education,10,12,2
627,5,home,12,16,4
627,6,shop,16,17,1
627,7,home,17,24,7
628,1,home,0,7,7
628,2,work,7,9,2
628,3,home,9,10,1
628,4,work,10,12,2
628,5,home,12,16,4
628,6,work,16,19,3
628,7,home,19,24,5
629,1,home,0,7,7
629,2,shop,7,9,2
629,3,education,9,12,3
629,4,shop,12,14,2
629,5,education,14,16,2
629,6,home,16,24,8
630,1,home,0,8,8
630,2,work,8,15,7
630,3,shop,15,16,1
630,4,work,16,20,4
630,5,home,20,24,4
631,1,home,0,7,7
631,2,work,7,14,7
631,3,home,14,21,7
631,4,shop,21,22,1
631,5,home,22,24,2
632,1,home,0,8,8
632,2,work,8,15,7
632,3,home,15,19,4
632,4,shop,19,20,1
632,5,home,20,24,4
633,1,home,0,8,8
633,2,work,8,15,7
633,3,home,15,24,9
634,1,home,0,7,7
634,2,work,7,14,7
634,3,home,14,24,10
635,1,home,0,8,8
635,2,work,8,15,7
635,3,home,15,24,9
636,1,home,0,8,8
636,2,work,8,15,7
636,3,home,15,24,9
637,1,home,0,9,9
637,2,work,9,16,7
637,3,shop,16,17,1
637,4,home,17,24,7
638,1,home,0,8,8
638,2,work,8,15,7
638,3,shop,15,16,1
638,4,home,16,21,5
638,5,work,21,22,1
638,6,home,22,24,2
639,1,home,0,9,9
639,2,work,9,15,6
639,3,shop,15,16,1
639,4,home,16,24,8
640,1,home,0,6,6
640,2,shop,6,7,1
640,3,home,7,9,2
640,4,education,9,12,3
640,5,home,12,17,5
640,6,shop,17,19,2
640,7,home,19,24,5
641,1,home,0,6,6
641,2,work,6,7,1
641,3,home,7,13,6
641,4,shop,13,14,1
641,5,home,14,22,8
641,6,work,22,23,1
641,7,home,23,24,1
642,1,home,0,8,8
642,2,work,8,15,7
642,3,home,15,22,7
642,4,work,22,23,1
642,5,home,23,24,1
643,1,home,0,7,7
643,2,shop,7,9,2
643,3,education,9,12,3
643,4,home,12,18,6
643,5,shop,18,19,1
643,6,home,19,24,5
644,1,home,0,7,7
644,2,shop,7,9,2
644,3,education,9,12,3
644,4,home,12,18,6
644,5,shop,18,19,1
644,6,home,19,24,5
645,1,home,0,8,8
645,2,work,8,15,7
645,3,home,15,21,6
645,4,work,21,22,1
645,5,home,22,24,2
646,1,home,0,7,7
646,2,work,7,13,6
646,3,shop,13,14,1
646,4,work,14,20,6
646,5,home,20,24,4
647,1,home,0,8,8
647,2,work,8,15,7
647,3,shop,15,16,1
647,4,work,16,20,4
647,5,home,20,24,4
648,1,home,0,7,7
648,2,shop,7,8,1
648,3,home,8,12,4
648,4,work,12,18,6
648,5,home,18,24,6
649,1,home,0,9,9
649,2,work,9,15,6
649,3,home,15,24,9
650,1,home,0,8,8
650,2,education,8,11,3
650,3,home,11,14,3
650,4,shop,14,15,1
650,5,work,15,19,4
650,6,home,19,23,4
650,7,work,23,24,1
651,1,home,0,7,7
651,2,work,7,14,7
651,3,shop,14,16,2
651,4,home,16,21,5
651,5,shop,21,22,1
651,6,home,22,24,2
652,1,home,0,7,7
652,2,shop,7,8,1
652,3,home,8,12,4
652,4,education,12,15,3
652,5,shop,15,16,1
652,6,work,16,20,4
652,7,home,20,24,4
653,1,home,0,7,7
653,2,work,7,13,6
653,3,shop,13,14,1
653,4,work,14,20,6
653,5,home,20,24,4
654,1,home,0,8,8
654,2,work,8,13,5
654,3,home,13,15,2
654,4,work,15,20,5
654,5,home,20,24,4
655,1,home,0,7,7
655,2,work,7,13,6
655,3,home,13,24,11
656,1,home,0,6,6
656,2,shop,6,7,1
656,3,home,7,9,2
656,4,work,9,15,6
656,5,home,15,24,9
657,1,home,0,7,7
657,2,work,7,8,1
657,3,home,8,11,3
657,4,work,11,12,1
657,5,home,12,21,9
657,6,work,21,22,1
657,7,home,22,24,2
658,1,home,0,7,7
658,2,shop,7,9,2
658,3,education,9,12,3
658,4,shop,12,14,2
658,5,education,14,16,2
658,6,home,16,24,8
659,1,home,0,7,7
659,2,work,7,14,7
659,3,shop,14,15,1
659,4,work,15,20,5
659,5,home,20,24,4
660,1,home,0,9,9
660,2,work,9,16,7
660,3,home,16,24,8
661,1,home,0,6,6
661,2,work,6,13,7
661,3,home,13,22,9
661,4,work,22,23,1
661,5,home,23,24,1
662,1,home,0,8,8
662,2,work,8,15,7
662,3,home,15,22,7
662,4,work,22,23,1
662,5,home,23,24,1
663,1,home,0,7,7
663,2,education,7,12,5
663,3,home,12,20,8
663,4,shop,20,21,1
663,5,home,21,24,3
664,1,home,0,7,7
664,2,education,7,13,6
664,3,home,13,20,7
664,4,shop,20,21,1
664,5,home,21,24,3
665,1,home,0,7,7
665,2,education,7,11,4
665,3,home,11,18,7
665,4,shop,18,19,1
665,5,home,19,24,5
666,1,home,0,7,7
666,2,education,7,13,6
666,3,shop,13,15,2
666,4,home,15,24,9
667,1,home,0,9,9
667,2,work,9,16,7
667,3,home,16,24,8
668,1,home,0,7,7
668,2,work,7,13,6
668,3,shop,13,14,1
668,4,work,14,20,6
668,5,home,20,24,4
669,1,home,0,6,6
669,2,work,6,13,7
669,3,home,13,24,11
670,1,home,0,9,9
670,2,work,9,15,6
670,3,home,15,24,9
671,1,home,0,6,6
671,2,work,6,15,9
671,3,home,15,20,5
671,4,shop,20,21,1
671,5,home,21,24,3
672,1,home,0,7,7
672,2,shop,7,8,1
672,3,work,8,15,7
672,4,shop,15,16,1
672,5,work,16,20,4
672,6,home,20,24,4
673,1,home,0,7,7
673,2,work,7,11,4
673,3,shop,11,12,1
673,4,home,12,24,12
674,1,home,0,8,8
674,2,work,8,16,8
674,3,home,16,20,4
674,4,shop,20,21,1
674,5,home,21,24,3
675,1,home,0,6,6
675,2,work,6,8,2
675,3,home,8,9,1
675,4,work,9,10,1
675,5,home,10,16,6
675,6,work,16,18,2
675,7,home,18,23,5
675,8,work,23,24,1
676,1,home,0,8,8
676,2,education,8,12,4
676,3,home,12,16,4
676,4,work,16,19,3
676,5,home,19,24,5
677,1,home,0,6,6
677,2,work,6,8,2
677,3,home,8,14,6
677,4,work,14,17,3
677,5,home,17,24,7
678,1,home,0,8,8
678,2,work,8,15,7
678,3,home,15,22,7
678,4,work,22,23,1
678,5,home,23,24,1
679,1,home,0,8,8
679,2,work,8,14,6
679,3,home,14,18,4
679,4,shop,18,19,1
679,5,home,19,24,5
680,1,home,0,7,7
680,2,education,7,11,4
680,3,home,11,19,8
680,4,shop,19,20,1
680,5,home,20,24,4
681,1,home,0,7,7
681,2,work,7,13,6
681,3,shop,13,14,1
681,4,work,14,20,6
681,5,home,20,24,4
682,1,home,0,7,7
682,2,work,7,13,6
682,3,home,13,23,10
682,4,work,23,24,1
683,1,home,0,7,7
683,2,work,7,13,6
683,3,shop,13,14,1
683,4,home,14,24,10
684,1,home,0,8,8
684,2,education,8,11,3
684,3,home,11,17,6
684,4,shop,17,18,1
684,5,home,18,24,6
685,1,home,0,7,7
685,2,work,7,14,7
685,3,shop,14,15,1
685,4,home,15,24,9
686,1,home,0,6,6
686,2,work,6,13,7
686,3,shop,13,14,1
686,4,work,14,18,4
686,5,home,18,24,6
687,1,home,0,6,6
687,2,work,6,8,2
687,3,home,8,14,6
687,4,work,14,16,2
687,5,home,16,23,7
687,6,work,23,24,1
688,1,home,0,6,6
688,2,work,6,13,7
688,3,shop,13,14,1
688,4,work,14,19,5
688,5,home,19,24,5
689,1,home,0,6,6
689,2,shop,6,7,1
689,3,home,7,9,2
689,4,work,9,17,8
689,5,home,17,23,6
689,6,work,23,24,1
690,1,home,0,8,8
690,2,work,8,15,7
690,3,shop,15,17,2
690,4,home,17,24,7
691,1,home,0,6,6
691,2,work,6,8,2
691,3,home,8,9,1
691,4,work,9,11,2
691,5,home,11,15,4
691,6,work,15,17,2
691,7,home,17,23,6
691,8,work,23,24,1
692,1,home,0,6,6
692,2,work,6,13,7
692,3,shop,13,14,1
692,4,home,14,24,10
693,1,home,0,7,7
693,2,work,7,13,6
693,3,home,13,18,5
693,4,work,18,20,2
693,5,home,20,24,4
694,1,home,0,7,7
694,2,work,7,14,7
694,3,home,14,18,4
694,4,work,18,20,2
694,5,home,20,24,4
695,1,home,0,6,6
695,2,work,6,13,7
695,3,home,13,19,6
695,4,shop,19,20,1
695,5,home,20,24,4
696,1,home,0,6,6
696,2,shop,6,7,1
696,3,work,7,14,7
696,4,shop,14,15,1
696,5,work,15,20,5
696,6,home,20,24,4
697,1,home,0,7,7
697,2,shop,7,8,1
697,3,education,8,11,3
697,4,home,11,19,8
697,5,shop,19,20,1
697,6,home,20,24,4
698,1,home,0,8,8
698,2,work,8,15,7
698,3,home,15,24,9
699,1,home,0,9,9
699,2,work,9,15,6
699,3,home,15,24,9
700,1,home,0,6,6
700,2,work,6,13,7
700,3,home,13,17,4
700,4,work,17,20,3
700,5,home,20,24,4
701,1,home,0,6,6
701,2,work,6,13,7
701,3,shop,13,14,1
701,4,work,14,19,5
701,5,home,19,24,5
702,1,home,0,6,6
702,2,shop,6,7,1
702,3,work,7,14,7
702,4,home,14,23,9
702,5,work,23,24,1
703,1,home,0,8,8
703,2,work,8,15,7
703,3,home,15,24,9
704,1,home,0,7,7
704,2,work,7,14,7
704,3,shop,14,15,1
704,4,work,15,19,4
704,5,home,19,23,4
704,6,work,23,24,1
705,1,home,0,7,7
705,2,education,7,11,4
705,3,home,11,17,6
705,4,shop,17,18,1
705,5,home,18,24,6
706,1,home,0,8,8
706,2,work,8,14,6
706,3,shop,14,15,1
706,4,work,15,20,5
706,5,home,20,24,4
707,1,home,0,7,7
707,2,work,7,14,7
707,3,shop,14,15,1
707,4,home,15,21,6
707,5,work,21,22,1
707,6,home,22,24,2
708,1,home,0,6,6
708,2,work,6,8,2
708,3,home,8,9,1
708,4,work,9,11,2
708,5,home,11,15,4
708,6,work,15,18,3
708,7,home,18,24,6
709,1,home,0,7,7
709,2,work,7,13,6
709,3,home,13,24,11
710,1,home,0,7,7
710,2,work,7,13,6
710,3,home,13,24,11
711,1,home,0,7,7
711,2,work,7,13,6
711,3,shop,13,15,2
711,4,work,15,20,5
711,5,home,20,24,4
712,1,home,0,8,8
712,2,work,8,15,7
712,3,home,15,21,6
712,4,work,21,22,1
712,5,home,22,24,2
713,1,home,0,8,8
713,2,work,8,17,9
713,3,home,17,24,7
714,1,home,0,9,9
714,2,work,9,15,6
714,3,home,15,24,9
715,1,home,0,8,8
715,2,work,8,14,6
715,3,home,14,17,3
715,4,work,17,20,3
715,5,home,20,24,4
716,1,home,0,7,7
716,2,work,7,15,8
716,3,home,15,24,9
717,1,home,0,7,7
717,2,education,7,11,4
717,3,home,11,16,5
717,4,shop,16,17,1
717,5,home,17,24,7
718,1,home,0,7,7
718,2,work,7,14,7
718,3,home,14,24,10
719,1,home,0,7,7
719,2,shop,7,8,1
719,3,work,8,14,6
719,4,home,14,21,7
719,5,work,21,22,1
719,6,home,22,24,2
720,1,home,0,7,7
720,2,education,7,11,4
720,3,home,11,18,7
720,4,shop,18,19,1
720,5,home,19,24,5
721,1,home,0,7,7
721,2,work,7,13,6
721,3,home,13,21,8
721,4,shop,21,22,1
721,5,home,22,24,2
722,1,home,0,7,7
722,2,work,7,14,7
722,3,shop,14,15,1
722,4,work,15,20,5
722,5,home,20,24,4
723,1,home,0,7,7
723,2,work,7,13,6
723,3,shop,13,14,1
723,4,work,14,19,5
723,5,home,19,24,5
724,1,home,0,7,7
724,2,education,7,12,5
724,3,home,12,19,7
724,4,shop,19,20,1
724,5,home,20,24,4
725,1,home,0,6,6
725,2,work,6,7,1
725,3,home,7,9,2
725,4,work,9,11,2
725,5,home,11,15,4
725,6,work,15,17,2
725,7,home,17,24,7
726,1,home,0,7,7
726,2,work,7,14,7
726,3,home,14,18,4
726,4,work,18,20,2
726,5,home,20,24,4
727,1,home,0,8,8
727,2,shop,8,9,1
727,3,home,9,13,4
727,4,education,13,15,2
727,5,home,15,24,9
728,1,home,0,9,9
728,2,work,9,15,6
728,3,home,15,24,9
729,1,home,0,6,6
729,2,work,6,8,2
729,3,home,8,12,4
729,4,work,12,14,2
729,5,home,14,22,8
729,6,work,22,23,1
729,7,home,23,24,1
730,1,home,0,7,7
730,2,work,7,8,1
730,3,home,8,12,4
730,4,work,12,14,2
730,5,home,14,16,2
730,6,work,16,18,2
730,7,home,18,22,4
730,8,work,22,23,1
730,9,home,23,24,1
731,1,home,0,9,9
731,2,work,9,17,8
731,3,home,17,24,7
732,1,home,0,6,6
732,2,work,6,8,2
732,3,home,8,15,7
732,4,work,15,18,3
732,5,home,18,24,6
733,1,home,0,7,7
733,2,work,7,13,6
733,3,home,13,17,4
733,4,shop,17,18,1
733,5,home,18,24,6
734,1,home,0,6,6
734,2,shop,6,7,1
734,3,work,7,14,7
734,4,home,14,24,10
735,1,home,0,8,8
735,2,education,8,11,3
735,3,home,11,16,5
735,4,work,16,20,4
735,5,home,20,24,4
736,1,home,0,8,8
736,2,work,8,15,7
736,3,home,15,19,4
736,4,shop,19,20,1
736,5,home,20,24,4
737,1,home,0,7,7
737,2,work,7,14,7
737,3,shop,14,15,1
737,4,home,15,24,9
738,1,home,0,8,8
738,2,shop,8,9,1
738,3,work,9,17,8
738,4,home,17,24,7
739,1,home,0,8,8
739,2,education,8,12,4
739,3,home,12,16,4
739,4,work,16,20,4
739,5,home,20,24,4
740,1,home,0,8,8
740,2,work,8,14,6
740,3,home,14,18,4
740,4,shop,18,19,1
740,5,home,19,24,5
741,1,home,0,6,6
741,2,shop,6,7,1
741,3,home,7,10,3
741,4,education,10,12,2
741,5,shop,12,14,2
741,6,education,14,16,2
741,7,home,16,24,8
742,1,home,0,6,6
742,2,work,6,13,7
742,3,shop,13,14,1
742,4,work,14,19,5
742,5,home,19,24,5
743,1,home,0,7,7
743,2,work,7,14,7
743,3,home,14,24,10
744,1,home,0,8,8
744,2,education,8,11,3
744,3,shop,11,12,1
744,4,work,12,19,7
744,5,home,19,24,5
745,1,home,0,8,8
745,2,work,8,14,6
745,3,home,14,24,10
746,1,home,0,6,6
746,2,work,6,13,7
746,3,shop,13,14,1
746,4,home,14,21,7
746,5,work,21,22,1
746,6,home,22,24,2
747,1,home,0,6,6
747,2,work,6,8,2
747,3,home,8,14,6
747,4,work,14,16,2
747,5,home,16,22,6
747,6,work,22,23,1
747,7,home,23,24,1
748,1,home,0,8,8
748,2,shop,8,9,1
748,3,work,9,16,7
748,4,home,16,24,8
749,1,home,0,7,7
749,2,shop,7,9,2
749,3,education,9,11,2
749,4,home,11,14,3
749,5,education,14,16,2
749,6,shop,16,17,1
749,7,home,17,24,7
750,1,home,0,6,6
750,2,work,6,13,7
750,3,home,13,16,3
750,4,shop,16,17,1
750,5,home,17,24,7
751,1,home,0,6,6
751,2,work,6,8,2
751,3,home,8,12,4
751,4,work,12,14,2
751,5,home,14,21,7
751,6,work,21,22,1
751,7,home,22,24,2
752,1,home,0,6,6
752,2,work,6,8,2
752,3,home,8,12,4
752,4,work,12,14,2
752,5,home,14,23,9
752,6,work,23,24,1
753,1,home,0,7,7
753,2,shop,7,8,1
753,3,education,8,11,3
753,4,home,11,19,8
753,5,shop,19,20,1
753,6,home,20,24,4
754,1,home,0,7,7
754,2,work,7,13,6
754,3,home,13,17,4
754,4,work,17,20,3
754,5,home,20,24,4
755,1,home,0,7,7
755,2,work,7,14,7
755,3,shop,14,15,1
755,4,work,15,19,4
755,5,home,19,24,5
756,1,home,0,7,7
756,2,shop,7,9,2
756,3,education,9,12,3
756,4,home,12,19,7
756,5,shop,19,21,2
756,6,home,21,24,3
757,1,home,0,7,7
757,2,shop,7,8,1
757,3,work,8,10,2
757,4,home,10,16,6
757,5,work,16,19,3
757,6,home,19,24,5
758,1,home,0,6,6
758,2,work,6,8,2
758,3,home,8,9,1
758,4,work,9,11,2
758,5,home,11,19,8
758,6,shop,19,20,1
758,7,home,20,24,4
759,1,home,0,6,6
759,2,shop,6,7,1
759,3,home,7,9,2
759,4,education,9,12,3
759,5,home,12,14,2
759,6,education,14,16,2
759,7,shop,16,17,1
759,8,home,17,24,7
760,1,home,0,7,7
760,2,work,7,14,7
760,3,home,14,24,10
761,1,home,0,6,6
761,2,work,6,8,2
761,3,home,8,12,4
761,4,work,12,15,3
761,5,home,15,22,7
761,6,work,22,23,1
761,7,home,23,24,1
762,1,home,0,6,6
762,2,shop,6,7,1
762,3,home,7,10,3
762,4,education,10,15,5
762,5,shop,15,17,2
762,6,home,17,21,4
762,7,shop,21,22,1
762,8,home,22,24,2
763,1,home,0,7,7
763,2,education,7,12,5
763,3,shop,12,14,2
763,4,education,14,16,2
763,5,home,16,24,8
764,1,home,0,8,8
764,2,work,8,15,7
764,3,home,15,21,6
764,4,work,21,22,1
764,5,home,22,24,2
765,1,home,0,9,9
765,2,work,9,15,6
765,3,home,15,24,9
766,1,home,0,8,8
766,2,work,8,14,6
766,3,home,14,24,10
767,1,home,0,7,7
767,2,education,7,10,3
767,3,home,10,14,4
767,4,education,14,17,3
767,5,shop,17,19,2
767,6,home,19,24,5
768,1,home,0,8,8
768,2,work,8,14,6
768,3,home,14,24,10
769,1,home,0,6,6
769,2,work,6,13,7
769,3,home,13,21,8
769,4,work,21,22,1
769,5,home,22,24,2
770,1,home,0,7,7
770,2,work,7,13,6
770,3,home,13,24,11
771,1,home,0,7,7
771,2,work,7,13,6
771,3,home,13,21,8
771,4,work,21,22,1
771,5,home,22,24,2
772,1,home,0,7,7
772,2,work,7,13,6
772,3,home,13,22,9
772,4,work,22,23,1
772,5,home,23,24,1
773,1,home,0,7,7
773,2,education,7,11,4
773,3,home,11,17,6
773,4,shop,17,18,1
773,5,home,18,24,6
774,1,home,0,8,8
774,2,work,8,14,6
774,3,home,14,17,3
774,4,work,17,19,2
774,5,home,19,24,5
775,1,home,0,6,6
775,2,work,6,13,7
775,3,shop,13,14,1
775,4,home,14,18,4
775,5,work,18,20,2
775,6,home,20,24,4
776,1,home,0,6,6
776,2,work,6,13,7
776,3,home,13,23,10
776,4,work,23,24,1
777,1,home,0,7,7
777,2,work,7,13,6
777,3,home,13,24,11
778,1,home,0,7,7
778,2,shop,7,8,1
778,3,work,8,15,7
778,4,home,15,24,9
779,1,home,0,7,7
779,2,work,7,14,7
779,3,home,14,24,10
780,1,home,0,7,7
780,2,education,7,11,4
780,3,home,11,20,9
780,4,shop,20,21,1
780,5,home,21,24,3
781,1,home,0,7,7
781,2,work,7,13,6
781,3,shop,13,14,1
781,4,home,14,22,8
781,5,work,22,23,1
781,6,home,23,24,1
782,1,home,0,7,7
782,2,education,7,11,4
782,3,home,11,19,8
782,4,shop,19,21,2
782,5,home,21,24,3
783,1,home,0,8,8
783,2,education,8,11,3
783,3,home,11,19,8
783,4,shop,19,21,2
783,5,home,21,24,3
784,1,home,0,6,6
784,2,shop,6,7,1
784,3,home,7,9,2
784,4,education,9,12,3
784,5,home,12,19,7
784,6,shop,19,21,2
784,7,home,21,24,3
785,1,home,0,8,8
785,2,work,8,14,6
785,3,shop,14,15,1
785,4,home,15,23,8
785,5,work,23,24,1
786,1,home,0,7,7
786,2,work,7,13,6
786,3,home,13,21,8
786,4,work,21,22,1
786,5,home,22,24,2
787,1,home,0,6,6
787,2,work,6,13,7
787,3,shop,13,14,1
787,4,work,14,19,5
787,5,home,19,24,5
788,1,home,0,6,6
788,2,shop,6,7,1
788,3,work,7,13,6
788,4,home,13,21,8
788,5,work,21,22,1
788,6,home,22,24,2
789,1,home,0,7,7
789,2,work,7,14,7
789,3,home,14,24,10
790,1,home,0,6,6
790,2,shop,6,7,1
790,3,work,7,13,6
790,4,home,13,17,4
790,5,work,17,20,3
790,6,home,20,24,4
791,1,home,0,8,8
791,2,work,8,15,7
791,3,shop,15,17,2
791,4,home,17,24,7
792,1,home,0,7,7
792,2,work,7,15,8
792,3,home,15,24,9
793,1,home,0,9,9
793,2,work,9,15,6
793,3,shop,15,16,1
793,4,work,16,20,4
793,5,home,20,24,4
794,1,home,0,7,7
794,2,work,7,8,1
794,3,home,8,14,6
794,4,education,14,15,1
794,5,work,15,17,2
794,6,home,17,24,7
795,1,home,0,6,6
795,2,work,6,13,7
795,3,home,13,24,11
796,1,home,0,7,7
796,2,work,7,13,6
796,3,shop,13,14,1
796,4,work,14,20,6
796,5,home,20,24,4
797,1,home,0,6,6
797,2,work,6,8,2
797,3,home,8,14,6
797,4,work,14,16,2
797,5,home,16,23,7
797,6,work,23,24,1
798,1,home,0,8,8
798,2,work,8,16,8
798,3,home,16,24,8
799,1,home,0,6,6
799,2,work,6,13,7
799,3,home,13,24,11
800,1,home,0,7,7
800,2,work,7,15,8
800,3,home,15,23,8
800,4,work,23,24,1
801,1,home,0,6,6
801,2,shop,6,7,1
801,3,home,7,9,2
801,4,education,9,11,2
801,5,home,11,19,8
801,6,shop,19,21,2
801,7,home,21,24,3
802,1,home,0,6,6
802,2,shop,6,7,1
802,3,work,7,13,6
802,4,home,13,22,9
802,5,work,22,23,1
802,6,home,23,24,1
803,1,home,0,6,6
803,2,shop,6,7,1
803,3,home,7,13,6
803,4,education,13,16,3
803,5,shop,16,17,1
803,6,home,17,24,7
804,1,home,0,8,8
804,2,work,8,17,9
804,3,home,17,24,7
805,1,home,0,7,7
805,2,education,7,11,4
805,3,home,11,18,7
805,4,shop,18,19,1
805,5,home,19,24,5
806,1,home,0,8,8
806,2,work,8,13,5
806,3,shop,13,14,1
806,4,home,14,24,10
807,1,home,0,7,7
807,2,education,7,12,5
807,3,home,12,19,7
807,4,shop,19,20,1
807,5,home,20,24,4
808,1,home,0,6,6
808,2,work,6,7,1
808,3,home,7,9,2
808,4,work,9,10,1
808,5,home,10,15,5
808,6,work,15,17,2
808,7,home,17,23,6
808,8,work,23,24,1
809,1,home,0,7,7
809,2,work,7,13,6
809,3,home,13,18,5
809,4,work,18,20,2
809,5,home,20,24,4
810,1,home,0,6,6
810,2,shop,6,8,2
810,3,work,8,14,6
810,4,home,14,18,4
810,5,shop,18,19,1
810,6,home,19,24,5
811,1,home,0,8,8
811,2,work,8,15,7
811,3,home,15,21,6
811,4,work,21,22,1
811,5,home,22,24,2
812,1,home,0,6,6
812,2,work,6,8,2
812,3,home,8,15,7
812,4,work,15,18,3
812,5,home,18,24,6
813,1,home,0,6,6
813,2,work,6,13,7
813,3,home,13,24,11
814,1,home,0,8,8
814,2,work,8,15,7
814,3,home,15,21,6
814,4,work,21,22,1
814,5,home,22,24,2
815,1,home,0,7,7
815,2,shop,7,8,1
815,3,education,8,11,3
815,4,home,11,19,8
815,5,shop,19,20,1
815,6,home,20,24,4
816,1,home,0,6,6
816,2,work,6,8,2
816,3,home,8,14,6
816,4,work,14,16,2
816,5,shop,16,17,1
816,6,home,17,23,6
816,7,work,23,24,1
817,1,home,0,6,6
817,2,work,6,13,7
817,3,home,13,21,8
817,4,work,21,22,1
817,5,home,22,24,2
818,1,home,0,6,6
818,2,work,6,7,1
818,3,home,7,13,6
818,4,work,13,15,2
818,5,home,15,21,6
818,6,work,21,22,1
818,7,home,22,24,2
819,1,home,0,7,7
819,2,work,7,9,2
819,3,home,9,15,6
819,4,work,15,17,2
819,5,home,17,24,7
820,1,home,0,9,9
820,2,work,9,16,7
820,3,shop,16,18,2
820,4,work,18,20,2
820,5,home,20,24,4
821,1,home,0,6,6
821,2,shop,6,7,1
821,3,home,7,9,2
821,4,education,9,12,3
821,5,home,12,20,8
821,6,shop,20,21,1
821,7,home,21,24,3
822,1,home,0,7,7
822,2,work,7,13,6
822,3,home,13,24,11
823,1,home,0,6,6
823,2,shop,6,7,1
823,3,work,7,14,7
823,4,home,14,21,7
823,5,shop,21,22,1
823,6,home,22,24,2
824,1,home,0,7,7
824,2,work,7,13,6
824,3,home,13,22,9
824,4,work,22,23,1
824,5,home,23,24,1
825,1,home,0,7,7
825,2,work,7,14,7
825,3,home,14,24,10
826,1,home,0,7,7
826,2,work,7,14,7
826,3,home,14,24,10
827,1,home,0,8,8
827,2,education,8,11,3
827,3,home,11,15,4
827,4,work,15,19,4
827,5,home,19,24,5
828,1,home,0,7,7
828,2,work,7,13,6
828,3,home,13,24,11
829,1,home,0,7,7
829,2,work,7,13,6
829,3,shop,13,14,1
829,4,work,14,19,5
829,5,home,19,24,5
830,1,home,0,9,9
830,2,work,9,16,7
830,3,shop,16,17,1
830,4,home,17,24,7
831,1,home,0,6,6
831,2,work,6,8,2
831,3,home,8,9,1
831,4,work,9,11,2
831,5,home,11,17,6
831,6,work,17,19,2
831,7,home,19,23,4
831,8,work,23,24,1
832,1,home,0,8,8
832,2,work,8,15,7
832,3,shop,15,16,1
832,4,home,16,21,5
832,5,work,21,22,1
832,6,home,22,24,2
833,1,home,0,8,8
833,2,work,8,15,7
833,3,home,15,23,8
833,4,work,23,24,1
834,1,home,0,6,6
834,2,shop,6,7,1
834,3,home,7,9,2
834,4,education,9,12,3
834,5,home,12,13,1
834,6,education,13,16,3
834,7,home,16,24,8
835,1,home,0,7,7
835,2,work,7,13,6
835,3,home,13,17,4
835,4,work,17,20,3
835,5,home,20,24,4
836,1,home,0,7,7
836,2,work,7,13,6
836,3,shop,13,14,1
836,4,work,14,20,6
836,5,home,20,24,4
837,1,home,0,8,8
837,2,work,8,15,7
837,3,home,15,24,9
838,1,home,0,8,8
838,2,work,8,14,6
838,3,home,14,24,10
839,1,home,0,7,7
839,2,work,7,14,7
839,3,home,14,24,10
840,1,home,0,8,8
840,2,work,8,15,7
840,3,home,15,24,9
841,1,home,0,7,7
841,2,work,7,14,7
841,3,home,14,24,10
842,1,home,0,6,6
842,2,work,6,13,7
842,3,home,13,17,4
842,4,work,17,20,3
842,5,home,20,24,4
843,1,home,0,6,6
843,2,work,6,8,2
843,3,home,8,9,1
843,4,work,9,11,2
843,5,home,11,17,6
843,6,work,17,19,2
843,7,home,19,24,5
844,1,home,0,8,8
844,2,work,8,14,6
844,3,shop,14,15,1
844,4,home,15,24,9
845,1,home,0,7,7
845,2,work,7,14,7
845,3,shop,14,16,2
845,4,work,16,20,4
845,5,home,20,24,4
846,1,home,0,7,7
846,2,work,7,13,6
846,3,home,13,24,11
847,1,home,0,6,6
847,2,work,6,8,2
847,3,home,8,12,4
847,4,work,12,14,2
847,5,home,14,23,9
847,6,work,23,24,1
848,1,home,0,6,6
848,2,work,6,8,2
848,3,home,8,9,1
848,4,work,9,11,2
848,5,home,11,16,5
848,6,work,16,18,2
848,7,home,18,23,5
848,8,work,23,24,1
849,1,home,0,7,7
849,2,work,7,13,6
849,3,shop,13,15,2
849,4,home,15,21,6
849,5,work,21,22,1
849,6,home,22,24,2
850,1,home,0,7,7
850,2,education,7,12,5
850,3,home,12,19,7
850,4,shop,19,20,1
850,5,home,20,24,4
851,1,home,0,7,7
851,2,work,7,14,7
851,3,home,14,24,10
852,1,home,0,7,7
852,2,shop,7,8,1
852,3,home,8,9,1
852,4,work,9,15,6
852,5,home,15,24,9
853,1,home,0,6,6
853,2,work,6,8,2
853,3,home,8,14,6
853,4,work,14,17,3
853,5,home,17,21,4
853,6,shop,21,22,1
853,7,home,22,24,2
854,1,home,0,8,8
854,2,work,8,16,8
854,3,home,16,24,8
855,1,home,0,6,6
855,2,work,6,13,7
855,3,home,13,22,9
855,4,work,22,23,1
855,5,home,23,24,1
856,1,home,0,6,6
856,2,work,6,13,7
856,3,home,13,18,5
856,4,work,18,20,2
856,5,home,20,24,4
857,1,home,0,8,8
857,2,education,8,10,2
857,3,home,10,13,3
857,4,education,13,16,3
857,5,home,16,24,8
858,1,home,0,7,7
858,2,work,7,13,6
858,3,shop,13,14,1
858,4,work,14,19,5
858,5,home,19,24,5
859,1,home,0,6,6
859,2,work,6,8,2
859,3,home,8,12,4
859,4,work,12,14,2
859,5,home,14,22,8
859,6,work,22,23,1
859,7,home,23,24,1
860,1,home,0,7,7
860,2,shop,7,8,1
860,3,work,8,15,7
860,4,home,15,24,9
861,1,home,0,7,7
861,2,work,7,13,6
861,3,shop,13,14,1
861,4,education,14,16,2
861,5,home,16,24,8
862,1,home,0,7,7
862,2,work,7,14,7
862,3,home,14,24,10
863,1,home,0,7,7
863,2,work,7,13,6
863,3,shop,13,14,1
863,4,home,14,24,10
864,1,home,0,6,6
864,2,work,6,12,6
864,3,shop,12,13,1
864,4,education,13,16,3
864,5,shop,16,17,1
864,6,home,17,21,4
864,7,work,21,22,1
864,8,home,22,24,2
865,1,home,0,7,7
865,2,education,7,11,4
865,3,home,11,14,3
865,4,education,14,16,2
865,5,home,16,24,8
866,1,home,0,7,7
866,2,work,7,14,7
866,3,shop,14,15,1
866,4,work,15,19,4
866,5,home,19,24,5
867,1,home,0,7,7
867,2,work,7,13,6
867,3,home,13,17,4
867,4,work,17,20,3
867,5,home,20,24,4
868,1,home,0,8,8
868,2,work,8,14,6
868,3,home,14,23,9
868,4,work,23,24,1
869,1,home,0,7,7
869,2,education,7,11,4
869,3,home,11,14,3
869,4,education,14,16,2
869,5,home,16,24,8
870,1,home,0,7,7
870,2,shop,7,9,2
870,3,education,9,12,3
870,4,shop,12,14,2
870,5,education,14,15,1
870,6,shop,15,16,1
870,7,home,16,24,8
871,1,home,0,6,6
871,2,work,6,8,2
871,3,home,8,15,7
871,4,work,15,17,2
871,5,home,17,24,7
872,1,home,0,6,6
872,2,work,6,8,2
872,3,home,8,15,7
872,4,work,15,17,2
872,5,home,17,24,7
873,1,home,0,8,8
873,2,shop,8,9,1
873,3,work,9,15,6
873,4,home,15,24,9
874,1,home,0,9,9
874,2,work,9,16,7
874,3,shop,16,17,1
874,4,home,17,24,7
875,1,home,0,6,6
875,2,work,6,8,2
875,3,home,8,12,4
875,4,work,12,14,2
875,5,shop,14,15,1
875,6,home,15,23,8
875,7,work,23,24,1
876,1,home,0,7,7
876,2,education,7,10,3
876,3,home,10,16,6
876,4,shop,16,17,1
876,5,home,17,24,7
877,1,home,0,6,6
877,2,work,6,8,2
877,3,home,8,14,6
877,4,work,14,17,3
877,5,home,17,21,4
877,6,shop,21,22,1
877,7,home,22,24,2
878,1,home,0,7,7
878,2,work,7,14,7
878,3,home,14,24,10
879,1,home,0,8,8
879,2,education,8,14,6
879,3,shop,14,15,1
879,4,home,15,24,9
880,1,home,0,7,7
880,2,shop,7,8,1
880,3,work,8,17,9
880,4,home,17,24,7
881,1,work,0,8,8
881,2,shop,8,9,1
881,3,work,9,15,6
881,4,home,15,24,9
882,1,home,0,6,6
882,2,work,6,13,7
882,3,shop,13,14,1
882,4,home,14,24,10
883,1,home,0,8,8
883,2,work,8,15,7
883,3,home,15,24,9
884,1,home,0,7,7
884,2,work,7,13,6
884,3,shop,13,14,1
884,4,work,14,20,6
884,5,home,20,24,4
885,1,home,0,6,6
885,2,work,6,8,2
885,3,home,8,15,7
885,4,work,15,18,3
885,5,home,18,24,6
886,1,home,0,7,7
886,2,education,7,12,5
886,3,home,12,18,6
886,4,shop,18,19,1
886,5,home,19,24,5
887,1,home,0,7,7
887,2,work,7,13,6
887,3,home,13,24,11
888,1,home,0,7,7
888,2,work,7,13,6
888,3,home,13,17,4
888,4,work,17,20,3
888,5,home,20,24,4
889,1,home,0,6,6
889,2,work,6,8,2
889,3,home,8,12,4
889,4,work,12,13,1
889,5,home,13,20,7
889,6,shop,20,21,1
889,7,home,21,24,3
890,1,home,0,8,8
890,2,work,8,14,6
890,3,shop,14,15,1
890,4,home,15,24,9
891,1,home,0,8,8
891,2,work,8,14,6
891,3,shop,14,15,1
891,4,work,15,20,5
891,5,home,20,24,4
892,1,home,0,6,6
892,2,shop,6,7,1
892,3,home,7,10,3
892,4,work,10,17,7
892,5,home,17,22,5
892,6,work,22,23,1
892,7,home,23,24,1
893,1,home,0,7,7
893,2,shop,7,8,1
893,3,education,8,12,4
893,4,shop,12,14,2
893,5,education,14,16,2
893,6,shop,16,17,1
893,7,home,17,24,7
894,1,home,0,7,7
894,2,work,7,9,2
894,3,home,9,13,4
894,4,work,13,17,4
894,5,home,17,23,6
894,6,work,23,24,1
895,1,home,0,7,7
895,2,work,7,14,7
895,3,shop,14,15,1
895,4,home,15,24,9
896,1,home,0,8,8
896,2,work,8,15,7
896,3,shop,15,16,1
896,4,home,16,23,7
896,5,work,23,24,1
897,1,home,0,6,6
897,2,work,6,13,7
897,3,home,13,24,11
898,1,home,0,6,6
898,2,work,6,13,7
898,3,home,13,18,5
898,4,shop,18,19,1
898,5,home,19,24,5
899,1,home,0,7,7
899,2,work,7,13,6
899,3,home,13,18,5
899,4,work,18,20,2
899,5,home,20,24,4
900,1,home,0,7,7
900,2,shop,7,8,1
900,3,work,8,15,7
900,4,home,15,24,9
901,1,home,0,8,8
901,2,education,8,11,3
901,3,home,11,18,7
901,4,shop,18,19,1
901,5,home,19,24,5
902,1,home,0,7,7
902,2,education,7,12,5
902,3,shop,12,13,1
902,4,home,13,17,4
902,5,shop,17,19,2
902,6,home,19,24,5
903,1,home,0,7,7
903,2,work,7,14,7
903,3,home,14,23,9
903,4,work,23,24,1
904,1,home,0,6,6
904,2,work,6,13,7
904,3,shop,13,14,1
904,4,work,14,19,5
904,5,home,19,24,5
905,1,home,0,6,6
905,2,shop,6,7,1
905,3,home,7,10,3
905,4,education,10,13,3
905,5,home,13,19,6
905,6,shop,19,21,2
905,7,home,21,24,3
906,1,home,0,7,7
906,2,work,7,14,7
906,3,shop,14,15,1
906,4,home,15,24,9
907,1,home,0,8,8
907,2,work,8,14,6
907,3,shop,14,15,1
907,4,home,15,24,9
908,1,home,0,7,7
908,2,education,7,11,4
908,3,home,11,14,3
908,4,education,14,16,2
908,5,home,16,24,8
909,1,home,0,8,8
909,2,work,8,14,6
909,3,shop,14,15,1
909,4,home,15,21,6
909,5,shop,21,22,1
909,6,home,22,24,2
910,1,home,0,8,8
910,2,work,8,14,6
910,3,home,14,23,9
910,4,work,23,24,1
911,1,home,0,7,7
911,2,shop,7,8,1
911,3,education,8,11,3
911,4,home,11,18,7
911,5,shop,18,20,2
911,6,home,20,24,4
912,1,home,0,6,6
912,2,work,6,13,7
912,3,shop,13,14,1
912,4,home,14,18,4
912,5,work,18,20,2
912,6,home,20,24,4
913,1,home,0,7,7
913,2,work,7,17,10
913,3,home,17,22,5
913,4,work,22,23,1
913,5,home,23,24,1
914,1,home,0,7,7
914,2,work,7,13,6
914,3,shop,13,14,1
914,4,work,14,19,5
914,5,home,19,24,5
915,1,home,0,7,7
915,2,education,7,12,5
915,3,shop,12,14,2
915,4,home,14,21,7
915,5,shop,21,22,1
915,6,home,22,24,2
916,1,home,0,8,8
916,2,work,8,15,7
916,3,shop,15,16,1
916,4,work,16,20,4
916,5,home,20,24,4
917,1,home,0,8,8
917,2,work,8,16,8
917,3,shop,16,17,1
917,4,work,17,20,3
917,5,home,20,24,4
918,1,home,0,7,7
918,2,education,7,11,4
918,3,home,11,18,7
918,4,shop,18,19,1
918,5,home,19,24,5
919,1,home,0,7,7
919,2,work,7,15,8
919,3,home,15,19,4
919,4,shop,19,20,1
919,5,home,20,24,4
920,1,home,0,6,6
920,2,work,6,8,2
920,3,home,8,12,4
920,4,work,12,14,2
920,5,home,14,21,7
920,6,work,21,22,1
920,7,home,22,24,2
921,1,home,0,8,8
921,2,work,8,15,7
921,3,shop,15,16,1
921,4,home,16,24,8
922,1,home,0,9,9
922,2,work,9,16,7
922,3,home,16,24,8
923,1,home,0,7,7
923,2,education,7,12,5
923,3,shop,12,13,1
923,4,education,13,15,2
923,5,shop,15,17,2
923,6,home,17,24,7
924,1,home,0,9,9
924,2,work,9,16,7
924,3,home,16,24,8
925,1,home,0,6,6
925,2,shop,6,7,1
925,3,home,7,13,6
925,4,education,13,16,3
925,5,home,16,24,8
926,1,home,0,6,6
926,2,work,6,13,7
926,3,home,13,24,11
927,1,home,0,8,8
927,2,education,8,11,3
927,3,home,11,19,8
927,4,shop,19,21,2
927,5,home,21,24,3
928,1,home,0,8,8
928,2,education,8,12,4
928,3,shop,12,14,2
928,4,education,14,16,2
928,5,home,16,24,8
929,1,home,0,7,7
929,2,work,7,14,7
929,3,home,14,24,10
930,1,home,0,7,7
930,2,work,7,13,6
930,3,shop,13,14,1
930,4,home,14,21,7
930,5,work,21,22,1
930,6,home,22,24,2
931,1,home,0,6,6
931,2,work,6,8,2
931,3,home,8,14,6
931,4,work,14,16,2
931,5,home,16,23,7
931,6,work,23,24,1
932,1,home,0,8,8
932,2,education,8,11,3
932,3,home,11,16,5
932,4,work,16,20,4
932,5,home,20,24,4
933,1,home,0,8,8
933,2,work,8,15,7
933,3,home,15,21,6
933,4,work,21,22,1
933,5,home,22,24,2
934,1,home,0,7,7
934,2,work,7,13,6
934,3,shop,13,14,1
934,4,work,14,20,6
934,5,home,20,24,4
935,1,home,0,7,7
935,2,work,7,8,1
935,3,home,8,12,4
935,4,work,12,13,1
935,5,home,13,20,7
935,6,shop,20,21,1
935,7,home,21,24,3
936,1,home,0,7,7
936,2,work,7,13,6
936,3,shop,13,14,1
936,4,work,14,19,5
936,5,home,19,24,5
937,1,home,0,6,6
937,2,work,6,8,2
937,3,home,8,13,5
937,4,work,13,15,2
937,5,home,15,22,7
937,6,work,22,23,1
937,7,home,23,24,1
938,1,home,0,7,7
938,2,shop,7,8,1
938,3,education,8,11,3
938,4,home,11,17,6
938,5,shop,17,18,1
938,6,home,18,24,6
939,1,home,0,6,6
939,2,shop,6,7,1
939,3,work,7,14,7
939,4,home,14,21,7
939,5,work,21,22,1
939,6,home,22,24,2
940,1,home,0,6,6
940,2,work,6,13,7
940,3,home,13,24,11
941,1,home,0,6,6
941,2,work,6,8,2
941,3,home,8,10,2
941,4,work,10,12,2
941,5,home,12,17,5
941,6,work,17,20,3
941,7,home,20,24,4
942,1,home,0,7,7
942,2,work,7,14,7
942,3,home,14,24,10
943,1,home,0,6,6
943,2,shop,6,7,1
943,3,home,7,13,6
943,4,education,13,16,3
943,5,shop,16,17,1
943,6,home,17,24,7
944,1,home,0,7,7
944,2,work,7,14,7
944,3,home,14,18,4
944,4,shop,18,19,1
944,5,home,19,24,5
945,1,home,0,7,7
945,2,work,7,14,7
945,3,shop,14,15,1
945,4,work,15,20,5
945,5,home,20,24,4
946,1,home,0,7,7
946,2,shop,7,9,2
946,3,education,9,12,3
946,4,home,12,19,7
946,5,shop,19,20,1
946,6,home,20,24,4
947,1,home,0,7,7
947,2,work,7,13,6
947,3,home,13,20,7
947,4,shop,20,21,1
947,5,home,21,24,3
948,1,home,0,7,7
948,2,work,7,12,5
948,3,shop,12,13,1
948,4,work,13,19,6
948,5,education,19,20,1
948,6,home,20,24,4
949,1,home,0,6,6
949,2,work,6,8,2
949,3,home,8,9,1
949,4,work,9,11,2
949,5,home,11,16,5
949,6,work,16,18,2
949,7,home,18,24,6
950,1,home,0,6,6
950,2,work,6,13,7
950,3,home,13,24,11
951,1,home,0,7,7
951,2,shop,7,8,1
951,3,education,8,11,3
951,4,home,11,17,6
951,5,shop,17,18,1
951,6,home,18,24,6
952,1,home,0,8,8
952,2,education,8,12,4
952,3,home,12,19,7
952,4,shop,19,20,1
952,5,home,20,24,4
953,1,home,0,7,7
953,2,work,7,14,7
953,3,home,14,23,9
953,4,work,23,24,1
954,1,home,0,6,6
954,2,shop,6,7,1
954,3,home,7,9,2
954,4,education,9,12,3
954,5,shop,12,14,2
954,6,home,14,24,10
955,1,home,0,8,8
955,2,education,8,12,4
955,3,home,12,19,7
955,4,shop,19,20,1
955,5,home,20,24,4
956,1,home,0,8,8
956,2,work,8,15,7
956,3,home,15,24,9
957,1,home,0,6,6
957,2,work,6,13,7
957,3,home,13,24,11
958,1,home,0,6,6
958,2,work,6,9,3
958,3,home,9,15,6
958,4,work,15,17,2
958,5,home,17,24,7
959,1,home,0,7,7
959,2,work,7,14,7
959,3,shop,14,15,1
959,4,home,15,24,9
960,1,home,0,7,7
960,2,education,7,11,4
960,3,home,11,18,7
960,4,shop,18,20,2
960,5,home,20,24,4
961,1,home,0,7,7
961,2,shop,7,9,2
961,3,education,9,13,4
961,4,shop,13,14,1
961,5,home,14,20,6
961,6,shop,20,21,1
961,7,home,21,24,3
962,1,home,0,7,7
962,2,education,7,11,4
962,3,home,11,17,6
962,4,shop,17,18,1
962,5,home,18,24,6
963,1,home,0,6,6
963,2,work,6,13,7
963,3,home,13,17,4
963,4,work,17,20,3
963,5,home,20,24,4
964,1,home,0,8,8
964,2,work,8,15,7
964,3,home,15,24,9
965,1,home,0,6,6
965,2,work,6,7,1
965,3,home,7,9,2
965,4,work,9,11,2
965,5,home,11,17,6
965,6,work,17,19,2
965,7,home,19,24,5
966,1,home,0,9,9
966,2,education,9,12,3
966,3,shop,12,13,1
966,4,work,13,20,7
966,5,home,20,24,4
967,1,home,0,7,7
967,2,work,7,9,2
967,3,home,9,15,6
967,4,work,15,17,2
967,5,home,17,21,4
967,6,work,21,22,1
967,7,home,22,24,2
968,1,home,0,8,8
968,2,work,8,14,6
968,3,shop,14,15,1
968,4,home,15,21,6
968,5,shop,21,22,1
968,6,home,22,24,2
969,1,home,0,7,7
969,2,education,7,11,4
969,3,home,11,18,7
969,4,shop,18,20,2
969,5,home,20,24,4
970,1,home,0,6,6
970,2,shop,6,7,1
970,3,home,7,9,2
970,4,education,9,12,3
970,5,shop,12,14,2
970,6,education,14,16,2
970,7,home,16,24,8
971,1,home,0,7,7
971,2,work,7,14,7
971,3,home,14,24,10
972,1,home,0,6,6
972,2,work,6,13,7
972,3,home,13,21,8
972,4,work,21,22,1
972,5,home,22,24,2
973,1,home,0,9,9
973,2,work,9,15,6
973,3,home,15,23,8
973,4,work,23,24,1
974,1,home,0,8,8
974,2,work,8,13,5
974,3,home,13,24,11
975,1,home,0,6,6
975,2,shop,6,7,1
975,3,home,7,13,6
975,4,education,13,16,3
975,5,shop,16,17,1
975,6,home,17,24,7
976,1,home,0,7,7
976,2,shop,7,8,1
976,3,work,8,16,8
976,4,home,16,24,8
977,1,home,0,6,6
977,2,work,6,12,6
977,3,shop,12,13,1
977,4,work,13,19,6
977,5,home,19,24,5
978,1,home,0,7,7
978,2,shop,7,9,2
978,3,education,9,12,3
978,4,home,12,19,7
978,5,shop,19,20,1
978,6,home,20,24,4
979,1,home,0,8,8
979,2,work,8,13,5
979,3,home,13,14,1
979,4,work,14,19,5
979,5,home,19,24,5
980,1,home,0,7,7
980,2,work,7,14,7
980,3,home,14,24,10
981,1,home,0,8,8
981,2,work,8,14,6
981,3,shop,14,15,1
981,4,home,15,24,9
982,1,home,0,6,6
982,2,shop,6,7,1
982,3,home,7,13,6
982,4,education,13,16,3
982,5,shop,16,18,2
982,6,home,18,24,6
983,1,home,0,8,8
983,2,education,8,11,3
983,3,home,11,17,6
983,4,shop,17,18,1
983,5,home,18,24,6
984,1,home,0,7,7
984,2,work,7,14,7
984,3,home,14,24,10
985,1,home,0,7,7
985,2,work,7,14,7
985,3,shop,14,15,1
985,4,work,15,20,5
985,5,home,20,24,4
986,1,home,0,7,7
986,2,work,7,13,6
986,3,shop,13,14,1
986,4,work,14,19,5
986,5,home,19,23,4
986,6,work,23,24,1
987,1,home,0,6,6
987,2,work,6,8,2
987,3,home,8,13,5
987,4,work,13,15,2
987,5,home,15,22,7
987,6,work,22,23,1
987,7,home,23,24,1
988,1,home,0,7,7
988,2,work,7,14,7
988,3,shop,14,15,1
988,4,home,15,24,9
989,1,home,0,6,6
989,2,work,6,8,2
989,3,home,8,12,4
989,4,work,12,15,3
989,5,home,15,19,4
989,6,shop,19,20,1
989,7,home,20,24,4
990,1,home,0,9,9
990,2,work,9,17,8
990,3,home,17,24,7
991,1,work,0,1,1
991,2,home,1,8,7
991,3,education,8,13,5
991,4,shop,13,15,2
991,5,home,15,24,9
992,1,home,0,6,6
992,2,work,6,13,7
992,3,home,13,17,4
992,4,work,17,20,3
992,5,home,20,24,4
993,1,home,0,6,6
993,2,shop,6,7,1
993,3,home,7,12,5
993,4,work,12,18,6
993,5,home,18,24,6
994,1,home,0,6,6
994,2,work,6,12,6
994,3,shop,12,13,1
994,4,work,13,19,6
994,5,home,19,24,5
995,1,home,0,8,8
995,2,work,8,15,7
995,3,home,15,22,7
995,4,work,22,23,1
995,5,home,23,24,1
996,1,home,0,8,8
996,2,work,8,13,5
996,3,home,13,21,8
996,4,shop,21,22,1
996,5,home,22,24,2
997,1,home,0,7,7
997,2,work,7,14,7
997,3,shop,14,15,1
997,4,work,15,20,5
997,5,home,20,24,4
998,1,home,0,8,8
998,2,work,8,15,7
998,3,home,15,21,6
998,4,shop,21,22,1
998,5,home,22,24,2
999,1,home,0,7,7
999,2,work,7,13,6
999,3,shop,13,14,1
999,4,work,14,20,6
999,5,home,20,24,4
1000,1,home,0,7,7
1000,2,work,7,14,7
1000,3,home,14,24,10
1001,1,home,0,7,7
1001,2,work,7,14,7
1001,3,home,14,24,10
1002,1,home,0,6,6
1002,2,work,6,13,7
1002,3,shop,13,14,1
1002,4,work,14,20,6
1002,5,home,20,24,4
1003,1,home,0,6,6
1003,2,work,6,13,7
1003,3,home,13,21,8
1003,4,shop,21,22,1
1003,5,home,22,24,2
1004,1,home,0,7,7
1004,2,work,7,13,6
1004,3,home,13,22,9
1004,4,work,22,23,1
1004,5,home,23,24,1
1005,1,home,0,8,8
1005,2,work,8,15,7
1005,3,home,15,24,9
1006,1,home,0,7,7
1006,2,work,7,13,6
1006,3,home,13,17,4
1006,4,shop,17,18,1
1006,5,home,18,24,6
1007,1,home,0,8,8
1007,2,work,8,14,6
1007,3,shop,14,15,1
1007,4,home,15,22,7
1007,5,work,22,23,1
1007,6,home,23,24,1
1008,1,home,0,7,7
1008,2,shop,7,8,1
1008,3,work,8,15,7
1008,4,home,15,24,9
1009,1,home,0,7,7
1009,2,education,7,11,4
1009,3,home,11,17,6
1009,4,shop,17,18,1
1009,5,home,18,24,6
1010,1,home,0,6,6
1010,2,shop,6,7,1
1010,3,home,7,10,3
1010,4,education,10,12,2
1010,5,shop,12,13,1
1010,6,education,13,16,3
1010,7,home,16,24,8
1011,1,home,0,7,7
1011,2,work,7,13,6
1011,3,home,13,17,4
1011,4,work,17,20,3
1011,5,home,20,24,4
1012,1,home,0,7,7
1012,2,work,7,13,6
1012,3,home,13,24,11
1013,1,home,0,7,7
1013,2,work,7,14,7
1013,3,shop,14,15,1
1013,4,work,15,20,5
1013,5,home,20,24,4
1014,1,home,0,7,7
1014,2,work,7,15,8
1014,3,home,15,21,6
1014,4,work,21,22,1
1014,5,home,22,24,2
1015,1,home,0,7,7
1015,2,shop,7,8,1
1015,3,education,8,12,4
1015,4,shop,12,13,1
1015,5,education,13,16,3
1015,6,shop,16,17,1
1015,7,home,17,24,7
1016,1,home,0,7,7
1016,2,work,7,13,6
1016,3,home,13,17,4
1016,4,shop,17,18,1
1016,5,home,18,24,6
1017,1,home,0,7,7
1017,2,work,7,8,1
1017,3,home,8,10,2
1017,4,work,10,11,1
1017,5,home,11,16,5
1017,6,work,16,19,3
1017,7,home,19,24,5
1018,1,home,0,7,7
1018,2,work,7,14,7
1018,3,shop,14,15,1
1018,4,home,15,21,6
1018,5,work,21,22,1
1018,6,home,22,24,2
1019,1,home,0,6,6
1019,2,work,6,13,7
1019,3,home,13,19,6
1019,4,shop,19,20,1
1019,5,home,20,24,4
1020,1,home,0,6,6
1020,2,shop,6,7,1
1020,3,home,7,9,2
1020,4,education,9,12,3
1020,5,home,12,19,7
1020,6,shop,19,20,1
1020,7,home,20,24,4
1021,1,home,0,7,7
1021,2,work,7,14,7
1021,3,home,14,21,7
1021,4,work,21,22,1
1021,5,home,22,24,2
1022,1,home,0,7,7
1022,2,shop,7,8,1
1022,3,work,8,15,7
1022,4,home,15,24,9
1023,1,home,0,7,7
1023,2,work,7,13,6
1023,3,shop,13,14,1
1023,4,home,14,22,8
1023,5,work,22,23,1
1023,6,home,23,24,1
1024,1,home,0,6,6
1024,2,work,6,7,1
1024,3,home,7,8,1
1024,4,work,8,10,2
1024,5,home,10,14,4
1024,6,work,14,17,3
1024,7,home,17,23,6
1024,8,work,23,24,1
1025,1,home,0,8,8
1025,2,work,8,15,7
1025,3,home,15,24,9
1026,1,home,0,7,7
1026,2,work,7,14,7
1026,3,home,14,21,7
1026,4,work,21,22,1
1026,5,home,22,24,2
1027,1,home,0,6,6
1027,2,shop,6,7,1
1027,3,home,7,13,6
1027,4,education,13,16,3
1027,5,home,16,24,8
1028,1,home,0,7,7
1028,2,work,7,13,6
1028,3,home,13,24,11
1029,1,home,0,8,8
1029,2,work,8,15,7
1029,3,home,15,24,9
1030,1,home,0,6,6
1030,2,shop,6,7,1
1030,3,home,7,13,6
1030,4,education,13,16,3
1030,5,home,16,24,8
1031,1,home,0,7,7
1031,2,work,7,13,6
1031,3,home,13,17,4
1031,4,work,17,20,3
1031,5,home,20,24,4
1032,1,home,0,6,6
1032,2,work,6,13,7
1032,3,shop,13,14,1
1032,4,work,14,19,5
1032,5,home,19,24,5
1033,1,home,0,6,6
1033,2,shop,6,7,1
1033,3,home,7,13,6
1033,4,education,13,14,1
1033,5,shop,14,15,1
1033,6,home,15,24,9
1034,1,home,0,7,7
1034,2,work,7,13,6
1034,3,shop,13,14,1
1034,4,work,14,20,6
1034,5,home,20,24,4
1035,1,home,0,8,8
1035,2,work,8,15,7
1035,3,shop,15,16,1
1035,4,work,16,20,4
1035,5,home,20,24,4
1036,1,home,0,6,6
1036,2,shop,6,7,1
1036,3,home,7,10,3
1036,4,education,10,12,2
1036,5,home,12,16,4
1036,6,shop,16,17,1
1036,7,home,17,24,7
1037,1,home,0,6,6
1037,2,work,6,8,2
1037,3,home,8,12,4
1037,4,work,12,14,2
1037,5,home,14,21,7
1037,6,work,21,22,1
1037,7,home,22,24,2
1038,1,home,0,7,7
1038,2,shop,7,8,1
1038,3,education,8,11,3
1038,4,home,11,19,8
1038,5,shop,19,20,1
1038,6,home,20,24,4
1039,1,home,0,6,6
1039,2,work,6,13,7
1039,3,home,13,18,5
1039,4,work,18,20,2
1039,5,home,20,24,4
1040,1,home,0,6,6
1040,2,shop,6,7,1
1040,3,work,7,13,6
1040,4,shop,13,15,2
1040,5,home,15,24,9
1041,1,home,0,6,6
1041,2,shop,6,7,1
1041,3,home,7,9,2
1041,4,education,9,12,3
1041,5,shop,12,13,1
1041,6,education,13,16,3
1041,7,shop,16,17,1
1041,8,home,17,24,7
1042,1,home,0,8,8
1042,2,work,8,15,7
1042,3,home,15,21,6
1042,4,work,21,22,1
1042,5,home,22,24,2
1043,1,home,0,8,8
1043,2,work,8,16,8
1043,3,home,16,21,5
1043,4,shop,21,22,1
1043,5,home,22,24,2
1044,1,home,0,8,8
1044,2,work,8,13,5
1044,3,home,13,24,11
1045,1,home,0,8,8
1045,2,work,8,15,7
1045,3,home,15,24,9
1046,1,home,0,6,6
1046,2,work,6,13,7
1046,3,shop,13,15,2
1046,4,work,15,20,5
1046,5,home,20,24,4
1047,1,home,0,7,7
1047,2,work,7,13,6
1047,3,home,13,19,6
1047,4,shop,19,20,1
1047,5,home,20,24,4
1048,1,home,0,7,7
1048,2,shop,7,8,1
1048,3,education,8,12,4
1048,4,home,12,18,6
1048,5,shop,18,19,1
1048,6,home,19,24,5
1049,1,home,0,6,6
1049,2,work,6,13,7
1049,3,home,13,17,4
1049,4,work,17,20,3
1049,5,home,20,24,4
1050,1,home,0,7,7
1050,2,work,7,9,2
1050,3,home,9,13,4
1050,4,work,13,15,2
1050,5,home,15,17,2
1050,6,work,17,19,2
1050,7,home,19,24,5
1051,1,home,0,7,7
1051,2,work,7,13,6
1051,3,shop,13,14,1
1051,4,home,14,22,8
1051,5,work,22,23,1
1051,6,home,23,24,1
1052,1,home,0,9,9
1052,2,work,9,19,10
1052,3,home,19,24,5
1053,1,home,0,6,6
1053,2,work,6,13,7
1053,3,shop,13,14,1
1053,4,work,14,19,5
1053,5,home,19,24,5
1054,1,home,0,6,6
1054,2,work,6,13,7
1054,3,shop,13,14,1
1054,4,work,14,19,5
1054,5,home,19,24,5
1055,1,home,0,7,7
1055,2,shop,7,8,1
1055,3,work,8,13,5
1055,4,home,13,24,11
1056,1,home,0,8,8
1056,2,work,8,15,7
1056,3,shop,15,16,1
1056,4,work,16,20,4
1056,5,home,20,24,4
1057,1,home,0,8,8
1057,2,shop,8,9,1
1057,3,work,9,15,6
1057,4,home,15,24,9
1058,1,home,0,8,8
1058,2,education,8,11,3
1058,3,home,11,15,4
1058,4,work,15,20,5
1058,5,home,20,24,4
1059,1,home,0,6,6
1059,2,work,6,13,7
1059,3,shop,13,14,1
1059,4,work,14,19,5
1059,5,home,19,24,5
1060,1,home,0,6,6
1060,2,shop,6,7,1
1060,3,home,7,13,6
1060,4,education,13,17,4
1060,5,home,17,24,7
1061,1,home,0,7,7
1061,2,education,7,12,5
1061,3,home,12,19,7
1061,4,shop,19,20,1
1061,5,home,20,24,4
1062,1,home,0,8,8
1062,2,work,8,15,7
1062,3,home,15,24,9
1063,1,home,0,8,8
1063,2,work,8,14,6
1063,3,home,14,24,10
1064,1,home,0,7,7
1064,2,work,7,9,2
1064,3,home,9,11,2
1064,4,work,11,13,2
1064,5,home,13,19,6
1064,6,shop,19,20,1
1064,7,home,20,24,4
1065,1,home,0,7,7
1065,2,work,7,9,2
1065,3,home,9,11,2
1065,4,work,11,13,2
1065,5,home,13,21,8
1065,6,shop,21,22,1
1065,7,home,22,24,2
1066,1,home,0,8,8
1066,2,education,8,13,5
1066,3,home,13,24,11
1067,1,home,0,7,7
1067,2,shop,7,8,1
1067,3,home,8,13,5
1067,4,education,13,16,3
1067,5,home,16,24,8
1068,1,home,0,6,6
1068,2,work,6,13,7
1068,3,shop,13,14,1
1068,4,work,14,19,5
1068,5,home,19,24,5
1069,1,home,0,6,6
1069,2,work,6,13,7
1069,3,shop,13,14,1
1069,4,home,14,24,10
1070,1,home,0,8,8
1070,2,work,8,15,7
1070,3,home,15,24,9
1071,1,home,0,8,8
1071,2,work,8,16,8
1071,3,home,16,20,4
1071,4,shop,20,21,1
1071,5,home,21,24,3
1072,1,home,0,7,7
1072,2,work,7,14,7
1072,3,shop,14,15,1
1072,4,work,15,20,5
1072,5,home,20,24,4
1073,1,home,0,8,8
1073,2,work,8,15,7
1073,3,home,15,24,9
1074,1,home,0,8,8
1074,2,education,8,11,3
1074,3,shop,11,12,1
1074,4,work,12,18,6
1074,5,home,18,24,6
1075,1,home,0,7,7
1075,2,education,7,11,4
1075,3,home,11,20,9
1075,4,shop,20,21,1
1075,5,home,21,24,3
1076,1,home,0,7,7
1076,2,work,7,14,7
1076,3,home,14,22,8
1076,4,work,22,23,1
1076,5,home,23,24,1
1077,1,home,0,9,9
1077,2,shop,9,10,1
1077,3,home,10,14,4
1077,4,work,14,20,6
1077,5,home,20,24,4
1078,1,home,0,8,8
1078,2,work,8,17,9
1078,3,home,17,22,5
1078,4,work,22,23,1
1078,5,home,23,24,1
1079,1,home,0,7,7
1079,2,education,7,11,4
1079,3,home,11,13,2
1079,4,education,13,16,3
1079,5,home,16,24,8
1080,1,home,0,7,7
1080,2,shop,7,8,1
1080,3,education,8,11,3
1080,4,home,11,17,6
1080,5,shop,17,18,1
1080,6,home,18,24,6
1081,1,home,0,6,6
1081,2,work,6,13,7
1081,3,shop,13,14,1
1081,4,work,14,19,5
1081,5,home,19,24,5
1082,1,home,0,9,9
1082,2,work,9,18,9
1082,3,home,18,24,6
1083,1,home,0,7,7
1083,2,shop,7,9,2
1083,3,work,9,16,7
1083,4,shop,16,17,1
1083,5,home,17,24,7
1084,1,home,0,6,6
1084,2,work,6,13,7
1084,3,shop,13,14,1
1084,4,home,14,24,10
1085,1,home,0,7,7
1085,2,education,7,11,4
1085,3,home,11,16,5
1085,4,shop,16,17,1
1085,5,home,17,24,7
1086,1,home,0,8,8
1086,2,work,8,15,7
1086,3,shop,15,16,1
1086,4,home,16,24,8
1087,1,home,0,7,7
1087,2,work,7,14,7
1087,3,shop,14,16,2
1087,4,work,16,20,4
1087,5,home,20,24,4
1088,1,home,0,8,8
1088,2,work,8,13,5
1088,3,shop,13,14,1
1088,4,work,14,19,5
1088,5,home,19,24,5
1089,1,home,0,7,7
1089,2,shop,7,8,1
1089,3,home,8,11,3
1089,4,work,11,18,7
1089,5,education,18,20,2
1089,6,home,20,24,4
1090,1,home,0,6,6
1090,2,shop,6,7,1
1090,3,home,7,9,2
1090,4,education,9,12,3
1090,5,shop,12,13,1
1090,6,education,13,16,3
1090,7,home,16,24,8
1091,1,home,0,8,8
1091,2,education,8,11,3
1091,3,home,11,14,3
1091,4,education,14,16,2
1091,5,shop,16,18,2
1091,6,home,18,24,6
1092,1,home,0,7,7
1092,2,education,7,11,4
1092,3,home,11,19,8
1092,4,shop,19,21,2
1092,5,home,21,24,3
1093,1,home,0,7,7
1093,2,work,7,9,2
1093,3,home,9,15,6
1093,4,work,15,17,2
1093,5,home,17,24,7
1094,1,home,0,7,7
1094,2,work,7,13,6
1094,3,shop,13,14,1
1094,4,work,14,19,5
1094,5,home,19,24,5
1095,1,home,0,6,6
1095,2,shop,6,7,1
1095,3,work,7,13,6
1095,4,home,13,24,11
1096,1,home,0,7,7
1096,2,work,7,14,7
1096,3,home,14,15,1
1096,4,work,15,20,5
1096,5,home,20,24,4
1097,1,home,0,8,8
1097,2,work,8,15,7
1097,3,home,15,24,9
1098,1,home,0,6,6
1098,2,work,6,13,7
1098,3,home,13,17,4
1098,4,work,17,20,3
1098,5,home,20,24,4
1099,1,home,0,7,7
1099,2,shop,7,8,1
1099,3,education,8,11,3
1099,4,home,11,18,7
1099,5,shop,18,19,1
1099,6,home,19,24,5
1100,1,home,0,7,7
1100,2,education,7,11,4
1100,3,home,11,18,7
1100,4,shop,18,19,1
1100,5,home,19,24,5
1101,1,home,0,8,8
1101,2,work,8,14,6
1101,3,home,14,24,10
1102,1,home,0,6,6
1102,2,work,6,13,7
1102,3,shop,13,14,1
1102,4,work,14,19,5
1102,5,home,19,22,3
1102,6,work,22,23,1
1102,7,home,23,24,1
1103,1,home,0,7,7
1103,2,education,7,11,4
1103,3,home,11,17,6
1103,4,shop,17,19,2
1103,5,home,19,24,5
1104,1,home,0,8,8
1104,2,work,8,15,7
1104,3,home,15,24,9
1105,1,home,0,7,7
1105,2,work,7,13,6
1105,3,shop,13,14,1
1105,4,home,14,17,3
1105,5,work,17,20,3
1105,6,home,20,24,4
1106,1,home,0,7,7
1106,2,work,7,13,6
1106,3,shop,13,14,1
1106,4,home,14,23,9
1106,5,work,23,24,1
1107,1,home,0,7,7
1107,2,work,7,14,7
1107,3,shop,14,15,1
1107,4,work,15,20,5
1107,5,home,20,24,4
1108,1,home,0,7,7
1108,2,shop,7,8,1
1108,3,home,8,14,6
1108,4,education,14,16,2
1108,5,home,16,21,5
1108,6,work,21,22,1
1108,7,home,22,24,2
1109,1,home,0,7,7
1109,2,work,7,13,6
1109,3,home,13,21,8
1109,4,work,21,22,1
1109,5,home,22,24,2
1110,1,home,0,7,7
1110,2,education,7,11,4
1110,3,home,11,19,8
1110,4,shop,19,21,2
1110,5,home,21,24,3
1111,1,home,0,6,6
1111,2,work,6,13,7
1111,3,shop,13,14,1
1111,4,work,14,20,6
1111,5,home,20,24,4
1112,1,home,0,6,6
1112,2,work,6,13,7
1112,3,shop,13,15,2
1112,4,work,15,19,4
1112,5,home,19,24,5
1113,1,home,0,6,6
1113,2,work,6,8,2
1113,3,home,8,14,6
1113,4,work,14,16,2
1113,5,shop,16,17,1
1113,6,home,17,21,4
1113,7,work,21,22,1
1113,8,home,22,24,2
1114,1,home,0,6,6
1114,2,work,6,8,2
1114,3,home,8,9,1
1114,4,work,9,11,2
1114,5,home,11,15,4
1114,6,work,15,18,3
1114,7,home,18,24,6
1115,1,home,0,6,6
1115,2,work,6,13,7
1115,3,shop,13,14,1
1115,4,home,14,24,10
1116,1,home,0,7,7
1116,2,shop,7,8,1
1116,3,education,8,11,3
1116,4,home,11,18,7
1116,5,shop,18,20,2
1116,6,home,20,24,4
1117,1,home,0,8,8
1117,2,work,8,14,6
1117,3,home,14,20,6
1117,4,shop,20,21,1
1117,5,home,21,24,3
1118,1,home,0,7,7
1118,2,education,7,14,7
1118,3,shop,14,16,2
1118,4,home,16,24,8
1119,1,home,0,7,7
1119,2,education,7,11,4
1119,3,home,11,18,7
1119,4,shop,18,20,2
1119,5,home,20,24,4
1120,1,home,0,7,7
1120,2,work,7,14,7
1120,3,shop,14,15,1
1120,4,work,15,20,5
1120,5,home,20,24,4
1121,1,home,0,7,7
1121,2,work,7,9,2
1121,3,home,9,14,5
1121,4,work,14,16,2
1121,5,home,16,23,7
1121,6,work,23,24,1
1122,1,home,0,6,6
1122,2,work,6,8,2
1122,3,home,8,12,4
1122,4,work,12,14,2
1122,5,home,14,21,7
1122,6,work,21,22,1
1122,7,home,22,24,2
1123,1,home,0,6,6
1123,2,work,6,7,1
1123,3,home,7,14,7
1123,4,work,14,18,4
1123,5,home,18,24,6
1124,1,home,0,7,7
1124,2,work,7,13,6
1124,3,home,13,22,9
1124,4,work,22,23,1
1124,5,home,23,24,1
1125,1,home,0,6,6
1125,2,work,6,8,2
1125,3,home,8,9,1
1125,4,shop,9,10,1
1125,5,work,10,11,1
1125,6,home,11,18,7
1125,7,work,18,19,1
1125,8,home,19,24,5
1126,1,home,0,7,7
1126,2,work,7,14,7
1126,3,home,14,16,2
1126,4,work,16,19,3
1126,5,education,19,20,1
1126,6,home,20,24,4
1127,1,home,0,7,7
1127,2,work,7,14,7
1127,3,home,14,22,8
1127,4,work,22,23,1
1127,5,home,23,24,1
1128,1,home,0,7,7
1128,2,work,7,13,6
1128,3,home,13,24,11
1129,1,home,0,8,8
1129,2,education,8,11,3
1129,3,home,11,16,5
1129,4,work,16,20,4
1129,5,home,20,24,4
1130,1,home,0,7,7
1130,2,work,7,14,7
1130,3,shop,14,15,1
1130,4,work,15,20,5
1130,5,home,20,24,4
1131,1,home,0,9,9
1131,2,work,9,13,4
1131,3,shop,13,14,1
1131,4,work,14,19,5
1131,5,home,19,24,5
1132,1,home,0,6,6
1132,2,work,6,8,2
1132,3,home,8,14,6
1132,4,work,14,16,2
1132,5,home,16,21,5
1132,6,work,21,22,1
1132,7,home,22,24,2
1133,1,home,0,7,7
1133,2,work,7,14,7
1133,3,home,14,16,2
1133,4,work,16,19,3
1133,5,education,19,20,1
1133,6,home,20,24,4
1134,1,home,0,6,6
1134,2,work,6,13,7
1134,3,shop,13,14,1
1134,4,education,14,17,3
1134,5,home,17,22,5
1134,6,work,22,23,1
1134,7,home,23,24,1
1135,1,home,0,6,6
1135,2,shop,6,7,1
1135,3,home,7,10,3
1135,4,education,10,13,3
1135,5,shop,13,15,2
1135,6,home,15,24,9
1136,1,home,0,8,8
1136,2,education,8,11,3
1136,3,home,11,18,7
1136,4,shop,18,19,1
1136,5,home,19,24,5
1137,1,home,0,8,8
1137,2,work,8,14,6
1137,3,home,14,21,7
1137,4,work,21,22,1
1137,5,home,22,24,2
1138,1,home,0,9,9
1138,2,work,9,16,7
1138,3,home,16,22,6
1138,4,work,22,23,1
1138,5,home,23,24,1
1139,1,home,0,6,6
1139,2,work,6,13,7
1139,3,home,13,23,10
1139,4,work,23,24,1
1140,1,home,0,7,7
1140,2,work,7,9,2
1140,3,home,9,15,6
1140,4,work,15,17,2
1140,5,home,17,21,4
1140,6,work,21,22,1
1140,7,home,22,24,2
1141,1,home,0,7,7
1141,2,work,7,14,7
1141,3,home,14,24,10
1142,1,home,0,8,8
1142,2,work,8,15,7
1142,3,shop,15,16,1
1142,4,home,16,24,8
1143,1,home,0,7,7
1143,2,work,7,13,6
1143,3,home,13,24,11
1144,1,home,0,7,7
1144,2,work,7,13,6
1144,3,home,13,24,11
1145,1,home,0,6,6
1145,2,work,6,13,7
1145,3,home,13,24,11
1146,1,home,0,7,7
1146,2,work,7,14,7
1146,3,home,14,19,5
1146,4,shop,19,20,1
1146,5,home,20,24,4
1147,1,home,0,7,7
1147,2,work,7,13,6
1147,3,shop,13,14,1
1147,4,work,14,20,6
1147,5,home,20,24,4
1148,1,home,0,6,6
1148,2,work,6,8,2
1148,3,home,8,14,6
1148,4,work,14,16,2
1148,5,home,16,22,6
1148,6,work,22,23,1
1148,7,home,23,24,1
1149,1,home,0,9,9
1149,2,work,9,17,8
1149,3,home,17,24,7
1150,1,home,0,6,6
1150,2,shop,6,7,1
1150,3,work,7,16,9
1150,4,home,16,24,8
1151,1,home,0,8,8
1151,2,work,8,15,7
1151,3,home,15,21,6
1151,4,shop,21,22,1
1151,5,home,22,24,2
1152,1,home,0,7,7
1152,2,work,7,9,2
1152,3,home,9,15,6
1152,4,work,15,18,3
1152,5,home,18,24,6
1153,1,home,0,6,6
1153,2,work,6,13,7
1153,3,home,13,17,4
1153,4,work,17,19,2
1153,5,home,19,24,5
1154,1,home,0,6,6
1154,2,shop,6,7,1
1154,3,home,7,9,2
1154,4,work,9,13,4
1154,5,home,13,18,5
1154,6,work,18,19,1
1154,7,education,19,20,1
1154,8,home,20,24,4
1155,1,home,0,6,6
1155,2,work,6,8,2
1155,3,home,8,11,3
1155,4,work,11,13,2
1155,5,home,13,16,3
1155,6,work,16,18,2
1155,7,home,18,24,6
1156,1,home,0,6,6
1156,2,shop,6,7,1
1156,3,home,7,9,2
1156,4,education,9,11,2
1156,5,home,11,20,9
1156,6,shop,20,21,1
1156,7,home,21,24,3
1157,1,home,0,6,6
1157,2,work,6,8,2
1157,3,home,8,10,2
1157,4,work,10,12,2
1157,5,home,12,18,6
1157,6,work,18,20,2
1157,7,home,20,24,4
1158,1,home,0,7,7
1158,2,work,7,13,6
1158,3,shop,13,14,1
1158,4,work,14,20,6
1158,5,home,20,24,4
1159,1,home,0,7,7
1159,2,education,7,12,5
1159,3,shop,12,14,2
1159,4,education,14,16,2
1159,5,home,16,24,8
1160,1,home,0,6,6
1160,2,work,6,13,7
1160,3,home,13,24,11
1161,1,home,0,8,8
1161,2,work,8,14,6
1161,3,home,14,24,10
1162,1,home,0,6,6
1162,2,work,6,13,7
1162,3,shop,13,14,1
1162,4,work,14,19,5
1162,5,home,19,24,5
1163,1,home,0,7,7
1163,2,education,7,12,5
1163,3,shop,12,14,2
1163,4,home,14,20,6
1163,5,shop,20,21,1
1163,6,home,21,24,3
1164,1,home,0,8,8
1164,2,work,8,16,8
1164,3,shop,16,17,1
1164,4,work,17,20,3
1164,5,home,20,24,4
1165,1,home,0,7,7
1165,2,work,7,13,6
1165,3,home,13,17,4
1165,4,work,17,19,2
1165,5,home,19,24,5
1166,1,home,0,7,7
1166,2,education,7,11,4
1166,3,home,11,19,8
1166,4,shop,19,20,1
1166,5,home,20,24,4
1167,1,home,0,6,6
1167,2,work,6,13,7
1167,3,home,13,21,8
1167,4,shop,21,22,1
1167,5,home,22,24,2
1168,1,home,0,6,6
1168,2,shop,6,7,1
1168,3,home,7,10,3
1168,4,education,10,16,6
1168,5,home,16,24,8
1169,1,home,0,7,7
1169,2,work,7,13,6
1169,3,home,13,24,11
1170,1,home,0,7,7
1170,2,work,7,13,6
1170,3,home,13,24,11
1171,1,home,0,6,6
1171,2,shop,6,7,1
1171,3,home,7,13,6
1171,4,education,13,16,3
1171,5,home,16,24,8
1172,1,home,0,7,7
1172,2,education,7,12,5
1172,3,shop,12,14,2
1172,4,home,14,21,7
1172,5,shop,21,22,1
1172,6,home,22,24,2
1173,1,home,0,8,8
1173,2,work,8,15,7
1173,3,home,15,22,7
1173,4,work,22,23,1
1173,5,home,23,24,1
1174,1,home,0,7,7
1174,2,work,7,13,6
1174,3,shop,13,14,1
1174,4,work,14,20,6
1174,5,home,20,24,4
1175,1,home,0,9,9
1175,2,work,9,16,7
1175,3,home,16,24,8
1176,1,home,0,6,6
1176,2,work,6,13,7
1176,3,shop,13,15,2
1176,4,home,15,24,9
1177,1,home,0,7,7
1177,2,work,7,9,2
1177,3,home,9,15,6
1177,4,work,15,17,2
1177,5,home,17,24,7
1178,1,home,0,6,6
1178,2,shop,6,7,1
1178,3,work,7,13,6
1178,4,home,13,21,8
1178,5,work,21,22,1
1178,6,home,22,24,2
1179,1,home,0,7,7
1179,2,work,7,13,6
1179,3,home,13,16,3
1179,4,work,16,19,3
1179,5,home,19,24,5
1180,1,home,0,6,6
1180,2,shop,6,7,1
1180,3,home,7,13,6
1180,4,education,13,16,3
1180,5,home,16,24,8
1181,1,home,0,7,7
1181,2,work,7,9,2
1181,3,home,9,13,4
1181,4,work,13,16,3
1181,5,home,16,22,6
1181,6,work,22,23,1
1181,7,home,23,24,1
1182,1,home,0,6,6
1182,2,work,6,8,2
1182,3,home,8,13,5
1182,4,work,13,15,2
1182,5,home,15,22,7
1182,6,work,22,23,1
1182,7,home,23,24,1
1183,1,home,0,7,7
1183,2,work,7,10,3
1183,3,home,10,14,4
1183,4,work,14,17,3
1183,5,home,17,23,6
1183,6,work,23,24,1
1184,1,home,0,6,6
1184,2,work,6,13,7
1184,3,home,13,24,11
1185,1,home,0,7,7
1185,2,work,7,14,7
1185,3,shop,14,15,1
1185,4,home,15,24,9
1186,1,home,0,6,6
1186,2,work,6,13,7
1186,3,home,13,24,11
1187,1,home,0,8,8
1187,2,work,8,15,7
1187,3,shop,15,16,1
1187,4,work,16,20,4
1187,5,home,20,24,4
1188,1,home,0,7,7
1188,2,work,7,14,7
1188,3,home,14,18,4
1188,4,shop,18,19,1
1188,5,home,19,24,5
1189,1,home,0,6,6
1189,2,work,6,8,2
1189,3,shop,8,9,1
1189,4,work,9,11,2
1189,5,home,11,15,4
1189,6,work,15,18,3
1189,7,home,18,24,6
1190,1,home,0,7,7
1190,2,work,7,14,7
1190,3,shop,14,15,1
1190,4,work,15,20,5
1190,5,home,20,24,4
1191,1,home,0,7,7
1191,2,education,7,11,4
1191,3,home,11,17,6
1191,4,shop,17,18,1
1191,5,home,18,24,6
1192,1,home,0,9,9
1192,2,shop,9,10,1
1192,3,work,10,17,7
1192,4,home,17,21,4
1192,5,work,21,22,1
1192,6,home,22,24,2
1193,1,home,0,6,6
1193,2,shop,6,7,1
1193,3,home,7,10,3
1193,4,education,10,13,3
1193,5,shop,13,15,2
1193,6,home,15,24,9
1194,1,home,0,7,7
1194,2,work,7,13,6
1194,3,home,13,18,5
1194,4,work,18,20,2
1194,5,home,20,24,4
1195,1,home,0,7,7
1195,2,work,7,10,3
1195,3,home,10,15,5
1195,4,work,15,17,2
1195,5,home,17,24,7
1196,1,home,0,8,8
1196,2,education,8,12,4
1196,3,shop,12,14,2
1196,4,education,14,16,2
1196,5,home,16,24,8
1197,1,home,0,6,6
1197,2,work,6,13,7
1197,3,home,13,24,11
1198,1,home,0,8,8
1198,2,work,8,14,6
1198,3,shop,14,15,1
1198,4,work,15,20,5
1198,5,home,20,24,4
1199,1,home,0,7,7
1199,2,work,7,14,7
1199,3,home,14,18,4
1199,4,work,18,20,2
1199,5,home,20,24,4
1200,1,home,0,8,8
1200,2,work,8,13,5
1200,3,shop,13,14,1
1200,4,work,14,20,6
1200,5,home,20,24,4
1201,1,home,0,7,7
1201,2,shop,7,8,1
1201,3,work,8,14,6
1201,4,home,14,22,8
1201,5,work,22,23,1
1201,6,home,23,24,1
1202,1,home,0,7,7
1202,2,shop,7,8,1
1202,3,work,8,16,8
1202,4,home,16,24,8
1203,1,home,0,7,7
1203,2,work,7,13,6
1203,3,shop,13,14,1
1203,4,work,14,18,4
1203,5,home,18,24,6
1204,1,home,0,8,8
1204,2,work,8,15,7
1204,3,shop,15,16,1
1204,4,home,16,23,7
1204,5,work,23,24,1
1205,1,home,0,7,7
1205,2,work,7,14,7
1205,3,home,14,18,4
1205,4,work,18,20,2
1205,5,home,20,24,4
1206,1,home,0,7,7
1206,2,work,7,14,7
1206,3,home,14,18,4
1206,4,work,18,20,2
1206,5,home,20,24,4
1207,1,home,0,7,7
1207,2,work,7,13,6
1207,3,shop,13,14,1
1207,4,work,14,19,5
1207,5,home,19,24,5
1208,1,home,0,7,7
1208,2,work,7,14,7
1208,3,shop,14,15,1
1208,4,home,15,24,9
1209,1,home,0,8,8
1209,2,education,8,12,4
1209,3,shop,12,14,2
1209,4,education,14,16,2
1209,5,home,16,18,2
1209,6,shop,18,20,2
1209,7,home,20,24,4
1210,1,home,0,6,6
1210,2,work,6,13,7
1210,3,shop,13,14,1
1210,4,work,14,20,6
1210,5,home,20,24,4
1211,1,home,0,6,6
1211,2,work,6,7,1
1211,3,home,7,9,2
1211,4,work,9,11,2
1211,5,home,11,18,7
1211,6,work,18,19,1
1211,7,home,19,24,5
1212,1,home,0,7,7
1212,2,education,7,11,4
1212,3,home,11,19,8
1212,4,shop,19,20,1
1212,5,home,20,24,4
1213,1,home,0,7,7
1213,2,shop,7,8,1
1213,3,work,8,15,7
1213,4,home,15,21,6
1213,5,work,21,22,1
1213,6,home,22,24,2
1214,1,home,0,7,7
1214,2,work,7,13,6
1214,3,home,13,17,4
1214,4,work,17,20,3
1214,5,home,20,24,4
1215,1,home,0,6,6
1215,2,shop,6,7,1
1215,3,home,7,9,2
1215,4,education,9,11,2
1215,5,home,11,17,6
1215,6,shop,17,18,1
1215,7,home,18,24,6
1216,1,home,0,6,6
1216,2,shop,6,7,1
1216,3,home,7,13,6
1216,4,education,13,16,3
1216,5,home,16,24,8
1217,1,home,0,9,9
1217,2,work,9,16,7
1217,3,home,16,22,6
1217,4,work,22,23,1
1217,5,home,23,24,1
1218,1,home,0,6,6
1218,2,shop,6,7,1
1218,3,home,7,9,2
1218,4,education,9,13,4
1218,5,shop,13,15,2
1218,6,home,15,21,6
1218,7,shop,21,22,1
1218,8,home,22,24,2
1219,1,home,0,7,7
1219,2,work,7,14,7
1219,3,shop,14,15,1
1219,4,work,15,19,4
1219,5,home,19,24,5
1220,1,home,0,7,7
1220,2,work,7,13,6
1220,3,home,13,24,11
1221,1,home,0,7,7
1221,2,work,7,13,6
1221,3,home,13,24,11
1222,1,home,0,7,7
1222,2,shop,7,8,1
1222,3,work,8,14,6
1222,4,shop,14,15,1
1222,5,home,15,24,9
1223,1,home,0,8,8
1223,2,education,8,11,3
1223,3,home,11,18,7
1223,4,shop,18,20,2
1223,5,home,20,24,4
1224,1,home,0,6,6
1224,2,work,6,7,1
1224,3,home,7,9,2
1224,4,work,9,11,2
1224,5,home,11,17,6
1224,6,work,17,19,2
1224,7,home,19,24,5
1225,1,home,0,7,7
1225,2,work,7,14,7
1225,3,shop,14,15,1
1225,4,home,15,24,9
1226,1,home,0,9,9
1226,2,education,9,12,3
1226,3,work,12,19,7
1226,4,home,19,24,5
1227,1,home,0,7,7
1227,2,work,7,13,6
1227,3,shop,13,14,1
1227,4,home,14,24,10
1228,1,home,0,7,7
1228,2,shop,7,8,1
1228,3,education,8,13,5
1228,4,shop,13,15,2
1228,5,home,15,21,6
1228,6,shop,21,22,1
1228,7,home,22,24,2
1229,1,home,0,6,6
1229,2,work,6,7,1
1229,3,home,7,13,6
1229,4,work,13,14,1
1229,5,home,14,20,6
1229,6,shop,20,21,1
1229,7,home,21,24,3
1230,1,home,0,8,8
1230,2,work,8,15,7
1230,3,shop,15,16,1
1230,4,work,16,19,3
1230,5,home,19,24,5
1231,1,home,0,7,7
1231,2,work,7,14,7
1231,3,shop,14,16,2
1231,4,home,16,24,8
1232,1,home,0,8,8
1232,2,work,8,14,6
1232,3,home,14,19,5
1232,4,shop,19,20,1
1232,5,home,20,24,4
1233,1,home,0,7,7
1233,2,work,7,13,6
1233,3,home,13,14,1
1233,4,shop,14,16,2
1233,5,home,16,22,6
1233,6,work,22,23,1
1233,7,home,23,24,1
1234,1,home,0,8,8
1234,2,work,8,14,6
1234,3,shop,14,16,2
1234,4,work,16,20,4
1234,5,home,20,24,4
1235,1,home,0,9,9
1235,2,work,9,16,7
1235,3,home,16,24,8
1236,1,home,0,8,8
1236,2,education,8,11,3
1236,3,home,11,19,8
1236,4,shop,19,20,1
1236,5,home,20,24,4
1237,1,home,0,6,6
1237,2,shop,6,7,1
1237,3,work,7,14,7
1237,4,home,14,24,10
1238,1,home,0,6,6
1238,2,work,6,8,2
1238,3,home,8,12,4
1238,4,shop,12,13,1
1238,5,work,13,16,3
1238,6,home,16,21,5
1238,7,work,21,22,1
1238,8,home,22,24,2
1239,1,home,0,8,8
1239,2,work,8,15,7
1239,3,shop,15,16,1
1239,4,work,16,20,4
1239,5,home,20,24,4
1240,1,home,0,7,7
1240,2,work,7,14,7
1240,3,shop,14,15,1
1240,4,home,15,24,9
1241,1,home,0,7,7
1241,2,work,7,13,6
1241,3,home,13,21,8
1241,4,shop,21,22,1
1241,5,home,22,24,2
1242,1,home,0,7,7
1242,2,shop,7,9,2
1242,3,education,9,12,3
1242,4,home,12,21,9
1242,5,shop,21,22,1
1242,6,home,22,24,2
1243,1,home,0,8,8
1243,2,work,8,14,6
1243,3,home,14,24,10
1244,1,home,0,6,6
1244,2,shop,6,7,1
1244,3,work,7,13,6
1244,4,home,13,24,11
1245,1,home,0,6,6
1245,2,work,6,13,7
1245,3,home,13,18,5
1245,4,shop,18,19,1
1245,5,home,19,24,5
1246,1,home,0,7,7
1246,2,education,7,12,5
1246,3,home,12,18,6
1246,4,shop,18,19,1
1246,5,home,19,24,5
1247,1,home,0,6,6
1247,2,shop,6,7,1
1247,3,work,7,13,6
1247,4,home,13,18,5
1247,5,work,18,20,2
1247,6,home,20,24,4
1248,1,home,0,7,7
1248,2,work,7,13,6
1248,3,shop,13,14,1
1248,4,home,14,24,10
1249,1,home,0,7,7
1249,2,work,7,13,6
1249,3,shop,13,14,1
1249,4,work,14,20,6
1249,5,home,20,24,4
1250,1,home,0,8,8
1250,2,shop,8,9,1
1250,3,home,9,22,13
1250,4,work,22,23,1
1250,5,home,23,24,1
1251,1,home,0,7,7
1251,2,work,7,13,6
1251,3,shop,13,14,1
1251,4,education,14,17,3
1251,5,home,17,23,6
1251,6,work,23,24,1
1252,1,home,0,7,7
1252,2,work,7,14,7
1252,3,shop,14,15,1
1252,4,home,15,21,6
1252,5,work,21,22,1
1252,6,home,22,24,2
1253,1,home,0,6,6
1253,2,work,6,7,1
1253,3,home,7,13,6
1253,4,work,13,15,2
1253,5,home,15,21,6
1253,6,work,21,22,1
1253,7,home,22,24,2
1254,1,home,0,8,8
1254,2,work,8,15,7
1254,3,home,15,24,9
1255,1,home,0,7,7
1255,2,education,7,11,4
1255,3,home,11,18,7
1255,4,shop,18,20,2
1255,5,home,20,24,4
1256,1,home,0,7,7
1256,2,work,7,13,6
1256,3,home,13,19,6
1256,4,shop,19,20,1
1256,5,home,20,24,4
1257,1,home,0,6,6
1257,2,shop,6,7,1
1257,3,home,7,13,6
1257,4,education,13,16,3
1257,5,home,16,24,8
1258,1,home,0,6,6
1258,2,work,6,13,7
1258,3,home,13,22,9
1258,4,work,22,23,1
1258,5,home,23,24,1
1259,1,home,0,7,7
1259,2,work,7,14,7
1259,3,shop,14,15,1
1259,4,home,15,23,8
1259,5,work,23,24,1
1260,1,home,0,8,8
1260,2,work,8,15,7
1260,3,home,15,24,9
1261,1,home,0,8,8
1261,2,work,8,15,7
1261,3,home,15,24,9
1262,1,home,0,6,6
1262,2,shop,6,7,1
1262,3,work,7,14,7
1262,4,shop,14,15,1
1262,5,home,15,24,9
1263,1,home,0,8,8
1263,2,work,8,15,7
1263,3,shop,15,16,1
1263,4,work,16,19,3
1263,5,home,19,24,5
1264,1,home,0,7,7
1264,2,work,7,9,2
1264,3,home,9,15,6
1264,4,work,15,17,2
1264,5,home,17,24,7
1265,1,home,0,7,7
1265,2,shop,7,9,2
1265,3,education,9,12,3
1265,4,home,12,20,8
1265,5,shop,20,21,1
1265,6,home,21,24,3
1266,1,home,0,8,8
1266,2,work,8,14,6
1266,3,home,14,24,10
1267,1,home,0,7,7
1267,2,work,7,14,7
1267,3,home,14,24,10
1268,1,home,0,8,8
1268,2,work,8,15,7
1268,3,shop,15,16,1
1268,4,home,16,22,6
1268,5,work,22,23,1
1268,6,home,23,24,1
1269,1,home,0,8,8
1269,2,work,8,14,6
1269,3,home,14,24,10
1270,1,home,0,8,8
1270,2,work,8,14,6
1270,3,home,14,18,4
1270,4,work,18,20,2
1270,5,home,20,24,4
1271,1,home,0,6,6
1271,2,work,6,13,7
1271,3,home,13,24,11
1272,1,home,0,7,7
1272,2,work,7,14,7
1272,3,home,14,23,9
1272,4,work,23,24,1
1273,1,home,0,6,6
1273,2,work,6,13,7
1273,3,home,13,19,6
1273,4,shop,19,20,1
1273,5,home,20,24,4
1274,1,home,0,9,9
1274,2,work,9,16,7
1274,3,home,16,21,5
1274,4,work,21,22,1
1274,5,home,22,24,2
1275,1,home,0,7,7
1275,2,work,7,9,2
1275,3,home,9,15,6
1275,4,work,15,17,2
1275,5,home,17,24,7
1276,1,home,0,7,7
1276,2,work,7,13,6
1276,3,home,13,24,11
1277,1,home,0,8,8
1277,2,education,8,12,4
1277,3,home,12,18,6
1277,4,work,18,20,2
1277,5,home,20,24,4
1278,1,home,0,6,6
1278,2,work,6,8,2
1278,3,home,8,9,1
1278,4,work,9,11,2
1278,5,home,11,17,6
1278,6,work,17,19,2
1278,7,home,19,24,5
1279,1,home,0,6,6
1279,2,shop,6,7,1
1279,3,home,7,13,6
1279,4,education,13,15,2
1279,5,shop,15,17,2
1279,6,home,17,24,7
1280,1,work,0,12,12
1280,2,shop,12,13,1
1280,3,work,13,19,6
1280,4,education,19,20,1
1280,5,work,20,21,1
1280,6,home,21,24,3
1281,1,home,0,6,6
1281,2,shop,6,7,1
1281,3,work,7,15,8
1281,4,home,15,23,8
1281,5,work,23,24,1
1282,1,home,0,7,7
1282,2,education,7,11,4
1282,3,home,11,16,5
1282,4,shop,16,18,2
1282,5,home,18,24,6
1283,1,home,0,7,7
1283,2,work,7,13,6
1283,3,shop,13,14,1
1283,4,work,14,19,5
1283,5,home,19,24,5
1284,1,home,0,7,7
1284,2,work,7,13,6
1284,3,home,13,24,11
1285,1,home,0,7,7
1285,2,education,7,12,5
1285,3,home,12,20,8
1285,4,shop,20,21,1
1285,5,home,21,24,3
1286,1,home,0,6,6
1286,2,work,6,11,5
1286,3,shop,11,12,1
1286,4,work,12,18,6
1286,5,home,18,24,6
1287,1,home,0,6,6
1287,2,work,6,7,1
1287,3,home,7,12,5
1287,4,work,12,13,1
1287,5,home,13,21,8
1287,6,work,21,22,1
1287,7,home,22,24,2
1288,1,home,0,6,6
1288,2,work,6,13,7
1288,3,shop,13,14,1
1288,4,home,14,24,10
1289,1,home,0,8,8
1289,2,work,8,15,7
1289,3,home,15,24,9
1290,1,home,0,7,7
1290,2,work,7,14,7
1290,3,home,14,22,8
1290,4,work,22,23,1
1290,5,home,23,24,1
1291,1,home,0,6,6
1291,2,work,6,13,7
1291,3,home,13,21,8
1291,4,work,21,22,1
1291,5,home,22,24,2
1292,1,home,0,6,6
1292,2,shop,6,7,1
1292,3,home,7,9,2
1292,4,education,9,11,2
1292,5,home,11,18,7
1292,6,shop,18,19,1
1292,7,home,19,24,5
1293,1,home,0,7,7
1293,2,work,7,14,7
1293,3,home,14,24,10
1294,1,home,0,7,7
1294,2,education,7,9,2
1294,3,home,9,17,8
1294,4,shop,17,18,1
1294,5,home,18,24,6
1295,1,home,0,7,7
1295,2,work,7,14,7
1295,3,shop,14,15,1
1295,4,home,15,21,6
1295,5,work,21,22,1
1295,6,home,22,24,2
1296,1,home,0,8,8
1296,2,education,8,12,4
1296,3,home,12,16,4
1296,4,shop,16,17,1
1296,5,home,17,23,6
1296,6,work,23,24,1
1297,1,home,0,7,7
1297,2,work,7,13,6
1297,3,shop,13,14,1
1297,4,home,14,24,10
1298,1,home,0,9,9
1298,2,work,9,16,7
1298,3,home,16,24,8
1299,1,home,0,6,6
1299,2,work,6,13,7
1299,3,home,13,21,8
1299,4,work,21,22,1
1299,5,home,22,24,2
1300,1,home,0,8,8
1300,2,work,8,15,7
1300,3,home,15,22,7
1300,4,work,22,23,1
1300,5,home,23,24,1
1301,1,home,0,7,7
1301,2,shop,7,8,1
1301,3,education,8,11,3
1301,4,home,11,20,9
1301,5,shop,20,21,1
1301,6,home,21,24,3
1302,1,home,0,8,8
1302,2,work,8,13,5
1302,3,shop,13,14,1
1302,4,work,14,19,5
1302,5,home,19,24,5
1303,1,home,0,9,9
1303,2,work,9,17,8
1303,3,home,17,23,6
1303,4,work,23,24,1
1304,1,home,0,8,8
1304,2,education,8,11,3
1304,3,home,11,19,8
1304,4,shop,19,21,2
1304,5,home,21,24,3
1305,1,home,0,7,7
1305,2,shop,7,8,1
1305,3,education,8,12,4
1305,4,shop,12,14,2
1305,5,education,14,16,2
1305,6,home,16,24,8
1306,1,home,0,6,6
1306,2,shop,6,8,2
1306,3,home,8,9,1
1306,4,work,9,16,7
1306,5,home,16,24,8
1307,1,home,0,8,8
1307,2,work,8,14,6
1307,3,shop,14,15,1
1307,4,work,15,19,4
1307,5,home,19,24,5
1308,1,home,0,8,8
1308,2,shop,8,9,1
1308,3,work,9,17,8
1308,4,home,17,24,7
1309,1,home,0,7,7
1309,2,work,7,13,6
1309,3,shop,13,14,1
1309,4,work,14,20,6
1309,5,home,20,24,4
1310,1,home,0,8,8
1310,2,shop,8,9,1
1310,3,home,9,21,12
1310,4,work,21,22,1
1310,5,home,22,24,2
1311,1,home,0,7,7
1311,2,work,7,14,7
1311,3,home,14,24,10
1312,1,home,0,8,8
1312,2,work,8,14,6
1312,3,shop,14,15,1
1312,4,home,15,21,6
1312,5,work,21,22,1
1312,6,home,22,24,2
1313,1,home,0,8,8
1313,2,education,8,11,3
1313,3,home,11,17,6
1313,4,shop,17,18,1
1313,5,home,18,24,6
1314,1,work,0,7,7
1314,2,shop,7,8,1
1314,3,work,8,15,7
1314,4,home,15,24,9
1315,1,home,0,8,8
1315,2,education,8,14,6
1315,3,shop,14,15,1
1315,4,work,15,20,5
1315,5,home,20,24,4
1316,1,home,0,7,7
1316,2,education,7,11,4
1316,3,home,11,18,7
1316,4,shop,18,19,1
1316,5,home,19,24,5
1317,1,home,0,6,6
1317,2,work,6,13,7
1317,3,home,13,17,4
1317,4,shop,17,18,1
1317,5,home,18,24,6
1318,1,home,0,7,7
1318,2,work,7,14,7
1318,3,home,14,17,3
1318,4,work,17,20,3
1318,5,home,20,24,4
1319,1,home,0,6,6
1319,2,work,6,13,7
1319,3,home,13,14,1
1319,4,work,14,20,6
1319,5,home,20,24,4
1320,1,home,0,8,8
1320,2,work,8,14,6
1320,3,home,14,24,10
1321,1,home,0,7,7
1321,2,shop,7,8,1
1321,3,education,8,11,3
1321,4,home,11,14,3
1321,5,education,14,17,3
1321,6,home,17,24,7
1322,1,home,0,8,8
1322,2,work,8,15,7
1322,3,shop,15,16,1
1322,4,home,16,21,5
1322,5,shop,21,22,1
1322,6,home,22,24,2
1323,1,home,0,6,6
1323,2,work,6,13,7
1323,3,shop,13,14,1
1323,4,work,14,19,5
1323,5,home,19,24,5
1324,1,home,0,7,7
1324,2,work,7,14,7
1324,3,home,14,24,10
1325,1,home,0,7,7
1325,2,work,7,14,7
1325,3,home,14,18,4
1325,4,shop,18,19,1
1325,5,home,19,24,5
1326,1,home,0,9,9
1326,2,work,9,15,6
1326,3,home,15,24,9
1327,1,home,0,6,6
1327,2,work,6,13,7
1327,3,shop,13,14,1
1327,4,work,14,20,6
1327,5,home,20,24,4
1328,1,home,0,6,6
1328,2,shop,6,7,1
1328,3,home,7,10,3
1328,4,education,10,13,3
1328,5,shop,13,15,2
1328,6,home,15,24,9
1329,1,home,0,8,8
1329,2,work,8,15,7
1329,3,home,15,24,9
1330,1,home,0,8,8
1330,2,work,8,14,6
1330,3,home,14,20,6
1330,4,shop,20,21,1
1330,5,home,21,24,3
1331,1,home,0,8,8
1331,2,work,8,14,6
1331,3,home,14,24,10
1332,1,home,0,7,7
1332,2,shop,7,8,1
1332,3,education,8,11,3
1332,4,home,11,18,7
1332,5,shop,18,19,1
1332,6,home,19,24,5
1333,1,home,0,8,8
1333,2,work,8,14,6
1333,3,home,14,21,7
1333,4,work,21,22,1
1333,5,home,22,24,2
1334,1,home,0,6,6
1334,2,shop,6,7,1
1334,3,home,7,13,6
1334,4,education,13,16,3
1334,5,home,16,24,8
1335,1,home,0,9,9
1335,2,work,9,16,7
1335,3,shop,16,18,2
1335,4,home,18,22,4
1335,5,work,22,23,1
1335,6,home,23,24,1
1336,1,home,0,7,7
1336,2,education,7,11,4
1336,3,home,11,14,3
1336,4,education,14,15,1
1336,5,shop,15,16,1
1336,6,home,16,24,8
1337,1,home,0,8,8
1337,2,work,8,15,7
1337,3,shop,15,16,1
1337,4,home,16,24,8
1338,1,home,0,8,8
1338,2,work,8,14,6
1338,3,shop,14,15,1
1338,4,home,15,21,6
1338,5,work,21,22,1
1338,6,home,22,24,2
1339,1,home,0,6,6
1339,2,shop,6,7,1
1339,3,work,7,13,6
1339,4,home,13,24,11
1340,1,home,0,6,6
1340,2,work,6,13,7
1340,3,shop,13,14,1
1340,4,work,14,19,5
1340,5,home,19,24,5
1341,1,home,0,7,7
1341,2,work,7,13,6
1341,3,home,13,17,4
1341,4,work,17,20,3
1341,5,home,20,24,4
1342,1,home,0,8,8
1342,2,work,8,15,7
1342,3,home,15,21,6
1342,4,shop,21,22,1
1342,5,home,22,24,2
1343,1,home,0,7,7
1343,2,work,7,13,6
1343,3,home,13,17,4
1343,4,shop,17,18,1
1343,5,home,18,24,6
1344,1,home,0,8,8
1344,2,education,8,11,3
1344,3,home,11,16,5
1344,4,shop,16,17,1
1344,5,home,17,24,7
1345,1,home,0,7,7
1345,2,work,7,10,3
1345,3,home,10,17,7
1345,4,work,17,19,2
1345,5,home,19,24,5
1346,1,home,0,7,7
1346,2,work,7,14,7
1346,3,home,14,24,10
1347,1,home,0,7,7
1347,2,shop,7,8,1
1347,3,home,8,13,5
1347,4,education,13,16,3
1347,5,home,16,24,8
1348,1,home,0,6,6
1348,2,work,6,13,7
1348,3,shop,13,14,1
1348,4,home,14,24,10
1349,1,home,0,7,7
1349,2,work,7,14,7
1349,3,home,14,18,4
1349,4,work,18,20,2
1349,5,home,20,23,3
1349,6,work,23,24,1
1350,1,home,0,7,7
1350,2,work,7,14,7
1350,3,shop,14,15,1
1350,4,work,15,20,5
1350,5,home,20,24,4
1351,1,home,0,7,7
1351,2,work,7,9,2
1351,3,home,9,16,7
1351,4,work,16,18,2
1351,5,home,18,22,4
1351,6,work,22,23,1
1351,7,home,23,24,1
1352,1,home,0,8,8
1352,2,education,8,12,4
1352,3,work,12,19,7
1352,4,home,19,24,5
1353,1,home,0,7,7
1353,2,work,7,13,6
1353,3,home,13,17,4
1353,4,work,17,20,3
1353,5,home,20,24,4
1354,1,home,0,8,8
1354,2,work,8,14,6
1354,3,home,14,24,10
1355,1,home,0,6,6
1355,2,shop,6,7,1
1355,3,work,7,9,2
1355,4,home,9,15,6
1355,5,work,15,17,2
1355,6,home,17,24,7
1356,1,home,0,8,8
1356,2,work,8,14,6
1356,3,shop,14,15,1
1356,4,work,15,19,4
1356,5,home,19,24,5
1357,1,home,0,7,7
1357,2,work,7,13,6
1357,3,shop,13,14,1
1357,4,work,14,20,6
1357,5,home,20,24,4
1358,1,home,0,6,6
1358,2,work,6,13,7
1358,3,shop,13,15,2
1358,4,home,15,24,9
1359,1,home,0,6,6
1359,2,work,6,13,7
1359,3,shop,13,14,1
1359,4,work,14,20,6
1359,5,home,20,24,4
1360,1,home,0,8,8
1360,2,work,8,15,7
1360,3,shop,15,16,1
1360,4,home,16,24,8
1361,1,home,0,7,7
1361,2,work,7,14,7
1361,3,home,14,24,10
1362,1,home,0,8,8
1362,2,work,8,15,7
1362,3,home,15,24,9
1363,1,home,0,8,8
1363,2,education,8,11,3
1363,3,home,11,15,4
1363,4,shop,15,16,1
1363,5,home,16,24,8
1364,1,home,0,7,7
1364,2,work,7,13,6
1364,3,home,13,18,5
1364,4,work,18,20,2
1364,5,home,20,24,4
1365,1,home,0,6,6
1365,2,work,6,13,7
1365,3,home,13,18,5
1365,4,work,18,20,2
1365,5,home,20,24,4
1366,1,home,0,7,7
1366,2,work,7,13,6
1366,3,shop,13,14,1
1366,4,education,14,16,2
1366,5,home,16,24,8
1367,1,home,0,6,6
1367,2,shop,6,7,1
1367,3,home,7,10,3
1367,4,education,10,14,4
1367,5,shop,14,15,1
1367,6,home,15,20,5
1367,7,shop,20,21,1
1367,8,home,21,24,3
1368,1,home,0,8,8
1368,2,work,8,14,6
1368,3,home,14,18,4
1368,4,shop,18,19,1
1368,5,home,19,24,5
1369,1,home,0,7,7
1369,2,work,7,13,6
1369,3,shop,13,15,2
1369,4,home,15,24,9
1370,1,home,0,7,7
1370,2,education,7,11,4
1370,3,home,11,16,5
1370,4,shop,16,17,1
1370,5,home,17,24,7
1371,1,home,0,6,6
1371,2,shop,6,7,1
1371,3,home,7,13,6
1371,4,education,13,16,3
1371,5,shop,16,18,2
1371,6,home,18,24,6
1372,1,home,0,6,6
1372,2,work,6,13,7
1372,3,home,13,17,4
1372,4,shop,17,18,1
1372,5,work,18,20,2
1372,6,home,20,24,4
1373,1,home,0,7,7
1373,2,work,7,13,6
1373,3,home,13,15,2
1373,4,work,15,19,4
1373,5,home,19,23,4
1373,6,work,23,24,1
1374,1,home,0,7,7
1374,2,work,7,14,7
1374,3,home,14,24,10
1375,1,home,0,6,6
1375,2,work,6,13,7
1375,3,home,13,24,11
1376,1,home,0,6,6
1376,2,work,6,13,7
1376,3,home,13,24,11
1377,1,home,0,6,6
1377,2,work,6,13,7
1377,3,shop,13,14,1
1377,4,home,14,24,10
1378,1,home,0,8,8
1378,2,work,8,15,7
1378,3,shop,15,16,1
1378,4,work,16,20,4
1378,5,home,20,24,4
1379,1,home,0,9,9
1379,2,work,9,16,7
1379,3,home,16,24,8
1380,1,home,0,8,8
1380,2,work,8,15,7
1380,3,home,15,20,5
1380,4,shop,20,21,1
1380,5,home,21,24,3
1381,1,home,0,7,7
1381,2,work,7,14,7
1381,3,shop,14,15,1
1381,4,work,15,20,5
1381,5,home,20,24,4
1382,1,home,0,7,7
1382,2,work,7,13,6
1382,3,home,13,18,5
1382,4,work,18,20,2
1382,5,home,20,24,4
1383,1,home,0,8,8
1383,2,work,8,15,7
1383,3,home,15,21,6
1383,4,work,21,22,1
1383,5,home,22,24,2
1384,1,home,0,9,9
1384,2,work,9,16,7
1384,3,home,16,19,3
1384,4,shop,19,20,1
1384,5,home,20,24,4
1385,1,home,0,7,7
1385,2,shop,7,9,2
1385,3,work,9,18,9
1385,4,home,18,24,6
1386,1,home,0,7,7
1386,2,work,7,14,7
1386,3,home,14,19,5
1386,4,shop,19,20,1
1386,5,home,20,24,4
1387,1,home,0,8,8
1387,2,work,8,16,8
1387,3,home,16,21,5
1387,4,work,21,22,1
1387,5,home,22,24,2
1388,1,work,0,7,7
1388,2,shop,7,8,1
1388,3,work,8,15,7
1388,4,home,15,24,9
1389,1,home,0,6,6
1389,2,work,6,13,7
1389,3,home,13,24,11
1390,1,home,0,7,7
1390,2,work,7,13,6
1390,3,home,13,16,3
1390,4,work,16,19,3
1390,5,home,19,24,5
1391,1,home,0,6,6
1391,2,shop,6,7,1
1391,3,work,7,13,6
1391,4,home,13,24,11
1392,1,home,0,8,8
1392,2,work,8,15,7
1392,3,shop,15,17,2
1392,4,home,17,21,4
1392,5,shop,21,22,1
1392,6,home,22,24,2
1393,1,work,0,10,10
1393,2,shop,10,11,1
1393,3,work,11,17,6
1393,4,home,17,24,7
1394,1,home,0,6,6
1394,2,work,6,13,7
1394,3,home,13,18,5
1394,4,shop,18,19,1
1394,5,home,19,24,5
1395,1,home,0,8,8
1395,2,work,8,15,7
1395,3,home,15,24,9
1396,1,home,0,7,7
1396,2,education,7,11,4
1396,3,home,11,14,3
1396,4,education,14,16,2
1396,5,home,16,24,8
1397,1,home,0,8,8
1397,2,work,8,15,7
1397,3,home,15,24,9
1398,1,home,0,8,8
1398,2,work,8,15,7
1398,3,home,15,21,6
1398,4,work,21,22,1
1398,5,home,22,24,2
1399,1,home,0,7,7
1399,2,work,7,13,6
1399,3,shop,13,14,1
1399,4,work,14,20,6
1399,5,home,20,24,4
1400,1,home,0,8,8
1400,2,work,8,17,9
1400,3,home,17,24,7
1401,1,home,0,7,7
1401,2,work,7,13,6
1401,3,home,13,18,5
1401,4,work,18,20,2
1401,5,home,20,24,4
1402,1,home,0,6,6
1402,2,work,6,13,7
1402,3,home,13,22,9
1402,4,work,22,23,1
1402,5,home,23,24,1
1403,1,home,0,6,6
1403,2,work,6,13,7
1403,3,home,13,22,9
1403,4,work,22,23,1
1403,5,home,23,24,1
1404,1,home,0,8,8
1404,2,work,8,15,7
1404,3,home,15,24,9
1405,1,home,0,8,8
1405,2,work,8,14,6
1405,3,home,14,19,5
1405,4,shop,19,20,1
1405,5,home,20,24,4
1406,1,home,0,8,8
1406,2,work,8,16,8
1406,3,home,16,24,8
1407,1,home,0,8,8
1407,2,shop,8,9,1
1407,3,home,9,13,4
1407,4,work,13,19,6
1407,5,home,19,24,5
1408,1,home,0,6,6
1408,2,work,6,13,7
1408,3,home,13,24,11
1409,1,home,0,8,8
1409,2,work,8,13,5
1409,3,shop,13,14,1
1409,4,work,14,18,4
1409,5,home,18,24,6
1410,1,home,0,7,7
1410,2,shop,7,8,1
1410,3,home,8,13,5
1410,4,work,13,19,6
1410,5,home,19,23,4
1410,6,work,23,24,1
1411,1,home,0,8,8
1411,2,work,8,14,6
1411,3,shop,14,15,1
1411,4,home,15,23,8
1411,5,work,23,24,1
1412,1,home,0,6,6
1412,2,shop,6,7,1
1412,3,home,7,10,3
1412,4,education,10,13,3
1412,5,shop,13,14,1
1412,6,education,14,16,2
1412,7,shop,16,17,1
1412,8,home,17,21,4
1412,9,shop,21,22,1
1412,10,home,22,24,2
1413,1,home,0,7,7
1413,2,work,7,14,7
1413,3,home,14,24,10
1414,1,home,0,7,7
1414,2,work,7,13,6
1414,3,shop,13,14,1
1414,4,work,14,20,6
1414,5,home,20,24,4
1415,1,home,0,6,6
1415,2,work,6,7,1
1415,3,home,7,9,2
1415,4,work,9,11,2
1415,5,home,11,17,6
1415,6,work,17,19,2
1415,7,home,19,24,5
1416,1,home,0,7,7
1416,2,work,7,13,6
1416,3,home,13,17,4
1416,4,work,17,20,3
1416,5,home,20,24,4
1417,1,home,0,7,7
1417,2,work,7,14,7
1417,3,home,14,22,8
1417,4,work,22,23,1
1417,5,home,23,24,1
1418,1,home,0,6,6
1418,2,work,6,13,7
1418,3,shop,13,14,1
1418,4,work,14,20,6
1418,5,home,20,24,4
1419,1,home,0,7,7
1419,2,shop,7,8,1
1419,3,education,8,11,3
1419,4,home,11,17,6
1419,5,shop,17,18,1
1419,6,home,18,24,6
1420,1,home,0,9,9
1420,2,work,9,16,7
1420,3,home,16,23,7
1420,4,work,23,24,1
1421,1,home,0,6,6
1421,2,work,6,13,7
1421,3,shop,13,15,2
1421,4,home,15,24,9
1422,1,home,0,7,7
1422,2,work,7,9,2
1422,3,home,9,15,6
1422,4,work,15,18,3
1422,5,home,18,24,6
1423,1,home,0,6,6
1423,2,work,6,8,2
1423,3,home,8,14,6
1423,4,work,14,16,2
1423,5,shop,16,17,1
1423,6,home,17,23,6
1423,7,work,23,24,1
1424,1,home,0,7,7
1424,2,work,7,13,6
1424,3,shop,13,14,1
1424,4,home,14,23,9
1424,5,work,23,24,1
1425,1,home,0,8,8
1425,2,work,8,15,7
1425,3,home,15,24,9
1426,1,home,0,8,8
1426,2,work,8,14,6
1426,3,shop,14,15,1
1426,4,work,15,20,5
1426,5,home,20,24,4
1427,1,home,0,7,7
1427,2,work,7,13,6
1427,3,shop,13,14,1
1427,4,work,14,20,6
1427,5,home,20,24,4
1428,1,home,0,7,7
1428,2,work,7,13,6
1428,3,home,13,21,8
1428,4,work,21,22,1
1428,5,home,22,24,2
1429,1,home,0,7,7
1429,2,education,7,11,4
1429,3,home,11,17,6
1429,4,shop,17,18,1
1429,5,home,18,24,6
1430,1,home,0,6,6
1430,2,shop,6,7,1
1430,3,home,7,9,2
1430,4,education,9,11,2
1430,5,home,11,17,6
1430,6,shop,17,18,1
1430,7,home,18,24,6
1431,1,home,0,8,8
1431,2,work,8,13,5
1431,3,home,13,17,4
1431,4,work,17,20,3
1431,5,home,20,24,4
1432,1,home,0,8,8
1432,2,work,8,15,7
1432,3,shop,15,16,1
1432,4,work,16,20,4
1432,5,home,20,24,4
1433,1,home,0,6,6
1433,2,work,6,8,2
1433,3,home,8,12,4
1433,4,work,12,14,2
1433,5,home,14,22,8
1433,6,work,22,23,1
1433,7,home,23,24,1
1434,1,home,0,7,7
1434,2,education,7,12,5
1434,3,shop,12,14,2
1434,4,education,14,16,2
1434,5,home,16,24,8
1435,1,home,0,6,6
1435,2,shop,6,7,1
1435,3,home,7,9,2
1435,4,education,9,12,3
1435,5,home,12,18,6
1435,6,shop,18,19,1
1435,7,home,19,24,5
1436,1,home,0,6,6
1436,2,work,6,8,2
1436,3,home,8,15,7
1436,4,work,15,17,2
1436,5,home,17,23,6
1436,6,work,23,24,1
1437,1,home,0,8,8
1437,2,work,8,15,7
1437,3,home,15,24,9
1438,1,home,0,7,7
1438,2,education,7,11,4
1438,3,home,11,18,7
1438,4,shop,18,20,2
1438,5,home,20,24,4
1439,1,home,0,7,7
1439,2,education,7,12,5
1439,3,shop,12,14,2
1439,4,home,14,24,10
1440,1,home,0,7,7
1440,2,work,7,13,6
1440,3,home,13,24,11
1441,1,home,0,9,9
1441,2,shop,9,10,1
1441,3,work,10,17,7
1441,4,home,17,24,7
1442,1,home,0,8,8
1442,2,work,8,13,5
1442,3,shop,13,14,1
1442,4,work,14,19,5
1442,5,home,19,24,5
1443,1,home,0,8,8
1443,2,work,8,15,7
1443,3,shop,15,16,1
1443,4,work,16,20,4
1443,5,home,20,24,4
1444,1,home,0,7,7
1444,2,education,7,12,5
1444,3,home,12,18,6
1444,4,shop,18,19,1
1444,5,home,19,24,5
1445,1,home,0,7,7
1445,2,work,7,14,7
1445,3,home,14,21,7
1445,4,work,21,22,1
1445,5,home,22,24,2
1446,1,home,0,7,7
1446,2,work,7,14,7
1446,3,home,14,24,10
1447,1,home,0,7,7
1447,2,work,7,13,6
1447,3,home,13,14,1
1447,4,work,14,20,6
1447,5,home,20,24,4
1448,1,home,0,7,7
1448,2,work,7,9,2
1448,3,home,9,13,4
1448,4,work,13,15,2
1448,5,home,15,22,7
1448,6,work,22,23,1
1448,7,home,23,24,1
1449,1,home,0,7,7
1449,2,education,7,11,4
1449,3,home,11,19,8
1449,4,shop,19,20,1
1449,5,home,20,24,4
1450,1,home,0,7,7
1450,2,education,7,10,3
1450,3,home,10,19,9
1450,4,shop,19,20,1
1450,5,home,20,24,4
1451,1,home,0,6,6
1451,2,work,6,13,7
1451,3,home,13,17,4
1451,4,work,17,19,2
1451,5,home,19,24,5
1452,1,home,0,7,7
1452,2,work,7,14,7
1452,3,shop,14,15,1
1452,4,work,15,19,4
1452,5,home,19,24,5
1453,1,home,0,7,7
1453,2,work,7,9,2
1453,3,home,9,15,6
1453,4,work,15,18,3
1453,5,home,18,24,6
1454,1,home,0,7,7
1454,2,work,7,13,6
1454,3,shop,13,14,1
1454,4,work,14,19,5
1454,5,home,19,24,5
1455,1,home,0,6,6
1455,2,shop,6,7,1
1455,3,work,7,13,6
1455,4,home,13,24,11
1456,1,home,0,6,6
1456,2,work,6,13,7
1456,3,shop,13,14,1
1456,4,work,14,19,5
1456,5,home,19,24,5
1457,1,home,0,6,6
1457,2,work,6,8,2
1457,3,home,8,14,6
1457,4,work,14,16,2
1457,5,home,16,22,6
1457,6,work,22,23,1
1457,7,home,23,24,1
1458,1,home,0,7,7
1458,2,shop,7,8,1
1458,3,education,8,11,3
1458,4,home,11,17,6
1458,5,shop,17,19,2
1458,6,home,19,24,5
1459,1,home,0,7,7
1459,2,work,7,13,6
1459,3,shop,13,14,1
1459,4,home,14,18,4
1459,5,work,18,20,2
1459,6,home,20,24,4
1460,1,home,0,8,8
1460,2,work,8,15,7
1460,3,home,15,21,6
1460,4,work,21,22,1
1460,5,home,22,24,2
1461,1,home,0,7,7
1461,2,work,7,14,7
1461,3,home,14,24,10
1462,1,home,0,6,6
1462,2,shop,6,7,1
1462,3,home,7,13,6
1462,4,education,13,16,3
1462,5,home,16,20,4
1462,6,shop,20,21,1
1462,7,home,21,24,3
1463,1,home,0,8,8
1463,2,education,8,11,3
1463,3,home,11,17,6
1463,4,shop,17,18,1
1463,5,home,18,24,6
1464,1,home,0,7,7
1464,2,work,7,14,7
1464,3,home,14,20,6
1464,4,shop,20,21,1
1464,5,home,21,24,3
1465,1,home,0,7,7
1465,2,work,7,13,6
1465,3,shop,13,14,1
1465,4,home,14,15,1
1465,5,work,15,19,4
1465,6,home,19,24,5
1466,1,home,0,8,8
1466,2,work,8,15,7
1466,3,shop,15,16,1
1466,4,home,16,24,8
1467,1,home,0,6,6
1467,2,shop,6,7,1
1467,3,home,7,9,2
1467,4,education,9,12,3
1467,5,home,12,19,7
1467,6,shop,19,20,1
1467,7,home,20,24,4
1468,1,home,0,7,7
1468,2,work,7,13,6
1468,3,home,13,17,4
1468,4,work,17,20,3
1468,5,home,20,24,4
1469,1,home,0,7,7
1469,2,work,7,14,7
1469,3,home,14,24,10
1470,1,home,0,6,6
1470,2,work,6,13,7
1470,3,home,13,24,11
1471,1,home,0,8,8
1471,2,work,8,14,6
1471,3,shop,14,15,1
1471,4,home,15,23,8
1471,5,work,23,24,1
1472,1,home,0,7,7
1472,2,work,7,14,7
1472,3,shop,14,16,2
1472,4,home,16,24,8
1473,1,home,0,7,7
1473,2,work,7,13,6
1473,3,home,13,17,4
1473,4,work,17,20,3
1473,5,home,20,24,4
1474,1,home,0,8,8
1474,2,education,8,11,3
1474,3,home,11,15,4
1474,4,shop,15,16,1
1474,5,work,16,20,4
1474,6,home,20,24,4
1475,1,home,0,9,9
1475,2,work,9,16,7
1475,3,shop,16,17,1
1475,4,home,17,24,7
1476,1,home,0,7,7
1476,2,work,7,14,7
1476,3,shop,14,15,1
1476,4,work,15,19,4
1476,5,home,19,24,5
1477,1,home,0,7,7
1477,2,shop,7,8,1
1477,3,work,8,15,7
1477,4,home,15,18,3
1477,5,work,18,20,2
1477,6,home,20,24,4
1478,1,home,0,7,7
1478,2,education,7,11,4
1478,3,home,11,18,7
1478,4,shop,18,19,1
1478,5,home,19,24,5
1479,1,home,0,6,6
1479,2,work,6,13,7
1479,3,home,13,16,3
1479,4,work,16,20,4
1479,5,home,20,24,4
1480,1,home,0,8,8
1480,2,work,8,15,7
1480,3,home,15,24,9
1481,1,home,0,7,7
1481,2,work,7,13,6
1481,3,shop,13,14,1
1481,4,work,14,20,6
1481,5,home,20,24,4
1482,1,home,0,9,9
1482,2,work,9,16,7
1482,3,home,16,24,8
1483,1,home,0,6,6
1483,2,work,6,8,2
1483,3,home,8,14,6
1483,4,work,14,17,3
1483,5,home,17,24,7
1484,1,home,0,8,8
1484,2,work,8,14,6
1484,3,home,14,19,5
1484,4,shop,19,20,1
1484,5,home,20,24,4
1485,1,home,0,7,7
1485,2,work,7,14,7
1485,3,shop,14,15,1
1485,4,home,15,24,9
1486,1,home,0,6,6
1486,2,work,6,8,2
1486,3,home,8,14,6
1486,4,work,14,17,3
1486,5,home,17,22,5
1486,6,work,22,23,1
1486,7,home,23,24,1
1487,1,home,0,7,7
1487,2,work,7,14,7
1487,3,shop,14,16,2
1487,4,home,16,23,7
1487,5,work,23,24,1
1488,1,home,0,7,7
1488,2,work,7,13,6
1488,3,home,13,24,11
1489,1,home,0,7,7
1489,2,work,7,8,1
1489,3,home,8,13,5
1489,4,work,13,15,2
1489,5,home,15,21,6
1489,6,work,21,22,1
1489,7,home,22,24,2
1490,1,home,0,8,8
1490,2,work,8,15,7
1490,3,home,15,24,9
1491,1,home,0,8,8
1491,2,work,8,13,5
1491,3,home,13,22,9
1491,4,work,22,23,1
1491,5,home,23,24,1
1492,1,home,0,6,6
1492,2,shop,6,7,1
1492,3,work,7,14,7
1492,4,home,14,24,10
1493,1,home,0,8,8
1493,2,education,8,11,3
1493,3,shop,11,12,1
1493,4,work,12,19,7
1493,5,home,19,24,5
1494,1,home,0,7,7
1494,2,work,7,13,6
1494,3,home,13,17,4
1494,4,work,17,20,3
1494,5,home,20,24,4
1495,1,home,0,7,7
1495,2,work,7,13,6
1495,3,home,13,21,8
1495,4,work,21,22,1
1495,5,home,22,24,2
1496,1,home,0,8,8
1496,2,work,8,14,6
1496,3,shop,14,15,1
1496,4,work,15,20,5
1496,5,home,20,24,4
1497,1,home,0,6,6
1497,2,work,6,13,7
1497,3,shop,13,14,1
1497,4,work,14,19,5
1497,5,home,19,24,5
1498,1,home,0,8,8
1498,2,work,8,15,7
1498,3,home,15,19,4
1498,4,shop,19,20,1
1498,5,home,20,24,4
1499,1,home,0,8,8
1499,2,work,8,15,7
1499,3,home,15,24,9
1500,1,home,0,6,6
1500,2,shop,6,7,1
1500,3,home,7,10,3
1500,4,education,10,16,6
1500,5,shop,16,17,1
1500,6,home,17,24,7
1501,1,home,0,6,6
1501,2,work,6,13,7
1501,3,home,13,17,4
1501,4,shop,17,18,1
1501,5,home,18,24,6
1502,1,home,0,7,7
1502,2,work,7,13,6
1502,3,shop,13,14,1
1502,4,home,14,23,9
1502,5,work,23,24,1
1503,1,home,0,7,7
1503,2,work,7,13,6
1503,3,shop,13,14,1
1503,4,work,14,19,5
1503,5,home,19,24,5
1504,1,home,0,7,7
1504,2,work,7,9,2
1504,3,home,9,14,5
1504,4,work,14,17,3
1504,5,home,17,24,7
1505,1,home,0,7,7
1505,2,education,7,11,4
1505,3,home,11,17,6
1505,4,shop,17,18,1
1505,5,home,18,24,6
1506,1,home,0,7,7
1506,2,work,7,13,6
1506,3,shop,13,14,1
1506,4,work,14,16,2
1506,5,home,16,21,5
1506,6,work,21,22,1
1506,7,home,22,24,2
1507,1,home,0,7,7
1507,2,shop,7,8,1
1507,3,home,8,9,1
1507,4,work,9,16,7
1507,5,home,16,24,8
1508,1,home,0,7,7
1508,2,education,7,11,4
1508,3,home,11,17,6
1508,4,shop,17,18,1
1508,5,home,18,24,6
1509,1,home,0,8,8
1509,2,work,8,15,7
1509,3,home,15,24,9
1510,1,home,0,7,7
1510,2,education,7,11,4
1510,3,home,11,18,7
1510,4,shop,18,19,1
1510,5,home,19,24,5
1511,1,home,0,8,8
1511,2,work,8,15,7
1511,3,home,15,21,6
1511,4,work,21,22,1
1511,5,home,22,24,2
1512,1,home,0,7,7
1512,2,education,7,11,4
1512,3,home,11,19,8
1512,4,shop,19,21,2
1512,5,home,21,24,3
1513,1,home,0,8,8
1513,2,work,8,15,7
1513,3,shop,15,17,2
1513,4,home,17,24,7
1514,1,home,0,7,7
1514,2,work,7,13,6
1514,3,home,13,16,3
1514,4,work,16,19,3
1514,5,home,19,24,5
1515,1,home,0,9,9
1515,2,education,9,12,3
1515,3,home,12,16,4
1515,4,work,16,20,4
1515,5,home,20,24,4
1516,1,home,0,7,7
1516,2,work,7,13,6
1516,3,shop,13,14,1
1516,4,home,14,22,8
1516,5,work,22,23,1
1516,6,home,23,24,1
1517,1,home,0,7,7
1517,2,work,7,12,5
1517,3,shop,12,13,1
1517,4,work,13,19,6
1517,5,home,19,24,5
1518,1,home,0,7,7
1518,2,work,7,13,6
1518,3,shop,13,14,1
1518,4,home,14,23,9
1518,5,work,23,24,1
1519,1,home,0,7,7
1519,2,shop,7,8,1
1519,3,home,8,12,4
1519,4,work,12,19,7
1519,5,home,19,24,5
1520,1,home,0,7,7
1520,2,work,7,13,6
1520,3,shop,13,14,1
1520,4,work,14,20,6
1520,5,home,20,24,4
1521,1,home,0,9,9
1521,2,shop,9,10,1
1521,3,work,10,18,8
1521,4,home,18,24,6
1522,1,home,0,6,6
1522,2,work,6,8,2
1522,3,home,8,14,6
1522,4,work,14,16,2
1522,5,home,16,24,8
1523,1,home,0,7,7
1523,2,work,7,14,7
1523,3,shop,14,15,1
1523,4,home,15,23,8
1523,5,work,23,24,1
1524,1,home,0,7,7
1524,2,work,7,9,2
1524,3,home,9,15,6
1524,4,work,15,17,2
1524,5,home,17,23,6
1524,6,work,23,24,1
1525,1,home,0,6,6
1525,2,work,6,8,2
1525,3,home,8,13,5
1525,4,shop,13,14,1
1525,5,work,14,16,2
1525,6,home,16,22,6
1525,7,work,22,23,1
1525,8,home,23,24,1
1526,1,home,0,7,7
1526,2,work,7,13,6
1526,3,home,13,22,9
1526,4,work,22,23,1
1526,5,home,23,24,1
1527,1,home,0,6,6
1527,2,work,6,8,2
1527,3,home,8,14,6
1527,4,work,14,16,2
1527,5,home,16,24,8
1528,1,home,0,8,8
1528,2,work,8,15,7
1528,3,home,15,20,5
1528,4,shop,20,21,1
1528,5,home,21,24,3
1529,1,work,0,10,10
1529,2,shop,10,11,1
1529,3,home,11,17,6
1529,4,work,17,19,2
1529,5,home,19,24,5
1530,1,home,0,7,7
1530,2,work,7,14,7
1530,3,home,14,24,10
1531,1,home,0,7,7
1531,2,work,7,14,7
1531,3,shop,14,15,1
1531,4,home,15,24,9
1532,1,home,0,6,6
1532,2,shop,6,7,1
1532,3,work,7,13,6
1532,4,home,13,24,11
1533,1,home,0,6,6
1533,2,shop,6,7,1
1533,3,home,7,10,3
1533,4,education,10,14,4
1533,5,shop,14,15,1
1533,6,home,15,20,5
1533,7,shop,20,21,1
1533,8,home,21,24,3
1534,1,home,0,6,6
1534,2,work,6,7,1
1534,3,home,7,9,2
1534,4,work,9,11,2
1534,5,home,11,17,6
1534,6,work,17,19,2
1534,7,home,19,24,5
1535,1,home,0,7,7
1535,2,work,7,14,7
1535,3,shop,14,15,1
1535,4,home,15,24,9
1536,1,home,0,6,6
1536,2,work,6,14,8
1536,3,home,14,24,10
1537,1,home,0,6,6
1537,2,work,6,12,6
1537,3,shop,12,13,1
1537,4,work,13,17,4
1537,5,home,17,24,7
1538,1,home,0,7,7
1538,2,education,7,11,4
1538,3,home,11,13,2
1538,4,education,13,16,3
1538,5,home,16,24,8
1539,1,home,0,7,7
1539,2,education,7,11,4
1539,3,home,11,14,3
1539,4,education,14,16,2
1539,5,home,16,24,8
1540,1,home,0,6,6
1540,2,work,6,12,6
1540,3,shop,12,13,1
1540,4,work,13,19,6
1540,5,education,19,20,1
1540,6,home,20,24,4
1541,1,home,0,7,7
1541,2,work,7,13,6
1541,3,shop,13,14,1
1541,4,home,14,21,7
1541,5,work,21,22,1
1541,6,home,22,24,2
1542,1,home,0,7,7
1542,2,shop,7,8,1
1542,3,education,8,11,3
1542,4,home,11,18,7
1542,5,shop,18,20,2
1542,6,home,20,24,4
1543,1,home,0,7,7
1543,2,shop,7,8,1
1543,3,education,8,12,4
1543,4,home,12,21,9
1543,5,shop,21,22,1
1543,6,home,22,24,2
1544,1,home,0,6,6
1544,2,work,6,13,7
1544,3,shop,13,14,1
1544,4,home,14,24,10
1545,1,home,0,8,8
1545,2,work,8,13,5
1545,3,home,13,24,11
1546,1,home,0,7,7
1546,2,education,7,11,4
1546,3,home,11,14,3
1546,4,education,14,17,3
1546,5,shop,17,18,1
1546,6,home,18,24,6
1547,1,home,0,6,6
1547,2,work,6,13,7
1547,3,home,13,14,1
1547,4,shop,14,15,1
1547,5,home,15,24,9
1548,1,home,0,7,7
1548,2,work,7,13,6
1548,3,home,13,17,4
1548,4,shop,17,18,1
1548,5,home,18,23,5
1548,6,work,23,24,1
1549,1,home,0,7,7
1549,2,education,7,11,4
1549,3,home,11,17,6
1549,4,shop,17,18,1
1549,5,home,18,21,3
1549,6,shop,21,22,1
1549,7,home,22,24,2
1550,1,home,0,6,6
1550,2,shop,6,7,1
1550,3,home,7,13,6
1550,4,education,13,16,3
1550,5,home,16,20,4
1550,6,shop,20,21,1
1550,7,home,21,24,3
1551,1,home,0,8,8
1551,2,work,8,15,7
1551,3,home,15,23,8
1551,4,work,23,24,1
1552,1,home,0,6,6
1552,2,work,6,13,7
1552,3,home,13,18,5
1552,4,work,18,20,2
1552,5,home,20,24,4
1553,1,home,0,6,6
1553,2,work,6,13,7
1553,3,home,13,24,11
1554,1,home,0,7,7
1554,2,shop,7,8,1
1554,3,work,8,15,7
1554,4,home,15,24,9
1555,1,home,0,7,7
1555,2,work,7,13,6
1555,3,home,13,24,11
1556,1,home,0,7,7
1556,2,work,7,13,6
1556,3,home,13,24,11
1557,1,home,0,5,5
1557,2,work,5,13,8
1557,3,shop,13,15,2
1557,4,home,15,24,9
1558,1,home,0,7,7
1558,2,work,7,13,6
1558,3,shop,13,14,1
1558,4,home,14,22,8
1558,5,work,22,23,1
1558,6,home,23,24,1
1559,1,home,0,9,9
1559,2,education,9,12,3
1559,3,work,12,19,7
1559,4,home,19,23,4
1559,5,work,23,24,1
1560,1,home,0,7,7
1560,2,work,7,14,7
1560,3,home,14,18,4
1560,4,work,18,20,2
1560,5,home,20,24,4
1561,1,home,0,8,8
1561,2,work,8,14,6
1561,3,home,14,24,10
1562,1,home,0,8,8
1562,2,work,8,13,5
1562,3,shop,13,14,1
1562,4,work,14,19,5
1562,5,education,19,20,1
1562,6,home,20,24,4
1563,1,home,0,6,6
1563,2,work,6,7,1
1563,3,home,7,12,5
1563,4,work,12,14,2
1563,5,home,14,22,8
1563,6,work,22,23,1
1563,7,home,23,24,1
1564,1,home,0,7,7
1564,2,shop,7,8,1
1564,3,home,8,13,5
1564,4,education,13,16,3
1564,5,home,16,24,8
1565,1,home,0,7,7
1565,2,work,7,13,6
1565,3,shop,13,14,1
1565,4,home,14,23,9
1565,5,work,23,24,1
1566,1,home,0,7,7
1566,2,work,7,14,7
1566,3,home,14,22,8
1566,4,work,22,23,1
1566,5,home,23,24,1
1567,1,home,0,9,9
1567,2,work,9,16,7
1567,3,home,16,23,7
1567,4,work,23,24,1
1568,1,home,0,7,7
1568,2,work,7,9,2
1568,3,home,9,16,7
1568,4,work,16,18,2
1568,5,home,18,24,6
1569,1,home,0,8,8
1569,2,shop,8,9,1
1569,3,home,9,16,7
1569,4,work,16,20,4
1569,5,home,20,24,4
1570,1,home,0,7,7
1570,2,work,7,14,7
1570,3,shop,14,15,1
1570,4,home,15,24,9
1571,1,home,0,7,7
1571,2,work,7,13,6
1571,3,shop,13,14,1
1571,4,work,14,19,5
1571,5,home,19,24,5
1572,1,home,0,6,6
1572,2,work,6,8,2
1572,3,home,8,14,6
1572,4,work,14,17,3
1572,5,home,17,23,6
1572,6,work,23,24,1
1573,1,home,0,6,6
1573,2,shop,6,7,1
1573,3,work,7,13,6
1573,4,home,13,22,9
1573,5,work,22,23,1
1573,6,home,23,24,1
1574,1,home,0,7,7
1574,2,work,7,13,6
1574,3,shop,13,14,1
1574,4,home,14,24,10
1575,1,home,0,7,7
1575,2,work,7,13,6
1575,3,shop,13,15,2
1575,4,home,15,24,9
1576,1,home,0,6,6
1576,2,shop,6,7,1
1576,3,home,7,10,3
1576,4,education,10,15,5
1576,5,shop,15,17,2
1576,6,home,17,24,7
1577,1,home,0,7,7
1577,2,work,7,13,6
1577,3,home,13,16,3
1577,4,work,16,20,4
1577,5,home,20,24,4
1578,1,home,0,7,7
1578,2,work,7,9,2
1578,3,home,9,13,4
1578,4,work,13,15,2
1578,5,home,15,21,6
1578,6,work,21,22,1
1578,7,home,22,24,2
1579,1,home,0,8,8
1579,2,work,8,15,7
1579,3,home,15,24,9
1580,1,home,0,8,8
1580,2,work,8,14,6
1580,3,home,14,17,3
1580,4,shop,17,18,1
1580,5,home,18,24,6
1581,1,home,0,6,6
1581,2,work,6,9,3
1581,3,home,9,13,4
1581,4,work,13,15,2
1581,5,home,15,21,6
1581,6,work,21,22,1
1581,7,home,22,24,2
1582,1,home,0,6,6
1582,2,work,6,8,2
1582,3,home,8,15,7
1582,4,work,15,18,3
1582,5,home,18,22,4
1582,6,work,22,23,1
1582,7,home,23,24,1
1583,1,home,0,6,6
1583,2,work,6,13,7
1583,3,home,13,17,4
1583,4,shop,17,18,1
1583,5,home,18,22,4
1583,6,work,22,23,1
1583,7,home,23,24,1
1584,1,home,0,7,7
1584,2,education,7,11,4
1584,3,home,11,15,4
1584,4,shop,15,17,2
1584,5,home,17,24,7
1585,1,home,0,7,7
1585,2,work,7,14,7
1585,3,home,14,18,4
1585,4,work,18,20,2
1585,5,home,20,24,4
1586,1,home,0,6,6
1586,2,work,6,12,6
1586,3,shop,12,13,1
1586,4,work,13,19,6
1586,5,home,19,24,5
1587,1,home,0,6,6
1587,2,shop,6,7,1
1587,3,home,7,12,5
1587,4,work,12,18,6
1587,5,home,18,24,6
1588,1,home,0,7,7
1588,2,work,7,14,7
1588,3,shop,14,15,1
1588,4,home,15,24,9
1589,1,home,0,6,6
1589,2,work,6,8,2
1589,3,home,8,13,5
1589,4,work,13,15,2
1589,5,home,15,23,8
1589,6,work,23,24,1
1590,1,home,0,8,8
1590,2,education,8,12,4
1590,3,shop,12,14,2
1590,4,home,14,21,7
1590,5,shop,21,22,1
1590,6,home,22,24,2
1591,1,home,0,8,8
1591,2,work,8,15,7
1591,3,home,15,24,9
1592,1,home,0,7,7
1592,2,work,7,13,6
1592,3,home,13,17,4
1592,4,work,17,20,3
1592,5,home,20,24,4
1593,1,home,0,7,7
1593,2,work,7,14,7
1593,3,shop,14,15,1
1593,4,home,15,22,7
1593,5,work,22,23,1
1593,6,home,23,24,1
1594,1,home,0,6,6
1594,2,work,6,13,7
1594,3,home,13,24,11
1595,1,home,0,7,7
1595,2,work,7,14,7
1595,3,home,14,24,10
1596,1,home,0,8,8
1596,2,work,8,14,6
1596,3,home,14,24,10
1597,1,home,0,7,7
1597,2,work,7,13,6
1597,3,shop,13,14,1
1597,4,work,14,18,4
1597,5,home,18,24,6
1598,1,home,0,6,6
1598,2,work,6,13,7
1598,3,shop,13,14,1
1598,4,home,14,24,10
1599,1,home,0,8,8
1599,2,education,8,12,4
1599,3,home,12,24,12
1600,1,home,0,7,7
1600,2,work,7,14,7
1600,3,home,14,18,4
1600,4,work,18,20,2
1600,5,home,20,24,4
1601,1,home,0,7,7
1601,2,shop,7,8,1
1601,3,education,8,11,3
1601,4,home,11,14,3
1601,5,education,14,16,2
1601,6,home,16,24,8
1602,1,home,0,7,7
1602,2,education,7,11,4
1602,3,home,11,18,7
1602,4,shop,18,20,2
1602,5,home,20,24,4
1603,1,home,0,6,6
1603,2,shop,6,7,1
1603,3,home,7,10,3
1603,4,education,10,14,4
1603,5,shop,14,15,1
1603,6,home,15,24,9
1604,1,home,0,7,7
1604,2,work,7,13,6
1604,3,home,13,24,11
1605,1,home,0,7,7
1605,2,work,7,13,6
1605,3,shop,13,14,1
1605,4,home,14,24,10
1606,1,home,0,7,7
1606,2,work,7,13,6
1606,3,home,13,17,4
1606,4,shop,17,18,1
1606,5,home,18,22,4
1606,6,work,22,23,1
1606,7,home,23,24,1
1607,1,home,0,6,6
1607,2,work,6,13,7
1607,3,shop,13,14,1
1607,4,home,14,24,10
1608,1,home,0,7,7
1608,2,shop,7,8,1
1608,3,work,8,15,7
1608,4,home,15,24,9
1609,1,home,0,6,6
1609,2,shop,6,7,1
1609,3,work,7,14,7
1609,4,home,14,22,8
1609,5,work,22,23,1
1609,6,home,23,24,1
1610,1,home,0,7,7
1610,2,education,7,11,4
1610,3,home,11,17,6
1610,4,shop,17,18,1
1610,5,home,18,24,6
1611,1,home,0,7,7
1611,2,work,7,13,6
1611,3,home,13,24,11
1612,1,home,0,8,8
1612,2,work,8,15,7
1612,3,home,15,20,5
1612,4,shop,20,21,1
1612,5,home,21,24,3
1613,1,home,0,7,7
1613,2,work,7,13,6
1613,3,shop,13,14,1
1613,4,education,14,17,3
1613,5,home,17,24,7
1614,1,home,0,7,7
1614,2,work,7,14,7
1614,3,shop,14,15,1
1614,4,work,15,20,5
1614,5,home,20,24,4
1615,1,home,0,7,7
1615,2,work,7,13,6
1615,3,shop,13,14,1
1615,4,education,14,16,2
1615,5,home,16,21,5
1615,6,work,21,22,1
1615,7,home,22,24,2
1616,1,home,0,7,7
1616,2,work,7,14,7
1616,3,shop,14,15,1
1616,4,home,15,21,6
1616,5,work,21,22,1
1616,6,home,22,24,2
1617,1,home,0,6,6
1617,2,shop,6,7,1
1617,3,home,7,10,3
1617,4,education,10,13,3
1617,5,shop,13,14,1
1617,6,education,14,16,2
1617,7,home,16,24,8
1618,1,home,0,6,6
1618,2,work,6,12,6
1618,3,shop,12,13,1
1618,4,work,13,19,6
1618,5,home,19,24,5
1619,1,home,0,8,8
1619,2,work,8,13,5
1619,3,home,13,24,11
1620,1,home,0,8,8
1620,2,education,8,11,3
1620,3,home,11,16,5
1620,4,shop,16,17,1
1620,5,home,17,24,7
1621,1,home,0,6,6
1621,2,work,6,8,2
1621,3,home,8,10,2
1621,4,work,10,12,2
1621,5,home,12,20,8
1621,6,shop,20,21,1
1621,7,home,21,24,3
1622,1,home,0,8,8
1622,2,work,8,15,7
1622,3,home,15,24,9
1623,1,home,0,7,7
1623,2,education,7,11,4
1623,3,home,11,17,6
1623,4,shop,17,18,1
1623,5,home,18,24,6
1624,1,home,0,8,8
1624,2,work,8,15,7
1624,3,home,15,24,9
1625,1,home,0,7,7
1625,2,education,7,12,5
1625,3,home,12,18,6
1625,4,shop,18,19,1
1625,5,home,19,24,5
1626,1,home,0,6,6
1626,2,work,6,13,7
1626,3,shop,13,14,1
1626,4,home,14,24,10
1627,1,home,0,6,6
1627,2,work,6,13,7
1627,3,home,13,17,4
1627,4,work,17,19,2
1627,5,home,19,24,5
1628,1,home,0,6,6
1628,2,work,6,13,7
1628,3,shop,13,14,1
1628,4,work,14,20,6
1628,5,home,20,24,4
1629,1,home,0,7,7
1629,2,shop,7,8,1
1629,3,home,8,13,5
1629,4,education,13,16,3
1629,5,home,16,24,8
1630,1,home,0,6,6
1630,2,shop,6,7,1
1630,3,home,7,10,3
1630,4,education,10,13,3
1630,5,home,13,20,7
1630,6,shop,20,21,1
1630,7,home,21,24,3
1631,1,home,0,7,7
1631,2,work,7,14,7
1631,3,home,14,21,7
1631,4,work,21,22,1
1631,5,home,22,24,2
1632,1,home,0,8,8
1632,2,work,8,16,8
1632,3,home,16,24,8
1633,1,home,0,8,8
1633,2,shop,8,9,1
1633,3,education,9,12,3
1633,4,shop,12,14,2
1633,5,education,14,16,2
1633,6,home,16,24,8
1634,1,home,0,6,6
1634,2,work,6,8,2
1634,3,home,8,13,5
1634,4,work,13,15,2
1634,5,home,15,22,7
1634,6,work,22,23,1
1634,7,home,23,24,1
1635,1,home,0,7,7
1635,2,shop,7,8,1
1635,3,home,8,9,1
1635,4,education,9,12,3
1635,5,shop,12,13,1
1635,6,home,13,20,7
1635,7,shop,20,21,1
1635,8,home,21,24,3
1636,1,home,0,8,8
1636,2,work,8,15,7
1636,3,home,15,24,9
1637,1,home,0,8,8
1637,2,work,8,15,7
1637,3,home,15,21,6
1637,4,work,21,22,1
1637,5,home,22,24,2
1638,1,home,0,8,8
1638,2,work,8,15,7
1638,3,home,15,24,9
1639,1,home,0,7,7
1639,2,education,7,11,4
1639,3,home,11,13,2
1639,4,education,13,16,3
1639,5,shop,16,18,2
1639,6,home,18,24,6
1640,1,home,0,7,7
1640,2,work,7,13,6
1640,3,home,13,18,5
1640,4,work,18,20,2
1640,5,home,20,24,4
1641,1,home,0,7,7
1641,2,education,7,11,4
1641,3,home,11,18,7
1641,4,shop,18,20,2
1641,5,home,20,24,4
1642,1,home,0,8,8
1642,2,shop,8,9,1
1642,3,education,9,13,4
1642,4,shop,13,15,2
1642,5,home,15,20,5
1642,6,shop,20,21,1
1642,7,home,21,24,3
1643,1,home,0,6,6
1643,2,work,6,8,2
1643,3,home,8,14,6
1643,4,work,14,16,2
1643,5,home,16,22,6
1643,6,work,22,23,1
1643,7,home,23,24,1
1644,1,home,0,7,7
1644,2,education,7,11,4
1644,3,home,11,16,5
1644,4,shop,16,17,1
1644,5,home,17,24,7
1645,1,home,0,7,7
1645,2,work,7,13,6
1645,3,home,13,16,3
1645,4,shop,16,17,1
1645,5,home,17,22,5
1645,6,work,22,23,1
1645,7,home,23,24,1
1646,1,home,0,8,8
1646,2,work,8,13,5
1646,3,shop,13,14,1
1646,4,education,14,17,3
1646,5,home,17,21,4
1646,6,work,21,22,1
1646,7,home,22,24,2
1647,1,home,0,7,7
1647,2,education,7,11,4
1647,3,home,11,18,7
1647,4,shop,18,19,1
1647,5,home,19,24,5
1648,1,home,0,7,7
1648,2,education,7,12,5
1648,3,shop,12,13,1
1648,4,education,13,15,2
1648,5,shop,15,16,1
1648,6,home,16,24,8
1649,1,home,0,7,7
1649,2,work,7,14,7
1649,3,shop,14,15,1
1649,4,work,15,19,4
1649,5,home,19,24,5
1650,1,home,0,6,6
1650,2,work,6,13,7
1650,3,home,13,17,4
1650,4,work,17,20,3
1650,5,home,20,24,4
1651,1,home,0,8,8
1651,2,work,8,14,6
1651,3,home,14,21,7
1651,4,work,21,22,1
1651,5,home,22,24,2
1652,1,home,0,7,7
1652,2,education,7,11,4
1652,3,home,11,15,4
1652,4,shop,15,17,2
1652,5,home,17,24,7
1653,1,home,0,7,7
1653,2,work,7,14,7
1653,3,home,14,24,10
1654,1,home,0,7,7
1654,2,work,7,14,7
1654,3,home,14,21,7
1654,4,work,21,22,1
1654,5,home,22,24,2
1655,1,home,0,6,6
1655,2,work,6,13,7
1655,3,home,13,24,11
1656,1,home,0,6,6
1656,2,work,6,7,1
1656,3,home,7,11,4
1656,4,work,11,13,2
1656,5,home,13,21,8
1656,6,work,21,22,1
1656,7,home,22,24,2
1657,1,home,0,9,9
1657,2,education,9,12,3
1657,3,home,12,16,4
1657,4,work,16,20,4
1657,5,home,20,24,4
1658,1,home,0,6,6
1658,2,shop,6,7,1
1658,3,work,7,14,7
1658,4,home,14,23,9
1658,5,work,23,24,1
1659,1,home,0,7,7
1659,2,work,7,14,7
1659,3,home,14,17,3
1659,4,work,17,20,3
1659,5,home,20,24,4
1660,1,home,0,8,8
1660,2,work,8,15,7
1660,3,home,15,24,9
1661,1,home,0,6,6
1661,2,work,6,13,7
1661,3,shop,13,15,2
1661,4,home,15,24,9
1662,1,home,0,7,7
1662,2,shop,7,8,1
1662,3,education,8,11,3
1662,4,home,11,14,3
1662,5,education,14,16,2
1662,6,home,16,24,8
1663,1,home,0,6,6
1663,2,work,6,13,7
1663,3,home,13,18,5
1663,4,work,18,20,2
1663,5,home,20,24,4
1664,1,home,0,8,8
1664,2,work,8,14,6
1664,3,home,14,24,10
1665,1,home,0,7,7
1665,2,work,7,13,6
1665,3,shop,13,14,1
1665,4,work,14,20,6
1665,5,home,20,24,4
1666,1,home,0,7,7
1666,2,work,7,13,6
1666,3,shop,13,14,1
1666,4,home,14,24,10
1667,1,home,0,8,8
1667,2,work,8,15,7
1667,3,home,15,22,7
1667,4,work,22,23,1
1667,5,home,23,24,1
1668,1,home,0,6,6
1668,2,shop,6,7,1
1668,3,home,7,13,6
1668,4,education,13,15,2
1668,5,shop,15,16,1
1668,6,home,16,24,8
1669,1,home,0,6,6
1669,2,work,6,7,1
1669,3,home,7,13,6
1669,4,work,13,17,4
1669,5,home,17,21,4
1669,6,work,21,22,1
1669,7,home,22,24,2
1670,1,home,0,6,6
1670,2,work,6,13,7
1670,3,home,13,21,8
1670,4,work,21,22,1
1670,5,home,22,24,2
1671,1,home,0,6,6
1671,2,work,6,13,7
1671,3,home,13,24,11
1672,1,home,0,8,8
1672,2,work,8,15,7
1672,3,home,15,23,8
1672,4,work,23,24,1
1673,1,home,0,8,8
1673,2,work,8,14,6
1673,3,home,14,24,10
1674,1,home,0,8,8
1674,2,education,8,11,3
1674,3,home,11,15,4
1674,4,work,15,20,5
1674,5,home,20,24,4
1675,1,home,0,9,9
1675,2,work,9,16,7
1675,3,home,16,24,8
1676,1,home,0,8,8
1676,2,work,8,15,7
1676,3,home,15,24,9
1677,1,home,0,6,6
1677,2,work,6,13,7
1677,3,home,13,24,11
1678,1,home,0,8,8
1678,2,work,8,14,6
1678,3,shop,14,15,1
1678,4,home,15,24,9
1679,1,home,0,8,8
1679,2,education,8,12,4
1679,3,home,12,18,6
1679,4,shop,18,19,1
1679,5,home,19,24,5
1680,1,home,0,7,7
1680,2,work,7,13,6
1680,3,shop,13,14,1
1680,4,home,14,24,10
1681,1,home,0,6,6
1681,2,work,6,13,7
1681,3,home,13,17,4
1681,4,work,17,20,3
1681,5,home,20,24,4
1682,1,home,0,6,6
1682,2,work,6,13,7
1682,3,shop,13,14,1
1682,4,work,14,20,6
1682,5,home,20,24,4
1683,1,home,0,6,6
1683,2,work,6,13,7
1683,3,home,13,17,4
1683,4,work,17,20,3
1683,5,home,20,24,4
1684,1,home,0,8,8
1684,2,education,8,11,3
1684,3,home,11,19,8
1684,4,shop,19,21,2
1684,5,home,21,24,3
1685,1,home,0,7,7
1685,2,work,7,14,7
1685,3,shop,14,15,1
1685,4,home,15,24,9
1686,1,home,0,6,6
1686,2,shop,6,7,1
1686,3,home,7,9,2
1686,4,education,9,11,2
1686,5,home,11,17,6
1686,6,shop,17,18,1
1686,7,home,18,24,6
1687,1,home,0,6,6
1687,2,shop,6,7,1
1687,3,home,7,10,3
1687,4,education,10,11,1
1687,5,home,11,18,7
1687,6,shop,18,20,2
1687,7,home,20,24,4
1688,1,home,0,7,7
1688,2,work,7,13,6
1688,3,home,13,21,8
1688,4,shop,21,22,1
1688,5,home,22,24,2
1689,1,home,0,6,6
1689,2,shop,6,7,1
1689,3,home,7,8,1
1689,4,work,8,15,7
1689,5,home,15,24,9
1690,1,home,0,7,7
1690,2,work,7,9,2
1690,3,home,9,13,4
1690,4,work,13,15,2
1690,5,home,15,22,7
1690,6,work,22,23,1
1690,7,home,23,24,1
1691,1,home,0,8,8
1691,2,work,8,14,6
1691,3,home,14,24,10
1692,1,home,0,8,8
1692,2,work,8,15,7
1692,3,shop,15,16,1
1692,4,home,16,22,6
1692,5,work,22,23,1
1692,6,home,23,24,1
1693,1,home,0,7,7
1693,2,education,7,11,4
1693,3,home,11,17,6
1693,4,shop,17,18,1
1693,5,home,18,24,6
1694,1,home,0,6,6
1694,2,work,6,13,7
1694,3,home,13,21,8
1694,4,work,21,22,1
1694,5,home,22,24,2
1695,1,home,0,8,8
1695,2,shop,8,9,1
1695,3,home,9,13,4
1695,4,education,13,16,3
1695,5,shop,16,17,1
1695,6,home,17,24,7
1696,1,home,0,7,7
1696,2,work,7,13,6
1696,3,shop,13,14,1
1696,4,home,14,24,10
1697,1,home,0,8,8
1697,2,work,8,14,6
1697,3,shop,14,15,1
1697,4,home,15,22,7
1697,5,work,22,23,1
1697,6,home,23,24,1
1698,1,home,0,6,6
1698,2,shop,6,7,1
1698,3,work,7,9,2
1698,4,home,9,12,3
1698,5,work,12,14,2
1698,6,home,14,21,7
1698,7,work,21,22,1
1698,8,home,22,24,2
1699,1,home,0,6,6
1699,2,shop,6,7,1
1699,3,home,7,13,6
1699,4,education,13,17,4
1699,5,home,17,24,7
1700,1,home,0,7,7
1700,2,work,7,13,6
1700,3,home,13,16,3
1700,4,work,16,20,4
1700,5,home,20,24,4
1701,1,home,0,7,7
1701,2,shop,7,8,1
1701,3,home,8,13,5
1701,4,work,13,19,6
1701,5,education,19,20,1
1701,6,home,20,24,4
1702,1,home,0,6,6
1702,2,work,6,13,7
1702,3,home,13,24,11
1703,1,home,0,8,8
1703,2,work,8,13,5
1703,3,shop,13,14,1
1703,4,home,14,24,10
1704,1,home,0,7,7
1704,2,education,7,12,5
1704,3,shop,12,14,2
1704,4,education,14,16,2
1704,5,shop,16,17,1
1704,6,home,17,24,7
1705,1,home,0,8,8
1705,2,shop,8,10,2
1705,3,education,10,12,2
1705,4,home,12,19,7
1705,5,shop,19,21,2
1705,6,home,21,24,3
1706,1,home,0,6,6
1706,2,work,6,13,7
1706,3,shop,13,14,1
1706,4,home,14,22,8
1706,5,work,22,23,1
1706,6,home,23,24,1
1707,1,home,0,6,6
1707,2,work,6,8,2
1707,3,home,8,12,4
1707,4,work,12,14,2
1707,5,home,14,21,7
1707,6,work,21,22,1
1707,7,home,22,24,2
1708,1,home,0,7,7
1708,2,education,7,11,4
1708,3,home,11,18,7
1708,4,shop,18,19,1
1708,5,home,19,24,5
1709,1,home,0,7,7
1709,2,work,7,13,6
1709,3,home,13,19,6
1709,4,shop,19,20,1
1709,5,home,20,24,4
1710,1,home,0,6,6
1710,2,work,6,13,7
1710,3,shop,13,14,1
1710,4,home,14,24,10
1711,1,home,0,8,8
1711,2,work,8,14,6
1711,3,home,14,18,4
1711,4,shop,18,19,1
1711,5,home,19,24,5
1712,1,home,0,7,7
1712,2,education,7,11,4
1712,3,home,11,18,7
1712,4,shop,18,19,1
1712,5,home,19,24,5
1713,1,home,0,6,6
1713,2,shop,6,7,1
1713,3,home,7,14,7
1713,4,education,14,16,2
1713,5,home,16,24,8
1714,1,home,0,8,8
1714,2,education,8,11,3
1714,3,home,11,14,3
1714,4,education,14,16,2
1714,5,shop,16,17,1
1714,6,home,17,24,7
1715,1,home,0,8,8
1715,2,education,8,11,3
1715,3,home,11,19,8
1715,4,shop,19,20,1
1715,5,home,20,24,4
1716,1,home,0,8,8
1716,2,work,8,17,9
1716,3,home,17,24,7
1717,1,home,0,6,6
1717,2,shop,6,7,1
1717,3,home,7,12,5
1717,4,education,12,14,2
1717,5,shop,14,15,1
1717,6,home,15,24,9
1718,1,home,0,6,6
1718,2,work,6,13,7
1718,3,home,13,24,11
1719,1,home,0,6,6
1719,2,work,6,8,2
1719,3,home,8,14,6
1719,4,work,14,15,1
1719,5,home,15,21,6
1719,6,work,21,22,1
1719,7,home,22,24,2
1720,1,home,0,9,9
1720,2,work,9,17,8
1720,3,home,17,24,7
1721,1,home,0,9,9
1721,2,work,9,14,5
1721,3,shop,14,15,1
1721,4,home,15,24,9
1722,1,home,0,6,6
1722,2,work,6,8,2
1722,3,home,8,13,5
1722,4,work,13,15,2
1722,5,home,15,21,6
1722,6,work,21,22,1
1722,7,home,22,24,2
1723,1,home,0,7,7
1723,2,work,7,13,6
1723,3,shop,13,14,1
1723,4,home,14,23,9
1723,5,work,23,24,1
1724,1,home,0,8,8
1724,2,work,8,15,7
1724,3,home,15,24,9
1725,1,home,0,7,7
1725,2,work,7,9,2
1725,3,home,9,14,5
1725,4,work,14,17,3
1725,5,home,17,24,7
1726,1,home,0,6,6
1726,2,shop,6,7,1
1726,3,home,7,13,6
1726,4,education,13,16,3
1726,5,home,16,21,5
1726,6,shop,21,22,1
1726,7,home,22,24,2
1727,1,home,0,7,7
1727,2,work,7,14,7
1727,3,home,14,24,10
1728,1,home,0,7,7
1728,2,work,7,9,2
1728,3,home,9,15,6
1728,4,work,15,17,2
1728,5,home,17,24,7
1729,1,home,0,7,7
1729,2,work,7,9,2
1729,3,home,9,16,7
1729,4,work,16,18,2
1729,5,home,18,24,6
1730,1,home,0,7,7
1730,2,shop,7,8,1
1730,3,education,8,11,3
1730,4,home,11,18,7
1730,5,shop,18,19,1
1730,6,home,19,24,5
1731,1,home,0,7,7
1731,2,education,7,12,5
1731,3,home,12,18,6
1731,4,shop,18,20,2
1731,5,home,20,24,4
1732,1,home,0,7,7
1732,2,work,7,13,6
1732,3,shop,13,14,1
1732,4,work,14,19,5
1732,5,home,19,24,5
1733,1,home,0,7,7
1733,2,education,7,11,4
1733,3,home,11,17,6
1733,4,shop,17,18,1
1733,5,home,18,24,6
1734,1,home,0,7,7
1734,2,work,7,13,6
1734,3,home,13,22,9
1734,4,work,22,23,1
1734,5,home,23,24,1
1735,1,home,0,7,7
1735,2,work,7,13,6
1735,3,shop,13,14,1
1735,4,home,14,24,10
1736,1,home,0,7,7
1736,2,work,7,13,6
1736,3,shop,13,14,1
1736,4,home,14,22,8
1736,5,work,22,23,1
1736,6,home,23,24,1
1737,1,home,0,8,8
1737,2,work,8,14,6
1737,3,shop,14,15,1
1737,4,home,15,16,1
1737,5,work,16,20,4
1737,6,home,20,24,4
1738,1,home,0,7,7
1738,2,work,7,13,6
1738,3,home,13,24,11
1739,1,home,0,7,7
1739,2,work,7,14,7
1739,3,shop,14,15,1
1739,4,home,15,24,9
1740,1,home,0,6,6
1740,2,work,6,8,2
1740,3,home,8,10,2
1740,4,work,10,13,3
1740,5,home,13,16,3
1740,6,work,16,18,2
1740,7,home,18,21,3
1740,8,work,21,22,1
1740,9,home,22,24,2
1741,1,home,0,7,7
1741,2,work,7,13,6
1741,3,home,13,17,4
1741,4,work,17,19,2
1741,5,home,19,24,5
1742,1,home,0,7,7
1742,2,work,7,13,6
1742,3,home,13,17,4
1742,4,work,17,20,3
1742,5,home,20,24,4
1743,1,home,0,7,7
1743,2,work,7,13,6
1743,3,shop,13,14,1
1743,4,work,14,20,6
1743,5,home,20,24,4
1744,1,home,0,6,6
1744,2,work,6,13,7
1744,3,shop,13,14,1
1744,4,education,14,17,3
1744,5,shop,17,18,1
1744,6,home,18,23,5
1744,7,work,23,24,1
1745,1,home,0,9,9
1745,2,education,9,12,3
1745,3,home,12,16,4
1745,4,work,16,20,4
1745,5,home,20,24,4
1746,1,home,0,6,6
1746,2,work,6,13,7
1746,3,home,13,21,8
1746,4,work,21,22,1
1746,5,home,22,24,2
1747,1,home,0,7,7
1747,2,education,7,10,3
1747,3,home,10,17,7
1747,4,shop,17,18,1
1747,5,home,18,24,6
1748,1,home,0,8,8
1748,2,work,8,15,7
1748,3,home,15,24,9
1749,1,home,0,8,8
1749,2,work,8,14,6
1749,3,home,14,24,10
1750,1,home,0,6,6
1750,2,shop,6,7,1
1750,3,home,7,13,6
1750,4,education,13,16,3
1750,5,shop,16,18,2
1750,6,home,18,24,6
1751,1,home,0,7,7
1751,2,education,7,12,5
1751,3,home,12,18,6
1751,4,shop,18,19,1
1751,5,home,19,24,5
1752,1,home,0,8,8
1752,2,work,8,13,5
1752,3,home,13,24,11
1753,1,home,0,6,6
1753,2,shop,6,7,1
1753,3,home,7,10,3
1753,4,education,10,13,3
1753,5,home,13,20,7
1753,6,shop,20,21,1
1753,7,home,21,24,3
1754,1,home,0,6,6
1754,2,work,6,7,1
1754,3,home,7,12,5
1754,4,work,12,14,2
1754,5,home,14,21,7
1754,6,work,21,22,1
1754,7,home,22,24,2
1755,1,home,0,8,8
1755,2,work,8,15,7
1755,3,home,15,19,4
1755,4,shop,19,20,1
1755,5,home,20,24,4
1756,1,home,0,7,7
1756,2,education,7,11,4
1756,3,home,11,17,6
1756,4,shop,17,18,1
1756,5,home,18,24,6
1757,1,home,0,8,8
1757,2,work,8,16,8
1757,3,home,16,20,4
1757,4,shop,20,21,1
1757,5,home,21,24,3
1758,1,home,0,8,8
1758,2,work,8,15,7
1758,3,home,15,20,5
1758,4,shop,20,21,1
1758,5,home,21,24,3
1759,1,home,0,7,7
1759,2,shop,7,8,1
1759,3,education,8,11,3
1759,4,home,11,18,7
1759,5,shop,18,20,2
1759,6,home,20,24,4
1760,1,home,0,6,6
1760,2,work,6,13,7
1760,3,home,13,24,11
1761,1,home,0,6,6
1761,2,shop,6,7,1
1761,3,home,7,10,3
1761,4,education,10,14,4
1761,5,shop,14,15,1
1761,6,home,15,24,9
1762,1,home,0,7,7
1762,2,work,7,8,1
1762,3,home,8,9,1
1762,4,work,9,11,2
1762,5,home,11,18,7
1762,6,work,18,19,1
1762,7,home,19,24,5
1763,1,home,0,8,8
1763,2,work,8,15,7
1763,3,home,15,24,9
1764,1,home,0,9,9
1764,2,work,9,15,6
1764,3,shop,15,16,1
1764,4,home,16,24,8
1765,1,home,0,6,6
1765,2,work,6,13,7
1765,3,home,13,24,11
1766,1,home,0,6,6
1766,2,work,6,13,7
1766,3,shop,13,14,1
1766,4,home,14,24,10
1767,1,home,0,7,7
1767,2,work,7,13,6
1767,3,shop,13,14,1
1767,4,education,14,17,3
1767,5,home,17,24,7
1768,1,home,0,9,9
1768,2,work,9,17,8
1768,3,home,17,21,4
1768,4,work,21,22,1
1768,5,home,22,24,2
1769,1,home,0,6,6
1769,2,work,6,12,6
1769,3,shop,12,13,1
1769,4,work,13,18,5
1769,5,education,18,19,1
1769,6,home,19,24,5
1770,1,home,0,7,7
1770,2,work,7,14,7
1770,3,shop,14,15,1
1770,4,home,15,24,9
1771,1,home,0,8,8
1771,2,work,8,14,6
1771,3,home,14,20,6
1771,4,shop,20,21,1
1771,5,home,21,24,3
1772,1,home,0,7,7
1772,2,work,7,14,7
1772,3,home,14,21,7
1772,4,shop,21,22,1
1772,5,home,22,24,2
1773,1,home,0,8,8
1773,2,work,8,14,6
1773,3,shop,14,15,1
1773,4,work,15,20,5
1773,5,home,20,24,4
1774,1,home,0,7,7
1774,2,work,7,13,6
1774,3,home,13,17,4
1774,4,shop,17,18,1
1774,5,home,18,24,6
1775,1,home,0,6,6
1775,2,work,6,7,1
1775,3,home,7,8,1
1775,4,work,8,10,2
1775,5,home,10,16,6
1775,6,work,16,18,2
1775,7,home,18,22,4
1775,8,work,22,23,1
1775,9,home,23,24,1
1776,1,home,0,7,7
1776,2,work,7,9,2
1776,3,home,9,16,7
1776,4,work,16,17,1
1776,5,home,17,24,7
1777,1,home,0,7,7
1777,2,shop,7,8,1
1777,3,work,8,15,7
1777,4,home,15,24,9
1778,1,home,0,8,8
1778,2,work,8,14,6
1778,3,shop,14,15,1
1778,4,work,15,20,5
1778,5,home,20,24,4
1779,1,home,0,7,7
1779,2,education,7,11,4
1779,3,home,11,17,6
1779,4,shop,17,19,2
1779,5,home,19,24,5
1780,1,home,0,6,6
1780,2,work,6,13,7
1780,3,shop,13,14,1
1780,4,work,14,19,5
1780,5,home,19,23,4
1780,6,work,23,24,1
1781,1,home,0,8,8
1781,2,work,8,17,9
1781,3,home,17,21,4
1781,4,work,21,22,1
1781,5,home,22,24,2
1782,1,home,0,7,7
1782,2,work,7,13,6
1782,3,shop,13,14,1
1782,4,work,14,19,5
1782,5,home,19,24,5
1783,1,home,0,6,6
1783,2,shop,6,7,1
1783,3,work,7,15,8
1783,4,home,15,23,8
1783,5,work,23,24,1
1784,1,home,0,8,8
1784,2,work,8,15,7
1784,3,home,15,24,9
1785,1,home,0,6,6
1785,2,work,6,8,2
1785,3,home,8,12,4
1785,4,work,12,14,2
1785,5,home,14,20,6
1785,6,shop,20,21,1
1785,7,home,21,24,3
1786,1,home,0,7,7
1786,2,work,7,13,6
1786,3,shop,13,14,1
1786,4,work,14,20,6
1786,5,home,20,24,4
1787,1,home,0,6,6
1787,2,work,6,13,7
1787,3,home,13,15,2
1787,4,work,15,19,4
1787,5,home,19,24,5
1788,1,home,0,6,6
1788,2,work,6,13,7
1788,3,shop,13,14,1
1788,4,work,14,19,5
1788,5,home,19,24,5
1789,1,home,0,8,8
1789,2,work,8,16,8
1789,3,home,16,21,5
1789,4,shop,21,22,1
1789,5,home,22,24,2
1790,1,home,0,6,6
1790,2,shop,6,7,1
1790,3,home,7,9,2
1790,4,work,9,13,4
1790,5,shop,13,14,1
1790,6,work,14,19,5
1790,7,home,19,24,5
1791,1,home,0,8,8
1791,2,shop,8,9,1
1791,3,home,9,14,5
1791,4,work,14,20,6
1791,5,home,20,24,4
1792,1,home,0,6,6
1792,2,shop,6,7,1
1792,3,home,7,13,6
1792,4,education,13,16,3
1792,5,home,16,24,8
1793,1,home,0,7,7
1793,2,work,7,13,6
1793,3,home,13,15,2
1793,4,work,15,20,5
1793,5,home,20,24,4
1794,1,home,0,7,7
1794,2,work,7,9,2
1794,3,home,9,14,5
1794,4,work,14,17,3
1794,5,home,17,23,6
1794,6,work,23,24,1
1795,1,home,0,6,6
1795,2,work,6,13,7
1795,3,shop,13,14,1
1795,4,work,14,20,6
1795,5,home,20,24,4
1796,1,home,0,6,6
1796,2,work,6,13,7
1796,3,shop,13,14,1
1796,4,home,14,22,8
1796,5,work,22,23,1
1796,6,home,23,24,1
1797,1,home,0,7,7
1797,2,work,7,13,6
1797,3,shop,13,15,2
1797,4,home,15,24,9
1798,1,home,0,7,7
1798,2,work,7,14,7
1798,3,home,14,21,7
1798,4,work,21,22,1
1798,5,home,22,24,2
1799,1,home,0,9,9
1799,2,shop,9,10,1
1799,3,work,10,17,7
1799,4,home,17,22,5
1799,5,work,22,23,1
1799,6,home,23,24,1
1800,1,home,0,8,8
1800,2,education,8,11,3
1800,3,home,11,13,2
1800,4,education,13,16,3
1800,5,shop,16,17,1
1800,6,home,17,24,7
1801,1,home,0,8,8
1801,2,work,8,15,7
1801,3,home,15,24,9
1802,1,home,0,8,8
1802,2,work,8,15,7
1802,3,home,15,23,8
1802,4,work,23,24,1
1803,1,home,0,7,7
1803,2,work,7,14,7
1803,3,home,14,24,10
1804,1,home,0,7,7
1804,2,work,7,14,7
1804,3,home,14,21,7
1804,4,shop,21,22,1
1804,5,home,22,24,2
1805,1,home,0,8,8
1805,2,work,8,9,1
1805,3,home,9,13,4
1805,4,shop,13,14,1
1805,5,home,14,22,8
1805,6,work,22,23,1
1805,7,home,23,24,1
1806,1,home,0,8,8
1806,2,work,8,15,7
1806,3,home,15,24,9
1807,1,home,0,7,7
1807,2,work,7,14,7
1807,3,shop,14,15,1
1807,4,home,15,23,8
1807,5,work,23,24,1
1808,1,home,0,6,6
1808,2,work,6,12,6
1808,3,shop,12,13,1
1808,4,work,13,19,6
1808,5,home,19,24,5
1809,1,home,0,7,7
1809,2,education,7,11,4
1809,3,home,11,18,7
1809,4,shop,18,20,2
1809,5,home,20,24,4
1810,1,home,0,7,7
1810,2,shop,7,8,1
1810,3,education,8,11,3
1810,4,home,11,17,6
1810,5,shop,17,18,1
1810,6,home,18,24,6
1811,1,home,0,7,7
1811,2,education,7,11,4
1811,3,home,11,17,6
1811,4,shop,17,19,2
1811,5,home,19,24,5
1812,1,home,0,7,7
1812,2,work,7,15,8
1812,3,home,15,21,6
1812,4,shop,21,22,1
1812,5,home,22,24,2
1813,1,home,0,7,7
1813,2,education,7,11,4
1813,3,home,11,14,3
1813,4,education,14,16,2
1813,5,home,16,24,8
1814,1,home,0,8,8
1814,2,work,8,14,6
1814,3,home,14,24,10
1815,1,home,0,7,7
1815,2,work,7,14,7
1815,3,home,14,24,10
1816,1,home,0,8,8
1816,2,work,8,15,7
1816,3,home,15,24,9
1817,1,home,0,7,7
1817,2,work,7,14,7
1817,3,shop,14,15,1
1817,4,work,15,20,5
1817,5,home,20,24,4
1818,1,home,0,7,7
1818,2,work,7,9,2
1818,3,home,9,13,4
1818,4,work,13,15,2
1818,5,home,15,21,6
1818,6,work,21,22,1
1818,7,home,22,24,2
1819,1,home,0,6,6
1819,2,work,6,8,2
1819,3,home,8,14,6
1819,4,work,14,16,2
1819,5,home,16,23,7
1819,6,work,23,24,1
1820,1,home,0,8,8
1820,2,shop,8,9,1
1820,3,work,9,16,7
1820,4,home,16,24,8
1821,1,home,0,6,6
1821,2,work,6,13,7
1821,3,shop,13,14,1
1821,4,work,14,20,6
1821,5,home,20,24,4
1822,1,home,0,7,7
1822,2,education,7,11,4
1822,3,home,11,18,7
1822,4,shop,18,20,2
1822,5,home,20,24,4
1823,1,home,0,7,7
1823,2,work,7,14,7
1823,3,home,14,24,10
1824,1,home,0,6,6
1824,2,work,6,13,7
1824,3,home,13,17,4
1824,4,work,17,20,3
1824,5,home,20,24,4
1825,1,home,0,7,7
1825,2,work,7,14,7
1825,3,home,14,21,7
1825,4,shop,21,22,1
1825,5,home,22,24,2
1826,1,home,0,6,6
1826,2,work,6,13,7
1826,3,home,13,24,11
1827,1,home,0,6,6
1827,2,shop,6,7,1
1827,3,home,7,9,2
1827,4,education,9,12,3
1827,5,home,12,21,9
1827,6,shop,21,22,1
1827,7,home,22,24,2
1828,1,home,0,7,7
1828,2,education,7,11,4
1828,3,home,11,14,3
1828,4,education,14,16,2
1828,5,home,16,24,8
1829,1,home,0,6,6
1829,2,work,6,13,7
1829,3,home,13,14,1
1829,4,work,14,15,1
1829,5,shop,15,16,1
1829,6,home,16,24,8
1830,1,home,0,6,6
1830,2,shop,6,7,1
1830,3,home,7,10,3
1830,4,education,10,12,2
1830,5,home,12,19,7
1830,6,shop,19,20,1
1830,7,home,20,24,4
1831,1,home,0,7,7
1831,2,work,7,13,6
1831,3,shop,13,14,1
1831,4,home,14,22,8
1831,5,work,22,23,1
1831,6,home,23,24,1
1832,1,home,0,6,6
1832,2,shop,6,7,1
1832,3,work,7,8,1
1832,4,home,8,9,1
1832,5,work,9,11,2
1832,6,home,11,16,5
1832,7,work,16,18,2
1832,8,home,18,23,5
1832,9,work,23,24,1
1833,1,home,0,6,6
1833,2,work,6,13,7
1833,3,shop,13,14,1
1833,4,home,14,24,10
1834,1,home,0,8,8
1834,2,education,8,11,3
1834,3,home,11,17,6
1834,4,shop,17,18,1
1834,5,home,18,24,6
1835,1,home,0,8,8
1835,2,work,8,15,7
1835,3,home,15,19,4
1835,4,shop,19,20,1
1835,5,home,20,24,4
1836,1,home,0,7,7
1836,2,work,7,14,7
1836,3,shop,14,16,2
1836,4,work,16,19,3
1836,5,home,19,24,5
1837,1,home,0,7,7
1837,2,work,7,14,7
1837,3,shop,14,15,1
1837,4,home,15,24,9
1838,1,home,0,7,7
1838,2,education,7,11,4
1838,3,home,11,15,4
1838,4,shop,15,16,1
1838,5,home,16,24,8
1839,1,home,0,7,7
1839,2,work,7,13,6
1839,3,shop,13,14,1
1839,4,home,14,20,6
1839,5,shop,20,21,1
1839,6,home,21,24,3
1840,1,home,0,7,7
1840,2,education,7,12,5
1840,3,home,12,19,7
1840,4,shop,19,20,1
1840,5,home,20,24,4
1841,1,home,0,6,6
1841,2,work,6,8,2
1841,3,home,8,13,5
1841,4,work,13,15,2
1841,5,home,15,23,8
1841,6,work,23,24,1
1842,1,home,0,8,8
1842,2,work,8,14,6
1842,3,home,14,18,4
1842,4,shop,18,19,1
1842,5,home,19,24,5
1843,1,home,0,7,7
1843,2,work,7,9,2
1843,3,home,9,13,4
1843,4,work,13,15,2
1843,5,home,15,22,7
1843,6,work,22,23,1
1843,7,home,23,24,1
1844,1,home,0,7,7
1844,2,work,7,13,6
1844,3,home,13,20,7
1844,4,shop,20,21,1
1844,5,home,21,24,3
1845,1,home,0,6,6
1845,2,work,6,13,7
1845,3,home,13,22,9
1845,4,work,22,23,1
1845,5,home,23,24,1
1846,1,home,0,6,6
1846,2,work,6,13,7
1846,3,shop,13,14,1
1846,4,home,14,23,9
1846,5,work,23,24,1
1847,1,home,0,7,7
1847,2,work,7,13,6
1847,3,shop,13,14,1
1847,4,home,14,18,4
1847,5,shop,18,19,1
1847,6,home,19,24,5
1848,1,home,0,6,6
1848,2,shop,6,7,1
1848,3,home,7,13,6
1848,4,education,13,16,3
1848,5,home,16,21,5
1848,6,shop,21,22,1
1848,7,home,22,24,2
1849,1,home,0,7,7
1849,2,work,7,14,7
1849,3,shop,14,15,1
1849,4,work,15,19,4
1849,5,home,19,24,5
1850,1,home,0,7,7
1850,2,work,7,14,7
1850,3,home,14,24,10
1851,1,home,0,7,7
1851,2,work,7,14,7
1851,3,home,14,18,4
1851,4,shop,18,19,1
1851,5,home,19,24,5
1852,1,home,0,8,8
1852,2,work,8,15,7
1852,3,shop,15,16,1
1852,4,home,16,24,8
1853,1,home,0,7,7
1853,2,work,7,9,2
1853,3,home,9,13,4
1853,4,work,13,17,4
1853,5,home,17,21,4
1853,6,work,21,22,1
1853,7,home,22,24,2
1854,1,home,0,7,7
1854,2,work,7,14,7
1854,3,shop,14,15,1
1854,4,work,15,20,5
1854,5,home,20,24,4
1855,1,home,0,6,6
1855,2,shop,6,7,1
1855,3,work,7,13,6
1855,4,home,13,16,3
1855,5,work,16,20,4
1855,6,home,20,24,4
1856,1,home,0,9,9
1856,2,work,9,17,8
1856,3,home,17,21,4
1856,4,shop,21,22,1
1856,5,home,22,24,2
1857,1,home,0,7,7
1857,2,work,7,13,6
1857,3,shop,13,14,1
1857,4,work,14,20,6
1857,5,home,20,24,4
1858,1,home,0,6,6
1858,2,shop,6,7,1
1858,3,home,7,9,2
1858,4,work,9,11,2
1858,5,home,11,21,10
1858,6,work,21,22,1
1858,7,home,22,24,2
1859,1,home,0,7,7
1859,2,work,7,13,6
1859,3,shop,13,14,1
1859,4,home,14,18,4
1859,5,work,18,20,2
1859,6,home,20,24,4
1860,1,home,0,8,8
1860,2,shop,8,9,1
1860,3,work,9,17,8
1860,4,home,17,24,7
1861,1,home,0,7,7
1861,2,work,7,14,7
1861,3,home,14,23,9
1861,4,work,23,24,1
1862,1,home,0,6,6
1862,2,work,6,8,2
1862,3,home,8,14,6
1862,4,work,14,15,1
1862,5,home,15,21,6
1862,6,work,21,22,1
1862,7,home,22,24,2
1863,1,home,0,7,7
1863,2,work,7,14,7
1863,3,home,14,21,7
1863,4,shop,21,22,1
1863,5,home,22,24,2
1864,1,home,0,6,6
1864,2,work,6,7,1
1864,3,home,7,10,3
1864,4,work,10,12,2
1864,5,home,12,18,6
1864,6,work,18,19,1
1864,7,home,19,23,4
1864,8,work,23,24,1
1865,1,home,0,8,8
1865,2,work,8,15,7
1865,3,home,15,16,1
1865,4,work,16,20,4
1865,5,home,20,24,4
1866,1,home,0,7,7
1866,2,work,7,14,7
1866,3,shop,14,15,1
1866,4,home,15,24,9
1867,1,home,0,7,7
1867,2,shop,7,8,1
1867,3,work,8,15,7
1867,4,home,15,24,9
1868,1,home,0,8,8
1868,2,work,8,14,6
1868,3,home,14,18,4
1868,4,work,18,19,1
1868,5,education,19,20,1
1868,6,home,20,24,4
1869,1,home,0,7,7
1869,2,education,7,11,4
1869,3,home,11,17,6
1869,4,shop,17,18,1
1869,5,home,18,24,6
1870,1,home,0,6,6
1870,2,work,6,12,6
1870,3,shop,12,13,1
1870,4,work,13,19,6
1870,5,home,19,24,5
1871,1,home,0,6,6
1871,2,work,6,13,7
1871,3,home,13,17,4
1871,4,work,17,20,3
1871,5,home,20,24,4
1872,1,home,0,9,9
1872,2,work,9,16,7
1872,3,home,16,23,7
1872,4,work,23,24,1
1873,1,home,0,8,8
1873,2,work,8,13,5
1873,3,shop,13,14,1
1873,4,work,14,20,6
1873,5,home,20,24,4
1874,1,home,0,7,7
1874,2,work,7,14,7
1874,3,shop,14,15,1
1874,4,home,15,24,9
1875,1,home,0,7,7
1875,2,work,7,8,1
1875,3,home,8,14,6
1875,4,work,14,17,3
1875,5,home,17,21,4
1875,6,work,21,22,1
1875,7,home,22,24,2
1876,1,home,0,8,8
1876,2,work,8,14,6
1876,3,home,14,24,10
1877,1,home,0,7,7
1877,2,shop,7,8,1
1877,3,education,8,11,3
1877,4,home,11,18,7
1877,5,shop,18,19,1
1877,6,home,19,24,5
1878,1,home,0,6,6
1878,2,work,6,13,7
1878,3,home,13,21,8
1878,4,shop,21,22,1
1878,5,home,22,24,2
1879,1,home,0,7,7
1879,2,work,7,13,6
1879,3,shop,13,14,1
1879,4,work,14,19,5
1879,5,home,19,24,5
1880,1,home,0,7,7
1880,2,work,7,13,6
1880,3,shop,13,14,1
1880,4,home,14,23,9
1880,5,work,23,24,1
1881,1,work,0,1,1
1881,2,home,1,7,6
1881,3,education,7,12,5
1881,4,home,12,18,6
1881,5,shop,18,19,1
1881,6,home,19,24,5
1882,1,home,0,7,7
1882,2,shop,7,8,1
1882,3,work,8,15,7
1882,4,home,15,24,9
1883,1,home,0,8,8
1883,2,education,8,14,6
1883,3,shop,14,15,1
1883,4,home,15,24,9
1884,1,home,0,8,8
1884,2,work,8,13,5
1884,3,home,13,17,4
1884,4,shop,17,18,1
1884,5,home,18,24,6
1885,1,home,0,6,6
1885,2,work,6,13,7
1885,3,home,13,20,7
1885,4,shop,20,21,1
1885,5,home,21,24,3
1886,1,home,0,7,7
1886,2,work,7,14,7
1886,3,home,14,21,7
1886,4,work,21,22,1
1886,5,home,22,24,2
1887,1,home,0,7,7
1887,2,work,7,14,7
1887,3,shop,14,15,1
1887,4,home,15,24,9
1888,1,home,0,8,8
1888,2,work,8,15,7
1888,3,home,15,24,9
1889,1,home,0,6,6
1889,2,work,6,7,1
1889,3,home,7,14,7
1889,4,work,14,16,2
1889,5,home,16,22,6
1889,6,work,22,23,1
1889,7,home,23,24,1
1890,1,home,0,6,6
1890,2,shop,6,7,1
1890,3,work,7,15,8
1890,4,home,15,24,9
1891,1,home,0,8,8
1891,2,work,8,15,7
1891,3,shop,15,16,1
1891,4,home,16,24,8
1892,1,home,0,8,8
1892,2,work,8,15,7
1892,3,home,15,23,8
1892,4,work,23,24,1
1893,1,home,0,6,6
1893,2,shop,6,7,1
1893,3,home,7,13,6
1893,4,education,13,16,3
1893,5,home,16,24,8
1894,1,home,0,6,6
1894,2,work,6,9,3
1894,3,home,9,15,6
1894,4,work,15,17,2
1894,5,home,17,23,6
1894,6,work,23,24,1
1895,1,home,0,8,8
1895,2,work,8,14,6
1895,3,shop,14,15,1
1895,4,home,15,24,9
1896,1,home,0,8,8
1896,2,work,8,13,5
1896,3,shop,13,14,1
1896,4,home,14,24,10
1897,1,home,0,6,6
1897,2,work,6,13,7
1897,3,shop,13,14,1
1897,4,home,14,24,10
1898,1,home,0,4,4
1898,2,work,4,12,8
1898,3,shop,12,13,1
1898,4,work,13,19,6
1898,5,education,19,20,1
1898,6,home,20,24,4
1899,1,home,0,8,8
1899,2,work,8,15,7
1899,3,home,15,20,5
1899,4,shop,20,21,1
1899,5,home,21,24,3
1900,1,home,0,8,8
1900,2,work,8,16,8
1900,3,home,16,24,8
1901,1,home,0,6,6
1901,2,shop,6,7,1
1901,3,home,7,13,6
1901,4,education,13,16,3
1901,5,home,16,24,8
1902,1,home,0,8,8
1902,2,work,8,15,7
1902,3,home,15,24,9
1903,1,home,0,9,9
1903,2,work,9,17,8
1903,3,home,17,24,7
1904,1,home,0,7,7
1904,2,work,7,13,6
1904,3,shop,13,14,1
1904,4,education,14,17,3
1904,5,home,17,24,7
1905,1,home,0,7,7
1905,2,work,7,13,6
1905,3,home,13,21,8
1905,4,shop,21,22,1
1905,5,home,22,24,2
1906,1,home,0,7,7
1906,2,work,7,13,6
1906,3,shop,13,14,1
1906,4,home,14,24,10
1907,1,home,0,7,7
1907,2,work,7,13,6
1907,3,home,13,17,4
1907,4,work,17,20,3
1907,5,home,20,24,4
1908,1,home,0,7,7
1908,2,work,7,13,6
1908,3,home,13,18,5
1908,4,shop,18,19,1
1908,5,home,19,24,5
1909,1,home,0,6,6
1909,2,shop,6,8,2
1909,3,home,8,23,15
1909,4,work,23,24,1
1910,1,home,0,8,8
1910,2,work,8,15,7
1910,3,home,15,22,7
1910,4,work,22,23,1
1910,5,home,23,24,1
1911,1,home,0,6,6
1911,2,shop,6,7,1
1911,3,home,7,9,2
1911,4,education,9,13,4
1911,5,shop,13,14,1
1911,6,home,14,20,6
1911,7,shop,20,21,1
1911,8,home,21,24,3
1912,1,home,0,8,8
1912,2,work,8,14,6
1912,3,home,14,24,10
1913,1,home,0,6,6
1913,2,work,6,13,7
1913,3,home,13,24,11
1914,1,home,0,7,7
1914,2,work,7,13,6
1914,3,home,13,24,11
1915,1,home,0,8,8
1915,2,work,8,15,7
1915,3,home,15,24,9
1916,1,home,0,6,6
1916,2,work,6,13,7
1916,3,home,13,24,11
1917,1,home,0,7,7
1917,2,work,7,13,6
1917,3,shop,13,14,1
1917,4,work,14,19,5
1917,5,home,19,24,5
1918,1,home,0,6,6
1918,2,work,6,13,7
1918,3,home,13,16,3
1918,4,work,16,20,4
1918,5,home,20,24,4
1919,1,home,0,6,6
1919,2,shop,6,7,1
1919,3,home,7,8,1
1919,4,work,8,14,6
1919,5,home,14,24,10
1920,1,home,0,7,7
1920,2,work,7,13,6
1920,3,home,13,23,10
1920,4,work,23,24,1
1921,1,home,0,8,8
1921,2,work,8,14,6
1921,3,shop,14,15,1
1921,4,work,15,20,5
1921,5,home,20,24,4
1922,1,home,0,6,6
1922,2,work,6,13,7
1922,3,home,13,24,11
1923,1,home,0,6,6
1923,2,work,6,7,1
1923,3,home,7,9,2
1923,4,work,9,11,2
1923,5,home,11,17,6
1923,6,work,17,19,2
1923,7,home,19,23,4
1923,8,work,23,24,1
1924,1,home,0,6,6
1924,2,work,6,8,2
1924,3,home,8,14,6
1924,4,work,14,17,3
1924,5,home,17,18,1
1924,6,work,18,19,1
1924,7,home,19,24,5
1925,1,home,0,7,7
1925,2,education,7,11,4
1925,3,home,11,18,7
1925,4,shop,18,19,1
1925,5,home,19,24,5
1926,1,home,0,9,9
1926,2,work,9,15,6
1926,3,shop,15,16,1
1926,4,home,16,24,8
1927,1,home,0,7,7
1927,2,shop,7,9,2
1927,3,education,9,12,3
1927,4,shop,12,14,2
1927,5,home,14,19,5
1927,6,shop,19,20,1
1927,7,home,20,24,4
1928,1,home,0,9,9
1928,2,education,9,12,3
1928,3,home,12,16,4
1928,4,work,16,20,4
1928,5,home,20,24,4
1929,1,home,0,6,6
1929,2,work,6,13,7
1929,3,home,13,23,10
1929,4,work,23,24,1
1930,1,home,0,8,8
1930,2,education,8,12,4
1930,3,shop,12,13,1
1930,4,work,13,19,6
1930,5,home,19,24,5
1931,1,home,0,7,7
1931,2,work,7,9,2
1931,3,home,9,14,5
1931,4,work,14,17,3
1931,5,home,17,24,7
1932,1,home,0,7,7
1932,2,education,7,11,4
1932,3,home,11,17,6
1932,4,shop,17,18,1
1932,5,home,18,24,6
1933,1,home,0,7,7
1933,2,education,7,10,3
1933,3,home,10,16,6
1933,4,shop,16,17,1
1933,5,home,17,24,7
1934,1,home,0,6,6
1934,2,work,6,8,2
1934,3,home,8,13,5
1934,4,work,13,15,2
1934,5,home,15,21,6
1934,6,work,21,22,1
1934,7,home,22,24,2
1935,1,home,0,8,8
1935,2,work,8,14,6
1935,3,shop,14,15,1
1935,4,work,15,19,4
1935,5,home,19,24,5
1936,1,home,0,6,6
1936,2,shop,6,7,1
1936,3,home,7,9,2
1936,4,education,9,12,3
1936,5,home,12,19,7
1936,6,shop,19,20,1
1936,7,home,20,24,4
1937,1,home,0,8,8
1937,2,work,8,15,7
1937,3,home,15,24,9
1938,1,home,0,7,7
1938,2,work,7,14,7
1938,3,home,14,24,10
1939,1,home,0,6,6
1939,2,work,6,14,8
1939,3,shop,14,15,1
1939,4,home,15,24,9
1940,1,home,0,8,8
1940,2,work,8,16,8
1940,3,home,16,24,8
1941,1,home,0,7,7
1941,2,education,7,11,4
1941,3,home,11,14,3
1941,4,education,14,16,2
1941,5,shop,16,17,1
1941,6,home,17,24,7
1942,1,home,0,7,7
1942,2,work,7,14,7
1942,3,home,14,24,10
1943,1,home,0,7,7
1943,2,shop,7,9,2
1943,3,education,9,12,3
1943,4,shop,12,13,1
1943,5,education,13,16,3
1943,6,home,16,24,8
1944,1,home,0,6,6
1944,2,shop,6,7,1
1944,3,home,7,9,2
1944,4,work,9,16,7
1944,5,home,16,24,8
1945,1,home,0,6,6
1945,2,work,6,13,7
1945,3,home,13,17,4
1945,4,work,17,20,3
1945,5,home,20,24,4
1946,1,home,0,8,8
1946,2,education,8,11,3
1946,3,home,11,18,7
1946,4,shop,18,20,2
1946,5,home,20,24,4
1947,1,home,0,8,8
1947,2,education,8,11,3
1947,3,home,11,18,7
1947,4,shop,18,19,1
1947,5,home,19,24,5
1948,1,home,0,6,6
1948,2,work,6,8,2
1948,3,home,8,9,1
1948,4,work,9,11,2
1948,5,shop,11,12,1
1948,6,work,12,13,1
1948,7,home,13,21,8
1948,8,work,21,22,1
1948,9,home,22,24,2
1949,1,home,0,7,7
1949,2,work,7,14,7
1949,3,home,14,24,10
1950,1,home,0,7,7
1950,2,work,7,13,6
1950,3,shop,13,14,1
1950,4,home,14,24,10
1951,1,home,0,6,6
1951,2,shop,6,7,1
1951,3,home,7,10,3
1951,4,education,10,12,2
1951,5,shop,12,14,2
1951,6,education,14,16,2
1951,7,home,16,24,8
1952,1,home,0,7,7
1952,2,work,7,13,6
1952,3,home,13,17,4
1952,4,work,17,20,3
1952,5,home,20,24,4
1953,1,home,0,7,7
1953,2,shop,7,8,1
1953,3,education,8,11,3
1953,4,home,11,20,9
1953,5,shop,20,21,1
1953,6,home,21,24,3
1954,1,home,0,8,8
1954,2,work,8,14,6
1954,3,home,14,24,10
1955,1,home,0,7,7
1955,2,work,7,13,6
1955,3,shop,13,14,1
1955,4,home,14,17,3
1955,5,work,17,20,3
1955,6,home,20,24,4
1956,1,home,0,7,7
1956,2,work,7,14,7
1956,3,home,14,21,7
1956,4,work,21,22,1
1956,5,home,22,24,2
1957,1,home,0,7,7
1957,2,work,7,14,7
1957,3,home,14,24,10
1958,1,home,0,8,8
1958,2,work,8,11,3
1958,3,shop,11,12,1
1958,4,work,12,18,6
1958,5,home,18,24,6
1959,1,home,0,7,7
1959,2,work,7,14,7
1959,3,home,14,22,8
1959,4,work,22,23,1
1959,5,home,23,24,1
1960,1,home,0,7,7
1960,2,work,7,14,7
1960,3,home,14,24,10
1961,1,home,0,7,7
1961,2,work,7,14,7
1961,3,home,14,21,7
1961,4,work,21,22,1
1961,5,home,22,24,2
1962,1,home,0,7,7
1962,2,work,7,13,6
1962,3,home,13,24,11
1963,1,home,0,7,7
1963,2,work,7,14,7
1963,3,home,14,24,10
1964,1,home,0,8,8
1964,2,education,8,11,3
1964,3,home,11,18,7
1964,4,shop,18,19,1
1964,5,home,19,24,5
1965,1,home,0,7,7
1965,2,work,7,14,7
1965,3,shop,14,15,1
1965,4,home,15,24,9
1966,1,home,0,7,7
1966,2,work,7,14,7
1966,3,home,14,24,10
1967,1,home,0,6,6
1967,2,shop,6,7,1
1967,3,home,7,10,3
1967,4,education,10,13,3
1967,5,shop,13,15,2
1967,6,home,15,24,9
1968,1,home,0,7,7
1968,2,work,7,14,7
1968,3,home,14,18,4
1968,4,shop,18,19,1
1968,5,home,19,24,5
1969,1,home,0,7,7
1969,2,work,7,14,7
1969,3,shop,14,15,1
1969,4,home,15,18,3
1969,5,work,18,20,2
1969,6,home,20,24,4
1970,1,home,0,7,7
1970,2,work,7,14,7
1970,3,shop,14,15,1
1970,4,work,15,20,5
1970,5,home,20,24,4
1971,1,home,0,6,6
1971,2,work,6,13,7
1971,3,shop,13,14,1
1971,4,work,14,19,5
1971,5,home,19,24,5
1972,1,home,0,8,8
1972,2,work,8,14,6
1972,3,home,14,16,2
1972,4,work,16,19,3
1972,5,home,19,24,5
1973,1,home,0,7,7
1973,2,work,7,13,6
1973,3,shop,13,14,1
1973,4,home,14,21,7
1973,5,work,21,22,1
1973,6,home,22,24,2
1974,1,home,0,8,8
1974,2,work,8,14,6
1974,3,home,14,24,10
1975,1,home,0,7,7
1975,2,work,7,14,7
1975,3,shop,14,15,1
1975,4,work,15,20,5
1975,5,home,20,24,4
1976,1,home,0,6,6
1976,2,shop,6,7,1
1976,3,home,7,9,2
1976,4,education,9,11,2
1976,5,home,11,19,8
1976,6,shop,19,20,1
1976,7,home,20,24,4
1977,1,home,0,7,7
1977,2,work,7,9,2
1977,3,home,9,15,6
1977,4,work,15,16,1
1977,5,home,16,23,7
1977,6,work,23,24,1
1978,1,home,0,6,6
1978,2,shop,6,7,1
1978,3,home,7,8,1
1978,4,education,8,11,3
1978,5,home,11,18,7
1978,6,shop,18,19,1
1978,7,home,19,24,5
1979,1,home,0,7,7
1979,2,work,7,14,7
1979,3,shop,14,15,1
1979,4,work,15,20,5
1979,5,home,20,24,4
1980,1,home,0,6,6
1980,2,shop,6,7,1
1980,3,home,7,10,3
1980,4,education,10,12,2
1980,5,shop,12,14,2
1980,6,education,14,16,2
1980,7,home,16,24,8
1981,1,home,0,7,7
1981,2,work,7,15,8
1981,3,home,15,24,9
1982,1,home,0,8,8
1982,2,education,8,11,3
1982,3,home,11,17,6
1982,4,shop,17,19,2
1982,5,home,19,24,5
1983,1,home,0,6,6
1983,2,shop,6,7,1
1983,3,home,7,10,3
1983,4,education,10,15,5
1983,5,shop,15,16,1
1983,6,home,16,24,8
1984,1,home,0,8,8
1984,2,shop,8,9,1
1984,3,education,9,12,3
1984,4,shop,12,14,2
1984,5,education,14,16,2
1984,6,shop,16,18,2
1984,7,home,18,24,6
1985,1,home,0,6,6
1985,2,shop,6,7,1
1985,3,home,7,15,8
1985,4,work,15,20,5
1985,5,home,20,24,4
1986,1,home,0,7,7
1986,2,work,7,13,6
1986,3,home,13,19,6
1986,4,shop,19,21,2
1986,5,home,21,24,3
1987,1,home,0,7,7
1987,2,work,7,13,6
1987,3,shop,13,14,1
1987,4,work,14,19,5
1987,5,home,19,24,5
1988,1,home,0,6,6
1988,2,work,6,13,7
1988,3,shop,13,14,1
1988,4,work,14,19,5
1988,5,home,19,24,5
1989,1,home,0,8,8
1989,2,work,8,15,7
1989,3,home,15,24,9
1990,1,home,0,7,7
1990,2,work,7,13,6
1990,3,home,13,17,4
1990,4,work,17,20,3
1990,5,home,20,24,4
1991,1,home,0,7,7
1991,2,education,7,12,5
1991,3,shop,12,14,2
1991,4,home,14,18,4
1991,5,shop,18,19,1
1991,6,home,19,24,5
1992,1,home,0,8,8
1992,2,education,8,11,3
1992,3,home,11,17,6
1992,4,work,17,20,3
1992,5,home,20,24,4
1993,1,home,0,7,7
1993,2,work,7,15,8
1993,3,home,15,24,9
1994,1,home,0,6,6
1994,2,work,6,13,7
1994,3,home,13,17,4
1994,4,work,17,19,2
1994,5,home,19,24,5
1995,1,home,0,7,7
1995,2,work,7,13,6
1995,3,home,13,24,11
1996,1,home,0,7,7
1996,2,work,7,13,6
1996,3,shop,13,14,1
1996,4,work,14,19,5
1996,5,home,19,24,5
1997,1,home,0,8,8
1997,2,work,8,15,7
1997,3,shop,15,16,1
1997,4,home,16,24,8
1998,1,home,0,6,6
1998,2,work,6,13,7
1998,3,home,13,21,8
1998,4,shop,21,22,1
1998,5,home,22,24,2
1999,1,home,0,7,7
1999,2,shop,7,8,1
1999,3,work,8,16,8
1999,4,home,16,23,7
1999,5,work,23,24,1
2000,1,home,0,7,7
2000,2,work,7,13,6
2000,3,home,13,24,11
2001,1,home,0,8,8
2001,2,work,8,15,7
2001,3,home,15,24,9
2002,1,home,0,8,8
2002,2,education,8,11,3
2002,3,home,11,15,4
2002,4,shop,15,16,1
2002,5,home,16,24,8
2003,1,home,0,7,7
2003,2,work,7,14,7
2003,3,home,14,24,10
2004,1,home,0,7,7
2004,2,work,7,13,6
2004,3,home,13,24,11
2005,1,home,0,8,8
2005,2,work,8,14,6
2005,3,home,14,24,10
2006,1,home,0,7,7
2006,2,work,7,9,2
2006,3,home,9,17,8
2006,4,work,17,19,2
2006,5,home,19,24,5
2007,1,home,0,7,7
2007,2,work,7,9,2
2007,3,home,9,14,5
2007,4,work,14,17,3
2007,5,home,17,24,7
2008,1,home,0,8,8
2008,2,work,8,15,7
2008,3,home,15,24,9
2009,1,home,0,8,8
2009,2,education,8,12,4
2009,3,home,12,16,4
2009,4,shop,16,17,1
2009,5,work,17,20,3
2009,6,home,20,24,4
2010,1,home,0,6,6
2010,2,work,6,13,7
2010,3,shop,13,14,1
2010,4,work,14,18,4
2010,5,home,18,24,6
2011,1,home,0,8,8
2011,2,work,8,15,7
2011,3,shop,15,16,1
2011,4,work,16,20,4
2011,5,home,20,24,4
2012,1,home,0,8,8
2012,2,work,8,15,7
2012,3,shop,15,16,1
2012,4,home,16,24,8
2013,1,home,0,7,7
2013,2,work,7,13,6
2013,3,home,13,18,5
2013,4,work,18,20,2
2013,5,home,20,24,4
2014,1,home,0,6,6
2014,2,work,6,13,7
2014,3,shop,13,14,1
2014,4,home,14,24,10
2015,1,home,0,8,8
2015,2,work,8,16,8
2015,3,home,16,24,8
2016,1,home,0,6,6
2016,2,work,6,13,7
2016,3,home,13,16,3
2016,4,work,16,20,4
2016,5,home,20,24,4
2017,1,home,0,6,6
2017,2,shop,6,7,1
2017,3,home,7,13,6
2017,4,education,13,16,3
2017,5,shop,16,18,2
2017,6,home,18,24,6
2018,1,home,0,7,7
2018,2,education,7,11,4
2018,3,home,11,18,7
2018,4,shop,18,19,1
2018,5,home,19,24,5
2019,1,home,0,8,8
2019,2,work,8,15,7
2019,3,shop,15,16,1
2019,4,home,16,18,2
2019,5,work,18,19,1
2019,6,home,19,24,5
2020,1,home,0,6,6
2020,2,work,6,8,2
2020,3,home,8,14,6
2020,4,work,14,17,3
2020,5,home,17,24,7
2021,1,home,0,9,9
2021,2,work,9,16,7
2021,3,home,16,24,8
2022,1,home,0,7,7
2022,2,work,7,13,6
2022,3,home,13,16,3
2022,4,work,16,20,4
2022,5,home,20,24,4
2023,1,home,0,8,8
2023,2,work,8,14,6
2023,3,home,14,24,10
2024,1,home,0,8,8
2024,2,shop,8,10,2
2024,3,home,10,14,4
2024,4,work,14,20,6
2024,5,home,20,24,4
2025,1,home,0,6,6
2025,2,shop,6,7,1
2025,3,home,7,9,2
2025,4,work,9,16,7
2025,5,home,16,21,5
2025,6,shop,21,22,1
2025,7,home,22,24,2
2026,1,home,0,7,7
2026,2,work,7,14,7
2026,3,home,14,24,10
2027,1,home,0,8,8
2027,2,work,8,15,7
2027,3,shop,15,16,1
2027,4,home,16,24,8
2028,1,home,0,7,7
2028,2,shop,7,9,2
2028,3,education,9,12,3
2028,4,shop,12,13,1
2028,5,education,13,16,3
2028,6,home,16,24,8
2029,1,home,0,6,6
2029,2,shop,6,7,1
2029,3,home,7,10,3
2029,4,education,10,13,3
2029,5,shop,13,14,1
2029,6,education,14,16,2
2029,7,shop,16,17,1
2029,8,home,17,24,7
2030,1,home,0,7,7
2030,2,shop,7,8,1
2030,3,work,8,14,6
2030,4,home,14,24,10
2031,1,home,0,6,6
2031,2,work,6,13,7
2031,3,home,13,18,5
2031,4,work,18,20,2
2031,5,home,20,24,4
2032,1,home,0,7,7
2032,2,education,7,12,5
2032,3,shop,12,14,2
2032,4,education,14,16,2
2032,5,shop,16,17,1
2032,6,home,17,24,7
2033,1,home,0,7,7
2033,2,shop,7,8,1
2033,3,work,8,15,7
2033,4,home,15,24,9
2034,1,home,0,6,6
2034,2,work,6,8,2
2034,3,home,8,11,3
2034,4,work,11,14,3
2034,5,home,14,21,7
2034,6,work,21,22,1
2034,7,home,22,24,2
2035,1,home,0,7,7
2035,2,shop,7,9,2
2035,3,education,9,12,3
2035,4,home,12,19,7
2035,5,shop,19,20,1
2035,6,home,20,24,4
2036,1,home,0,6,6
2036,2,work,6,8,2
2036,3,home,8,14,6
2036,4,work,14,17,3
2036,5,home,17,24,7
2037,1,home,0,6,6
2037,2,work,6,13,7
2037,3,home,13,17,4
2037,4,work,17,20,3
2037,5,home,20,24,4
2038,1,home,0,7,7
2038,2,education,7,11,4
2038,3,home,11,17,6
2038,4,shop,17,18,1
2038,5,home,18,24,6
2039,1,home,0,7,7
2039,2,work,7,14,7
2039,3,home,14,24,10
2040,1,home,0,7,7
2040,2,education,7,11,4
2040,3,home,11,18,7
2040,4,shop,18,19,1
2040,5,home,19,24,5
2041,1,home,0,6,6
2041,2,shop,6,7,1
2041,3,home,7,13,6
2041,4,education,13,16,3
2041,5,home,16,24,8
2042,1,home,0,8,8
2042,2,education,8,12,4
2042,3,home,12,17,5
2042,4,work,17,20,3
2042,5,home,20,24,4
2043,1,home,0,6,6
2043,2,work,6,8,2
2043,3,home,8,12,4
2043,4,work,12,14,2
2043,5,shop,14,15,1
2043,6,home,15,21,6
2043,7,work,21,22,1
2043,8,home,22,24,2
2044,1,home,0,6,6
2044,2,work,6,8,2
2044,3,home,8,12,4
2044,4,work,12,14,2
2044,5,home,14,21,7
2044,6,work,21,22,1
2044,7,home,22,24,2
2045,1,home,0,6,6
2045,2,work,6,13,7
2045,3,shop,13,14,1
2045,4,work,14,20,6
2045,5,home,20,24,4
2046,1,home,0,7,7
2046,2,education,7,11,4
2046,3,home,11,15,4
2046,4,shop,15,17,2
2046,5,home,17,24,7
2047,1,home,0,8,8
2047,2,work,8,14,6
2047,3,home,14,23,9
2047,4,work,23,24,1
2048,1,home,0,6,6
2048,2,shop,6,7,1
2048,3,home,7,9,2
2048,4,education,9,12,3
2048,5,shop,12,13,1
2048,6,education,13,16,3
2048,7,home,16,21,5
2048,8,shop,21,22,1
2048,9,home,22,24,2
2049,1,home,0,7,7
2049,2,education,7,11,4
2049,3,home,11,14,3
2049,4,education,14,16,2
2049,5,home,16,24,8
2050,1,home,0,9,9
2050,2,work,9,15,6
2050,3,home,15,24,9
2051,1,home,0,8,8
2051,2,work,8,14,6
2051,3,home,14,24,10
2052,1,home,0,9,9
2052,2,work,9,16,7
2052,3,home,16,24,8
2053,1,home,0,7,7
2053,2,work,7,13,6
2053,3,shop,13,14,1
2053,4,home,14,24,10
2054,1,home,0,6,6
2054,2,work,6,13,7
2054,3,shop,13,14,1
2054,4,home,14,21,7
2054,5,work,21,22,1
2054,6,home,22,24,2
2055,1,home,0,7,7
2055,2,work,7,14,7
2055,3,home,14,24,10
2056,1,home,0,7,7
2056,2,shop,7,8,1
2056,3,work,8,15,7
2056,4,home,15,24,9
2057,1,home,0,8,8
2057,2,work,8,13,5
2057,3,home,13,17,4
2057,4,work,17,20,3
2057,5,home,20,24,4
2058,1,home,0,8,8
2058,2,work,8,14,6
2058,3,shop,14,15,1
2058,4,home,15,21,6
2058,5,work,21,22,1
2058,6,home,22,24,2
2059,1,home,0,6,6
2059,2,shop,6,7,1
2059,3,home,7,13,6
2059,4,education,13,16,3
2059,5,home,16,20,4
2059,6,shop,20,21,1
2059,7,home,21,24,3
2060,1,home,0,9,9
2060,2,work,9,16,7
2060,3,home,16,23,7
2060,4,work,23,24,1
2061,1,home,0,6,6
2061,2,shop,6,7,1
2061,3,home,7,10,3
2061,4,education,10,12,2
2061,5,shop,12,14,2
2061,6,education,14,16,2
2061,7,home,16,24,8
2062,1,home,0,7,7
2062,2,work,7,14,7
2062,3,home,14,24,10
2063,1,home,0,8,8
2063,2,work,8,15,7
2063,3,shop,15,16,1
2063,4,home,16,24,8
2064,1,home,0,7,7
2064,2,work,7,14,7
2064,3,home,14,24,10
2065,1,home,0,7,7
2065,2,work,7,14,7
2065,3,home,14,24,10
2066,1,home,0,6,6
2066,2,work,6,8,2
2066,3,home,8,14,6
2066,4,work,14,17,3
2066,5,home,17,23,6
2066,6,work,23,24,1
2067,1,home,0,7,7
2067,2,work,7,10,3
2067,3,home,10,14,4
2067,4,work,14,16,2
2067,5,home,16,24,8
2068,1,home,0,8,8
2068,2,education,8,11,3
2068,3,home,11,16,5
2068,4,shop,16,17,1
2068,5,work,17,20,3
2068,6,home,20,24,4
2069,1,home,0,7,7
2069,2,work,7,13,6
2069,3,home,13,16,3
2069,4,work,16,20,4
2069,5,home,20,24,4
2070,1,home,0,7,7
2070,2,shop,7,8,1
2070,3,work,8,16,8
2070,4,home,16,22,6
2070,5,work,22,23,1
2070,6,home,23,24,1
2071,1,home,0,6,6
2071,2,work,6,13,7
2071,3,home,13,15,2
2071,4,work,15,19,4
2071,5,home,19,24,5
2072,1,home,0,7,7
2072,2,work,7,13,6
2072,3,home,13,18,5
2072,4,work,18,20,2
2072,5,home,20,24,4
2073,1,home,0,7,7
2073,2,work,7,14,7
2073,3,shop,14,15,1
2073,4,home,15,24,9
2074,1,home,0,6,6
2074,2,shop,6,7,1
2074,3,work,7,14,7
2074,4,home,14,22,8
2074,5,work,22,23,1
2074,6,home,23,24,1
2075,1,home,0,7,7
2075,2,work,7,13,6
2075,3,shop,13,14,1
2075,4,home,14,18,4
2075,5,work,18,20,2
2075,6,home,20,24,4
2076,1,home,0,6,6
2076,2,work,6,13,7
2076,3,home,13,17,4
2076,4,work,17,20,3
2076,5,home,20,24,4
2077,1,home,0,8,8
2077,2,work,8,15,7
2077,3,home,15,24,9
2078,1,home,0,9,9
2078,2,work,9,16,7
2078,3,home,16,24,8
2079,1,home,0,6,6
2079,2,work,6,13,7
2079,3,home,13,16,3
2079,4,work,16,20,4
2079,5,home,20,24,4
2080,1,home,0,7,7
2080,2,work,7,13,6
2080,3,shop,13,14,1
2080,4,work,14,19,5
2080,5,home,19,24,5
2081,1,home,0,6,6
2081,2,work,6,13,7
2081,3,shop,13,14,1
2081,4,work,14,16,2
2081,5,home,16,24,8
2082,1,home,0,8,8
2082,2,education,8,11,3
2082,3,home,11,18,7
2082,4,shop,18,19,1
2082,5,home,19,24,5
2083,1,home,0,8,8
2083,2,work,8,14,6
2083,3,home,14,22,8
2083,4,work,22,23,1
2083,5,home,23,24,1
2084,1,home,0,6,6
2084,2,work,6,8,2
2084,3,home,8,13,5
2084,4,work,13,15,2
2084,5,home,15,22,7
2084,6,work,22,23,1
2084,7,home,23,24,1
2085,1,home,0,6,6
2085,2,work,6,8,2
2085,3,home,8,12,4
2085,4,work,12,15,3
2085,5,home,15,22,7
2085,6,work,22,23,1
2085,7,home,23,24,1
2086,1,home,0,8,8
2086,2,work,8,15,7
2086,3,shop,15,16,1
2086,4,work,16,19,3
2086,5,home,19,24,5
2087,1,home,0,7,7
2087,2,work,7,13,6
2087,3,home,13,17,4
2087,4,work,17,20,3
2087,5,home,20,24,4
2088,1,home,0,7,7
2088,2,work,7,13,6
2088,3,home,13,24,11
2089,1,home,0,7,7
2089,2,work,7,13,6
2089,3,shop,13,14,1
2089,4,work,14,17,3
2089,5,home,17,24,7
2090,1,home,0,7,7
2090,2,shop,7,8,1
2090,3,home,8,12,4
2090,4,work,12,18,6
2090,5,home,18,24,6
2091,1,home,0,7,7
2091,2,work,7,15,8
2091,3,home,15,21,6
2091,4,work,21,22,1
2091,5,home,22,24,2
2092,1,home,0,7,7
2092,2,work,7,9,2
2092,3,home,9,15,6
2092,4,work,15,17,2
2092,5,home,17,23,6
2092,6,work,23,24,1
2093,1,home,0,7,7
2093,2,shop,7,8,1
2093,3,education,8,12,4
2093,4,home,12,20,8
2093,5,shop,20,21,1
2093,6,home,21,24,3
2094,1,home,0,7,7
2094,2,work,7,13,6
2094,3,home,13,14,1
2094,4,education,14,16,2
2094,5,home,16,23,7
2094,6,work,23,24,1
2095,1,home,0,7,7
2095,2,work,7,14,7
2095,3,shop,14,15,1
2095,4,work,15,20,5
2095,5,home,20,24,4
2096,1,home,0,7,7
2096,2,work,7,13,6
2096,3,shop,13,14,1
2096,4,work,14,19,5
2096,5,home,19,24,5
2097,1,home,0,6,6
2097,2,work,6,14,8
2097,3,shop,14,15,1
2097,4,home,15,21,6
2097,5,work,21,22,1
2097,6,home,22,24,2
2098,1,home,0,6,6
2098,2,shop,6,7,1
2098,3,home,7,10,3
2098,4,education,10,11,1
2098,5,home,11,14,3
2098,6,education,14,16,2
2098,7,shop,16,17,1
2098,8,home,17,24,7
2099,1,home,0,6,6
2099,2,work,6,8,2
2099,3,home,8,14,6
2099,4,work,14,16,2
2099,5,home,16,23,7
2099,6,work,23,24,1
2100,1,home,0,7,7
2100,2,work,7,13,6
2100,3,shop,13,14,1
2100,4,home,14,24,10
2101,1,home,0,6,6
2101,2,shop,6,7,1
2101,3,work,7,13,6
2101,4,home,13,24,11
2102,1,home,0,7,7
2102,2,work,7,14,7
2102,3,shop,14,16,2
2102,4,home,16,24,8
2103,1,home,0,8,8
2103,2,shop,8,9,1
2103,3,work,9,16,7
2103,4,home,16,24,8
2104,1,home,0,6,6
2104,2,work,6,13,7
2104,3,shop,13,14,1
2104,4,home,14,23,9
2104,5,work,23,24,1
2105,1,home,0,8,8
2105,2,work,8,15,7
2105,3,home,15,24,9
2106,1,home,0,6,6
2106,2,work,6,7,1
2106,3,home,7,11,4
2106,4,work,11,13,2
2106,5,home,13,21,8
2106,6,work,21,22,1
2106,7,home,22,24,2
2107,1,home,0,7,7
2107,2,work,7,9,2
2107,3,home,9,14,5
2107,4,work,14,16,2
2107,5,home,16,23,7
2107,6,work,23,24,1
2108,1,home,0,6,6
2108,2,work,6,13,7
2108,3,shop,13,14,1
2108,4,work,14,19,5
2108,5,home,19,24,5
2109,1,home,0,7,7
2109,2,work,7,14,7
2109,3,shop,14,15,1
2109,4,home,15,22,7
2109,5,work,22,23,1
2109,6,home,23,24,1
2110,1,home,0,7,7
2110,2,work,7,14,7
2110,3,shop,14,15,1
2110,4,home,15,24,9
2111,1,home,0,7,7
2111,2,shop,7,9,2
2111,3,education,9,13,4
2111,4,shop,13,15,2
2111,5,home,15,19,4
2111,6,shop,19,20,1
2111,7,home,20,24,4
2112,1,home,0,6,6
2112,2,shop,6,7,1
2112,3,home,7,13,6
2112,4,education,13,15,2
2112,5,shop,15,16,1
2112,6,home,16,24,8
2113,1,home,0,7,7
2113,2,work,7,14,7
2113,3,shop,14,15,1
2113,4,work,15,19,4
2113,5,home,19,24,5
2114,1,home,0,6,6
2114,2,work,6,13,7
2114,3,shop,13,14,1
2114,4,work,14,19,5
2114,5,home,19,24,5
2115,1,home,0,7,7
2115,2,shop,7,8,1
2115,3,education,8,11,3
2115,4,home,11,19,8
2115,5,shop,19,21,2
2115,6,home,21,24,3
2116,1,home,0,7,7
2116,2,work,7,14,7
2116,3,shop,14,15,1
2116,4,work,15,19,4
2116,5,home,19,24,5
2117,1,home,0,6,6
2117,2,work,6,8,2
2117,3,home,8,12,4
2117,4,shop,12,13,1
2117,5,work,13,15,2
2117,6,home,15,21,6
2117,7,work,21,22,1
2117,8,home,22,24,2
2118,1,home,0,6,6
2118,2,work,6,13,7
2118,3,home,13,23,10
2118,4,work,23,24,1
2119,1,home,0,8,8
2119,2,work,8,15,7
2119,3,home,15,24,9
2120,1,home,0,8,8
2120,2,work,8,16,8
2120,3,home,16,21,5
2120,4,work,21,22,1
2120,5,home,22,24,2
2121,1,home,0,7,7
2121,2,work,7,13,6
2121,3,shop,13,14,1
2121,4,work,14,20,6
2121,5,home,20,24,4
2122,1,home,0,6,6
2122,2,work,6,14,8
2122,3,home,14,24,10
2123,1,home,0,7,7
2123,2,work,7,14,7
2123,3,home,14,24,10
2124,1,home,0,6,6
2124,2,work,6,7,1
2124,3,home,7,10,3
2124,4,work,10,12,2
2124,5,home,12,16,4
2124,6,work,16,18,2
2124,7,home,18,23,5
2124,8,work,23,24,1
2125,1,home,0,7,7
2125,2,education,7,11,4
2125,3,home,11,18,7
2125,4,shop,18,19,1
2125,5,home,19,24,5
2126,1,home,0,7,7
2126,2,work,7,14,7
2126,3,home,14,24,10
2127,1,home,0,6,6
2127,2,shop,6,7,1
2127,3,work,7,15,8
2127,4,home,15,19,4
2127,5,shop,19,20,1
2127,6,home,20,24,4
2128,1,home,0,8,8
2128,2,work,8,15,7
2128,3,shop,15,16,1
2128,4,work,16,19,3
2128,5,home,19,24,5
2129,1,home,0,8,8
2129,2,work,8,14,6
2129,3,shop,14,15,1
2129,4,work,15,19,4
2129,5,home,19,24,5
2130,1,home,0,7,7
2130,2,work,7,13,6
2130,3,shop,13,14,1
2130,4,work,14,19,5
2130,5,home,19,24,5
2131,1,home,0,7,7
2131,2,education,7,12,5
2131,3,shop,12,14,2
2131,4,home,14,24,10
2132,1,home,0,7,7
2132,2,work,7,10,3
2132,3,home,10,14,4
2132,4,work,14,17,3
2132,5,home,17,23,6
2132,6,work,23,24,1
2133,1,home,0,7,7
2133,2,shop,7,8,1
2133,3,education,8,11,3
2133,4,home,11,18,7
2133,5,shop,18,19,1
2133,6,home,19,24,5
2134,1,home,0,7,7
2134,2,work,7,13,6
2134,3,home,13,18,5
2134,4,work,18,20,2
2134,5,home,20,24,4
2135,1,work,0,12,12
2135,2,shop,12,13,1
2135,3,work,13,19,6
2135,4,home,19,24,5
2136,1,home,0,8,8
2136,2,work,8,14,6
2136,3,shop,14,15,1
2136,4,work,15,20,5
2136,5,home,20,24,4
2137,1,home,0,7,7
2137,2,education,7,11,4
2137,3,home,11,14,3
2137,4,education,14,16,2
2137,5,shop,16,17,1
2137,6,home,17,24,7
2138,1,home,0,7,7
2138,2,work,7,13,6
2138,3,home,13,24,11
2139,1,home,0,8,8
2139,2,work,8,15,7
2139,3,home,15,24,9
2140,1,home,0,9,9
2140,2,work,9,16,7
2140,3,home,16,24,8
2141,1,home,0,6,6
2141,2,work,6,13,7
2141,3,shop,13,14,1
2141,4,work,14,20,6
2141,5,home,20,24,4
2142,1,home,0,6,6
2142,2,work,6,8,2
2142,3,home,8,9,1
2142,4,work,9,11,2
2142,5,home,11,20,9
2142,6,shop,20,21,1
2142,7,home,21,24,3
2143,1,home,0,6,6
2143,2,shop,6,7,1
2143,3,home,7,13,6
2143,4,education,13,16,3
2143,5,shop,16,17,1
2143,6,home,17,24,7
2144,1,home,0,7,7
2144,2,shop,7,8,1
2144,3,education,8,12,4
2144,4,shop,12,14,2
2144,5,home,14,20,6
2144,6,shop,20,21,1
2144,7,home,21,24,3
2145,1,home,0,6,6
2145,2,shop,6,7,1
2145,3,home,7,13,6
2145,4,education,13,16,3
2145,5,home,16,24,8
2146,1,home,0,6,6
2146,2,work,6,13,7
2146,3,home,13,14,1
2146,4,shop,14,15,1
2146,5,home,15,22,7
2146,6,work,22,23,1
2146,7,home,23,24,1
2147,1,home,0,8,8
2147,2,work,8,15,7
2147,3,home,15,24,9
2148,1,home,0,8,8
2148,2,work,8,15,7
2148,3,home,15,24,9
2149,1,home,0,7,7
2149,2,work,7,13,6
2149,3,shop,13,14,1
2149,4,work,14,19,5
2149,5,home,19,24,5
2150,1,home,0,9,9
2150,2,shop,9,10,1
2150,3,work,10,16,6
2150,4,home,16,24,8
2151,1,home,0,7,7
2151,2,shop,7,8,1
2151,3,education,8,11,3
2151,4,home,11,13,2
2151,5,education,13,15,2
2151,6,shop,15,16,1
2151,7,home,16,24,8
2152,1,home,0,7,7
2152,2,work,7,14,7
2152,3,home,14,24,10
2153,1,home,0,6,6
2153,2,shop,6,7,1
2153,3,home,7,12,5
2153,4,work,12,14,2
2153,5,home,14,21,7
2153,6,work,21,22,1
2153,7,home,22,24,2
2154,1,home,0,9,9
2154,2,work,9,18,9
2154,3,home,18,24,6
2155,1,home,0,8,8
2155,2,work,8,14,6
2155,3,shop,14,15,1
2155,4,home,15,22,7
2155,5,work,22,23,1
2155,6,home,23,24,1
2156,1,home,0,8,8
2156,2,work,8,15,7
2156,3,home,15,24,9
2157,1,home,0,11,11
2157,2,work,11,19,8
2157,3,home,19,23,4
2157,4,work,23,24,1
2158,1,home,0,7,7
2158,2,work,7,13,6
2158,3,home,13,17,4
2158,4,shop,17,18,1
2158,5,home,18,24,6
2159,1,home,0,8,8
2159,2,education,8,12,4
2159,3,home,12,24,12
2160,1,home,0,7,7
2160,2,education,7,11,4
2160,3,home,11,19,8
2160,4,shop,19,20,1
2160,5,home,20,24,4
2161,1,home,0,6,6
2161,2,work,6,13,7
2161,3,home,13,24,11
2162,1,home,0,7,7
2162,2,work,7,15,8
2162,3,home,15,24,9
2163,1,home,0,6,6
2163,2,shop,6,7,1
2163,3,home,7,10,3
2163,4,education,10,12,2
2163,5,home,12,19,7
2163,6,shop,19,20,1
2163,7,home,20,24,4
2164,1,home,0,7,7
2164,2,shop,7,9,2
2164,3,education,9,12,3
2164,4,shop,12,14,2
2164,5,education,14,16,2
2164,6,shop,16,17,1
2164,7,home,17,24,7
2165,1,home,0,6,6
2165,2,shop,6,7,1
2165,3,home,7,10,3
2165,4,education,10,13,3
2165,5,home,13,19,6
2165,6,shop,19,20,1
2165,7,home,20,24,4
2166,1,home,0,7,7
2166,2,work,7,15,8
2166,3,home,15,24,9
2167,1,home,0,7,7
2167,2,work,7,9,2
2167,3,home,9,15,6
2167,4,work,15,17,2
2167,5,home,17,24,7
2168,1,home,0,6,6
2168,2,work,6,13,7
2168,3,home,13,17,4
2168,4,shop,17,18,1
2168,5,work,18,20,2
2168,6,home,20,24,4
2169,1,home,0,6,6
2169,2,work,6,8,2
2169,3,home,8,9,1
2169,4,work,9,11,2
2169,5,home,11,17,6
2169,6,work,17,19,2
2169,7,home,19,23,4
2169,8,work,23,24,1
2170,1,home,0,7,7
2170,2,work,7,13,6
2170,3,home,13,21,8
2170,4,shop,21,22,1
2170,5,home,22,24,2
2171,1,home,0,6,6
2171,2,work,6,8,2
2171,3,home,8,14,6
2171,4,work,14,17,3
2171,5,home,17,24,7
2172,1,home,0,7,7
2172,2,work,7,13,6
2172,3,shop,13,14,1
2172,4,home,14,24,10
2173,1,home,0,6,6
2173,2,work,6,13,7
2173,3,home,13,24,11
2174,1,home,0,7,7
2174,2,work,7,15,8
2174,3,home,15,24,9
2175,1,home,0,7,7
2175,2,work,7,13,6
2175,3,shop,13,14,1
2175,4,home,14,24,10
2176,1,home,0,7,7
2176,2,shop,7,8,1
2176,3,work,8,15,7
2176,4,home,15,24,9
2177,1,home,0,6,6
2177,2,shop,6,7,1
2177,3,home,7,10,3
2177,4,education,10,13,3
2177,5,home,13,19,6
2177,6,shop,19,21,2
2177,7,home,21,24,3
2178,1,home,0,6,6
2178,2,work,6,8,2
2178,3,home,8,12,4
2178,4,work,12,14,2
2178,5,home,14,22,8
2178,6,work,22,23,1
2178,7,home,23,24,1
2179,1,home,0,7,7
2179,2,work,7,14,7
2179,3,shop,14,15,1
2179,4,home,15,21,6
2179,5,work,21,22,1
2179,6,home,22,24,2
2180,1,home,0,8,8
2180,2,education,8,12,4
2180,3,work,12,18,6
2180,4,home,18,22,4
2180,5,work,22,23,1
2180,6,home,23,24,1
2181,1,home,0,6,6
2181,2,work,6,8,2
2181,3,home,8,14,6
2181,4,work,14,16,2
2181,5,home,16,22,6
2181,6,work,22,23,1
2181,7,home,23,24,1
2182,1,home,0,8,8
2182,2,work,8,15,7
2182,3,home,15,24,9
2183,1,home,0,6,6
2183,2,work,6,13,7
2183,3,home,13,15,2
2183,4,work,15,20,5
2183,5,home,20,24,4
2184,1,home,0,7,7
2184,2,work,7,13,6
2184,3,shop,13,14,1
2184,4,work,14,19,5
2184,5,education,19,20,1
2184,6,home,20,23,3
2184,7,work,23,24,1
2185,1,home,0,6,6
2185,2,work,6,13,7
2185,3,shop,13,14,1
2185,4,home,14,24,10
2186,1,home,0,9,9
2186,2,work,9,16,7
2186,3,home,16,24,8
2187,1,home,0,7,7
2187,2,work,7,10,3
2187,3,home,10,16,6
2187,4,work,16,18,2
2187,5,home,18,24,6
2188,1,home,0,7,7
2188,2,education,7,12,5
2188,3,shop,12,14,2
2188,4,education,14,16,2
2188,5,home,16,24,8
2189,1,home,0,7,7
2189,2,education,7,12,5
2189,3,shop,12,14,2
2189,4,education,14,16,2
2189,5,home,16,24,8
2190,1,home,0,6,6
2190,2,work,6,13,7
2190,3,home,13,17,4
2190,4,work,17,20,3
2190,5,home,20,23,3
2190,6,work,23,24,1
2191,1,home,0,7,7
2191,2,shop,7,8,1
2191,3,work,8,14,6
2191,4,home,14,24,10
2192,1,home,0,6,6
2192,2,shop,6,7,1
2192,3,work,7,14,7
2192,4,shop,14,16,2
2192,5,home,16,24,8
2193,1,home,0,7,7
2193,2,work,7,13,6
2193,3,home,13,21,8
2193,4,shop,21,22,1
2193,5,home,22,24,2
2194,1,home,0,8,8
2194,2,work,8,14,6
2194,3,shop,14,15,1
2194,4,work,15,20,5
2194,5,home,20,24,4
2195,1,home,0,7,7
2195,2,work,7,14,7
2195,3,shop,14,15,1
2195,4,work,15,19,4
2195,5,home,19,24,5
2196,1,home,0,7,7
2196,2,shop,7,9,2
2196,3,education,9,12,3
2196,4,shop,12,14,2
2196,5,education,14,16,2
2196,6,home,16,24,8
2197,1,home,0,6,6
2197,2,shop,6,7,1
2197,3,home,7,9,2
2197,4,education,9,13,4
2197,5,shop,13,15,2
2197,6,home,15,21,6
2197,7,shop,21,22,1
2197,8,home,22,24,2
2198,1,home,0,7,7
2198,2,education,7,11,4
2198,3,home,11,16,5
2198,4,shop,16,17,1
2198,5,home,17,24,7
2199,1,home,0,6,6
2199,2,work,6,7,1
2199,3,home,7,13,6
2199,4,work,13,15,2
2199,5,home,15,18,3
2199,6,work,18,20,2
2199,7,home,20,24,4
2200,1,home,0,8,8
2200,2,work,8,14,6
2200,3,shop,14,15,1
2200,4,work,15,20,5
2200,5,home,20,24,4
2201,1,home,0,6,6
2201,2,work,6,14,8
2201,3,home,14,24,10
2202,1,home,0,9,9
2202,2,work,9,16,7
2202,3,home,16,24,8
2203,1,home,0,6,6
2203,2,shop,6,7,1
2203,3,home,7,9,2
2203,4,education,9,12,3
2203,5,shop,12,14,2
2203,6,education,14,16,2
2203,7,shop,16,18,2
2203,8,home,18,24,6
2204,1,home,0,6,6
2204,2,work,6,7,1
2204,3,home,7,8,1
2204,4,work,8,9,1
2204,5,home,9,13,4
2204,6,work,13,15,2
2204,7,home,15,21,6
2204,8,work,21,22,1
2204,9,home,22,24,2
2205,1,home,0,7,7
2205,2,work,7,13,6
2205,3,shop,13,14,1
2205,4,work,14,20,6
2205,5,home,20,24,4
2206,1,home,0,6,6
2206,2,work,6,13,7
2206,3,shop,13,14,1
2206,4,home,14,22,8
2206,5,work,22,23,1
2206,6,home,23,24,1
2207,1,home,0,7,7
2207,2,work,7,15,8
2207,3,home,15,24,9
2208,1,home,0,7,7
2208,2,work,7,13,6
2208,3,home,13,24,11
2209,1,home,0,6,6
2209,2,shop,6,7,1
2209,3,work,7,14,7
2209,4,shop,14,15,1
2209,5,home,15,22,7
2209,6,work,22,23,1
2209,7,home,23,24,1
2210,1,home,0,7,7
2210,2,education,7,12,5
2210,3,shop,12,14,2
2210,4,education,14,17,3
2210,5,home,17,24,7
2211,1,home,0,6,6
2211,2,work,6,9,3
2211,3,home,9,15,6
2211,4,work,15,17,2
2211,5,home,17,23,6
2211,6,work,23,24,1
2212,1,home,0,7,7
2212,2,work,7,13,6
2212,3,shop,13,14,1
2212,4,work,14,18,4
2212,5,home,18,24,6
2213,1,home,0,7,7
2213,2,work,7,14,7
2213,3,shop,14,15,1
2213,4,work,15,20,5
2213,5,home,20,24,4
2214,1,home,0,6,6
2214,2,shop,6,7,1
2214,3,home,7,10,3
2214,4,education,10,13,3
2214,5,shop,13,14,1
2214,6,education,14,16,2
2214,7,shop,16,17,1
2214,8,home,17,24,7
2215,1,home,0,6,6
2215,2,work,6,8,2
2215,3,home,8,12,4
2215,4,work,12,15,3
2215,5,home,15,22,7
2215,6,work,22,23,1
2215,7,home,23,24,1
2216,1,home,0,8,8
2216,2,work,8,14,6
2216,3,shop,14,15,1
2216,4,work,15,20,5
2216,5,home,20,24,4
2217,1,home,0,6,6
2217,2,work,6,8,2
2217,3,home,8,14,6
2217,4,work,14,16,2
2217,5,home,16,22,6
2217,6,work,22,23,1
2217,7,home,23,24,1
2218,1,home,0,7,7
2218,2,work,7,13,6
2218,3,home,13,17,4
2218,4,work,17,19,2
2218,5,home,19,24,5
2219,1,home,0,8,8
2219,2,education,8,12,4
2219,3,home,12,14,2
2219,4,education,14,16,2
2219,5,home,16,24,8
2220,1,home,0,6,6
2220,2,shop,6,7,1
2220,3,home,7,9,2
2220,4,work,9,12,3
2220,5,home,12,17,5
2220,6,work,17,19,2
2220,7,home,19,24,5
2221,1,home,0,7,7
2221,2,shop,7,8,1
2221,3,work,8,15,7
2221,4,home,15,22,7
2221,5,work,22,23,1
2221,6,home,23,24,1
2222,1,home,0,9,9
2222,2,work,9,16,7
2222,3,home,16,21,5
2222,4,shop,21,22,1
2222,5,home,22,24,2
2223,1,home,0,7,7
2223,2,work,7,14,7
2223,3,home,14,15,1
2223,4,work,15,19,4
2223,5,home,19,24,5
2224,1,home,0,8,8
2224,2,work,8,15,7
2224,3,shop,15,16,1
2224,4,work,16,20,4
2224,5,home,20,24,4
2225,1,home,0,8,8
2225,2,work,8,17,9
2225,3,home,17,22,5
2225,4,work,22,23,1
2225,5,home,23,24,1
2226,1,home,0,6,6
2226,2,work,6,13,7
2226,3,home,13,17,4
2226,4,work,17,20,3
2226,5,home,20,24,4
2227,1,home,0,6,6
2227,2,work,6,13,7
2227,3,home,13,15,2
2227,4,work,15,20,5
2227,5,home,20,24,4
2228,1,home,0,7,7
2228,2,work,7,9,2
2228,3,home,9,15,6
2228,4,work,15,17,2
2228,5,home,17,23,6
2228,6,work,23,24,1
2229,1,home,0,8,8
2229,2,work,8,15,7
2229,3,home,15,24,9
2230,1,home,0,6,6
2230,2,work,6,13,7
2230,3,home,13,17,4
2230,4,work,17,20,3
2230,5,home,20,24,4
2231,1,home,0,6,6
2231,2,shop,6,7,1
2231,3,home,7,10,3
2231,4,education,10,12,2
2231,5,home,12,19,7
2231,6,shop,19,20,1
2231,7,home,20,24,4
2232,1,home,0,6,6
2232,2,shop,6,7,1
2232,3,home,7,13,6
2232,4,education,13,16,3
2232,5,shop,16,17,1
2232,6,home,17,21,4
2232,7,shop,21,22,1
2232,8,home,22,24,2
2233,1,home,0,6,6
2233,2,shop,6,7,1
2233,3,home,7,9,2
2233,4,education,9,11,2
2233,5,home,11,17,6
2233,6,shop,17,18,1
2233,7,home,18,24,6
2234,1,home,0,6,6
2234,2,work,6,7,1
2234,3,home,7,8,1
2234,4,work,8,9,1
2234,5,home,9,15,6
2234,6,work,15,17,2
2234,7,home,17,24,7
2235,1,home,0,7,7
2235,2,work,7,14,7
2235,3,home,14,24,10
2236,1,home,0,6,6
2236,2,work,6,8,2
2236,3,home,8,12,4
2236,4,work,12,14,2
2236,5,home,14,21,7
2236,6,work,21,22,1
2236,7,home,22,24,2
2237,1,home,0,7,7
2237,2,shop,7,8,1
2237,3,education,8,11,3
2237,4,home,11,18,7
2237,5,shop,18,19,1
2237,6,home,19,24,5
2238,1,home,0,8,8
2238,2,work,8,14,6
2238,3,shop,14,15,1
2238,4,work,15,20,5
2238,5,home,20,24,4
2239,1,home,0,7,7
2239,2,shop,7,8,1
2239,3,home,8,22,14
2239,4,work,22,23,1
2239,5,home,23,24,1
2240,1,home,0,7,7
2240,2,work,7,13,6
2240,3,shop,13,14,1
2240,4,work,14,19,5
2240,5,home,19,24,5
2241,1,home,0,6,6
2241,2,shop,6,7,1
2241,3,work,7,14,7
2241,4,home,14,24,10
2242,1,home,0,7,7
2242,2,work,7,14,7
2242,3,shop,14,15,1
2242,4,home,15,21,6
2242,5,work,21,22,1
2242,6,home,22,24,2
2243,1,home,0,6,6
2243,2,work,6,13,7
2243,3,shop,13,15,2
2243,4,home,15,24,9
2244,1,home,0,7,7
2244,2,work,7,14,7
2244,3,shop,14,15,1
2244,4,home,15,22,7
2244,5,work,22,23,1
2244,6,home,23,24,1
2245,1,home,0,6,6
2245,2,work,6,13,7
2245,3,shop,13,14,1
2245,4,work,14,19,5
2245,5,home,19,24,5
2246,1,home,0,9,9
2246,2,work,9,14,5
2246,3,home,14,24,10
2247,1,home,0,6,6
2247,2,work,6,13,7
2247,3,shop,13,14,1
2247,4,work,14,20,6
2247,5,home,20,24,4
2248,1,home,0,6,6
2248,2,shop,6,7,1
2248,3,home,7,10,3
2248,4,education,10,11,1
2248,5,home,11,18,7
2248,6,shop,18,19,1
2248,7,home,19,24,5
2249,1,home,0,6,6
2249,2,work,6,8,2
2249,3,home,8,11,3
2249,4,work,11,13,2
2249,5,home,13,17,4
2249,6,work,17,19,2
2249,7,home,19,24,5
2250,1,home,0,13,13
2250,2,work,13,20,7
2250,3,home,20,24,4
2251,1,home,0,7,7
2251,2,work,7,14,7
2251,3,shop,14,15,1
2251,4,home,15,21,6
2251,5,work,21,22,1
2251,6,home,22,24,2
2252,1,home,0,8,8
2252,2,work,8,15,7
2252,3,home,15,24,9
2253,1,home,0,7,7
2253,2,work,7,13,6
2253,3,shop,13,14,1
2253,4,home,14,24,10
2254,1,home,0,7,7
2254,2,work,7,9,2
2254,3,home,9,12,3
2254,4,work,12,14,2
2254,5,shop,14,15,1
2254,6,home,15,22,7
2254,7,work,22,23,1
2254,8,home,23,24,1
2255,1,home,0,9,9
2255,2,work,9,15,6
2255,3,shop,15,16,1
2255,4,work,16,20,4
2255,5,home,20,24,4
2256,1,home,0,9,9
2256,2,work,9,16,7
2256,3,home,16,24,8
2257,1,home,0,8,8
2257,2,work,8,16,8
2257,3,home,16,21,5
2257,4,work,21,22,1
2257,5,home,22,24,2
2258,1,home,0,7,7
2258,2,work,7,14,7
2258,3,home,14,22,8
2258,4,work,22,23,1
2258,5,home,23,24,1
2259,1,home,0,7,7
2259,2,work,7,13,6
2259,3,home,13,23,10
2259,4,work,23,24,1
2260,1,home,0,7,7
2260,2,education,7,13,6
2260,3,shop,13,15,2
2260,4,home,15,24,9
2261,1,home,0,7,7
2261,2,work,7,9,2
2261,3,home,9,13,4
2261,4,work,13,15,2
2261,5,home,15,21,6
2261,6,work,21,22,1
2261,7,home,22,24,2
2262,1,home,0,6,6
2262,2,shop,6,7,1
2262,3,home,7,9,2
2262,4,education,9,12,3
2262,5,shop,12,14,2
2262,6,home,14,24,10
2263,1,home,0,7,7
2263,2,work,7,13,6
2263,3,home,13,18,5
2263,4,shop,18,19,1
2263,5,home,19,24,5
2264,1,home,0,7,7
2264,2,education,7,11,4
2264,3,home,11,18,7
2264,4,shop,18,20,2
2264,5,home,20,24,4
2265,1,home,0,7,7
2265,2,work,7,15,8
2265,3,home,15,21,6
2265,4,work,21,22,1
2265,5,home,22,24,2
2266,1,home,0,8,8
2266,2,work,8,14,6
2266,3,home,14,22,8
2266,4,work,22,23,1
2266,5,home,23,24,1
2267,1,home,0,7,7
2267,2,work,7,9,2
2267,3,home,9,15,6
2267,4,work,15,17,2
2267,5,home,17,24,7
2268,1,home,0,7,7
2268,2,work,7,13,6
2268,3,shop,13,14,1
2268,4,work,14,19,5
2268,5,home,19,24,5
2269,1,home,0,7,7
2269,2,education,7,11,4
2269,3,home,11,16,5
2269,4,shop,16,17,1
2269,5,home,17,24,7
2270,1,home,0,6,6
2270,2,shop,6,7,1
2270,3,home,7,13,6
2270,4,education,13,16,3
2270,5,home,16,24,8
2271,1,home,0,6,6
2271,2,work,6,13,7
2271,3,shop,13,14,1
2271,4,work,14,17,3
2271,5,home,17,24,7
2272,1,home,0,7,7
2272,2,education,7,11,4
2272,3,home,11,19,8
2272,4,shop,19,20,1
2272,5,home,20,24,4
2273,1,home,0,6,6
2273,2,shop,6,7,1
2273,3,home,7,10,3
2273,4,education,10,12,2
2273,5,shop,12,14,2
2273,6,education,14,16,2
2273,7,home,16,24,8
2274,1,home,0,7,7
2274,2,work,7,14,7
2274,3,home,14,24,10
2275,1,home,0,7,7
2275,2,work,7,13,6
2275,3,home,13,24,11
2276,1,home,0,8,8
2276,2,work,8,14,6
2276,3,home,14,24,10
2277,1,home,0,6,6
2277,2,shop,6,7,1
2277,3,home,7,13,6
2277,4,work,13,19,6
2277,5,home,19,24,5
2278,1,home,0,8,8
2278,2,shop,8,9,1
2278,3,education,9,12,3
2278,4,shop,12,13,1
2278,5,education,13,15,2
2278,6,shop,15,16,1
2278,7,home,16,24,8
2279,1,home,0,7,7
2279,2,work,7,13,6
2279,3,shop,13,14,1
2279,4,work,14,20,6
2279,5,home,20,24,4
2280,1,home,0,8,8
2280,2,work,8,13,5
2280,3,home,13,17,4
2280,4,work,17,20,3
2280,5,home,20,24,4
2281,1,work,0,8,8
2281,2,shop,8,9,1
2281,3,work,9,16,7
2281,4,home,16,24,8
2282,1,home,0,8,8
2282,2,work,8,15,7
2282,3,home,15,21,6
2282,4,shop,21,22,1
2282,5,home,22,24,2
2283,1,home,0,7,7
2283,2,shop,7,8,1
2283,3,home,8,13,5
2283,4,work,13,20,7
2283,5,home,20,24,4
2284,1,home,0,8,8
2284,2,work,8,15,7
2284,3,shop,15,16,1
2284,4,work,16,19,3
2284,5,home,19,24,5
2285,1,home,0,7,7
2285,2,work,7,13,6
2285,3,home,13,15,2
2285,4,work,15,19,4
2285,5,home,19,23,4
2285,6,work,23,24,1
2286,1,home,0,7,7
2286,2,work,7,14,7
2286,3,home,14,17,3
2286,4,work,17,20,3
2286,5,home,20,24,4
2287,1,home,0,7,7
2287,2,shop,7,9,2
2287,3,education,9,12,3
2287,4,home,12,20,8
2287,5,shop,20,21,1
2287,6,home,21,24,3
2288,1,home,0,7,7
2288,2,work,7,14,7
2288,3,home,14,21,7
2288,4,work,21,22,1
2288,5,home,22,24,2
2289,1,home,0,6,6
2289,2,shop,6,7,1
2289,3,work,7,13,6
2289,4,home,13,23,10
2289,5,work,23,24,1
2290,1,home,0,7,7
2290,2,work,7,13,6
2290,3,shop,13,14,1
2290,4,work,14,19,5
2290,5,home,19,24,5
2291,1,home,0,8,8
2291,2,work,8,15,7
2291,3,home,15,22,7
2291,4,work,22,23,1
2291,5,home,23,24,1
2292,1,home,0,7,7
2292,2,work,7,13,6
2292,3,shop,13,14,1
2292,4,work,14,20,6
2292,5,home,20,24,4
2293,1,home,0,7,7
2293,2,education,7,11,4
2293,3,home,11,18,7
2293,4,shop,18,19,1
2293,5,home,19,24,5
2294,1,home,0,7,7
2294,2,work,7,13,6
2294,3,home,13,24,11
2295,1,home,0,8,8
2295,2,education,8,11,3
2295,3,home,11,18,7
2295,4,shop,18,19,1
2295,5,home,19,24,5
2296,1,home,0,6,6
2296,2,work,6,13,7
2296,3,shop,13,14,1
2296,4,home,14,24,10
2297,1,home,0,8,8
2297,2,shop,8,10,2
2297,3,education,10,16,6
2297,4,shop,16,17,1
2297,5,home,17,24,7
2298,1,home,0,7,7
2298,2,work,7,14,7
2298,3,home,14,18,4
2298,4,shop,18,19,1
2298,5,home,19,24,5
2299,1,home,0,6,6
2299,2,work,6,13,7
2299,3,home,13,15,2
2299,4,work,15,16,1
2299,5,shop,16,17,1
2299,6,work,17,20,3
2299,7,home,20,24,4
2300,1,home,0,8,8
2300,2,work,8,9,1
2300,3,shop,9,10,1
2300,4,home,10,23,13
2300,5,work,23,24,1
2301,1,home,0,6,6
2301,2,shop,6,7,1
2301,3,home,7,10,3
2301,4,education,10,12,2
2301,5,home,12,18,6
2301,6,shop,18,19,1
2301,7,home,19,24,5
2302,1,home,0,8,8
2302,2,work,8,13,5
2302,3,shop,13,14,1
2302,4,home,14,18,4
2302,5,work,18,20,2
2302,6,home,20,24,4
2303,1,home,0,6,6
2303,2,work,6,13,7
2303,3,home,13,15,2
2303,4,work,15,20,5
2303,5,home,20,24,4
2304,1,home,0,7,7
2304,2,education,7,11,4
2304,3,home,11,19,8
2304,4,shop,19,21,2
2304,5,home,21,24,3
2305,1,home,0,7,7
2305,2,work,7,13,6
2305,3,home,13,21,8
2305,4,shop,21,22,1
2305,5,home,22,24,2
2306,1,home,0,7,7
2306,2,work,7,13,6
2306,3,home,13,15,2
2306,4,shop,15,16,1
2306,5,work,16,20,4
2306,6,home,20,24,4
2307,1,home,0,6,6
2307,2,work,6,8,2
2307,3,home,8,15,7
2307,4,work,15,18,3
2307,5,home,18,24,6
2308,1,home,0,7,7
2308,2,work,7,14,7
2308,3,home,14,24,10
2309,1,home,0,6,6
2309,2,work,6,13,7
2309,3,shop,13,14,1
2309,4,work,14,19,5
2309,5,home,19,24,5
2310,1,home,0,8,8
2310,2,education,8,11,3
2310,3,shop,11,12,1
2310,4,home,12,16,4
2310,5,work,16,19,3
2310,6,home,19,24,5
2311,1,home,0,6,6
2311,2,work,6,8,2
2311,3,home,8,9,1
2311,4,work,9,11,2
2311,5,home,11,15,4
2311,6,shop,15,16,1
2311,7,work,16,19,3
2311,8,home,19,24,5
2312,1,home,0,7,7
2312,2,shop,7,8,1
2312,3,education,8,11,3
2312,4,home,11,17,6
2312,5,shop,17,18,1
2312,6,home,18,24,6
2313,1,home,0,8,8
2313,2,work,8,14,6
2313,3,shop,14,15,1
2313,4,work,15,20,5
2313,5,home,20,24,4
2314,1,home,0,7,7
2314,2,work,7,14,7
2314,3,shop,14,15,1
2314,4,home,15,24,9
2315,1,home,0,7,7
2315,2,work,7,13,6
2315,3,shop,13,14,1
2315,4,work,14,19,5
2315,5,home,19,24,5
2316,1,home,0,7,7
2316,2,work,7,14,7
2316,3,shop,14,15,1
2316,4,home,15,24,9
2317,1,home,0,6,6
2317,2,shop,6,7,1
2317,3,home,7,10,3
2317,4,education,10,13,3
2317,5,shop,13,14,1
2317,6,home,14,20,6
2317,7,shop,20,21,1
2317,8,home,21,24,3
2318,1,home,0,7,7
2318,2,work,7,14,7
2318,3,home,14,24,10
2319,1,home,0,8,8
2319,2,work,8,15,7
2319,3,home,15,24,9
2320,1,home,0,6,6
2320,2,work,6,8,2
2320,3,home,8,13,5
2320,4,work,13,15,2
2320,5,home,15,23,8
2320,6,work,23,24,1
2321,1,home,0,6,6
2321,2,shop,6,7,1
2321,3,home,7,13,6
2321,4,education,13,16,3
2321,5,home,16,24,8
2322,1,home,0,7,7
2322,2,work,7,14,7
2322,3,shop,14,15,1
2322,4,work,15,20,5
2322,5,home,20,24,4
2323,1,home,0,6,6
2323,2,shop,6,7,1
2323,3,home,7,13,6
2323,4,education,13,16,3
2323,5,shop,16,17,1
2323,6,home,17,24,7
2324,1,home,0,7,7
2324,2,work,7,15,8
2324,3,shop,15,16,1
2324,4,home,16,24,8
2325,1,home,0,8,8
2325,2,work,8,16,8
2325,3,home,16,22,6
2325,4,work,22,23,1
2325,5,home,23,24,1
2326,1,home,0,9,9
2326,2,education,9,14,5
2326,3,work,14,20,6
2326,4,home,20,24,4
2327,1,home,0,6,6
2327,2,work,6,13,7
2327,3,shop,13,14,1
2327,4,education,14,17,3
2327,5,shop,17,18,1
2327,6,home,18,24,6
2328,1,home,0,7,7
2328,2,work,7,10,3
2328,3,home,10,18,8
2328,4,work,18,19,1
2328,5,home,19,24,5
2329,1,home,0,8,8
2329,2,work,8,15,7
2329,3,home,15,24,9
2330,1,home,0,7,7
2330,2,shop,7,8,1
2330,3,education,8,11,3
2330,4,home,11,18,7
2330,5,shop,18,19,1
2330,6,home,19,24,5
2331,1,home,0,7,7
2331,2,shop,7,8,1
2331,3,work,8,15,7
2331,4,home,15,21,6
2331,5,work,21,22,1
2331,6,home,22,24,2
2332,1,home,0,7,7
2332,2,work,7,13,6
2332,3,shop,13,14,1
2332,4,home,14,23,9
2332,5,work,23,24,1
2333,1,home,0,7,7
2333,2,education,7,11,4
2333,3,home,11,18,7
2333,4,shop,18,19,1
2333,5,home,19,24,5
2334,1,home,0,8,8
2334,2,shop,8,9,1
2334,3,work,9,15,6
2334,4,home,15,21,6
2334,5,work,21,22,1
2334,6,home,22,24,2
2335,1,home,0,8,8
2335,2,work,8,15,7
2335,3,shop,15,16,1
2335,4,work,16,20,4
2335,5,home,20,24,4
2336,1,home,0,7,7
2336,2,work,7,14,7
2336,3,shop,14,15,1
2336,4,work,15,19,4
2336,5,home,19,24,5
2337,1,home,0,7,7
2337,2,work,7,14,7
2337,3,home,14,24,10
2338,1,home,0,7,7
2338,2,work,7,13,6
2338,3,shop,13,14,1
2338,4,work,14,19,5
2338,5,home,19,24,5
2339,1,home,0,7,7
2339,2,education,7,12,5
2339,3,home,12,20,8
2339,4,shop,20,21,1
2339,5,home,21,24,3
2340,1,home,0,8,8
2340,2,work,8,15,7
2340,3,home,15,24,9
2341,1,home,0,8,8
2341,2,work,8,15,7
2341,3,home,15,20,5
2341,4,shop,20,21,1
2341,5,home,21,24,3
2342,1,home,0,7,7
2342,2,work,7,13,6
2342,3,shop,13,14,1
2342,4,work,14,20,6
2342,5,home,20,24,4
2343,1,home,0,7,7
2343,2,education,7,11,4
2343,3,home,11,16,5
2343,4,shop,16,17,1
2343,5,home,17,24,7
2344,1,home,0,6,6
2344,2,work,6,8,2
2344,3,home,8,13,5
2344,4,work,13,16,3
2344,5,home,16,22,6
2344,6,work,22,23,1
2344,7,home,23,24,1
2345,1,home,0,6,6
2345,2,work,6,8,2
2345,3,home,8,9,1
2345,4,work,9,11,2
2345,5,home,11,17,6
2345,6,work,17,19,2
2345,7,home,19,24,5
2346,1,home,0,8,8
2346,2,education,8,12,4
2346,3,home,12,21,9
2346,4,work,21,22,1
2346,5,home,22,24,2
2347,1,home,0,6,6
2347,2,work,6,13,7
2347,3,shop,13,15,2
2347,4,work,15,19,4
2347,5,home,19,24,5
2348,1,home,0,7,7
2348,2,work,7,14,7
2348,3,shop,14,15,1
2348,4,home,15,24,9
2349,1,home,0,8,8
2349,2,education,8,11,3
2349,3,home,11,16,5
2349,4,shop,16,17,1
2349,5,home,17,24,7
2350,1,home,0,9,9
2350,2,work,9,16,7
2350,3,home,16,24,8
2351,1,home,0,6,6
2351,2,work,6,13,7
2351,3,home,13,17,4
2351,4,shop,17,18,1
2351,5,work,18,20,2
2351,6,home,20,24,4
2352,1,home,0,8,8
2352,2,work,8,16,8
2352,3,home,16,18,2
2352,4,work,18,19,1
2352,5,home,19,24,5
2353,1,home,0,8,8
2353,2,work,8,15,7
2353,3,shop,15,16,1
2353,4,home,16,24,8
2354,1,home,0,7,7
2354,2,work,7,13,6
2354,3,shop,13,14,1
2354,4,home,14,24,10
2355,1,home,0,8,8
2355,2,work,8,15,7
2355,3,home,15,19,4
2355,4,shop,19,20,1
2355,5,home,20,24,4
2356,1,home,0,8,8
2356,2,work,8,15,7
2356,3,shop,15,16,1
2356,4,home,16,23,7
2356,5,work,23,24,1
2357,1,home,0,9,9
2357,2,work,9,16,7
2357,3,home,16,24,8
2358,1,home,0,7,7
2358,2,work,7,14,7
2358,3,home,14,21,7
2358,4,work,21,22,1
2358,5,home,22,24,2
2359,1,home,0,6,6
2359,2,shop,6,7,1
2359,3,home,7,12,5
2359,4,education,12,15,3
2359,5,shop,15,17,2
2359,6,home,17,24,7
2360,1,home,0,8,8
2360,2,work,8,14,6
2360,3,shop,14,15,1
2360,4,home,15,24,9
2361,1,home,0,6,6
2361,2,shop,6,7,1
2361,3,home,7,10,3
2361,4,education,10,12,2
2361,5,shop,12,14,2
2361,6,education,14,16,2
2361,7,home,16,24,8
2362,1,home,0,6,6
2362,2,shop,6,7,1
2362,3,home,7,9,2
2362,4,education,9,12,3
2362,5,shop,12,14,2
2362,6,education,14,16,2
2362,7,home,16,20,4
2362,8,shop,20,21,1
2362,9,home,21,24,3
2363,1,home,0,6,6
2363,2,work,6,8,2
2363,3,home,8,11,3
2363,4,work,11,12,1
2363,5,home,12,17,5
2363,6,work,17,19,2
2363,7,home,19,24,5
2364,1,home,0,6,6
2364,2,work,6,13,7
2364,3,shop,13,14,1
2364,4,work,14,19,5
2364,5,home,19,24,5
2365,1,home,0,6,6
2365,2,shop,6,7,1
2365,3,home,7,9,2
2365,4,education,9,12,3
2365,5,home,12,24,12
2366,1,home,0,6,6
2366,2,shop,6,7,1
2366,3,home,7,9,2
2366,4,education,9,12,3
2366,5,shop,12,14,2
2366,6,home,14,24,10
2367,1,home,0,7,7
2367,2,education,7,12,5
2367,3,home,12,18,6
2367,4,shop,18,19,1
2367,5,home,19,24,5
2368,1,home,0,7,7
2368,2,shop,7,9,2
2368,3,home,9,14,5
2368,4,work,14,20,6
2368,5,home,20,24,4
2369,1,home,0,7,7
2369,2,shop,7,8,1
2369,3,education,8,13,5
2369,4,home,13,20,7
2369,5,shop,20,21,1
2369,6,home,21,24,3
2370,1,home,0,8,8
2370,2,work,8,14,6
2370,3,shop,14,15,1
2370,4,home,15,24,9
2371,1,home,0,7,7
2371,2,work,7,13,6
2371,3,home,13,23,10
2371,4,work,23,24,1
2372,1,home,0,6,6
2372,2,work,6,13,7
2372,3,home,13,24,11
2373,1,home,0,7,7
2373,2,work,7,13,6
2373,3,shop,13,14,1
2373,4,work,14,19,5
2373,5,home,19,24,5
2374,1,home,0,6,6
2374,2,work,6,13,7
2374,3,home,13,24,11
2375,1,home,0,7,7
2375,2,work,7,13,6
2375,3,home,13,22,9
2375,4,work,22,23,1
2375,5,home,23,24,1
2376,1,home,0,7,7
2376,2,education,7,11,4
2376,3,home,11,19,8
2376,4,shop,19,20,1
2376,5,home,20,24,4
2377,1,home,0,7,7
2377,2,work,7,14,7
2377,3,shop,14,15,1
2377,4,work,15,20,5
2377,5,home,20,24,4
2378,1,home,0,8,8
2378,2,education,8,14,6
2378,3,home,14,24,10
2379,1,home,0,8,8
2379,2,work,8,15,7
2379,3,shop,15,16,1
2379,4,home,16,24,8
2380,1,home,0,8,8
2380,2,work,8,16,8
2380,3,shop,16,17,1
2380,4,work,17,20,3
2380,5,home,20,24,4
2381,1,home,0,7,7
2381,2,work,7,14,7
2381,3,home,14,24,10
2382,1,home,0,6,6
2382,2,work,6,13,7
2382,3,shop,13,14,1
2382,4,work,14,20,6
2382,5,home,20,24,4
2383,1,home,0,7,7
2383,2,education,7,11,4
2383,3,home,11,18,7
2383,4,shop,18,19,1
2383,5,home,19,24,5
2384,1,home,0,7,7
2384,2,work,7,15,8
2384,3,shop,15,16,1
2384,4,home,16,24,8
2385,1,home,0,7,7
2385,2,work,7,13,6
2385,3,shop,13,15,2
2385,4,home,15,24,9
2386,1,home,0,6,6
2386,2,work,6,13,7
2386,3,shop,13,14,1
2386,4,work,14,20,6
2386,5,home,20,24,4
2387,1,home,0,7,7
2387,2,work,7,14,7
2387,3,home,14,23,9
2387,4,work,23,24,1
2388,1,home,0,6,6
2388,2,work,6,13,7
2388,3,home,13,17,4
2388,4,work,17,20,3
2388,5,home,20,24,4
2389,1,home,0,7,7
2389,2,education,7,11,4
2389,3,home,11,19,8
2389,4,shop,19,20,1
2389,5,home,20,24,4
2390,1,home,0,6,6
2390,2,work,6,13,7
2390,3,home,13,24,11
2391,1,home,0,7,7
2391,2,work,7,14,7
2391,3,home,14,24,10
2392,1,home,0,7,7
2392,2,education,7,11,4
2392,3,home,11,18,7
2392,4,shop,18,19,1
2392,5,home,19,24,5
2393,1,home,0,7,7
2393,2,shop,7,8,1
2393,3,education,8,15,7
2393,4,shop,15,16,1
2393,5,home,16,24,8
2394,1,home,0,7,7
2394,2,work,7,13,6
2394,3,shop,13,14,1
2394,4,work,14,19,5
2394,5,education,19,20,1
2394,6,home,20,24,4
2395,1,home,0,6,6
2395,2,work,6,8,2
2395,3,home,8,14,6
2395,4,work,14,17,3
2395,5,home,17,24,7
2396,1,home,0,7,7
2396,2,work,7,13,6
2396,3,shop,13,14,1
2396,4,work,14,20,6
2396,5,home,20,24,4
2397,1,home,0,7,7
2397,2,work,7,13,6
2397,3,shop,13,14,1
2397,4,work,14,19,5
2397,5,home,19,24,5
2398,1,home,0,7,7
2398,2,work,7,13,6
2398,3,shop,13,14,1
2398,4,work,14,20,6
2398,5,home,20,24,4
2399,1,home,0,6,6
2399,2,work,6,13,7
2399,3,home,13,24,11
2400,1,home,0,6,6
2400,2,shop,6,7,1
2400,3,home,7,9,2
2400,4,education,9,12,3
2400,5,shop,12,13,1
2400,6,education,13,16,3
2400,7,shop,16,17,1
2400,8,home,17,24,7
2401,1,home,0,8,8
2401,2,work,8,15,7
2401,3,shop,15,17,2
2401,4,home,17,21,4
2401,5,work,21,22,1
2401,6,home,22,24,2
2402,1,home,0,7,7
2402,2,work,7,14,7
2402,3,home,14,20,6
2402,4,shop,20,21,1
2402,5,home,21,24,3
2403,1,home,0,7,7
2403,2,education,7,12,5
2403,3,shop,12,13,1
2403,4,education,13,16,3
2403,5,home,16,21,5
2403,6,shop,21,22,1
2403,7,home,22,24,2
2404,1,home,0,6,6
2404,2,work,6,13,7
2404,3,home,13,24,11
2405,1,home,0,6,6
2405,2,work,6,13,7
2405,3,home,13,17,4
2405,4,work,17,20,3
2405,5,home,20,24,4
2406,1,home,0,7,7
2406,2,work,7,14,7
2406,3,shop,14,15,1
2406,4,home,15,23,8
2406,5,work,23,24,1
2407,1,home,0,9,9
2407,2,education,9,14,5
2407,3,shop,14,16,2
2407,4,home,16,24,8
2408,1,home,0,7,7
2408,2,education,7,11,4
2408,3,home,11,14,3
2408,4,education,14,17,3
2408,5,shop,17,18,1
2408,6,home,18,24,6
2409,1,home,0,7,7
2409,2,work,7,14,7
2409,3,home,14,17,3
2409,4,work,17,20,3
2409,5,home,20,24,4
2410,1,home,0,6,6
2410,2,shop,6,7,1
2410,3,home,7,13,6
2410,4,education,13,16,3
2410,5,home,16,24,8
2411,1,home,0,7,7
2411,2,work,7,9,2
2411,3,home,9,13,4
2411,4,work,13,15,2
2411,5,home,15,21,6
2411,6,work,21,22,1
2411,7,home,22,24,2
2412,1,home,0,8,8
2412,2,work,8,15,7
2412,3,home,15,18,3
2412,4,work,18,20,2
2412,5,home,20,24,4
2413,1,home,0,6,6
2413,2,work,6,13,7
2413,3,shop,13,14,1
2413,4,home,14,24,10
2414,1,home,0,8,8
2414,2,shop,8,9,1
2414,3,work,9,16,7
2414,4,home,16,22,6
2414,5,work,22,23,1
2414,6,home,23,24,1
2415,1,home,0,8,8
2415,2,work,8,15,7
2415,3,home,15,24,9
2416,1,home,0,6,6
2416,2,work,6,13,7
2416,3,home,13,19,6
2416,4,shop,19,20,1
2416,5,home,20,24,4
2417,1,home,0,7,7
2417,2,work,7,13,6
2417,3,shop,13,15,2
2417,4,home,15,24,9
2418,1,home,0,8,8
2418,2,education,8,14,6
2418,3,shop,14,16,2
2418,4,home,16,24,8
2419,1,home,0,7,7
2419,2,education,7,11,4
2419,3,home,11,17,6
2419,4,shop,17,19,2
2419,5,home,19,24,5
2420,1,home,0,7,7
2420,2,work,7,14,7
2420,3,shop,14,15,1
2420,4,work,15,20,5
2420,5,home,20,24,4
2421,1,home,0,7,7
2421,2,education,7,11,4
2421,3,home,11,19,8
2421,4,shop,19,20,1
2421,5,home,20,24,4
2422,1,home,0,6,6
2422,2,shop,6,7,1
2422,3,home,7,9,2
2422,4,education,9,13,4
2422,5,shop,13,15,2
2422,6,home,15,21,6
2422,7,shop,21,22,1
2422,8,home,22,24,2
2423,1,home,0,7,7
2423,2,work,7,15,8
2423,3,home,15,20,5
2423,4,shop,20,21,1
2423,5,home,21,24,3
2424,1,home,0,7,7
2424,2,shop,7,8,1
2424,3,home,8,13,5
2424,4,education,13,16,3
2424,5,shop,16,17,1
2424,6,home,17,24,7
2425,1,home,0,7,7
2425,2,work,7,13,6
2425,3,home,13,18,5
2425,4,work,18,20,2
2425,5,home,20,24,4
2426,1,home,0,6,6
2426,2,work,6,13,7
2426,3,shop,13,14,1
2426,4,work,14,19,5
2426,5,home,19,24,5
2427,1,home,0,6,6
2427,2,work,6,13,7
2427,3,shop,13,14,1
2427,4,work,14,19,5
2427,5,home,19,24,5
2428,1,home,0,7,7
2428,2,shop,7,9,2
2428,3,education,9,12,3
2428,4,home,12,20,8
2428,5,shop,20,21,1
2428,6,home,21,24,3
2429,1,home,0,8,8
2429,2,education,8,14,6
2429,3,work,14,20,6
2429,4,home,20,24,4
2430,1,home,0,6,6
2430,2,work,6,7,1
2430,3,home,7,9,2
2430,4,work,9,11,2
2430,5,home,11,15,4
2430,6,work,15,18,3
2430,7,home,18,24,6
2431,1,home,0,7,7
2431,2,work,7,13,6
2431,3,shop,13,14,1
2431,4,home,14,24,10
2432,1,home,0,7,7
2432,2,work,7,9,2
2432,3,home,9,14,5
2432,4,work,14,16,2
2432,5,home,16,24,8
2433,1,home,0,7,7
2433,2,work,7,14,7
2433,3,home,14,24,10
2434,1,home,0,7,7
2434,2,shop,7,8,1
2434,3,education,8,11,3
2434,4,home,11,19,8
2434,5,shop,19,20,1
2434,6,home,20,24,4
2435,1,home,0,7,7
2435,2,work,7,13,6
2435,3,shop,13,14,1
2435,4,home,14,24,10
2436,1,home,0,7,7
2436,2,work,7,14,7
2436,3,home,14,24,10
2437,1,home,0,7,7
2437,2,work,7,14,7
2437,3,shop,14,15,1
2437,4,home,15,22,7
2437,5,work,22,23,1
2437,6,home,23,24,1
2438,1,home,0,6,6
2438,2,shop,6,7,1
2438,3,work,7,13,6
2438,4,home,13,24,11
2439,1,home,0,7,7
2439,2,work,7,14,7
2439,3,home,14,24,10
2440,1,home,0,6,6
2440,2,shop,6,7,1
2440,3,home,7,10,3
2440,4,education,10,14,4
2440,5,shop,14,15,1
2440,6,home,15,21,6
2440,7,shop,21,22,1
2440,8,home,22,24,2
2441,1,home,0,7,7
2441,2,work,7,13,6
2441,3,home,13,23,10
2441,4,work,23,24,1
2442,1,home,0,7,7
2442,2,work,7,14,7
2442,3,shop,14,15,1
2442,4,work,15,20,5
2442,5,home,20,24,4
2443,1,home,0,7,7
2443,2,work,7,9,2
2443,3,home,9,15,6
2443,4,work,15,18,3
2443,5,home,18,24,6
2444,1,home,0,9,9
2444,2,education,9,12,3
2444,3,home,12,16,4
2444,4,work,16,20,4
2444,5,home,20,24,4
2445,1,home,0,8,8
2445,2,education,8,14,6
2445,3,shop,14,15,1
2445,4,home,15,21,6
2445,5,shop,21,22,1
2445,6,home,22,24,2
2446,1,home,0,7,7
2446,2,education,7,13,6
2446,3,home,13,19,6
2446,4,shop,19,20,1
2446,5,home,20,24,4
2447,1,home,0,6,6
2447,2,work,6,13,7
2447,3,home,13,14,1
2447,4,work,14,20,6
2447,5,home,20,24,4
2448,1,home,0,6,6
2448,2,shop,6,7,1
2448,3,home,7,10,3
2448,4,education,10,12,2
2448,5,home,12,14,2
2448,6,education,14,16,2
2448,7,shop,16,18,2
2448,8,home,18,24,6
2449,1,home,0,8,8
2449,2,work,8,14,6
2449,3,home,14,18,4
2449,4,work,18,20,2
2449,5,home,20,24,4
2450,1,home,0,7,7
2450,2,education,7,11,4
2450,3,home,11,18,7
2450,4,shop,18,19,1
2450,5,home,19,24,5
2451,1,home,0,8,8
2451,2,education,8,12,4
2451,3,home,12,18,6
2451,4,shop,18,19,1
2451,5,home,19,24,5
2452,1,home,0,8,8
2452,2,work,8,14,6
2452,3,home,14,20,6
2452,4,shop,20,21,1
2452,5,home,21,24,3
2453,1,home,0,8,8
2453,2,education,8,11,3
2453,3,home,11,17,6
2453,4,shop,17,19,2
2453,5,home,19,24,5
2454,1,home,0,6,6
2454,2,work,6,8,2
2454,3,home,8,13,5
2454,4,work,13,14,1
2454,5,home,14,21,7
2454,6,work,21,22,1
2454,7,home,22,24,2
2455,1,home,0,8,8
2455,2,work,8,15,7
2455,3,shop,15,16,1
2455,4,home,16,24,8
2456,1,home,0,6,6
2456,2,work,6,14,8
2456,3,shop,14,15,1
2456,4,home,15,17,2
2456,5,work,17,20,3
2456,6,home,20,24,4
2457,1,home,0,6,6
2457,2,shop,6,7,1
2457,3,home,7,9,2
2457,4,education,9,12,3
2457,5,home,12,20,8
2457,6,shop,20,21,1
2457,7,home,21,24,3
2458,1,home,0,7,7
2458,2,work,7,14,7
2458,3,home,14,20,6
2458,4,shop,20,21,1
2458,5,home,21,24,3
2459,1,home,0,7,7
2459,2,work,7,14,7
2459,3,home,14,24,10
2460,1,home,0,6,6
2460,2,shop,6,7,1
2460,3,home,7,8,1
2460,4,education,8,12,4
2460,5,home,12,19,7
2460,6,shop,19,20,1
2460,7,home,20,24,4
2461,1,home,0,8,8
2461,2,education,8,11,3
2461,3,home,11,14,3
2461,4,education,14,16,2
2461,5,home,16,24,8
2462,1,home,0,7,7
2462,2,work,7,13,6
2462,3,home,13,21,8
2462,4,shop,21,22,1
2462,5,home,22,24,2
2463,1,home,0,8,8
2463,2,work,8,15,7
2463,3,home,15,19,4
2463,4,shop,19,20,1
2463,5,home,20,24,4
2464,1,home,0,8,8
2464,2,work,8,16,8
2464,3,home,16,24,8
2465,1,home,0,6,6
2465,2,work,6,13,7
2465,3,home,13,17,4
2465,4,work,17,20,3
2465,5,home,20,24,4
2466,1,home,0,6,6
2466,2,work,6,13,7
2466,3,shop,13,14,1
2466,4,home,14,24,10
2467,1,home,0,7,7
2467,2,work,7,14,7
2467,3,home,14,24,10
2468,1,home,0,6,6
2468,2,work,6,13,7
2468,3,shop,13,14,1
2468,4,home,14,24,10
2469,1,home,0,8,8
2469,2,education,8,11,3
2469,3,home,11,24,13
2470,1,home,0,6,6
2470,2,shop,6,7,1
2470,3,home,7,9,2
2470,4,education,9,12,3
2470,5,home,12,19,7
2470,6,shop,19,20,1
2470,7,home,20,24,4
2471,1,home,0,6,6
2471,2,work,6,8,2
2471,3,home,8,12,4
2471,4,work,12,14,2
2471,5,home,14,21,7
2471,6,work,21,22,1
2471,7,home,22,24,2
2472,1,home,0,7,7
2472,2,work,7,13,6
2472,3,shop,13,14,1
2472,4,home,14,24,10
2473,1,home,0,7,7
2473,2,work,7,15,8
2473,3,home,15,24,9
2474,1,home,0,8,8
2474,2,work,8,14,6
2474,3,home,14,20,6
2474,4,shop,20,21,1
2474,5,home,21,24,3
2475,1,home,0,7,7
2475,2,work,7,14,7
2475,3,home,14,24,10
2476,1,home,0,6,6
2476,2,work,6,13,7
2476,3,shop,13,14,1
2476,4,home,14,23,9
2476,5,work,23,24,1
2477,1,home,0,7,7
2477,2,work,7,14,7
2477,3,home,14,24,10
2478,1,home,0,7,7
2478,2,work,7,13,6
2478,3,shop,13,14,1
2478,4,work,14,19,5
2478,5,home,19,24,5
2479,1,home,0,7,7
2479,2,shop,7,8,1
2479,3,work,8,15,7
2479,4,home,15,24,9
2480,1,home,0,7,7
2480,2,work,7,13,6
2480,3,shop,13,15,2
2480,4,home,15,24,9
2481,1,home,0,7,7
2481,2,shop,7,8,1
2481,3,work,8,15,7
2481,4,home,15,24,9
2482,1,home,0,6,6
2482,2,work,6,13,7
2482,3,shop,13,14,1
2482,4,home,14,24,10
2483,1,home,0,6,6
2483,2,work,6,13,7
2483,3,home,13,20,7
2483,4,shop,20,21,1
2483,5,home,21,24,3
2484,1,home,0,7,7
2484,2,education,7,12,5
2484,3,shop,12,14,2
2484,4,education,14,16,2
2484,5,home,16,24,8
2485,1,home,0,7,7
2485,2,work,7,13,6
2485,3,shop,13,14,1
2485,4,education,14,17,3
2485,5,home,17,23,6
2485,6,work,23,24,1
2486,1,home,0,7,7
2486,2,work,7,13,6
2486,3,home,13,17,4
2486,4,work,17,20,3
2486,5,home,20,24,4
2487,1,home,0,6,6
2487,2,work,6,8,2
2487,3,home,8,9,1
2487,4,work,9,11,2
2487,5,home,11,17,6
2487,6,work,17,18,1
2487,7,home,18,24,6
2488,1,home,0,7,7
2488,2,work,7,13,6
2488,3,home,13,17,4
2488,4,work,17,20,3
2488,5,home,20,24,4
2489,1,home,0,8,8
2489,2,work,8,14,6
2489,3,home,14,24,10
2490,1,home,0,6,6
2490,2,work,6,13,7
2490,3,shop,13,14,1
2490,4,work,14,20,6
2490,5,home,20,24,4
2491,1,home,0,8,8
2491,2,work,8,14,6
2491,3,home,14,16,2
2491,4,work,16,20,4
2491,5,home,20,24,4
2492,1,home,0,6,6
2492,2,shop,6,7,1
2492,3,home,7,9,2
2492,4,education,9,13,4
2492,5,shop,13,15,2
2492,6,home,15,24,9
2493,1,home,0,7,7
2493,2,shop,7,8,1
2493,3,education,8,11,3
2493,4,home,11,18,7
2493,5,shop,18,19,1
2493,6,home,19,24,5
2494,1,home,0,6,6
2494,2,work,6,14,8
2494,3,home,14,24,10
2495,1,home,0,7,7
2495,2,education,7,11,4
2495,3,home,11,18,7
2495,4,shop,18,19,1
2495,5,home,19,24,5
2496,1,home,0,6,6
2496,2,work,6,13,7
2496,3,home,13,17,4
2496,4,work,17,20,3
2496,5,home,20,24,4
2497,1,home,0,7,7
2497,2,work,7,11,4
2497,3,shop,11,12,1
2497,4,home,12,20,8
2497,5,shop,20,21,1
2497,6,home,21,24,3
2498,1,home,0,9,9
2498,2,work,9,18,9
2498,3,education,18,20,2
2498,4,home,20,24,4
2499,1,home,0,7,7
2499,2,work,7,13,6
2499,3,home,13,17,4
2499,4,work,17,20,3
2499,5,home,20,24,4
2500,1,home,0,8,8
2500,2,education,8,12,4
2500,3,work,12,18,6
2500,4,home,18,24,6
2501,1,home,0,7,7
2501,2,shop,7,8,1
2501,3,education,8,11,3
2501,4,home,11,17,6
2501,5,shop,17,18,1
2501,6,home,18,24,6
2502,1,home,0,7,7
2502,2,work,7,14,7
2502,3,home,14,24,10
2503,1,home,0,7,7
2503,2,shop,7,8,1
2503,3,home,8,12,4
2503,4,work,12,19,7
2503,5,home,19,24,5
2504,1,home,0,7,7
2504,2,work,7,9,2
2504,3,home,9,13,4
2504,4,work,13,15,2
2504,5,home,15,21,6
2504,6,work,21,22,1
2504,7,home,22,24,2
2505,1,home,0,7,7
2505,2,work,7,13,6
2505,3,shop,13,14,1
2505,4,home,14,24,10
2506,1,home,0,6,6
2506,2,work,6,7,1
2506,3,home,7,12,5
2506,4,work,12,14,2
2506,5,home,14,22,8
2506,6,work,22,23,1
2506,7,home,23,24,1
2507,1,home,0,6,6
2507,2,work,6,13,7
2507,3,shop,13,14,1
2507,4,home,14,24,10
2508,1,home,0,8,8
2508,2,education,8,11,3
2508,3,shop,11,12,1
2508,4,home,12,15,3
2508,5,work,15,19,4
2508,6,home,19,24,5
2509,1,home,0,8,8
2509,2,work,8,15,7
2509,3,home,15,24,9
2510,1,home,0,6,6
2510,2,work,6,13,7
2510,3,home,13,18,5
2510,4,shop,18,19,1
2510,5,home,19,24,5
2511,1,home,0,6,6
2511,2,work,6,13,7
2511,3,home,13,16,3
2511,4,work,16,20,4
2511,5,home,20,24,4
2512,1,home,0,7,7
2512,2,work,7,13,6
2512,3,home,13,24,11
2513,1,home,0,8,8
2513,2,work,8,13,5
2513,3,shop,13,14,1
2513,4,work,14,18,4
2513,5,home,18,24,6
2514,1,home,0,8,8
2514,2,work,8,15,7
2514,3,home,15,21,6
2514,4,work,21,22,1
2514,5,home,22,24,2
2515,1,home,0,7,7
2515,2,work,7,14,7
2515,3,home,14,24,10
2516,1,home,0,8,8
2516,2,work,8,14,6
2516,3,home,14,17,3
2516,4,work,17,20,3
2516,5,home,20,24,4
2517,1,home,0,7,7
2517,2,education,7,12,5
2517,3,home,12,20,8
2517,4,shop,20,21,1
2517,5,home,21,24,3
2518,1,home,0,7,7
2518,2,work,7,13,6
2518,3,home,13,15,2
2518,4,work,15,19,4
2518,5,home,19,24,5
2519,1,home,0,6,6
2519,2,work,6,7,1
2519,3,home,7,9,2
2519,4,work,9,10,1
2519,5,home,10,11,1
2519,6,work,11,13,2
2519,7,home,13,17,4
2519,8,work,17,19,2
2519,9,home,19,24,5
2520,1,home,0,7,7
2520,2,work,7,14,7
2520,3,shop,14,15,1
2520,4,work,15,20,5
2520,5,home,20,24,4
2521,1,home,0,8,8
2521,2,work,8,14,6
2521,3,shop,14,16,2
2521,4,work,16,20,4
2521,5,home,20,24,4
2522,1,home,0,7,7
2522,2,work,7,14,7
2522,3,shop,14,15,1
2522,4,home,15,24,9
2523,1,home,0,8,8
2523,2,work,8,15,7
2523,3,shop,15,16,1
2523,4,home,16,23,7
2523,5,work,23,24,1
2524,1,home,0,7,7
2524,2,work,7,14,7
2524,3,home,14,24,10
2525,1,home,0,8,8
2525,2,shop,8,9,1
2525,3,education,9,13,4
2525,4,home,13,19,6
2525,5,shop,19,20,1
2525,6,home,20,24,4
2526,1,home,0,7,7
2526,2,work,7,13,6
2526,3,home,13,24,11
2527,1,home,0,6,6
2527,2,work,6,13,7
2527,3,home,13,17,4
2527,4,work,17,20,3
2527,5,home,20,24,4
2528,1,home,0,9,9
2528,2,shop,9,10,1
2528,3,work,10,17,7
2528,4,home,17,24,7
2529,1,home,0,8,8
2529,2,work,8,14,6
2529,3,home,14,21,7
2529,4,shop,21,22,1
2529,5,home,22,24,2
2530,1,home,0,6,6
2530,2,work,6,13,7
2530,3,shop,13,14,1
2530,4,home,14,24,10
2531,1,home,0,7,7
2531,2,education,7,11,4
2531,3,home,11,15,4
2531,4,shop,15,16,1
2531,5,home,16,24,8
2532,1,home,0,6,6
2532,2,shop,6,7,1
2532,3,work,7,8,1
2532,4,home,8,12,4
2532,5,work,12,15,3
2532,6,home,15,22,7
2532,7,work,22,23,1
2532,8,home,23,24,1
2533,1,home,0,7,7
2533,2,work,7,13,6
2533,3,shop,13,14,1
2533,4,home,14,17,3
2533,5,work,17,20,3
2533,6,home,20,24,4
2534,1,home,0,6,6
2534,2,shop,6,7,1
2534,3,home,7,13,6
2534,4,education,13,16,3
2534,5,home,16,20,4
2534,6,shop,20,21,1
2534,7,home,21,24,3
2535,1,home,0,8,8
2535,2,work,8,15,7
2535,3,home,15,24,9
2536,1,home,0,6,6
2536,2,work,6,13,7
2536,3,home,13,18,5
2536,4,work,18,20,2
2536,5,home,20,24,4
2537,1,home,0,7,7
2537,2,education,7,11,4
2537,3,home,11,18,7
2537,4,shop,18,20,2
2537,5,home,20,24,4
2538,1,home,0,7,7
2538,2,work,7,14,7
2538,3,shop,14,15,1
2538,4,home,15,24,9
2539,1,home,0,6,6
2539,2,work,6,13,7
2539,3,home,13,18,5
2539,4,work,18,20,2
2539,5,home,20,24,4
2540,1,home,0,8,8
2540,2,work,8,13,5
2540,3,home,13,24,11
2541,1,home,0,6,6
2541,2,shop,6,7,1
2541,3,work,7,13,6
2541,4,home,13,24,11
2542,1,home,0,7,7
2542,2,shop,7,8,1
2542,3,education,8,12,4
2542,4,home,12,19,7
2542,5,shop,19,20,1
2542,6,home,20,24,4
2543,1,home,0,6,6
2543,2,work,6,8,2
2543,3,home,8,13,5
2543,4,work,13,15,2
2543,5,home,15,23,8
2543,6,work,23,24,1
2544,1,home,0,8,8
2544,2,work,8,15,7
2544,3,home,15,24,9
2545,1,home,0,6,6
2545,2,shop,6,7,1
2545,3,home,7,10,3
2545,4,education,10,12,2
2545,5,shop,12,13,1
2545,6,home,13,17,4
2545,7,shop,17,18,1
2545,8,home,18,24,6
2546,1,home,0,6,6
2546,2,work,6,8,2
2546,3,home,8,11,3
2546,4,work,11,14,3
2546,5,home,14,21,7
2546,6,work,21,22,1
2546,7,home,22,24,2
2547,1,home,0,7,7
2547,2,work,7,13,6
2547,3,shop,13,14,1
2547,4,home,14,16,2
2547,5,work,16,20,4
2547,6,home,20,24,4
2548,1,home,0,7,7
2548,2,work,7,9,2
2548,3,home,9,15,6
2548,4,work,15,18,3
2548,5,home,18,23,5
2548,6,work,23,24,1
2549,1,home,0,7,7
2549,2,education,7,10,3
2549,3,home,10,13,3
2549,4,education,13,16,3
2549,5,home,16,24,8
2550,1,home,0,7,7
2550,2,work,7,13,6
2550,3,home,13,23,10
2550,4,work,23,24,1
2551,1,home,0,6,6
2551,2,work,6,7,1
2551,3,home,7,9,2
2551,4,work,9,11,2
2551,5,home,11,16,5
2551,6,work,16,19,3
2551,7,home,19,23,4
2551,8,work,23,24,1
2552,1,home,0,6,6
2552,2,shop,6,7,1
2552,3,work,7,14,7
2552,4,home,14,24,10
2553,1,home,0,7,7
2553,2,work,7,9,2
2553,3,home,9,15,6
2553,4,work,15,17,2
2553,5,home,17,23,6
2553,6,work,23,24,1
2554,1,home,0,6,6
2554,2,work,6,7,1
2554,3,home,7,9,2
2554,4,work,9,11,2
2554,5,home,11,17,6
2554,6,work,17,19,2
2554,7,home,19,24,5
2555,1,home,0,8,8
2555,2,education,8,11,3
2555,3,home,11,17,6
2555,4,shop,17,18,1
2555,5,home,18,24,6
2556,1,home,0,7,7
2556,2,work,7,13,6
2556,3,shop,13,14,1
2556,4,work,14,19,5
2556,5,home,19,24,5
2557,1,home,0,6,6
2557,2,work,6,13,7
2557,3,shop,13,14,1
2557,4,work,14,20,6
2557,5,home,20,24,4
2558,1,home,0,7,7
2558,2,work,7,13,6
2558,3,home,13,18,5
2558,4,shop,18,19,1
2558,5,home,19,24,5
2559,1,home,0,9,9
2559,2,education,9,12,3
2559,3,work,12,19,7
2559,4,home,19,24,5
2560,1,home,0,7,7
2560,2,shop,7,9,2
2560,3,education,9,12,3
2560,4,home,12,19,7
2560,5,shop,19,20,1
2560,6,home,20,24,4
2561,1,home,0,7,7
2561,2,shop,7,9,2
2561,3,education,9,11,2
2561,4,home,11,18,7
2561,5,shop,18,19,1
2561,6,home,19,24,5
2562,1,home,0,6,6
2562,2,work,6,13,7
2562,3,shop,13,14,1
2562,4,work,14,20,6
2562,5,home,20,24,4
2563,1,home,0,6,6
2563,2,shop,6,7,1
2563,3,home,7,11,4
2563,4,work,11,18,7
2563,5,home,18,24,6
2564,1,home,0,7,7
2564,2,shop,7,9,2
2564,3,work,9,15,6
2564,4,shop,15,16,1
2564,5,work,16,20,4
2564,6,home,20,24,4
2565,1,home,0,9,9
2565,2,work,9,17,8
2565,3,home,17,24,7
2566,1,home,0,6,6
2566,2,work,6,13,7
2566,3,shop,13,15,2
2566,4,home,15,24,9
2567,1,home,0,6,6
2567,2,shop,6,7,1
2567,3,home,7,9,2
2567,4,education,9,11,2
2567,5,home,11,18,7
2567,6,shop,18,20,2
2567,7,home,20,24,4
2568,1,home,0,7,7
2568,2,work,7,15,8
2568,3,home,15,24,9
2569,1,home,0,7,7
2569,2,work,7,14,7
2569,3,shop,14,15,1
2569,4,work,15,19,4
2569,5,home,19,24,5
2570,1,home,0,8,8
2570,2,work,8,14,6
2570,3,shop,14,15,1
2570,4,work,15,20,5
2570,5,home,20,24,4
2571,1,home,0,6,6
2571,2,work,6,8,2
2571,3,home,8,9,1
2571,4,work,9,12,3
2571,5,home,12,18,6
2571,6,work,18,19,1
2571,7,home,19,23,4
2571,8,work,23,24,1
2572,1,home,0,7,7
2572,2,education,7,11,4
2572,3,home,11,21,10
2572,4,shop,21,22,1
2572,5,home,22,24,2
2573,1,home,0,7,7
2573,2,work,7,14,7
2573,3,home,14,24,10
2574,1,home,0,7,7
2574,2,shop,7,8,1
2574,3,education,8,12,4
2574,4,home,12,18,6
2574,5,shop,18,19,1
2574,6,home,19,24,5
2575,1,home,0,7,7
2575,2,work,7,13,6
2575,3,shop,13,14,1
2575,4,work,14,19,5
2575,5,home,19,24,5
2576,1,home,0,6,6
2576,2,shop,6,7,1
2576,3,home,7,10,3
2576,4,education,10,13,3
2576,5,home,13,20,7
2576,6,shop,20,21,1
2576,7,home,21,24,3
2577,1,home,0,8,8
2577,2,education,8,14,6
2577,3,shop,14,15,1
2577,4,home,15,22,7
2577,5,work,22,23,1
2577,6,home,23,24,1
2578,1,home,0,7,7
2578,2,work,7,13,6
2578,3,home,13,18,5
2578,4,work,18,20,2
2578,5,home,20,24,4
2579,1,home,0,6,6
2579,2,shop,6,7,1
2579,3,work,7,14,7
2579,4,home,14,24,10
2580,1,home,0,6,6
2580,2,shop,6,7,1
2580,3,work,7,8,1
2580,4,home,8,9,1
2580,5,work,9,11,2
2580,6,home,11,17,6
2580,7,work,17,19,2
2580,8,home,19,24,5
2581,1,home,0,6,6
2581,2,work,6,13,7
2581,3,shop,13,14,1
2581,4,work,14,20,6
2581,5,home,20,24,4
2582,1,home,0,7,7
2582,2,education,7,11,4
2582,3,home,11,17,6
2582,4,shop,17,18,1
2582,5,home,18,24,6
2583,1,home,0,7,7
2583,2,education,7,10,3
2583,3,home,10,17,7
2583,4,shop,17,18,1
2583,5,home,18,24,6
2584,1,home,0,6,6
2584,2,work,6,8,2
2584,3,home,8,14,6
2584,4,work,14,16,2
2584,5,home,16,24,8
2585,1,home,0,6,6
2585,2,shop,6,7,1
2585,3,work,7,13,6
2585,4,home,13,24,11
2586,1,home,0,7,7
2586,2,work,7,14,7
2586,3,shop,14,15,1
2586,4,home,15,22,7
2586,5,work,22,23,1
2586,6,home,23,24,1
2587,1,home,0,8,8
2587,2,work,8,15,7
2587,3,shop,15,16,1
2587,4,work,16,20,4
2587,5,home,20,24,4
2588,1,home,0,7,7
2588,2,work,7,9,2
2588,3,home,9,14,5
2588,4,work,14,15,1
2588,5,home,15,22,7
2588,6,work,22,23,1
2588,7,home,23,24,1
2589,1,home,0,7,7
2589,2,work,7,13,6
2589,3,home,13,24,11
2590,1,home,0,7,7
2590,2,work,7,14,7
2590,3,shop,14,15,1
2590,4,home,15,24,9
2591,1,home,0,7,7
2591,2,shop,7,8,1
2591,3,home,8,12,4
2591,4,work,12,18,6
2591,5,home,18,24,6
2592,1,home,0,7,7
2592,2,work,7,14,7
2592,3,shop,14,15,1
2592,4,home,15,24,9
2593,1,home,0,7,7
2593,2,work,7,13,6
2593,3,home,13,18,5
2593,4,shop,18,19,1
2593,5,home,19,24,5
2594,1,home,0,8,8
2594,2,work,8,14,6
2594,3,home,14,21,7
2594,4,work,21,22,1
2594,5,home,22,24,2
2595,1,home,0,6,6
2595,2,work,6,8,2
2595,3,home,8,14,6
2595,4,work,14,16,2
2595,5,home,16,22,6
2595,6,work,22,23,1
2595,7,home,23,24,1
2596,1,home,0,7,7
2596,2,education,7,11,4
2596,3,home,11,16,5
2596,4,shop,16,18,2
2596,5,home,18,24,6
2597,1,home,0,8,8
2597,2,work,8,14,6
2597,3,home,14,21,7
2597,4,work,21,22,1
2597,5,home,22,24,2
2598,1,home,0,8,8
2598,2,education,8,12,4
2598,3,home,12,19,7
2598,4,shop,19,20,1
2598,5,home,20,24,4
2599,1,home,0,7,7
2599,2,work,7,14,7
2599,3,home,14,18,4
2599,4,work,18,20,2
2599,5,home,20,24,4
2600,1,home,0,6,6
2600,2,shop,6,7,1
2600,3,home,7,11,4
2600,4,education,11,16,5
2600,5,home,16,24,8
2601,1,home,0,7,7
2601,2,work,7,14,7
2601,3,shop,14,15,1
2601,4,home,15,21,6
2601,5,work,21,22,1
2601,6,home,22,24,2
2602,1,home,0,9,9
2602,2,work,9,17,8
2602,3,home,17,23,6
2602,4,work,23,24,1
2603,1,home,0,7,7
2603,2,work,7,14,7
2603,3,home,14,24,10
2604,1,home,0,9,9
2604,2,shop,9,10,1
2604,3,work,10,17,7
2604,4,home,17,21,4
2604,5,work,21,22,1
2604,6,home,22,24,2
2605,1,home,0,6,6
2605,2,shop,6,7,1
2605,3,work,7,14,7
2605,4,shop,14,15,1
2605,5,home,15,24,9
2606,1,home,0,7,7
2606,2,education,7,11,4
2606,3,home,11,18,7
2606,4,shop,18,20,2
2606,5,home,20,24,4
2607,1,home,0,6,6
2607,2,work,6,13,7
2607,3,home,13,22,9
2607,4,work,22,23,1
2607,5,home,23,24,1
2608,1,home,0,7,7
2608,2,work,7,13,6
2608,3,shop,13,14,1
2608,4,work,14,20,6
2608,5,home,20,24,4
2609,1,home,0,6,6
2609,2,work,6,8,2
2609,3,home,8,12,4
2609,4,work,12,14,2
2609,5,home,14,21,7
2609,6,shop,21,22,1
2609,7,home,22,24,2
2610,1,home,0,7,7
2610,2,work,7,13,6
2610,3,home,13,24,11
2611,1,home,0,7,7
2611,2,work,7,13,6
2611,3,home,13,16,3
2611,4,work,16,20,4
2611,5,home,20,24,4
2612,1,home,0,7,7
2612,2,work,7,14,7
2612,3,shop,14,15,1
2612,4,home,15,24,9
2613,1,home,0,6,6
2613,2,shop,6,7,1
2613,3,work,7,14,7
2613,4,shop,14,15,1
2613,5,home,15,24,9
2614,1,home,0,6,6
2614,2,work,6,13,7
2614,3,home,13,18,5
2614,4,work,18,20,2
2614,5,home,20,24,4
2615,1,home,0,6,6
2615,2,work,6,13,7
2615,3,home,13,17,4
2615,4,work,17,20,3
2615,5,home,20,24,4
2616,1,home,0,6,6
2616,2,work,6,13,7
2616,3,home,13,24,11
2617,1,home,0,7,7
2617,2,shop,7,9,2
2617,3,work,9,15,6
2617,4,home,15,24,9
2618,1,home,0,6,6
2618,2,work,6,8,2
2618,3,home,8,12,4
2618,4,work,12,14,2
2618,5,home,14,22,8
2618,6,work,22,23,1
2618,7,home,23,24,1
2619,1,home,0,6,6
2619,2,shop,6,7,1
2619,3,work,7,9,2
2619,4,home,9,11,2
2619,5,work,11,12,1
2619,6,home,12,17,5
2619,7,work,17,19,2
2619,8,home,19,24,5
2620,1,home,0,8,8
2620,2,work,8,15,7
2620,3,home,15,23,8
2620,4,work,23,24,1
2621,1,home,0,7,7
2621,2,work,7,14,7
2621,3,home,14,17,3
2621,4,shop,17,19,2
2621,5,home,19,24,5
2622,1,home,0,6,6
2622,2,work,6,13,7
2622,3,home,13,24,11
2623,1,home,0,6,6
2623,2,work,6,8,2
2623,3,home,8,14,6
2623,4,work,14,16,2
2623,5,home,16,23,7
2623,6,work,23,24,1
2624,1,home,0,8,8
2624,2,work,8,13,5
2624,3,home,13,16,3
2624,4,work,16,20,4
2624,5,home,20,24,4
2625,1,home,0,6,6
2625,2,shop,6,7,1
2625,3,home,7,13,6
2625,4,education,13,16,3
2625,5,home,16,24,8
2626,1,home,0,8,8
2626,2,work,8,15,7
2626,3,shop,15,17,2
2626,4,home,17,24,7
2627,1,home,0,6,6
2627,2,shop,6,7,1
2627,3,work,7,13,6
2627,4,home,13,16,3
2627,5,work,16,20,4
2627,6,home,20,24,4
2628,1,home,0,6,6
2628,2,shop,6,7,1
2628,3,home,7,10,3
2628,4,education,10,13,3
2628,5,shop,13,15,2
2628,6,home,15,21,6
2628,7,shop,21,22,1
2628,8,home,22,24,2
2629,1,home,0,6,6
2629,2,work,6,8,2
2629,3,home,8,9,1
2629,4,work,9,10,1
2629,5,home,10,16,6
2629,6,work,16,18,2
2629,7,home,18,24,6
2630,1,home,0,6,6
2630,2,work,6,13,7
2630,3,shop,13,14,1
2630,4,home,14,18,4
2630,5,work,18,20,2
2630,6,home,20,24,4
2631,1,home,0,6,6
2631,2,work,6,13,7
2631,3,home,13,18,5
2631,4,work,18,20,2
2631,5,home,20,24,4
2632,1,home,0,7,7
2632,2,education,7,11,4
2632,3,home,11,14,3
2632,4,education,14,16,2
2632,5,home,16,24,8
2633,1,home,0,7,7
2633,2,education,7,12,5
2633,3,home,12,19,7
2633,4,shop,19,20,1
2633,5,home,20,24,4
2634,1,home,0,7,7
2634,2,work,7,14,7
2634,3,home,14,18,4
2634,4,shop,18,19,1
2634,5,home,19,24,5
2635,1,home,0,7,7
2635,2,work,7,14,7
2635,3,home,14,24,10
2636,1,home,0,6,6
2636,2,work,6,13,7
2636,3,shop,13,14,1
2636,4,work,14,19,5
2636,5,home,19,24,5
2637,1,home,0,7,7
2637,2,shop,7,8,1
2637,3,education,8,12,4
2637,4,home,12,17,5
2637,5,shop,17,18,1
2637,6,home,18,24,6
2638,1,home,0,6,6
2638,2,shop,6,7,1
2638,3,home,7,9,2
2638,4,education,9,12,3
2638,5,home,12,17,5
2638,6,shop,17,19,2
2638,7,home,19,24,5
2639,1,home,0,6,6
2639,2,work,6,12,6
2639,3,shop,12,13,1
2639,4,work,13,19,6
2639,5,home,19,24,5
2640,1,home,0,7,7
2640,2,work,7,13,6
2640,3,shop,13,14,1
2640,4,education,14,16,2
2640,5,home,16,24,8
2641,1,home,0,6,6
2641,2,shop,6,7,1
2641,3,home,7,10,3
2641,4,education,10,13,3
2641,5,work,13,19,6
2641,6,home,19,24,5
2642,1,home,0,7,7
2642,2,work,7,10,3
2642,3,home,10,13,3
2642,4,work,13,15,2
2642,5,home,15,22,7
2642,6,work,22,23,1
2642,7,home,23,24,1
2643,1,home,0,6,6
2643,2,work,6,13,7
2643,3,home,13,24,11
2644,1,home,0,7,7
2644,2,work,7,13,6
2644,3,home,13,17,4
2644,4,work,17,20,3
2644,5,home,20,24,4
2645,1,home,0,7,7
2645,2,shop,7,9,2
2645,3,education,9,15,6
2645,4,shop,15,16,1
2645,5,home,16,24,8
2646,1,home,0,7,7
2646,2,shop,7,8,1
2646,3,work,8,15,7
2646,4,home,15,21,6
2646,5,work,21,22,1
2646,6,home,22,24,2
2647,1,home,0,6,6
2647,2,work,6,13,7
2647,3,shop,13,14,1
2647,4,work,14,19,5
2647,5,home,19,24,5
2648,1,home,0,6,6
2648,2,work,6,13,7
2648,3,shop,13,14,1
2648,4,work,14,19,5
2648,5,education,19,20,1
2648,6,home,20,24,4
2649,1,home,0,10,10
2649,2,education,10,13,3
2649,3,shop,13,14,1
2649,4,work,14,20,6
2649,5,home,20,24,4
2650,1,home,0,7,7
2650,2,work,7,14,7
2650,3,home,14,18,4
2650,4,work,18,20,2
2650,5,home,20,24,4
2651,1,work,0,1,1
2651,2,home,1,6,5
2651,3,work,6,7,1
2651,4,home,7,10,3
2651,5,work,10,12,2
2651,6,home,12,18,6
2651,7,work,18,19,1
2651,8,home,19,24,5
2652,1,home,0,8,8
2652,2,work,8,15,7
2652,3,home,15,24,9
2653,1,home,0,7,7
2653,2,work,7,13,6
2653,3,home,13,17,4
2653,4,work,17,20,3
2653,5,home,20,24,4
2654,1,home,0,7,7
2654,2,work,7,13,6
2654,3,home,13,24,11
2655,1,home,0,8,8
2655,2,education,8,11,3
2655,3,home,11,17,6
2655,4,shop,17,19,2
2655,5,home,19,23,4
2655,6,work,23,24,1
2656,1,home,0,8,8
2656,2,work,8,13,5
2656,3,home,13,18,5
2656,4,work,18,20,2
2656,5,home,20,24,4
2657,1,home,0,7,7
2657,2,work,7,14,7
2657,3,shop,14,15,1
2657,4,work,15,20,5
2657,5,home,20,24,4
2658,1,home,0,7,7
2658,2,work,7,9,2
2658,3,home,9,14,5
2658,4,work,14,17,3
2658,5,home,17,23,6
2658,6,work,23,24,1
2659,1,home,0,6,6
2659,2,work,6,13,7
2659,3,home,13,24,11
2660,1,home,0,7,7
2660,2,shop,7,8,1
2660,3,home,8,12,4
2660,4,education,12,16,4
2660,5,home,16,20,4
2660,6,shop,20,21,1
2660,7,home,21,24,3
2661,1,home,0,6,6
2661,2,shop,6,7,1
2661,3,home,7,12,5
2661,4,work,12,19,7
2661,5,home,19,24,5
2662,1,home,0,6,6
2662,2,shop,6,7,1
2662,3,home,7,9,2
2662,4,education,9,15,6
2662,5,work,15,20,5
2662,6,home,20,24,4
2663,1,home,0,6,6
2663,2,work,6,7,1
2663,3,home,7,14,7
2663,4,work,14,17,3
2663,5,home,17,23,6
2663,6,work,23,24,1
2664,1,home,0,7,7
2664,2,shop,7,8,1
2664,3,education,8,11,3
2664,4,home,11,18,7
2664,5,shop,18,20,2
2664,6,home,20,24,4
2665,1,home,0,7,7
2665,2,work,7,13,6
2665,3,home,13,23,10
2665,4,work,23,24,1
2666,1,home,0,7,7
2666,2,education,7,10,3
2666,3,home,10,14,4
2666,4,education,14,16,2
2666,5,shop,16,17,1
2666,6,home,17,24,7
2667,1,home,0,7,7
2667,2,work,7,14,7
2667,3,shop,14,15,1
2667,4,home,15,24,9
2668,1,home,0,6,6
2668,2,work,6,13,7
2668,3,home,13,24,11
2669,1,home,0,7,7
2669,2,work,7,13,6
2669,3,shop,13,14,1
2669,4,home,14,22,8
2669,5,work,22,23,1
2669,6,home,23,24,1
2670,1,home,0,8,8
2670,2,work,8,15,7
2670,3,home,15,24,9
2671,1,home,0,7,7
2671,2,work,7,14,7
2671,3,shop,14,15,1
2671,4,home,15,24,9
2672,1,home,0,6,6
2672,2,shop,6,7,1
2672,3,home,7,11,4
2672,4,education,11,14,3
2672,5,shop,14,15,1
2672,6,home,15,24,9
2673,1,home,0,8,8
2673,2,work,8,15,7
2673,3,home,15,24,9
2674,1,home,0,7,7
2674,2,shop,7,8,1
2674,3,work,8,14,6
2674,4,home,14,24,10
2675,1,home,0,8,8
2675,2,work,8,15,7
2675,3,shop,15,16,1
2675,4,home,16,23,7
2675,5,work,23,24,1
2676,1,home,0,6,6
2676,2,work,6,13,7
2676,3,home,13,22,9
2676,4,work,22,23,1
2676,5,home,23,24,1
2677,1,home,0,7,7
2677,2,work,7,13,6
2677,3,shop,13,14,1
2677,4,work,14,17,3
2677,5,home,17,24,7
2678,1,home,0,6,6
2678,2,shop,6,7,1
2678,3,home,7,9,2
2678,4,education,9,15,6
2678,5,home,15,19,4
2678,6,shop,19,20,1
2678,7,home,20,24,4
2679,1,home,0,6,6
2679,2,work,6,14,8
2679,3,shop,14,15,1
2679,4,work,15,19,4
2679,5,home,19,24,5
2680,1,home,0,9,9
2680,2,work,9,16,7
2680,3,home,16,24,8
2681,1,home,0,7,7
2681,2,work,7,13,6
2681,3,home,13,17,4
2681,4,work,17,20,3
2681,5,home,20,24,4
2682,1,home,0,7,7
2682,2,work,7,13,6
2682,3,shop,13,14,1
2682,4,work,14,20,6
2682,5,home,20,24,4
2683,1,home,0,6,6
2683,2,work,6,13,7
2683,3,shop,13,15,2
2683,4,work,15,20,5
2683,5,home,20,24,4
2684,1,home,0,9,9
2684,2,education,9,14,5
2684,3,home,14,18,4
2684,4,work,18,20,2
2684,5,home,20,24,4
2685,1,home,0,7,7
2685,2,work,7,14,7
2685,3,home,14,24,10
2686,1,home,0,6,6
2686,2,work,6,8,2
2686,3,home,8,9,1
2686,4,work,9,11,2
2686,5,home,11,15,4
2686,6,work,15,18,3
2686,7,home,18,24,6
2687,1,home,0,8,8
2687,2,work,8,16,8
2687,3,home,16,24,8
2688,1,home,0,4,4
2688,2,work,4,7,3
2688,3,home,7,11,4
2688,4,work,11,13,2
2688,5,home,13,21,8
2688,6,work,21,22,1
2688,7,home,22,24,2
2689,1,home,0,7,7
2689,2,work,7,9,2
2689,3,home,9,15,6
2689,4,work,15,17,2
2689,5,home,17,23,6
2689,6,work,23,24,1
2690,1,home,0,6,6
2690,2,work,6,8,2
2690,3,home,8,13,5
2690,4,work,13,16,3
2690,5,home,16,23,7
2690,6,work,23,24,1
2691,1,home,0,8,8
2691,2,work,8,9,1
2691,3,home,9,15,6
2691,4,work,15,18,3
2691,5,home,18,24,6
2692,1,home,0,7,7
2692,2,work,7,13,6
2692,3,home,13,24,11
2693,1,home,0,6,6
2693,2,work,6,13,7
2693,3,shop,13,14,1
2693,4,work,14,20,6
2693,5,home,20,24,4
2694,1,home,0,6,6
2694,2,shop,6,7,1
2694,3,home,7,13,6
2694,4,education,13,16,3
2694,5,home,16,24,8
2695,1,home,0,6,6
2695,2,shop,6,7,1
2695,3,home,7,9,2
2695,4,education,9,12,3
2695,5,home,12,18,6
2695,6,shop,18,19,1
2695,7,home,19,24,5
2696,1,home,0,7,7
2696,2,work,7,13,6
2696,3,home,13,22,9
2696,4,work,22,23,1
2696,5,home,23,24,1
2697,1,home,0,7,7
2697,2,education,7,12,5
2697,3,home,12,19,7
2697,4,shop,19,20,1
2697,5,home,20,24,4
2698,1,home,0,8,8
2698,2,work,8,15,7
2698,3,shop,15,16,1
2698,4,work,16,19,3
2698,5,education,19,20,1
2698,6,home,20,24,4
2699,1,home,0,9,9
2699,2,work,9,15,6
2699,3,home,15,24,9
2700,1,home,0,6,6
2700,2,work,6,13,7
2700,3,home,13,17,4
2700,4,work,17,20,3
2700,5,home,20,24,4
2701,1,home,0,7,7
2701,2,work,7,13,6
2701,3,home,13,17,4
2701,4,work,17,20,3
2701,5,home,20,24,4
2702,1,home,0,7,7
2702,2,shop,7,8,1
2702,3,home,8,9,1
2702,4,work,9,16,7
2702,5,home,16,24,8
2703,1,home,0,8,8
2703,2,work,8,15,7
2703,3,home,15,24,9
2704,1,home,0,6,6
2704,2,work,6,8,2
2704,3,home,8,13,5
2704,4,work,13,15,2
2704,5,home,15,21,6
2704,6,work,21,22,1
2704,7,home,22,24,2
2705,1,home,0,7,7
2705,2,work,7,14,7
2705,3,shop,14,15,1
2705,4,work,15,20,5
2705,5,home,20,24,4
2706,1,home,0,7,7
2706,2,work,7,13,6
2706,3,home,13,24,11
2707,1,work,0,10,10
2707,2,shop,10,11,1
2707,3,home,11,15,4
2707,4,work,15,20,5
2707,5,home,20,24,4
2708,1,home,0,7,7
2708,2,education,7,11,4
2708,3,home,11,18,7
2708,4,shop,18,20,2
2708,5,home,20,24,4
2709,1,home,0,7,7
2709,2,education,7,11,4
2709,3,home,11,18,7
2709,4,shop,18,19,1
2709,5,home,19,24,5
2710,1,home,0,8,8
2710,2,work,8,15,7
2710,3,shop,15,17,2
2710,4,home,17,24,7
2711,1,home,0,6,6
2711,2,work,6,13,7
2711,3,home,13,24,11
2712,1,work,0,8,8
2712,2,shop,8,9,1
2712,3,work,9,14,5
2712,4,home,14,24,10
2713,1,home,0,6,6
2713,2,shop,6,7,1
2713,3,home,7,9,2
2713,4,education,9,11,2
2713,5,home,11,18,7
2713,6,shop,18,20,2
2713,7,home,20,24,4
2714,1,home,0,7,7
2714,2,work,7,15,8
2714,3,home,15,19,4
2714,4,shop,19,20,1
2714,5,home,20,24,4
2715,1,home,0,8,8
2715,2,work,8,14,6
2715,3,shop,14,15,1
2715,4,home,15,24,9
2716,1,home,0,7,7
2716,2,education,7,11,4
2716,3,home,11,18,7
2716,4,shop,18,19,1
2716,5,home,19,24,5
2717,1,home,0,7,7
2717,2,work,7,13,6
2717,3,shop,13,14,1
2717,4,education,14,16,2
2717,5,home,16,24,8
2718,1,home,0,7,7
2718,2,work,7,13,6
2718,3,shop,13,14,1
2718,4,work,14,19,5
2718,5,home,19,24,5
2719,1,home,0,7,7
2719,2,work,7,13,6
2719,3,home,13,18,5
2719,4,work,18,20,2
2719,5,home,20,24,4
2720,1,home,0,6,6
2720,2,shop,6,7,1
2720,3,home,7,13,6
2720,4,education,13,16,3
2720,5,home,16,24,8
2721,1,home,0,7,7
2721,2,education,7,11,4
2721,3,home,11,17,6
2721,4,shop,17,18,1
2721,5,home,18,24,6
2722,1,home,0,7,7
2722,2,education,7,11,4
2722,3,home,11,18,7
2722,4,shop,18,19,1
2722,5,home,19,24,5
2723,1,home,0,7,7
2723,2,work,7,13,6
2723,3,shop,13,15,2
2723,4,work,15,20,5
2723,5,home,20,24,4
2724,1,home,0,7,7
2724,2,work,7,13,6
2724,3,home,13,22,9
2724,4,work,22,23,1
2724,5,home,23,24,1
2725,1,home,0,7,7
2725,2,work,7,9,2
2725,3,home,9,16,7
2725,4,work,16,18,2
2725,5,home,18,24,6
2726,1,home,0,6,6
2726,2,shop,6,8,2
2726,3,work,8,15,7
2726,4,shop,15,16,1
2726,5,home,16,22,6
2726,6,work,22,23,1
2726,7,home,23,24,1
2727,1,home,0,7,7
2727,2,work,7,9,2
2727,3,home,9,13,4
2727,4,work,13,15,2
2727,5,home,15,17,2
2727,6,work,17,19,2
2727,7,home,19,24,5
2728,1,home,0,7,7
2728,2,work,7,8,1
2728,3,home,8,12,4
2728,4,work,12,13,1
2728,5,home,13,20,7
2728,6,shop,20,21,1
2728,7,home,21,24,3
2729,1,home,0,7,7
2729,2,work,7,13,6
2729,3,shop,13,14,1
2729,4,home,14,24,10
2730,1,home,0,7,7
2730,2,work,7,14,7
2730,3,home,14,24,10
2731,1,home,0,7,7
2731,2,work,7,14,7
2731,3,shop,14,15,1
2731,4,home,15,24,9
2732,1,home,0,8,8
2732,2,education,8,12,4
2732,3,home,12,14,2
2732,4,education,14,16,2
2732,5,home,16,24,8
2733,1,home,0,7,7
2733,2,work,7,13,6
2733,3,shop,13,14,1
2733,4,work,14,19,5
2733,5,home,19,24,5
2734,1,home,0,8,8
2734,2,work,8,16,8
2734,3,home,16,24,8
2735,1,home,0,6,6
2735,2,work,6,13,7
2735,3,shop,13,14,1
2735,4,home,14,24,10
2736,1,home,0,6,6
2736,2,work,6,13,7
2736,3,shop,13,14,1
2736,4,work,14,19,5
2736,5,home,19,24,5
2737,1,home,0,7,7
2737,2,shop,7,8,1
2737,3,education,8,11,3
2737,4,home,11,17,6
2737,5,shop,17,18,1
2737,6,home,18,24,6
2738,1,home,0,8,8
2738,2,work,8,15,7
2738,3,home,15,22,7
2738,4,work,22,23,1
2738,5,home,23,24,1
2739,1,home,0,7,7
2739,2,work,7,14,7
2739,3,shop,14,15,1
2739,4,work,15,20,5
2739,5,home,20,24,4
2740,1,home,0,7,7
2740,2,work,7,15,8
2740,3,shop,15,16,1
2740,4,home,16,24,8
2741,1,home,0,6,6
2741,2,shop,6,7,1
2741,3,home,7,10,3
2741,4,education,10,13,3
2741,5,home,13,17,4
2741,6,shop,17,19,2
2741,7,home,19,24,5
2742,1,home,0,7,7
2742,2,work,7,14,7
2742,3,home,14,24,10
2743,1,home,0,6,6
2743,2,shop,6,7,1
2743,3,home,7,13,6
2743,4,education,13,16,3
2743,5,shop,16,17,1
2743,6,home,17,24,7
2744,1,home,0,7,7
2744,2,work,7,9,2
2744,3,home,9,15,6
2744,4,work,15,18,3
2744,5,home,18,24,6
2745,1,home,0,7,7
2745,2,shop,7,8,1
2745,3,work,8,14,6
2745,4,home,14,24,10
2746,1,home,0,7,7
2746,2,shop,7,8,1
2746,3,education,8,12,4
2746,4,shop,12,14,2
2746,5,home,14,24,10
2747,1,home,0,6,6
2747,2,work,6,13,7
2747,3,home,13,24,11
2748,1,home,0,7,7
2748,2,education,7,11,4
2748,3,home,11,17,6
2748,4,shop,17,19,2
2748,5,home,19,24,5
2749,1,home,0,7,7
2749,2,shop,7,8,1
2749,3,education,8,11,3
2749,4,home,11,14,3
2749,5,education,14,16,2
2749,6,home,16,24,8
2750,1,home,0,7,7
2750,2,work,7,13,6
2750,3,shop,13,14,1
2750,4,work,14,19,5
2750,5,home,19,24,5
2751,1,home,0,6,6
2751,2,work,6,13,7
2751,3,home,13,24,11
2752,1,home,0,8,8
2752,2,education,8,11,3
2752,3,shop,11,12,1
2752,4,work,12,19,7
2752,5,home,19,24,5
2753,1,home,0,6,6
2753,2,shop,6,7,1
2753,3,home,7,20,13
2753,4,shop,20,21,1
2753,5,home,21,24,3
2754,1,home,0,7,7
2754,2,education,7,12,5
2754,3,home,12,19,7
2754,4,shop,19,20,1
2754,5,home,20,24,4
2755,1,home,0,9,9
2755,2,work,9,15,6
2755,3,home,15,18,3
2755,4,work,18,20,2
2755,5,home,20,24,4
2756,1,home,0,7,7
2756,2,work,7,15,8
2756,3,home,15,24,9
2757,1,home,0,8,8
2757,2,education,8,11,3
2757,3,home,11,23,12
2757,4,work,23,24,1
2758,1,home,0,7,7
2758,2,education,7,12,5
2758,3,shop,12,14,2
2758,4,home,14,20,6
2758,5,shop,20,21,1
2758,6,home,21,24,3
2759,1,home,0,6,6
2759,2,shop,6,7,1
2759,3,home,7,9,2
2759,4,education,9,12,3
2759,5,shop,12,13,1
2759,6,education,13,16,3
2759,7,home,16,24,8
2760,1,home,0,7,7
2760,2,work,7,13,6
2760,3,shop,13,14,1
2760,4,home,14,22,8
2760,5,work,22,23,1
2760,6,home,23,24,1
2761,1,home,0,7,7
2761,2,education,7,11,4
2761,3,home,11,19,8
2761,4,shop,19,20,1
2761,5,home,20,24,4
2762,1,home,0,7,7
2762,2,shop,7,8,1
2762,3,education,8,11,3
2762,4,home,11,18,7
2762,5,shop,18,19,1
2762,6,home,19,24,5
2763,1,home,0,6,6
2763,2,work,6,8,2
2763,3,home,8,10,2
2763,4,work,10,12,2
2763,5,home,12,18,6
2763,6,work,18,19,1
2763,7,home,19,23,4
2763,8,work,23,24,1
2764,1,home,0,6,6
2764,2,work,6,13,7
2764,3,home,13,16,3
2764,4,work,16,20,4
2764,5,home,20,24,4
2765,1,work,0,9,9
2765,2,shop,9,10,1
2765,3,work,10,17,7
2765,4,home,17,24,7
2766,1,home,0,7,7
2766,2,work,7,13,6
2766,3,home,13,24,11
2767,1,home,0,6,6
2767,2,shop,6,7,1
2767,3,work,7,9,2
2767,4,home,9,15,6
2767,5,work,15,17,2
2767,6,home,17,21,4
2767,7,work,21,22,1
2767,8,home,22,24,2
2768,1,home,0,7,7
2768,2,work,7,14,7
2768,3,shop,14,15,1
2768,4,work,15,20,5
2768,5,home,20,24,4
2769,1,home,0,8,8
2769,2,work,8,15,7
2769,3,home,15,24,9
2770,1,home,0,7,7
2770,2,work,7,14,7
2770,3,shop,14,15,1
2770,4,work,15,20,5
2770,5,home,20,24,4
2771,1,home,0,7,7
2771,2,shop,7,9,2
2771,3,education,9,12,3
2771,4,shop,12,13,1
2771,5,education,13,16,3
2771,6,home,16,24,8
2772,1,home,0,6,6
2772,2,work,6,13,7
2772,3,home,13,24,11
2773,1,home,0,7,7
2773,2,work,7,14,7
2773,3,shop,14,15,1
2773,4,work,15,20,5
2773,5,home,20,24,4
2774,1,home,0,6,6
2774,2,work,6,13,7
2774,3,shop,13,14,1
2774,4,work,14,20,6
2774,5,home,20,24,4
2775,1,home,0,6,6
2775,2,work,6,13,7
2775,3,shop,13,14,1
2775,4,home,14,24,10
2776,1,home,0,8,8
2776,2,work,8,15,7
2776,3,shop,15,16,1
2776,4,work,16,19,3
2776,5,home,19,24,5
2777,1,home,0,6,6
2777,2,work,6,9,3
2777,3,home,9,15,6
2777,4,work,15,18,3
2777,5,home,18,23,5
2777,6,work,23,24,1
2778,1,home,0,6,6
2778,2,shop,6,7,1
2778,3,home,7,10,3
2778,4,education,10,12,2
2778,5,home,12,18,6
2778,6,shop,18,19,1
2778,7,home,19,24,5
2779,1,home,0,7,7
2779,2,work,7,14,7
2779,3,home,14,23,9
2779,4,work,23,24,1
2780,1,home,0,7,7
2780,2,work,7,13,6
2780,3,shop,13,14,1
2780,4,work,14,19,5
2780,5,home,19,24,5
2781,1,home,0,7,7
2781,2,shop,7,8,1
2781,3,education,8,10,2
2781,4,home,10,14,4
2781,5,education,14,16,2
2781,6,home,16,24,8
2782,1,home,0,6,6
2782,2,work,6,8,2
2782,3,home,8,15,7
2782,4,work,15,17,2
2782,5,home,17,21,4
2782,6,work,21,22,1
2782,7,home,22,24,2
2783,1,home,0,7,7
2783,2,work,7,13,6
2783,3,home,13,16,3
2783,4,work,16,20,4
2783,5,home,20,24,4
2784,1,home,0,6,6
2784,2,work,6,7,1
2784,3,home,7,9,2
2784,4,work,9,11,2
2784,5,home,11,16,5
2784,6,work,16,18,2
2784,7,home,18,24,6
2785,1,home,0,6,6
2785,2,work,6,13,7
2785,3,shop,13,14,1
2785,4,work,14,20,6
2785,5,home,20,24,4
2786,1,home,0,8,8
2786,2,work,8,14,6
2786,3,home,14,24,10
2787,1,home,0,6,6
2787,2,work,6,8,2
2787,3,home,8,14,6
2787,4,work,14,16,2
2787,5,home,16,23,7
2787,6,work,23,24,1
2788,1,home,0,8,8
2788,2,work,8,13,5
2788,3,home,13,24,11
2789,1,home,0,7,7
2789,2,work,7,13,6
2789,3,home,13,22,9
2789,4,work,22,23,1
2789,5,home,23,24,1
2790,1,home,0,7,7
2790,2,education,7,11,4
2790,3,home,11,14,3
2790,4,education,14,16,2
2790,5,home,16,24,8
2791,1,home,0,7,7
2791,2,work,7,14,7
2791,3,home,14,24,10
2792,1,home,0,6,6
2792,2,work,6,8,2
2792,3,home,8,12,4
2792,4,work,12,13,1
2792,5,home,13,21,8
2792,6,work,21,22,1
2792,7,home,22,24,2
2793,1,home,0,7,7
2793,2,work,7,13,6
2793,3,home,13,20,7
2793,4,shop,20,21,1
2793,5,home,21,24,3
2794,1,home,0,7,7
2794,2,work,7,14,7
2794,3,shop,14,15,1
2794,4,home,15,22,7
2794,5,work,22,23,1
2794,6,home,23,24,1
2795,1,home,0,8,8
2795,2,shop,8,9,1
2795,3,home,9,12,3
2795,4,work,12,19,7
2795,5,home,19,24,5
2796,1,home,0,7,7
2796,2,work,7,14,7
2796,3,shop,14,15,1
2796,4,work,15,20,5
2796,5,home,20,24,4
2797,1,home,0,8,8
2797,2,education,8,13,5
2797,3,shop,13,14,1
2797,4,work,14,19,5
2797,5,home,19,24,5
2798,1,work,0,7,7
2798,2,shop,7,8,1
2798,3,work,8,14,6
2798,4,home,14,24,10
2799,1,home,0,8,8
2799,2,work,8,15,7
2799,3,shop,15,17,2
2799,4,home,17,23,6
2799,5,work,23,24,1
2800,1,work,0,8,8
2800,2,shop,8,9,1
2800,3,home,9,16,7
2800,4,work,16,20,4
2800,5,home,20,24,4
2801,1,home,0,6,6
2801,2,shop,6,7,1
2801,3,home,7,9,2
2801,4,education,9,12,3
2801,5,shop,12,14,2
2801,6,education,14,16,2
2801,7,home,16,24,8
2802,1,home,0,7,7
2802,2,work,7,14,7
2802,3,shop,14,15,1
2802,4,home,15,24,9
2803,1,home,0,6,6
2803,2,shop,6,7,1
2803,3,home,7,8,1
2803,4,work,8,11,3
2803,5,home,11,15,4
2803,6,work,15,17,2
2803,7,home,17,23,6
2803,8,work,23,24,1
2804,1,home,0,8,8
2804,2,work,8,15,7
2804,3,home,15,22,7
2804,4,work,22,23,1
2804,5,home,23,24,1
2805,1,home,0,7,7
2805,2,work,7,13,6
2805,3,home,13,24,11
2806,1,home,0,6,6
2806,2,work,6,13,7
2806,3,shop,13,15,2
2806,4,home,15,24,9
2807,1,home,0,6,6
2807,2,work,6,8,2
2807,3,home,8,14,6
2807,4,work,14,16,2
2807,5,home,16,22,6
2807,6,work,22,23,1
2807,7,home,23,24,1
2808,1,home,0,9,9
2808,2,work,9,17,8
2808,3,home,17,21,4
2808,4,work,21,22,1
2808,5,home,22,24,2
2809,1,home,0,6,6
2809,2,work,6,13,7
2809,3,home,13,23,10
2809,4,work,23,24,1
2810,1,home,0,8,8
2810,2,work,8,14,6
2810,3,home,14,24,10
2811,1,home,0,7,7
2811,2,work,7,13,6
2811,3,home,13,17,4
2811,4,shop,17,18,1
2811,5,home,18,22,4
2811,6,work,22,23,1
2811,7,home,23,24,1
2812,1,home,0,7,7
2812,2,work,7,13,6
2812,3,shop,13,14,1
2812,4,home,14,24,10
2813,1,home,0,6,6
2813,2,work,6,8,2
2813,3,home,8,9,1
2813,4,work,9,10,1
2813,5,home,10,14,4
2813,6,work,14,18,4
2813,7,home,18,22,4
2813,8,work,22,23,1
2813,9,home,23,24,1
2814,1,home,0,7,7
2814,2,education,7,11,4
2814,3,home,11,19,8
2814,4,shop,19,20,1
2814,5,home,20,24,4
2815,1,home,0,7,7
2815,2,work,7,13,6
2815,3,home,13,19,6
2815,4,shop,19,20,1
2815,5,home,20,24,4
2816,1,home,0,8,8
2816,2,work,8,14,6
2816,3,shop,14,15,1
2816,4,home,15,19,4
2816,5,shop,19,20,1
2816,6,home,20,24,4
2817,1,home,0,7,7
2817,2,work,7,13,6
2817,3,shop,13,14,1
2817,4,work,14,20,6
2817,5,home,20,24,4
2818,1,home,0,7,7
2818,2,work,7,14,7
2818,3,home,14,24,10
2819,1,home,0,8,8
2819,2,work,8,16,8
2819,3,shop,16,17,1
2819,4,work,17,20,3
2819,5,home,20,24,4
2820,1,home,0,8,8
2820,2,work,8,15,7
2820,3,shop,15,16,1
2820,4,home,16,24,8
2821,1,home,0,8,8
2821,2,work,8,15,7
2821,3,home,15,24,9
2822,1,home,0,7,7
2822,2,work,7,13,6
2822,3,home,13,24,11
2823,1,home,0,6,6
2823,2,shop,6,7,1
2823,3,home,7,13,6
2823,4,education,13,16,3
2823,5,shop,16,17,1
2823,6,home,17,21,4
2823,7,shop,21,22,1
2823,8,home,22,24,2
2824,1,home,0,7,7
2824,2,work,7,14,7
2824,3,home,14,20,6
2824,4,shop,20,21,1
2824,5,home,21,24,3
2825,1,home,0,8,8
2825,2,work,8,15,7
2825,3,home,15,23,8
2825,4,work,23,24,1
2826,1,home,0,8,8
2826,2,education,8,11,3
2826,3,home,11,18,7
2826,4,shop,18,19,1
2826,5,home,19,24,5
2827,1,home,0,8,8
2827,2,work,8,14,6
2827,3,shop,14,15,1
2827,4,home,15,24,9
2828,1,home,0,7,7
2828,2,work,7,14,7
2828,3,home,14,24,10
2829,1,home,0,7,7
2829,2,work,7,14,7
2829,3,shop,14,15,1
2829,4,home,15,24,9
2830,1,home,0,7,7
2830,2,work,7,13,6
2830,3,shop,13,14,1
2830,4,work,14,20,6
2830,5,home,20,24,4
2831,1,home,0,7,7
2831,2,education,7,11,4
2831,3,home,11,17,6
2831,4,shop,17,18,1
2831,5,home,18,24,6
2832,1,home,0,8,8
2832,2,work,8,14,6
2832,3,home,14,18,4
2832,4,work,18,20,2
2832,5,home,20,24,4
2833,1,home,0,6,6
2833,2,work,6,12,6
2833,3,shop,12,13,1
2833,4,work,13,19,6
2833,5,home,19,24,5
2834,1,home,0,5,5
2834,2,work,5,13,8
2834,3,shop,13,14,1
2834,4,home,14,24,10
2835,1,home,0,8,8
2835,2,shop,8,9,1
2835,3,work,9,16,7
2835,4,home,16,24,8
2836,1,home,0,6,6
2836,2,work,6,13,7
2836,3,shop,13,14,1
2836,4,work,14,19,5
2836,5,home,19,24,5
2837,1,home,0,7,7
2837,2,work,7,13,6
2837,3,home,13,24,11
2838,1,home,0,7,7
2838,2,work,7,15,8
2838,3,shop,15,16,1
2838,4,work,16,20,4
2838,5,home,20,24,4
2839,1,home,0,6,6
2839,2,shop,6,7,1
2839,3,home,7,9,2
2839,4,education,9,12,3
2839,5,home,12,19,7
2839,6,shop,19,21,2
2839,7,home,21,24,3
2840,1,home,0,6,6
2840,2,work,6,13,7
2840,3,home,13,21,8
2840,4,shop,21,22,1
2840,5,home,22,24,2
2841,1,home,0,7,7
2841,2,work,7,13,6
2841,3,home,13,22,9
2841,4,work,22,23,1
2841,5,home,23,24,1
2842,1,home,0,6,6
2842,2,work,6,13,7
2842,3,shop,13,14,1
2842,4,home,14,22,8
2842,5,work,22,23,1
2842,6,home,23,24,1
2843,1,home,0,8,8
2843,2,work,8,15,7
2843,3,home,15,24,9
2844,1,home,0,9,9
2844,2,work,9,16,7
2844,3,home,16,24,8
2845,1,home,0,8,8
2845,2,work,8,14,6
2845,3,shop,14,15,1
2845,4,home,15,24,9
2846,1,home,0,8,8
2846,2,education,8,11,3
2846,3,shop,11,12,1
2846,4,work,12,19,7
2846,5,home,19,24,5
2847,1,home,0,7,7
2847,2,work,7,14,7
2847,3,home,14,23,9
2847,4,work,23,24,1
2848,1,home,0,6,6
2848,2,work,6,13,7
2848,3,shop,13,14,1
2848,4,work,14,20,6
2848,5,home,20,24,4
2849,1,home,0,7,7
2849,2,work,7,14,7
2849,3,shop,14,15,1
2849,4,home,15,24,9
2850,1,home,0,7,7
2850,2,education,7,11,4
2850,3,home,11,14,3
2850,4,education,14,16,2
2850,5,shop,16,17,1
2850,6,home,17,24,7
2851,1,home,0,6,6
2851,2,work,6,13,7
2851,3,home,13,17,4
2851,4,work,17,20,3
2851,5,home,20,24,4
2852,1,home,0,6,6
2852,2,work,6,13,7
2852,3,home,13,24,11
2853,1,home,0,7,7
2853,2,shop,7,8,1
2853,3,education,8,11,3
2853,4,home,11,19,8
2853,5,shop,19,21,2
2853,6,home,21,24,3
2854,1,home,0,7,7
2854,2,work,7,13,6
2854,3,home,13,17,4
2854,4,work,17,19,2
2854,5,home,19,24,5
2855,1,home,0,7,7
2855,2,shop,7,8,1
2855,3,education,8,11,3
2855,4,home,11,17,6
2855,5,shop,17,19,2
2855,6,home,19,24,5
2856,1,home,0,7,7
2856,2,work,7,13,6
2856,3,shop,13,14,1
2856,4,home,14,24,10
2857,1,home,0,7,7
2857,2,work,7,9,2
2857,3,home,9,13,4
2857,4,work,13,15,2
2857,5,shop,15,16,1
2857,6,work,16,19,3
2857,7,home,19,24,5
2858,1,home,0,7,7
2858,2,shop,7,8,1
2858,3,work,8,14,6
2858,4,home,14,24,10
2859,1,home,0,7,7
2859,2,education,7,11,4
2859,3,home,11,17,6
2859,4,shop,17,19,2
2859,5,home,19,24,5
2860,1,home,0,7,7
2860,2,education,7,11,4
2860,3,home,11,17,6
2860,4,shop,17,18,1
2860,5,home,18,24,6
2861,1,home,0,6,6
2861,2,shop,6,7,1
2861,3,home,7,9,2
2861,4,education,9,12,3
2861,5,shop,12,14,2
2861,6,education,14,16,2
2861,7,home,16,24,8
2862,1,home,0,7,7
2862,2,work,7,13,6
2862,3,home,13,23,10
2862,4,work,23,24,1
2863,1,home,0,6,6
2863,2,work,6,9,3
2863,3,home,9,13,4
2863,4,work,13,15,2
2863,5,home,15,22,7
2863,6,work,22,23,1
2863,7,home,23,24,1
2864,1,home,0,7,7
2864,2,work,7,13,6
2864,3,home,13,17,4
2864,4,shop,17,18,1
2864,5,home,18,22,4
2864,6,work,22,23,1
2864,7,home,23,24,1
2865,1,home,0,6,6
2865,2,work,6,12,6
2865,3,shop,12,13,1
2865,4,work,13,19,6
2865,5,home,19,24,5
2866,1,home,0,6,6
2866,2,work,6,13,7
2866,3,home,13,21,8
2866,4,work,21,22,1
2866,5,home,22,24,2
2867,1,home,0,7,7
2867,2,work,7,15,8
2867,3,shop,15,16,1
2867,4,work,16,20,4
2867,5,home,20,24,4
2868,1,home,0,7,7
2868,2,education,7,12,5
2868,3,shop,12,14,2
2868,4,education,14,16,2
2868,5,shop,16,17,1
2868,6,home,17,24,7
2869,1,home,0,7,7
2869,2,work,7,9,2
2869,3,home,9,15,6
2869,4,work,15,17,2
2869,5,home,17,24,7
2870,1,home,0,8,8
2870,2,work,8,14,6
2870,3,shop,14,15,1
2870,4,home,15,24,9
2871,1,home,0,6,6
2871,2,shop,6,7,1
2871,3,work,7,14,7
2871,4,home,14,24,10
2872,1,home,0,7,7
2872,2,shop,7,8,1
2872,3,home,8,12,4
2872,4,work,12,18,6
2872,5,home,18,24,6
2873,1,home,0,7,7
2873,2,education,7,12,5
2873,3,home,12,18,6
2873,4,shop,18,19,1
2873,5,home,19,24,5
2874,1,home,0,8,8
2874,2,shop,8,9,1
2874,3,work,9,16,7
2874,4,home,16,24,8
2875,1,home,0,8,8
2875,2,work,8,17,9
2875,3,home,17,24,7
2876,1,home,0,7,7
2876,2,education,7,11,4
2876,3,home,11,17,6
2876,4,shop,17,19,2
2876,5,home,19,24,5
2877,1,home,0,7,7
2877,2,shop,7,8,1
2877,3,work,8,15,7
2877,4,home,15,24,9
2878,1,home,0,6,6
2878,2,work,6,8,2
2878,3,home,8,9,1
2878,4,work,9,10,1
2878,5,home,10,16,6
2878,6,work,16,19,3
2878,7,home,19,23,4
2878,8,work,23,24,1
2879,1,home,0,6,6
2879,2,shop,6,7,1
2879,3,home,7,10,3
2879,4,education,10,12,2
2879,5,shop,12,14,2
2879,6,home,14,21,7
2879,7,shop,21,22,1
2879,8,home,22,24,2
2880,1,home,0,6,6
2880,2,work,6,8,2
2880,3,home,8,12,4
2880,4,work,12,14,2
2880,5,home,14,21,7
2880,6,work,21,22,1
2880,7,home,22,24,2
2881,1,home,0,7,7
2881,2,work,7,9,2
2881,3,home,9,13,4
2881,4,work,13,15,2
2881,5,home,15,22,7
2881,6,work,22,23,1
2881,7,home,23,24,1
2882,1,home,0,6,6
2882,2,work,6,13,7
2882,3,home,13,17,4
2882,4,work,17,20,3
2882,5,home,20,24,4
2883,1,home,0,8,8
2883,2,work,8,14,6
2883,3,shop,14,15,1
2883,4,home,15,23,8
2883,5,work,23,24,1
2884,1,home,0,7,7
2884,2,work,7,14,7
2884,3,shop,14,15,1
2884,4,work,15,20,5
2884,5,home,20,24,4
2885,1,home,0,7,7
2885,2,work,7,13,6
2885,3,shop,13,15,2
2885,4,home,15,21,6
2885,5,shop,21,22,1
2885,6,home,22,24,2
2886,1,home,0,8,8
2886,2,work,8,14,6
2886,3,home,14,24,10
2887,1,home,0,7,7
2887,2,work,7,14,7
2887,3,shop,14,15,1
2887,4,home,15,24,9
2888,1,home,0,7,7
2888,2,work,7,13,6
2888,3,shop,13,14,1
2888,4,home,14,24,10
2889,1,home,0,7,7
2889,2,work,7,14,7
2889,3,shop,14,15,1
2889,4,home,15,21,6
2889,5,work,21,22,1
2889,6,home,22,24,2
2890,1,home,0,6,6
2890,2,shop,6,7,1
2890,3,work,7,14,7
2890,4,home,14,24,10
2891,1,home,0,7,7
2891,2,work,7,13,6
2891,3,shop,13,14,1
2891,4,work,14,19,5
2891,5,home,19,24,5
2892,1,home,0,6,6
2892,2,work,6,8,2
2892,3,home,8,12,4
2892,4,work,12,13,1
2892,5,home,13,21,8
2892,6,work,21,22,1
2892,7,home,22,24,2
2893,1,home,0,8,8
2893,2,work,8,14,6
2893,3,home,14,24,10
2894,1,home,0,7,7
2894,2,shop,7,8,1
2894,3,work,8,13,5
2894,4,shop,13,14,1
2894,5,home,14,24,10
2895,1,work,0,7,7
2895,2,shop,7,8,1
2895,3,work,8,14,6
2895,4,home,14,24,10
2896,1,home,0,7,7
2896,2,work,7,9,2
2896,3,home,9,14,5
2896,4,work,14,16,2
2896,5,home,16,23,7
2896,6,work,23,24,1
2897,1,home,0,8,8
2897,2,education,8,12,4
2897,3,home,12,14,2
2897,4,work,14,20,6
2897,5,home,20,24,4
2898,1,home,0,8,8
2898,2,work,8,14,6
2898,3,home,14,17,3
2898,4,work,17,20,3
2898,5,home,20,24,4
2899,1,home,0,7,7
2899,2,work,7,13,6
2899,3,shop,13,14,1
2899,4,work,14,19,5
2899,5,home,19,24,5
2900,1,home,0,7,7
2900,2,work,7,14,7
2900,3,home,14,18,4
2900,4,work,18,20,2
2900,5,home,20,24,4
2901,1,home,0,7,7
2901,2,shop,7,9,2
2901,3,education,9,11,2
2901,4,home,11,13,2
2901,5,education,13,16,3
2901,6,home,16,24,8
2902,1,home,0,6,6
2902,2,work,6,13,7
2902,3,shop,13,14,1
2902,4,home,14,21,7
2902,5,shop,21,22,1
2902,6,home,22,24,2
2903,1,home,0,8,8
2903,2,work,8,15,7
2903,3,home,15,20,5
2903,4,shop,20,21,1
2903,5,home,21,24,3
2904,1,home,0,8,8
2904,2,work,8,15,7
2904,3,home,15,22,7
2904,4,work,22,23,1
2904,5,home,23,24,1
2905,1,home,0,7,7
2905,2,work,7,15,8
2905,3,shop,15,16,1
2905,4,home,16,24,8
2906,1,home,0,6,6
2906,2,work,6,13,7
2906,3,home,13,18,5
2906,4,work,18,20,2
2906,5,home,20,24,4
2907,1,home,0,6,6
2907,2,work,6,13,7
2907,3,home,13,24,11
2908,1,home,0,7,7
2908,2,work,7,13,6
2908,3,home,13,24,11
2909,1,home,0,7,7
2909,2,shop,7,8,1
2909,3,home,8,10,2
2909,4,work,10,14,4
2909,5,home,14,18,4
2909,6,work,18,20,2
2909,7,home,20,24,4
2910,1,home,0,7,7
2910,2,shop,7,8,1
2910,3,education,8,11,3
2910,4,home,11,15,4
2910,5,shop,15,17,2
2910,6,home,17,24,7
2911,1,home,0,6,6
2911,2,work,6,7,1
2911,3,home,7,11,4
2911,4,work,11,13,2
2911,5,home,13,21,8
2911,6,work,21,22,1
2911,7,home,22,24,2
2912,1,home,0,6,6
2912,2,shop,6,7,1
2912,3,home,7,10,3
2912,4,education,10,12,2
2912,5,home,12,20,8
2912,6,shop,20,21,1
2912,7,home,21,24,3
2913,1,home,0,6,6
2913,2,work,6,13,7
2913,3,home,13,17,4
2913,4,work,17,20,3
2913,5,home,20,24,4
2914,1,home,0,7,7
2914,2,work,7,13,6
2914,3,shop,13,14,1
2914,4,work,14,20,6
2914,5,home,20,24,4
2915,1,home,0,8,8
2915,2,work,8,14,6
2915,3,shop,14,15,1
2915,4,home,15,24,9
2916,1,home,0,7,7
2916,2,work,7,13,6
2916,3,home,13,18,5
2916,4,work,18,20,2
2916,5,home,20,24,4
2917,1,home,0,6,6
2917,2,work,6,8,2
2917,3,home,8,13,5
2917,4,work,13,16,3
2917,5,home,16,22,6
2917,6,work,22,23,1
2917,7,home,23,24,1
2918,1,home,0,6,6
2918,2,shop,6,7,1
2918,3,home,7,15,8
2918,4,work,15,20,5
2918,5,home,20,24,4
2919,1,home,0,6,6
2919,2,work,6,13,7
2919,3,home,13,18,5
2919,4,shop,18,19,1
2919,5,home,19,24,5
2920,1,home,0,7,7
2920,2,work,7,14,7
2920,3,shop,14,15,1
2920,4,work,15,20,5
2920,5,home,20,24,4
2921,1,home,0,8,8
2921,2,work,8,15,7
2921,3,shop,15,16,1
2921,4,home,16,23,7
2921,5,work,23,24,1
2922,1,home,0,7,7
2922,2,work,7,13,6
2922,3,shop,13,14,1
2922,4,work,14,20,6
2922,5,home,20,24,4
2923,1,home,0,7,7
2923,2,work,7,15,8
2923,3,home,15,16,1
2923,4,work,16,20,4
2923,5,home,20,24,4
2924,1,home,0,7,7
2924,2,shop,7,9,2
2924,3,education,9,12,3
2924,4,shop,12,13,1
2924,5,education,13,16,3
2924,6,shop,16,18,2
2924,7,home,18,24,6
2925,1,home,0,8,8
2925,2,work,8,15,7
2925,3,home,15,24,9
2926,1,home,0,8,8
2926,2,education,8,11,3
2926,3,home,11,15,4
2926,4,work,15,20,5
2926,5,home,20,24,4
2927,1,home,0,7,7
2927,2,work,7,14,7
2927,3,home,14,22,8
2927,4,work,22,23,1
2927,5,home,23,24,1
2928,1,home,0,7,7
2928,2,shop,7,8,1
2928,3,work,8,15,7
2928,4,home,15,24,9
2929,1,home,0,7,7
2929,2,work,7,13,6
2929,3,shop,13,14,1
2929,4,work,14,19,5
2929,5,home,19,24,5
2930,1,home,0,8,8
2930,2,work,8,15,7
2930,3,home,15,23,8
2930,4,work,23,24,1
2931,1,home,0,7,7
2931,2,education,7,12,5
2931,3,shop,12,13,1
2931,4,home,13,19,6
2931,5,shop,19,21,2
2931,6,home,21,24,3
2932,1,home,0,6,6
2932,2,work,6,13,7
2932,3,home,13,24,11
2933,1,home,0,8,8
2933,2,work,8,15,7
2933,3,shop,15,16,1
2933,4,work,16,20,4
2933,5,home,20,24,4
2934,1,home,0,7,7
2934,2,education,7,12,5
2934,3,shop,12,13,1
2934,4,education,13,16,3
2934,5,home,16,24,8
2935,1,home,0,6,6
2935,2,shop,6,7,1
2935,3,work,7,14,7
2935,4,home,14,24,10
2936,1,home,0,8,8
2936,2,work,8,15,7
2936,3,home,15,24,9
2937,1,home,0,6,6
2937,2,work,6,8,2
2937,3,home,8,12,4
2937,4,work,12,14,2
2937,5,shop,14,15,1
2937,6,home,15,23,8
2937,7,work,23,24,1
2938,1,home,0,8,8
2938,2,work,8,14,6
2938,3,home,14,22,8
2938,4,work,22,23,1
2938,5,home,23,24,1
2939,1,home,0,6,6
2939,2,shop,6,7,1
2939,3,home,7,9,2
2939,4,education,9,12,3
2939,5,home,12,18,6
2939,6,shop,18,20,2
2939,7,home,20,24,4
2940,1,home,0,7,7
2940,2,education,7,12,5
2940,3,home,12,19,7
2940,4,shop,19,20,1
2940,5,home,20,24,4
2941,1,home,0,7,7
2941,2,work,7,13,6
2941,3,home,13,18,5
2941,4,work,18,20,2
2941,5,home,20,24,4
2942,1,home,0,7,7
2942,2,shop,7,8,1
2942,3,education,8,11,3
2942,4,home,11,18,7
2942,5,shop,18,19,1
2942,6,home,19,24,5
2943,1,home,0,7,7
2943,2,education,7,11,4
2943,3,home,11,16,5
2943,4,shop,16,17,1
2943,5,home,17,24,7
2944,1,home,0,6,6
2944,2,work,6,13,7
2944,3,shop,13,14,1
2944,4,home,14,24,10
2945,1,home,0,9,9
2945,2,work,9,17,8
2945,3,home,17,23,6
2945,4,work,23,24,1
2946,1,home,0,7,7
2946,2,shop,7,9,2
2946,3,education,9,13,4
2946,4,home,13,20,7
2946,5,shop,20,21,1
2946,6,home,21,24,3
2947,1,home,0,8,8
2947,2,work,8,15,7
2947,3,shop,15,16,1
2947,4,home,16,21,5
2947,5,work,21,22,1
2947,6,home,22,24,2
2948,1,home,0,7,7
2948,2,work,7,8,1
2948,3,home,8,9,1
2948,4,work,9,11,2
2948,5,home,11,15,4
2948,6,work,15,18,3
2948,7,home,18,23,5
2948,8,work,23,24,1
2949,1,home,0,8,8
2949,2,work,8,14,6
2949,3,shop,14,15,1
2949,4,work,15,20,5
2949,5,home,20,24,4
2950,1,home,0,7,7
2950,2,education,7,12,5
2950,3,shop,12,13,1
2950,4,education,13,15,2
2950,5,shop,15,17,2
2950,6,home,17,21,4
2950,7,shop,21,22,1
2950,8,home,22,24,2
2951,1,home,0,6,6
2951,2,work,6,13,7
2951,3,home,13,24,11
2952,1,home,0,7,7
2952,2,work,7,13,6
2952,3,shop,13,14,1
2952,4,work,14,19,5
2952,5,home,19,24,5
2953,1,home,0,8,8
2953,2,education,8,11,3
2953,3,home,11,18,7
2953,4,shop,18,19,1
2953,5,home,19,24,5
2954,1,home,0,6,6
2954,2,work,6,13,7
2954,3,home,13,24,11
2955,1,home,0,6,6
2955,2,work,6,13,7
2955,3,home,13,17,4
2955,4,work,17,20,3
2955,5,home,20,24,4
2956,1,home,0,8,8
2956,2,work,8,14,6
2956,3,home,14,18,4
2956,4,work,18,20,2
2956,5,home,20,24,4
2957,1,home,0,7,7
2957,2,education,7,12,5
2957,3,shop,12,13,1
2957,4,education,13,16,3
2957,5,home,16,24,8
2958,1,home,0,8,8
2958,2,work,8,15,7
2958,3,shop,15,16,1
2958,4,home,16,17,1
2958,5,work,17,19,2
2958,6,home,19,24,5
2959,1,home,0,7,7
2959,2,work,7,9,2
2959,3,home,9,16,7
2959,4,work,16,18,2
2959,5,home,18,24,6
2960,1,home,0,7,7
2960,2,work,7,14,7
2960,3,home,14,21,7
2960,4,shop,21,22,1
2960,5,home,22,24,2
2961,1,home,0,7,7
2961,2,shop,7,8,1
2961,3,education,8,12,4
2961,4,home,12,18,6
2961,5,shop,18,19,1
2961,6,home,19,24,5
2962,1,home,0,8,8
2962,2,education,8,12,4
2962,3,home,12,21,9
2962,4,shop,21,22,1
2962,5,home,22,24,2
2963,1,home,0,6,6
2963,2,work,6,13,7
2963,3,shop,13,14,1
2963,4,home,14,24,10
2964,1,home,0,7,7
2964,2,shop,7,8,1
2964,3,work,8,15,7
2964,4,home,15,24,9
2965,1,home,0,6,6
2965,2,work,6,13,7
2965,3,home,13,24,11
2966,1,home,0,8,8
2966,2,work,8,13,5
2966,3,shop,13,14,1
2966,4,work,14,19,5
2966,5,home,19,24,5
2967,1,home,0,7,7
2967,2,shop,7,8,1
2967,3,home,8,14,6
2967,4,work,14,18,4
2967,5,home,18,24,6
2968,1,home,0,7,7
2968,2,shop,7,9,2
2968,3,education,9,11,2
2968,4,home,11,18,7
2968,5,shop,18,20,2
2968,6,home,20,24,4
2969,1,home,0,6,6
2969,2,work,6,12,6
2969,3,shop,12,13,1
2969,4,work,13,19,6
2969,5,education,19,20,1
2969,6,home,20,24,4
2970,1,home,0,6,6
2970,2,work,6,8,2
2970,3,home,8,12,4
2970,4,work,12,13,1
2970,5,home,13,21,8
2970,6,work,21,22,1
2970,7,home,22,24,2
2971,1,home,0,7,7
2971,2,work,7,9,2
2971,3,home,9,15,6
2971,4,work,15,17,2
2971,5,home,17,24,7
2972,1,home,0,6,6
2972,2,work,6,7,1
2972,3,home,7,8,1
2972,4,work,8,10,2
2972,5,home,10,14,4
2972,6,work,14,16,2
2972,7,home,16,21,5
2972,8,work,21,22,1
2972,9,home,22,24,2
2973,1,home,0,9,9
2973,2,education,9,12,3
2973,3,shop,12,13,1
2973,4,work,13,19,6
2973,5,home,19,24,5
2974,1,home,0,8,8
2974,2,shop,8,10,2
2974,3,education,10,12,2
2974,4,shop,12,14,2
2974,5,education,14,16,2
2974,6,home,16,24,8
2975,1,home,0,7,7
2975,2,work,7,13,6
2975,3,home,13,24,11
2976,1,home,0,7,7
2976,2,work,7,14,7
2976,3,home,14,24,10
2977,1,home,0,7,7
2977,2,work,7,13,6
2977,3,shop,13,14,1
2977,4,work,14,19,5
2977,5,education,19,20,1
2977,6,work,20,21,1
2977,7,home,21,24,3
2978,1,home,0,7,7
2978,2,shop,7,8,1
2978,3,home,8,13,5
2978,4,education,13,16,3
2978,5,home,16,24,8
2979,1,home,0,6,6
2979,2,work,6,13,7
2979,3,shop,13,14,1
2979,4,home,14,24,10
2980,1,home,0,6,6
2980,2,work,6,13,7
2980,3,shop,13,14,1
2980,4,work,14,19,5
2980,5,home,19,24,5
2981,1,home,0,6,6
2981,2,work,6,8,2
2981,3,home,8,12,4
2981,4,work,12,14,2
2981,5,shop,14,15,1
2981,6,work,15,17,2
2981,7,home,17,24,7
2982,1,home,0,7,7
2982,2,work,7,14,7
2982,3,shop,14,15,1
2982,4,home,15,23,8
2982,5,work,23,24,1
2983,1,home,0,8,8
2983,2,work,8,14,6
2983,3,home,14,22,8
2983,4,work,22,23,1
2983,5,home,23,24,1
2984,1,home,0,7,7
2984,2,shop,7,8,1
2984,3,work,8,16,8
2984,4,home,16,24,8
2985,1,home,0,7,7
2985,2,work,7,13,6
2985,3,shop,13,14,1
2985,4,home,14,21,7
2985,5,work,21,22,1
2985,6,home,22,24,2
2986,1,home,0,9,9
2986,2,education,9,12,3
2986,3,work,12,19,7
2986,4,home,19,24,5
2987,1,home,0,6,6
2987,2,shop,6,7,1
2987,3,home,7,9,2
2987,4,education,9,11,2
2987,5,home,11,14,3
2987,6,education,14,17,3
2987,7,home,17,24,7
2988,1,home,0,8,8
2988,2,work,8,14,6
2988,3,home,14,19,5
2988,4,shop,19,20,1
2988,5,home,20,23,3
2988,6,work,23,24,1
2989,1,home,0,7,7
2989,2,work,7,14,7
2989,3,shop,14,15,1
2989,4,home,15,24,9
2990,1,home,0,7,7
2990,2,education,7,12,5
2990,3,home,12,19,7
2990,4,shop,19,20,1
2990,5,home,20,24,4
2991,1,home,0,6,6
2991,2,work,6,13,7
2991,3,shop,13,14,1
2991,4,home,14,22,8
2991,5,work,22,23,1
2991,6,home,23,24,1
2992,1,home,0,7,7
2992,2,education,7,11,4
2992,3,home,11,19,8
2992,4,shop,19,20,1
2992,5,home,20,24,4
2993,1,home,0,7,7
2993,2,education,7,11,4
2993,3,home,11,20,9
2993,4,shop,20,21,1
2993,5,home,21,24,3
2994,1,home,0,7,7
2994,2,work,7,13,6
2994,3,shop,13,14,1
2994,4,work,14,20,6
2994,5,home,20,24,4
2995,1,home,0,8,8
2995,2,work,8,13,5
2995,3,home,13,17,4
2995,4,work,17,20,3
2995,5,home,20,24,4
2996,1,home,0,6,6
2996,2,shop,6,7,1
2996,3,home,7,10,3
2996,4,education,10,12,2
2996,5,home,12,19,7
2996,6,shop,19,21,2
2996,7,home,21,24,3
2997,1,home,0,8,8
2997,2,work,8,15,7
2997,3,shop,15,16,1
2997,4,home,16,24,8
2998,1,home,0,8,8
2998,2,education,8,13,5
2998,3,shop,13,15,2
2998,4,home,15,24,9
2999,1,home,0,8,8
2999,2,work,8,15,7
2999,3,shop,15,16,1
2999,4,work,16,20,4
2999,5,home,20,24,4
3000,1,home,0,7,7
3000,2,work,7,14,7
3000,3,shop,14,15,1
3000,4,work,15,20,5
3000,5,home,20,24,4
3001,1,home,0,6,6
3001,2,work,6,13,7
3001,3,home,13,24,11
3002,1,home,0,7,7
3002,2,work,7,14,7
3002,3,shop,14,15,1
3002,4,home,15,24,9
3003,1,home,0,7,7
3003,2,education,7,11,4
3003,3,home,11,18,7
3003,4,shop,18,19,1
3003,5,home,19,24,5
3004,1,home,0,6,6
3004,2,work,6,8,2
3004,3,home,8,12,4
3004,4,work,12,15,3
3004,5,home,15,21,6
3004,6,work,21,22,1
3004,7,home,22,24,2
3005,1,home,0,7,7
3005,2,education,7,12,5
3005,3,shop,12,14,2
3005,4,education,14,16,2
3005,5,home,16,24,8
3006,1,home,0,9,9
3006,2,work,9,17,8
3006,3,home,17,22,5
3006,4,work,22,23,1
3006,5,home,23,24,1
3007,1,home,0,7,7
3007,2,work,7,9,2
3007,3,home,9,13,4
3007,4,work,13,16,3
3007,5,home,16,22,6
3007,6,work,22,23,1
3007,7,home,23,24,1
3008,1,home,0,8,8
3008,2,education,8,11,3
3008,3,home,11,18,7
3008,4,shop,18,19,1
3008,5,home,19,24,5
3009,1,home,0,6,6
3009,2,work,6,13,7
3009,3,shop,13,14,1
3009,4,home,14,24,10
3010,1,home,0,6,6
3010,2,work,6,13,7
3010,3,home,13,24,11
3011,1,home,0,7,7
3011,2,education,7,11,4
3011,3,home,11,20,9
3011,4,shop,20,21,1
3011,5,home,21,24,3
3012,1,home,0,8,8
3012,2,work,8,15,7
3012,3,home,15,20,5
3012,4,shop,20,21,1
3012,5,home,21,24,3
3013,1,home,0,10,10
3013,2,education,10,13,3
3013,3,home,13,24,11
3014,1,home,0,7,7
3014,2,shop,7,8,1
3014,3,education,8,12,4
3014,4,shop,12,13,1
3014,5,education,13,15,2
3014,6,shop,15,16,1
3014,7,home,16,24,8
3015,1,home,0,7,7
3015,2,work,7,13,6
3015,3,shop,13,14,1
3015,4,work,14,19,5
3015,5,home,19,24,5
3016,1,home,0,6,6
3016,2,work,6,8,2
3016,3,home,8,13,5
3016,4,work,13,15,2
3016,5,home,15,21,6
3016,6,work,21,22,1
3016,7,home,22,24,2
3017,1,home,0,7,7
3017,2,work,7,13,6
3017,3,home,13,24,11
3018,1,home,0,8,8
3018,2,education,8,11,3
3018,3,home,11,18,7
3018,4,shop,18,19,1
3018,5,home,19,24,5
3019,1,home,0,6,6
3019,2,shop,6,7,1
3019,3,home,7,13,6
3019,4,education,13,16,3
3019,5,home,16,24,8
3020,1,home,0,6,6
3020,2,work,6,8,2
3020,3,home,8,9,1
3020,4,work,9,11,2
3020,5,home,11,18,7
3020,6,work,18,19,1
3020,7,home,19,24,5
3021,1,home,0,8,8
3021,2,work,8,15,7
3021,3,shop,15,16,1
3021,4,home,16,24,8
3022,1,home,0,7,7
3022,2,work,7,13,6
3022,3,home,13,17,4
3022,4,shop,17,18,1
3022,5,home,18,24,6
3023,1,home,0,7,7
3023,2,education,7,12,5
3023,3,home,12,20,8
3023,4,shop,20,21,1
3023,5,home,21,24,3
3024,1,home,0,7,7
3024,2,shop,7,9,2
3024,3,education,9,12,3
3024,4,shop,12,14,2
3024,5,home,14,21,7
3024,6,shop,21,22,1
3024,7,home,22,24,2
3025,1,home,0,8,8
3025,2,work,8,16,8
3025,3,shop,16,17,1
3025,4,work,17,19,2
3025,5,education,19,20,1
3025,6,home,20,24,4
3026,1,home,0,7,7
3026,2,shop,7,8,1
3026,3,home,8,12,4
3026,4,work,12,19,7
3026,5,home,19,24,5
3027,1,home,0,6,6
3027,2,work,6,13,7
3027,3,home,13,24,11
3028,1,home,0,9,9
3028,2,work,9,16,7
3028,3,home,16,24,8
3029,1,home,0,7,7
3029,2,work,7,14,7
3029,3,home,14,23,9
3029,4,work,23,24,1
3030,1,home,0,7,7
3030,2,work,7,14,7
3030,3,home,14,21,7
3030,4,work,21,22,1
3030,5,home,22,24,2
3031,1,home,0,7,7
3031,2,work,7,10,3
3031,3,home,10,16,6
3031,4,work,16,18,2
3031,5,home,18,22,4
3031,6,work,22,23,1
3031,7,home,23,24,1
3032,1,home,0,7,7
3032,2,education,7,11,4
3032,3,home,11,18,7
3032,4,shop,18,20,2
3032,5,home,20,24,4
3033,1,home,0,7,7
3033,2,work,7,14,7
3033,3,home,14,18,4
3033,4,work,18,20,2
3033,5,home,20,24,4
3034,1,home,0,9,9
3034,2,education,9,13,4
3034,3,work,13,19,6
3034,4,home,19,24,5
3035,1,home,0,7,7
3035,2,work,7,13,6
3035,3,home,13,16,3
3035,4,shop,16,17,1
3035,5,home,17,21,4
3035,6,work,21,22,1
3035,7,home,22,24,2
3036,1,home,0,8,8
3036,2,work,8,10,2
3036,3,home,10,15,5
3036,4,work,15,16,1
3036,5,home,16,23,7
3036,6,work,23,24,1
3037,1,home,0,7,7
3037,2,shop,7,8,1
3037,3,education,8,11,3
3037,4,home,11,14,3
3037,5,education,14,16,2
3037,6,shop,16,17,1
3037,7,home,17,24,7
3038,1,home,0,7,7
3038,2,shop,7,8,1
3038,3,work,8,13,5
3038,4,home,13,23,10
3038,5,work,23,24,1
3039,1,home,0,8,8
3039,2,work,8,15,7
3039,3,home,15,21,6
3039,4,work,21,22,1
3039,5,home,22,24,2
3040,1,home,0,7,7
3040,2,work,7,13,6
3040,3,home,13,24,11
3041,1,home,0,7,7
3041,2,work,7,13,6
3041,3,home,13,18,5
3041,4,work,18,20,2
3041,5,home,20,24,4
3042,1,home,0,8,8
3042,2,work,8,14,6
3042,3,home,14,18,4
3042,4,work,18,20,2
3042,5,home,20,24,4
3043,1,home,0,7,7
3043,2,work,7,14,7
3043,3,home,14,20,6
3043,4,shop,20,21,1
3043,5,home,21,24,3
3044,1,home,0,7,7
3044,2,shop,7,8,1
3044,3,education,8,12,4
3044,4,home,12,19,7
3044,5,shop,19,20,1
3044,6,home,20,24,4
3045,1,home,0,8,8
3045,2,work,8,14,6
3045,3,home,14,17,3
3045,4,work,17,20,3
3045,5,home,20,24,4
3046,1,home,0,7,7
3046,2,work,7,9,2
3046,3,home,9,15,6
3046,4,work,15,17,2
3046,5,home,17,24,7
3047,1,home,0,7,7
3047,2,education,7,11,4
3047,3,home,11,18,7
3047,4,shop,18,20,2
3047,5,home,20,24,4
3048,1,home,0,8,8
3048,2,work,8,17,9
3048,3,home,17,24,7
3049,1,home,0,8,8
3049,2,shop,8,9,1
3049,3,home,9,13,4
3049,4,work,13,19,6
3049,5,home,19,24,5
3050,1,home,0,8,8
3050,2,shop,8,10,2
3050,3,home,10,14,4
3050,4,work,14,19,5
3050,5,home,19,23,4
3050,6,work,23,24,1
3051,1,home,0,7,7
3051,2,shop,7,9,2
3051,3,education,9,12,3
3051,4,home,12,16,4
3051,5,shop,16,18,2
3051,6,home,18,24,6
3052,1,home,0,7,7
3052,2,work,7,14,7
3052,3,shop,14,15,1
3052,4,home,15,24,9
3053,1,home,0,6,6
3053,2,work,6,13,7
3053,3,shop,13,14,1
3053,4,home,14,24,10
3054,1,home,0,7,7
3054,2,work,7,13,6
3054,3,shop,13,14,1
3054,4,work,14,19,5
3054,5,home,19,24,5
3055,1,home,0,9,9
3055,2,work,9,16,7
3055,3,home,16,21,5
3055,4,shop,21,22,1
3055,5,home,22,24,2
3056,1,home,0,6,6
3056,2,shop,6,7,1
3056,3,home,7,9,2
3056,4,education,9,12,3
3056,5,home,12,18,6
3056,6,shop,18,19,1
3056,7,home,19,24,5
3057,1,home,0,7,7
3057,2,shop,7,8,1
3057,3,education,8,11,3
3057,4,home,11,18,7
3057,5,shop,18,19,1
3057,6,home,19,24,5
3058,1,home,0,7,7
3058,2,work,7,13,6
3058,3,home,13,17,4
3058,4,work,17,19,2
3058,5,home,19,24,5
3059,1,home,0,7,7
3059,2,work,7,13,6
3059,3,home,13,24,11
3060,1,home,0,7,7
3060,2,work,7,14,7
3060,3,home,14,22,8
3060,4,work,22,23,1
3060,5,home,23,24,1
3061,1,home,0,8,8
3061,2,work,8,16,8
3061,3,home,16,24,8
3062,1,home,0,6,6
3062,2,work,6,13,7
3062,3,home,13,21,8
3062,4,shop,21,22,1
3062,5,home,22,24,2
3063,1,home,0,7,7
3063,2,work,7,14,7
3063,3,shop,14,15,1
3063,4,home,15,24,9
3064,1,home,0,7,7
3064,2,education,7,11,4
3064,3,home,11,18,7
3064,4,shop,18,19,1
3064,5,home,19,24,5
3065,1,home,0,6,6
3065,2,work,6,13,7
3065,3,home,13,16,3
3065,4,shop,16,17,1
3065,5,home,17,24,7
3066,1,home,0,6,6
3066,2,shop,6,7,1
3066,3,home,7,13,6
3066,4,education,13,16,3
3066,5,home,16,24,8
3067,1,home,0,8,8
3067,2,work,8,13,5
3067,3,home,13,14,1
3067,4,work,14,20,6
3067,5,home,20,24,4
3068,1,home,0,7,7
3068,2,work,7,13,6
3068,3,home,13,24,11
3069,1,home,0,6,6
3069,2,shop,6,7,1
3069,3,home,7,11,4
3069,4,education,11,15,4
3069,5,shop,15,16,1
3069,6,home,16,21,5
3069,7,shop,21,22,1
3069,8,home,22,24,2
3070,1,home,0,7,7
3070,2,work,7,13,6
3070,3,shop,13,14,1
3070,4,work,14,20,6
3070,5,home,20,24,4
3071,1,home,0,6,6
3071,2,shop,6,7,1
3071,3,home,7,10,3
3071,4,education,10,12,2
3071,5,shop,12,14,2
3071,6,education,14,16,2
3071,7,home,16,24,8
3072,1,home,0,7,7
3072,2,work,7,13,6
3072,3,home,13,24,11
3073,1,home,0,7,7
3073,2,work,7,13,6
3073,3,home,13,23,10
3073,4,work,23,24,1
3074,1,home,0,7,7
3074,2,work,7,14,7
3074,3,home,14,24,10
3075,1,home,0,6,6
3075,2,work,6,13,7
3075,3,shop,13,14,1
3075,4,home,14,22,8
3075,5,work,22,23,1
3075,6,home,23,24,1
3076,1,home,0,7,7
3076,2,work,7,13,6
3076,3,shop,13,14,1
3076,4,home,14,18,4
3076,5,shop,18,19,1
3076,6,home,19,24,5
3077,1,home,0,7,7
3077,2,work,7,14,7
3077,3,shop,14,15,1
3077,4,home,15,22,7
3077,5,work,22,23,1
3077,6,home,23,24,1
3078,1,home,0,7,7
3078,2,shop,7,9,2
3078,3,home,9,14,5
3078,4,shop,14,15,1
3078,5,home,15,16,1
3078,6,work,16,20,4
3078,7,home,20,24,4
3079,1,home,0,7,7
3079,2,work,7,13,6
3079,3,shop,13,14,1
3079,4,home,14,24,10
3080,1,home,0,7,7
3080,2,work,7,15,8
3080,3,shop,15,16,1
3080,4,work,16,19,3
3080,5,home,19,24,5
3081,1,home,0,7,7
3081,2,work,7,13,6
3081,3,home,13,17,4
3081,4,work,17,20,3
3081,5,home,20,24,4
3082,1,home,0,8,8
3082,2,work,8,16,8
3082,3,home,16,21,5
3082,4,work,21,22,1
3082,5,home,22,24,2
3083,1,home,0,8,8
3083,2,work,8,14,6
3083,3,home,14,24,10
3084,1,home,0,6,6
3084,2,work,6,8,2
3084,3,home,8,13,5
3084,4,work,13,17,4
3084,5,home,17,24,7
3085,1,home,0,7,7
3085,2,work,7,14,7
3085,3,home,14,18,4
3085,4,work,18,20,2
3085,5,home,20,24,4
3086,1,home,0,6,6
3086,2,work,6,13,7
3086,3,shop,13,14,1
3086,4,work,14,19,5
3086,5,home,19,24,5
3087,1,home,0,6,6
3087,2,shop,6,7,1
3087,3,work,7,15,8
3087,4,shop,15,16,1
3087,5,home,16,24,8
3088,1,home,0,7,7
3088,2,work,7,13,6
3088,3,home,13,16,3
3088,4,work,16,20,4
3088,5,home,20,24,4
3089,1,home,0,6,6
3089,2,shop,6,7,1
3089,3,home,7,13,6
3089,4,education,13,17,4
3089,5,home,17,24,7
3090,1,home,0,7,7
3090,2,work,7,13,6
3090,3,shop,13,14,1
3090,4,work,14,20,6
3090,5,home,20,24,4
3091,1,home,0,6,6
3091,2,work,6,13,7
3091,3,home,13,21,8
3091,4,work,21,22,1
3091,5,home,22,24,2
3092,1,home,0,7,7
3092,2,work,7,14,7
3092,3,shop,14,15,1
3092,4,home,15,24,9
3093,1,home,0,8,8
3093,2,work,8,15,7
3093,3,home,15,22,7
3093,4,work,22,23,1
3093,5,home,23,24,1
3094,1,home,0,6,6
3094,2,shop,6,7,1
3094,3,home,7,10,3
3094,4,education,10,12,2
3094,5,shop,12,14,2
3094,6,home,14,21,7
3094,7,shop,21,22,1
3094,8,home,22,24,2
3095,1,home,0,8,8
3095,2,shop,8,9,1
3095,3,education,9,12,3
3095,4,shop,12,14,2
3095,5,home,14,21,7
3095,6,shop,21,22,1
3095,7,home,22,24,2
3096,1,home,0,6,6
3096,2,work,6,13,7
3096,3,home,13,17,4
3096,4,shop,17,18,1
3096,5,home,18,24,6
3097,1,home,0,7,7
3097,2,education,7,11,4
3097,3,home,11,18,7
3097,4,shop,18,19,1
3097,5,home,19,24,5
3098,1,home,0,7,7
3098,2,work,7,13,6
3098,3,home,13,18,5
3098,4,work,18,20,2
3098,5,home,20,24,4
3099,1,home,0,7,7
3099,2,education,7,11,4
3099,3,home,11,19,8
3099,4,shop,19,21,2
3099,5,home,21,24,3
3100,1,home,0,7,7
3100,2,work,7,13,6
3100,3,home,13,17,4
3100,4,work,17,19,2
3100,5,home,19,24,5
3101,1,home,0,7,7
3101,2,education,7,12,5
3101,3,home,12,21,9
3101,4,shop,21,22,1
3101,5,home,22,24,2
3102,1,home,0,7,7
3102,2,work,7,13,6
3102,3,home,13,18,5
3102,4,work,18,19,1
3102,5,home,19,24,5
3103,1,home,0,7,7
3103,2,shop,7,8,1
3103,3,education,8,12,4
3103,4,shop,12,14,2
3103,5,home,14,20,6
3103,6,shop,20,21,1
3103,7,home,21,24,3
3104,1,home,0,8,8
3104,2,work,8,15,7
3104,3,home,15,24,9
3105,1,home,0,7,7
3105,2,work,7,13,6
3105,3,home,13,24,11
3106,1,home,0,7,7
3106,2,shop,7,8,1
3106,3,home,8,10,2
3106,4,work,10,17,7
3106,5,home,17,24,7
3107,1,home,0,6,6
3107,2,shop,6,7,1
3107,3,home,7,10,3
3107,4,education,10,16,6
3107,5,home,16,24,8
3108,1,home,0,7,7
3108,2,education,7,12,5
3108,3,home,12,20,8
3108,4,shop,20,21,1
3108,5,home,21,24,3
3109,1,home,0,7,7
3109,2,work,7,13,6
3109,3,shop,13,14,1
3109,4,work,14,19,5
3109,5,home,19,24,5
3110,1,home,0,9,9
3110,2,work,9,17,8
3110,3,home,17,24,7
3111,1,home,0,6,6
3111,2,shop,6,7,1
3111,3,home,7,10,3
3111,4,education,10,13,3
3111,5,shop,13,15,2
3111,6,home,15,24,9
3112,1,home,0,8,8
3112,2,work,8,16,8
3112,3,shop,16,17,1
3112,4,home,17,21,4
3112,5,shop,21,22,1
3112,6,home,22,24,2
3113,1,home,0,7,7
3113,2,work,7,14,7
3113,3,shop,14,15,1
3113,4,home,15,21,6
3113,5,work,21,22,1
3113,6,home,22,24,2
3114,1,home,0,7,7
3114,2,work,7,14,7
3114,3,shop,14,15,1
3114,4,home,15,24,9
3115,1,home,0,9,9
3115,2,work,9,17,8
3115,3,home,17,24,7
3116,1,home,0,6,6
3116,2,work,6,8,2
3116,3,home,8,9,1
3116,4,work,9,11,2
3116,5,home,11,18,7
3116,6,work,18,20,2
3116,7,home,20,24,4
3117,1,home,0,7,7
3117,2,work,7,14,7
3117,3,shop,14,15,1
3117,4,work,15,20,5
3117,5,home,20,24,4
3118,1,home,0,6,6
3118,2,work,6,13,7
3118,3,shop,13,14,1
3118,4,education,14,17,3
3118,5,home,17,24,7
3119,1,home,0,6,6
3119,2,work,6,13,7
3119,3,shop,13,14,1
3119,4,home,14,24,10
3120,1,home,0,6,6
3120,2,work,6,13,7
3120,3,shop,13,14,1
3120,4,work,14,20,6
3120,5,home,20,24,4
3121,1,home,0,6,6
3121,2,work,6,8,2
3121,3,home,8,12,4
3121,4,work,12,13,1
3121,5,home,13,17,4
3121,6,work,17,19,2
3121,7,home,19,23,4
3121,8,work,23,24,1
3122,1,home,0,7,7
3122,2,education,7,11,4
3122,3,home,11,18,7
3122,4,shop,18,19,1
3122,5,home,19,24,5
3123,1,home,0,8,8
3123,2,work,8,15,7
3123,3,home,15,24,9
3124,1,home,0,6,6
3124,2,work,6,13,7
3124,3,home,13,24,11
3125,1,home,0,8,8
3125,2,shop,8,9,1
3125,3,work,9,17,8
3125,4,home,17,22,5
3125,5,work,22,23,1
3125,6,home,23,24,1
3126,1,home,0,8,8
3126,2,work,8,16,8
3126,3,home,16,24,8
3127,1,home,0,7,7
3127,2,work,7,14,7
3127,3,shop,14,15,1
3127,4,home,15,24,9
3128,1,home,0,7,7
3128,2,work,7,13,6
3128,3,home,13,22,9
3128,4,work,22,23,1
3128,5,home,23,24,1
3129,1,home,0,8,8
3129,2,work,8,15,7
3129,3,home,15,24,9
3130,1,home,0,6,6
3130,2,work,6,13,7
3130,3,home,13,22,9
3130,4,work,22,23,1
3130,5,home,23,24,1
3131,1,home,0,7,7
3131,2,education,7,11,4
3131,3,home,11,16,5
3131,4,shop,16,17,1
3131,5,home,17,24,7
3132,1,home,0,7,7
3132,2,work,7,14,7
3132,3,shop,14,15,1
3132,4,home,15,21,6
3132,5,work,21,22,1
3132,6,home,22,24,2
3133,1,home,0,7,7
3133,2,education,7,11,4
3133,3,home,11,17,6
3133,4,shop,17,18,1
3133,5,home,18,24,6
3134,1,home,0,6,6
3134,2,work,6,13,7
3134,3,shop,13,14,1
3134,4,work,14,19,5
3134,5,home,19,24,5
3135,1,home,0,6,6
3135,2,work,6,13,7
3135,3,shop,13,14,1
3135,4,home,14,21,7
3135,5,work,21,22,1
3135,6,home,22,24,2
3136,1,home,0,7,7
3136,2,work,7,14,7
3136,3,home,14,24,10
3137,1,home,0,7,7
3137,2,work,7,14,7
3137,3,shop,14,15,1
3137,4,work,15,20,5
3137,5,home,20,24,4
3138,1,home,0,6,6
3138,2,shop,6,7,1
3138,3,home,7,10,3
3138,4,education,10,12,2
3138,5,shop,12,13,1
3138,6,home,13,19,6
3138,7,shop,19,20,1
3138,8,home,20,24,4
3139,1,home,0,6,6
3139,2,shop,6,7,1
3139,3,home,7,11,4
3139,4,work,11,17,6
3139,5,home,17,24,7
3140,1,home,0,8,8
3140,2,work,8,15,7
3140,3,home,15,21,6
3140,4,work,21,22,1
3140,5,home,22,24,2
3141,1,home,0,6,6
3141,2,work,6,13,7
3141,3,shop,13,14,1
3141,4,home,14,24,10
3142,1,home,0,8,8
3142,2,work,8,14,6
3142,3,home,14,24,10
3143,1,home,0,7,7
3143,2,work,7,13,6
3143,3,home,13,24,11
3144,1,home,0,8,8
3144,2,work,8,15,7
3144,3,shop,15,16,1
3144,4,work,16,20,4
3144,5,home,20,24,4
3145,1,home,0,6,6
3145,2,shop,6,7,1
3145,3,work,7,13,6
3145,4,home,13,18,5
3145,5,work,18,20,2
3145,6,home,20,24,4
3146,1,home,0,8,8
3146,2,work,8,15,7
3146,3,home,15,24,9
3147,1,home,0,8,8
3147,2,work,8,14,6
3147,3,shop,14,15,1
3147,4,work,15,20,5
3147,5,home,20,24,4
3148,1,home,0,7,7
3148,2,work,7,13,6
3148,3,home,13,24,11
3149,1,home,0,7,7
3149,2,work,7,13,6
3149,3,home,13,24,11
3150,1,home,0,7,7
3150,2,work,7,14,7
3150,3,home,14,24,10
3151,1,home,0,7,7
3151,2,work,7,13,6
3151,3,shop,13,14,1
3151,4,work,14,20,6
3151,5,home,20,24,4
3152,1,home,0,8,8
3152,2,work,8,14,6
3152,3,shop,14,15,1
3152,4,home,15,19,4
3152,5,shop,19,20,1
3152,6,home,20,23,3
3152,7,work,23,24,1
3153,1,home,0,8,8
3153,2,education,8,11,3
3153,3,home,11,17,6
3153,4,shop,17,18,1
3153,5,home,18,24,6
3154,1,home,0,7,7
3154,2,work,7,15,8
3154,3,home,15,23,8
3154,4,work,23,24,1
3155,1,home,0,7,7
3155,2,work,7,14,7
3155,3,shop,14,15,1
3155,4,home,15,24,9
3156,1,home,0,6,6
3156,2,work,6,13,7
3156,3,shop,13,14,1
3156,4,home,14,18,4
3156,5,work,18,20,2
3156,6,home,20,24,4
3157,1,home,0,7,7
3157,2,work,7,14,7
3157,3,home,14,18,4
3157,4,work,18,20,2
3157,5,home,20,24,4
3158,1,home,0,6,6
3158,2,work,6,13,7
3158,3,home,13,24,11
3159,1,home,0,6,6
3159,2,work,6,13,7
3159,3,home,13,24,11
3160,1,home,0,8,8
3160,2,education,8,11,3
3160,3,shop,11,12,1
3160,4,home,12,16,4
3160,5,work,16,20,4
3160,6,home,20,24,4
3161,1,home,0,6,6
3161,2,work,6,13,7
3161,3,home,13,24,11
3162,1,home,0,8,8
3162,2,work,8,13,5
3162,3,home,13,15,2
3162,4,work,15,19,4
3162,5,home,19,24,5
3163,1,home,0,7,7
3163,2,work,7,13,6
3163,3,home,13,17,4
3163,4,work,17,20,3
3163,5,home,20,24,4
3164,1,home,0,7,7
3164,2,education,7,11,4
3164,3,home,11,19,8
3164,4,shop,19,20,1
3164,5,home,20,24,4
3165,1,home,0,7,7
3165,2,work,7,14,7
3165,3,home,14,24,10
3166,1,home,0,7,7
3166,2,education,7,12,5
3166,3,shop,12,14,2
3166,4,education,14,16,2
3166,5,home,16,24,8
3167,1,home,0,7,7
3167,2,shop,7,8,1
3167,3,education,8,11,3
3167,4,home,11,19,8
3167,5,shop,19,21,2
3167,6,home,21,24,3
3168,1,home,0,8,8
3168,2,work,8,15,7
3168,3,home,15,24,9
3169,1,home,0,7,7
3169,2,work,7,9,2
3169,3,home,9,13,4
3169,4,work,13,15,2
3169,5,home,15,21,6
3169,6,work,21,22,1
3169,7,home,22,24,2
3170,1,home,0,7,7
3170,2,work,7,13,6
3170,3,home,13,17,4
3170,4,work,17,20,3
3170,5,home,20,24,4
3171,1,home,0,8,8
3171,2,work,8,15,7
3171,3,shop,15,16,1
3171,4,home,16,24,8
3172,1,home,0,5,5
3172,2,work,5,12,7
3172,3,shop,12,13,1
3172,4,work,13,19,6
3172,5,home,19,24,5
3173,1,home,0,7,7
3173,2,education,7,11,4
3173,3,home,11,19,8
3173,4,shop,19,21,2
3173,5,home,21,24,3
3174,1,home,0,7,7
3174,2,work,7,13,6
3174,3,home,13,24,11
3175,1,home,0,7,7
3175,2,education,7,11,4
3175,3,home,11,17,6
3175,4,shop,17,18,1
3175,5,home,18,24,6
3176,1,home,0,6,6
3176,2,work,6,13,7
3176,3,home,13,17,4
3176,4,shop,17,18,1
3176,5,home,18,24,6
3177,1,home,0,6,6
3177,2,work,6,13,7
3177,3,home,13,21,8
3177,4,shop,21,22,1
3177,5,home,22,24,2
3178,1,home,0,7,7
3178,2,work,7,13,6
3178,3,home,13,16,3
3178,4,work,16,19,3
3178,5,home,19,24,5
3179,1,home,0,7,7
3179,2,work,7,13,6
3179,3,shop,13,14,1
3179,4,work,14,19,5
3179,5,home,19,24,5
3180,1,home,0,7,7
3180,2,work,7,14,7
3180,3,home,14,19,5
3180,4,shop,19,20,1
3180,5,home,20,24,4
3181,1,home,0,7,7
3181,2,shop,7,8,1
3181,3,work,8,16,8
3181,4,home,16,24,8
3182,1,home,0,6,6
3182,2,work,6,13,7
3182,3,shop,13,14,1
3182,4,home,14,24,10
3183,1,home,0,6,6
3183,2,work,6,13,7
3183,3,home,13,22,9
3183,4,work,22,23,1
3183,5,home,23,24,1
3184,1,home,0,6,6
3184,2,work,6,13,7
3184,3,home,13,17,4
3184,4,work,17,20,3
3184,5,home,20,24,4
3185,1,home,0,7,7
3185,2,work,7,14,7
3185,3,home,14,24,10
3186,1,home,0,7,7
3186,2,work,7,13,6
3186,3,shop,13,14,1
3186,4,home,14,24,10
3187,1,home,0,7,7
3187,2,work,7,14,7
3187,3,shop,14,16,2
3187,4,work,16,20,4
3187,5,home,20,24,4
3188,1,home,0,7,7
3188,2,work,7,13,6
3188,3,home,13,17,4
3188,4,work,17,20,3
3188,5,home,20,24,4
3189,1,home,0,7,7
3189,2,education,7,11,4
3189,3,home,11,14,3
3189,4,education,14,16,2
3189,5,shop,16,17,1
3189,6,home,17,24,7
3190,1,home,0,6,6
3190,2,work,6,13,7
3190,3,home,13,23,10
3190,4,work,23,24,1
3191,1,home,0,7,7
3191,2,work,7,14,7
3191,3,shop,14,15,1
3191,4,home,15,24,9
3192,1,home,0,7,7
3192,2,work,7,13,6
3192,3,shop,13,14,1
3192,4,work,14,19,5
3192,5,home,19,24,5
3193,1,home,0,7,7
3193,2,work,7,13,6
3193,3,home,13,22,9
3193,4,work,22,23,1
3193,5,home,23,24,1
3194,1,home,0,7,7
3194,2,work,7,14,7
3194,3,shop,14,15,1
3194,4,home,15,24,9
3195,1,home,0,7,7
3195,2,work,7,14,7
3195,3,home,14,24,10
3196,1,home,0,8,8
3196,2,work,8,15,7
3196,3,home,15,24,9
3197,1,home,0,8,8
3197,2,education,8,11,3
3197,3,home,11,16,5
3197,4,work,16,19,3
3197,5,home,19,24,5
3198,1,home,0,7,7
3198,2,work,7,13,6
3198,3,shop,13,14,1
3198,4,work,14,19,5
3198,5,home,19,24,5
3199,1,home,0,7,7
3199,2,work,7,8,1
3199,3,home,8,14,6
3199,4,work,14,16,2
3199,5,home,16,22,6
3199,6,work,22,23,1
3199,7,home,23,24,1
3200,1,home,0,6,6
3200,2,work,6,13,7
3200,3,shop,13,14,1
3200,4,work,14,19,5
3200,5,home,19,24,5
3201,1,home,0,7,7
3201,2,work,7,13,6
3201,3,home,13,24,11
3202,1,home,0,7,7
3202,2,work,7,14,7
3202,3,home,14,16,2
3202,4,work,16,20,4
3202,5,home,20,24,4
3203,1,home,0,6,6
3203,2,work,6,13,7
3203,3,home,13,22,9
3203,4,work,22,23,1
3203,5,home,23,24,1
3204,1,home,0,7,7
3204,2,work,7,14,7
3204,3,shop,14,15,1
3204,4,work,15,20,5
3204,5,home,20,24,4
3205,1,home,0,6,6
3205,2,work,6,8,2
3205,3,home,8,12,4
3205,4,work,12,14,2
3205,5,home,14,17,3
3205,6,shop,17,18,1
3205,7,home,18,24,6
3206,1,home,0,7,7
3206,2,work,7,9,2
3206,3,home,9,16,7
3206,4,work,16,17,1
3206,5,home,17,24,7
3207,1,home,0,7,7
3207,2,work,7,16,9
3207,3,home,16,22,6
3207,4,work,22,23,1
3207,5,home,23,24,1
3208,1,home,0,6,6
3208,2,work,6,13,7
3208,3,home,13,24,11
3209,1,home,0,7,7
3209,2,education,7,11,4
3209,3,home,11,18,7
3209,4,shop,18,19,1
3209,5,home,19,24,5
3210,1,home,0,6,6
3210,2,shop,6,7,1
3210,3,work,7,14,7
3210,4,home,14,18,4
3210,5,work,18,20,2
3210,6,home,20,24,4
3211,1,home,0,7,7
3211,2,work,7,13,6
3211,3,shop,13,14,1
3211,4,home,14,16,2
3211,5,work,16,20,4
3211,6,home,20,24,4
3212,1,home,0,9,9
3212,2,work,9,15,6
3212,3,home,15,19,4
3212,4,shop,19,21,2
3212,5,home,21,24,3
3213,1,home,0,7,7
3213,2,education,7,10,3
3213,3,home,10,19,9
3213,4,shop,19,21,2
3213,5,home,21,24,3
3214,1,home,0,7,7
3214,2,shop,7,8,1
3214,3,work,8,15,7
3214,4,home,15,22,7
3214,5,work,22,23,1
3214,6,home,23,24,1
3215,1,home,0,6,6
3215,2,shop,6,7,1
3215,3,home,7,9,2
3215,4,education,9,12,3
3215,5,home,12,19,7
3215,6,shop,19,21,2
3215,7,home,21,24,3
3216,1,home,0,8,8
3216,2,work,8,15,7
3216,3,home,15,24,9
3217,1,home,0,7,7
3217,2,work,7,14,7
3217,3,home,14,20,6
3217,4,shop,20,21,1
3217,5,home,21,24,3
3218,1,home,0,6,6
3218,2,work,6,13,7
3218,3,home,13,24,11
3219,1,home,0,7,7
3219,2,shop,7,8,1
3219,3,work,8,15,7
3219,4,home,15,24,9
3220,1,home,0,7,7
3220,2,work,7,12,5
3220,3,shop,12,13,1
3220,4,education,13,15,2
3220,5,work,15,20,5
3220,6,home,20,24,4
3221,1,home,0,7,7
3221,2,work,7,14,7
3221,3,home,14,24,10
3222,1,home,0,7,7
3222,2,education,7,11,4
3222,3,home,11,18,7
3222,4,shop,18,19,1
3222,5,home,19,24,5
3223,1,home,0,7,7
3223,2,work,7,14,7
3223,3,shop,14,15,1
3223,4,home,15,21,6
3223,5,shop,21,22,1
3223,6,home,22,24,2
3224,1,home,0,9,9
3224,2,work,9,15,6
3224,3,home,15,24,9
3225,1,home,0,7,7
3225,2,work,7,14,7
3225,3,home,14,22,8
3225,4,work,22,23,1
3225,5,home,23,24,1
3226,1,home,0,9,9
3226,2,work,9,16,7
3226,3,shop,16,17,1
3226,4,work,17,20,3
3226,5,home,20,24,4
3227,1,home,0,7,7
3227,2,work,7,13,6
3227,3,shop,13,14,1
3227,4,home,14,22,8
3227,5,work,22,23,1
3227,6,home,23,24,1
3228,1,home,0,7,7
3228,2,shop,7,8,1
3228,3,education,8,11,3
3228,4,home,11,18,7
3228,5,shop,18,20,2
3228,6,home,20,24,4
3229,1,home,0,6,6
3229,2,work,6,13,7
3229,3,home,13,16,3
3229,4,work,16,19,3
3229,5,home,19,24,5
3230,1,home,0,6,6
3230,2,shop,6,7,1
3230,3,work,7,13,6
3230,4,shop,13,14,1
3230,5,home,14,18,4
3230,6,work,18,19,1
3230,7,home,19,24,5
3231,1,home,0,8,8
3231,2,education,8,11,3
3231,3,home,11,17,6
3231,4,shop,17,18,1
3231,5,home,18,24,6
3232,1,home,0,6,6
3232,2,work,6,13,7
3232,3,shop,13,14,1
3232,4,home,14,24,10
3233,1,home,0,7,7
3233,2,education,7,12,5
3233,3,shop,12,14,2
3233,4,home,14,21,7
3233,5,shop,21,22,1
3233,6,home,22,24,2
3234,1,home,0,7,7
3234,2,work,7,9,2
3234,3,home,9,13,4
3234,4,work,13,14,1
3234,5,home,14,21,7
3234,6,work,21,22,1
3234,7,home,22,24,2
3235,1,home,0,6,6
3235,2,work,6,13,7
3235,3,home,13,23,10
3235,4,work,23,24,1
3236,1,home,0,9,9
3236,2,work,9,16,7
3236,3,home,16,24,8
3237,1,home,0,7,7
3237,2,education,7,11,4
3237,3,home,11,14,3
3237,4,education,14,16,2
3237,5,shop,16,17,1
3237,6,home,17,20,3
3237,7,shop,20,21,1
3237,8,home,21,24,3
3238,1,home,0,8,8
3238,2,work,8,15,7
3238,3,home,15,20,5
3238,4,shop,20,21,1
3238,5,home,21,24,3
3239,1,home,0,9,9
3239,2,education,9,12,3
3239,3,work,12,18,6
3239,4,home,18,24,6
3240,1,home,0,7,7
3240,2,work,7,14,7
3240,3,home,14,16,2
3240,4,work,16,20,4
3240,5,home,20,24,4
3241,1,home,0,6,6
3241,2,work,6,13,7
3241,3,home,13,24,11
3242,1,home,0,7,7
3242,2,work,7,14,7
3242,3,shop,14,15,1
3242,4,home,15,24,9
3243,1,home,0,7,7
3243,2,shop,7,8,1
3243,3,education,8,11,3
3243,4,home,11,18,7
3243,5,shop,18,19,1
3243,6,home,19,24,5
3244,1,home,0,6,6
3244,2,work,6,13,7
3244,3,shop,13,14,1
3244,4,home,14,23,9
3244,5,work,23,24,1
3245,1,home,0,6,6
3245,2,work,6,13,7
3245,3,home,13,17,4
3245,4,shop,17,18,1
3245,5,home,18,24,6
3246,1,home,0,7,7
3246,2,work,7,13,6
3246,3,home,13,17,4
3246,4,work,17,20,3
3246,5,home,20,24,4
3247,1,home,0,7,7
3247,2,work,7,13,6
3247,3,home,13,21,8
3247,4,work,21,22,1
3247,5,home,22,24,2
3248,1,home,0,7,7
3248,2,work,7,15,8
3248,3,home,15,24,9
3249,1,home,0,6,6
3249,2,shop,6,7,1
3249,3,home,7,10,3
3249,4,education,10,13,3
3249,5,shop,13,15,2
3249,6,home,15,24,9
3250,1,home,0,6,6
3250,2,shop,6,7,1
3250,3,home,7,10,3
3250,4,education,10,14,4
3250,5,shop,14,15,1
3250,6,home,15,24,9
3251,1,home,0,8,8
3251,2,education,8,11,3
3251,3,home,11,14,3
3251,4,education,14,16,2
3251,5,shop,16,18,2
3251,6,home,18,24,6
3252,1,home,0,7,7
3252,2,work,7,9,2
3252,3,home,9,15,6
3252,4,work,15,17,2
3252,5,home,17,23,6
3252,6,work,23,24,1
3253,1,home,0,6,6
3253,2,work,6,13,7
3253,3,shop,13,14,1
3253,4,home,14,22,8
3253,5,work,22,23,1
3253,6,home,23,24,1
3254,1,home,0,7,7
3254,2,work,7,14,7
3254,3,home,14,18,4
3254,4,work,18,20,2
3254,5,home,20,24,4
3255,1,home,0,7,7
3255,2,work,7,13,6
3255,3,home,13,17,4
3255,4,work,17,20,3
3255,5,home,20,24,4
3256,1,home,0,8,8
3256,2,work,8,15,7
3256,3,shop,15,16,1
3256,4,home,16,22,6
3256,5,work,22,23,1
3256,6,home,23,24,1
3257,1,home,0,8,8
3257,2,shop,8,9,1
3257,3,work,9,15,6
3257,4,home,15,24,9
3258,1,home,0,8,8
3258,2,education,8,12,4
3258,3,work,12,19,7
3258,4,home,19,23,4
3258,5,work,23,24,1
3259,1,home,0,8,8
3259,2,work,8,15,7
3259,3,shop,15,16,1
3259,4,work,16,20,4
3259,5,home,20,24,4
3260,1,home,0,7,7
3260,2,work,7,13,6
3260,3,shop,13,14,1
3260,4,home,14,24,10
3261,1,home,0,9,9
3261,2,work,9,15,6
3261,3,home,15,21,6
3261,4,work,21,22,1
3261,5,home,22,24,2
3262,1,home,0,6,6
3262,2,work,6,8,2
3262,3,home,8,13,5
3262,4,work,13,15,2
3262,5,home,15,22,7
3262,6,work,22,23,1
3262,7,home,23,24,1
3263,1,home,0,6,6
3263,2,work,6,13,7
3263,3,home,13,24,11
3264,1,home,0,7,7
3264,2,work,7,14,7
3264,3,home,14,24,10
3265,1,home,0,7,7
3265,2,work,7,13,6
3265,3,shop,13,14,1
3265,4,work,14,19,5
3265,5,home,19,24,5
3266,1,home,0,7,7
3266,2,work,7,13,6
3266,3,shop,13,14,1
3266,4,work,14,20,6
3266,5,home,20,24,4
3267,1,home,0,6,6
3267,2,work,6,13,7
3267,3,shop,13,14,1
3267,4,work,14,20,6
3267,5,home,20,24,4
3268,1,home,0,6,6
3268,2,shop,6,7,1
3268,3,home,7,13,6
3268,4,education,13,16,3
3268,5,shop,16,18,2
3268,6,home,18,24,6
3269,1,home,0,8,8
3269,2,work,8,15,7
3269,3,shop,15,16,1
3269,4,home,16,24,8
3270,1,home,0,7,7
3270,2,work,7,8,1
3270,3,home,8,13,5
3270,4,work,13,16,3
3270,5,home,16,21,5
3270,6,work,21,22,1
3270,7,home,22,24,2
3271,1,home,0,6,6
3271,2,work,6,8,2
3271,3,home,8,12,4
3271,4,work,12,14,2
3271,5,home,14,17,3
3271,6,work,17,19,2
3271,7,home,19,24,5
3272,1,home,0,6,6
3272,2,shop,6,7,1
3272,3,home,7,10,3
3272,4,education,10,13,3
3272,5,shop,13,15,2
3272,6,home,15,24,9
3273,1,home,0,8,8
3273,2,work,8,15,7
3273,3,home,15,20,5
3273,4,shop,20,21,1
3273,5,home,21,24,3
3274,1,work,0,8,8
3274,2,shop,8,9,1
3274,3,work,9,16,7
3274,4,home,16,24,8
3275,1,home,0,7,7
3275,2,work,7,13,6
3275,3,shop,13,14,1
3275,4,work,14,19,5
3275,5,home,19,24,5
3276,1,home,0,9,9
3276,2,work,9,16,7
3276,3,home,16,24,8
3277,1,home,0,7,7
3277,2,work,7,14,7
3277,3,home,14,24,10
3278,1,home,0,7,7
3278,2,work,7,14,7
3278,3,home,14,22,8
3278,4,work,22,23,1
3278,5,home,23,24,1
3279,1,home,0,6,6
3279,2,work,6,8,2
3279,3,home,8,12,4
3279,4,work,12,14,2
3279,5,home,14,21,7
3279,6,shop,21,22,1
3279,7,home,22,24,2
3280,1,home,0,6,6
3280,2,work,6,13,7
3280,3,shop,13,14,1
3280,4,home,14,24,10
3281,1,home,0,7,7
3281,2,work,7,13,6
3281,3,home,13,21,8
3281,4,work,21,22,1
3281,5,home,22,24,2
3282,1,home,0,8,8
3282,2,work,8,15,7
3282,3,shop,15,16,1
3282,4,home,16,24,8
3283,1,home,0,7,7
3283,2,shop,7,8,1
3283,3,education,8,11,3
3283,4,home,11,17,6
3283,5,shop,17,19,2
3283,6,home,19,24,5
3284,1,home,0,8,8
3284,2,work,8,15,7
3284,3,home,15,24,9
3285,1,home,0,6,6
3285,2,work,6,13,7
3285,3,home,13,18,5
3285,4,work,18,20,2
3285,5,home,20,24,4
3286,1,home,0,8,8
3286,2,work,8,14,6
3286,3,shop,14,15,1
3286,4,work,15,19,4
3286,5,home,19,24,5
3287,1,home,0,6,6
3287,2,work,6,13,7
3287,3,home,13,17,4
3287,4,work,17,19,2
3287,5,home,19,24,5
3288,1,home,0,7,7
3288,2,education,7,11,4
3288,3,home,11,16,5
3288,4,shop,16,17,1
3288,5,home,17,24,7
3289,1,home,0,8,8
3289,2,work,8,13,5
3289,3,home,13,18,5
3289,4,work,18,20,2
3289,5,home,20,24,4
3290,1,home,0,7,7
3290,2,education,7,11,4
3290,3,home,11,16,5
3290,4,shop,16,17,1
3290,5,home,17,24,7
3291,1,home,0,8,8
3291,2,work,8,15,7
3291,3,shop,15,16,1
3291,4,home,16,24,8
3292,1,home,0,7,7
3292,2,work,7,13,6
3292,3,shop,13,14,1
3292,4,work,14,19,5
3292,5,home,19,24,5
3293,1,home,0,8,8
3293,2,work,8,14,6
3293,3,shop,14,15,1
3293,4,work,15,20,5
3293,5,home,20,24,4
3294,1,home,0,7,7
3294,2,work,7,9,2
3294,3,home,9,14,5
3294,4,work,14,16,2
3294,5,home,16,22,6
3294,6,work,22,23,1
3294,7,home,23,24,1
3295,1,home,0,7,7
3295,2,work,7,14,7
3295,3,shop,14,15,1
3295,4,work,15,19,4
3295,5,home,19,24,5
3296,1,home,0,8,8
3296,2,work,8,15,7
3296,3,shop,15,16,1
3296,4,home,16,24,8
3297,1,home,0,8,8
3297,2,education,8,13,5
3297,3,shop,13,15,2
3297,4,home,15,19,4
3297,5,shop,19,20,1
3297,6,home,20,24,4
3298,1,home,0,7,7
3298,2,work,7,13,6
3298,3,home,13,17,4
3298,4,work,17,20,3
3298,5,home,20,24,4
3299,1,home,0,9,9
3299,2,work,9,16,7
3299,3,home,16,24,8
3300,1,home,0,7,7
3300,2,shop,7,8,1
3300,3,education,8,12,4
3300,4,shop,12,13,1
3300,5,home,13,20,7
3300,6,shop,20,21,1
3300,7,home,21,24,3
3301,1,home,0,8,8
3301,2,education,8,13,5
3301,3,shop,13,14,1
3301,4,home,14,24,10
3302,1,home,0,8,8
3302,2,work,8,16,8
3302,3,home,16,24,8
3303,1,home,0,6,6
3303,2,work,6,13,7
3303,3,home,13,17,4
3303,4,work,17,20,3
3303,5,home,20,21,1
3303,6,work,21,22,1
3303,7,home,22,24,2
3304,1,home,0,6,6
3304,2,work,6,13,7
3304,3,shop,13,14,1
3304,4,work,14,20,6
3304,5,home,20,24,4
3305,1,home,0,7,7
3305,2,work,7,13,6
3305,3,shop,13,14,1
3305,4,education,14,16,2
3305,5,home,16,24,8
3306,1,home,0,8,8
3306,2,work,8,14,6
3306,3,home,14,24,10
3307,1,home,0,7,7
3307,2,work,7,13,6
3307,3,home,13,22,9
3307,4,work,22,23,1
3307,5,home,23,24,1
3308,1,home,0,7,7
3308,2,work,7,13,6
3308,3,shop,13,15,2
3308,4,home,15,21,6
3308,5,work,21,22,1
3308,6,home,22,24,2
3309,1,home,0,7,7
3309,2,shop,7,9,2
3309,3,education,9,11,2
3309,4,home,11,19,8
3309,5,shop,19,20,1
3309,6,home,20,24,4
3310,1,home,0,7,7
3310,2,work,7,15,8
3310,3,home,15,24,9
3311,1,home,0,6,6
3311,2,shop,6,7,1
3311,3,home,7,9,2
3311,4,education,9,11,2
3311,5,home,11,15,4
3311,6,shop,15,17,2
3311,7,home,17,21,4
3311,8,shop,21,22,1
3311,9,home,22,24,2
3312,1,home,0,7,7
3312,2,work,7,14,7
3312,3,home,14,24,10
3313,1,home,0,6,6
3313,2,work,6,13,7
3313,3,home,13,17,4
3313,4,shop,17,18,1
3313,5,home,18,24,6
3314,1,home,0,6,6
3314,2,shop,6,7,1
3314,3,home,7,11,4
3314,4,work,11,18,7
3314,5,home,18,24,6
3315,1,home,0,7,7
3315,2,work,7,13,6
3315,3,shop,13,14,1
3315,4,work,14,19,5
3315,5,home,19,24,5
3316,1,home,0,8,8
3316,2,work,8,15,7
3316,3,home,15,24,9
3317,1,home,0,8,8
3317,2,work,8,14,6
3317,3,home,14,20,6
3317,4,shop,20,21,1
3317,5,home,21,24,3
3318,1,home,0,7,7
3318,2,work,7,14,7
3318,3,home,14,24,10
3319,1,home,0,7,7
3319,2,shop,7,8,1
3319,3,education,8,11,3
3319,4,home,11,18,7
3319,5,shop,18,19,1
3319,6,home,19,24,5
3320,1,home,0,8,8
3320,2,work,8,13,5
3320,3,shop,13,14,1
3320,4,home,14,24,10
3321,1,home,0,7,7
3321,2,work,7,15,8
3321,3,home,15,24,9
3322,1,home,0,8,8
3322,2,work,8,14,6
3322,3,home,14,24,10
3323,1,home,0,7,7
3323,2,work,7,13,6
3323,3,home,13,16,3
3323,4,work,16,20,4
3323,5,home,20,24,4
3324,1,home,0,8,8
3324,2,work,8,15,7
3324,3,home,15,24,9
3325,1,home,0,8,8
3325,2,work,8,15,7
3325,3,home,15,24,9
3326,1,home,0,8,8
3326,2,work,8,16,8
3326,3,home,16,24,8
3327,1,home,0,7,7
3327,2,shop,7,8,1
3327,3,education,8,12,4
3327,4,home,12,19,7
3327,5,shop,19,20,1
3327,6,home,20,24,4
3328,1,home,0,8,8
3328,2,work,8,16,8
3328,3,home,16,22,6
3328,4,work,22,23,1
3328,5,home,23,24,1
3329,1,home,0,7,7
3329,2,work,7,13,6
3329,3,home,13,24,11
3330,1,home,0,6,6
3330,2,shop,6,7,1
3330,3,home,7,9,2
3330,4,education,9,12,3
3330,5,shop,12,14,2
3330,6,education,14,16,2
3330,7,shop,16,17,1
3330,8,home,17,24,7
3331,1,home,0,8,8
3331,2,work,8,15,7
3331,3,home,15,24,9
3332,1,home,0,8,8
3332,2,education,8,11,3
3332,3,home,11,17,6
3332,4,shop,17,18,1
3332,5,home,18,24,6
3333,1,home,0,9,9
3333,2,work,9,16,7
3333,3,home,16,24,8
3334,1,home,0,7,7
3334,2,education,7,12,5
3334,3,shop,12,14,2
3334,4,home,14,21,7
3334,5,shop,21,22,1
3334,6,home,22,24,2
3335,1,home,0,6,6
3335,2,work,6,7,1
3335,3,home,7,9,2
3335,4,work,9,11,2
3335,5,home,11,17,6
3335,6,work,17,19,2
3335,7,home,19,24,5
3336,1,home,0,7,7
3336,2,work,7,14,7
3336,3,home,14,19,5
3336,4,shop,19,20,1
3336,5,home,20,24,4
3337,1,home,0,9,9
3337,2,education,9,12,3
3337,3,home,12,24,12
3338,1,home,0,7,7
3338,2,education,7,11,4
3338,3,home,11,17,6
3338,4,shop,17,18,1
3338,5,home,18,24,6
3339,1,home,0,7,7
3339,2,work,7,13,6
3339,3,home,13,24,11
3340,1,home,0,8,8
3340,2,work,8,15,7
3340,3,home,15,22,7
3340,4,work,22,23,1
3340,5,home,23,24,1
3341,1,home,0,7,7
3341,2,work,7,13,6
3341,3,home,13,17,4
3341,4,work,17,20,3
3341,5,home,20,24,4
3342,1,home,0,7,7
3342,2,shop,7,8,1
3342,3,education,8,11,3
3342,4,home,11,18,7
3342,5,shop,18,19,1
3342,6,home,19,24,5
3343,1,home,0,7,7
3343,2,work,7,13,6
3343,3,shop,13,14,1
3343,4,work,14,18,4
3343,5,home,18,24,6
3344,1,home,0,7,7
3344,2,work,7,9,2
3344,3,home,9,15,6
3344,4,work,15,18,3
3344,5,home,18,22,4
3344,6,work,22,23,1
3344,7,home,23,24,1
3345,1,home,0,6,6
3345,2,shop,6,7,1
3345,3,work,7,14,7
3345,4,home,14,15,1
3345,5,work,15,18,3
3345,6,home,18,24,6
3346,1,home,0,7,7
3346,2,work,7,9,2
3346,3,home,9,13,4
3346,4,work,13,14,1
3346,5,shop,14,15,1
3346,6,home,15,22,7
3346,7,work,22,23,1
3346,8,home,23,24,1
3347,1,home,0,6,6
3347,2,work,6,13,7
3347,3,home,13,18,5
3347,4,shop,18,19,1
3347,5,home,19,24,5
3348,1,home,0,7,7
3348,2,work,7,13,6
3348,3,shop,13,14,1
3348,4,work,14,20,6
3348,5,home,20,24,4
3349,1,home,0,7,7
3349,2,work,7,13,6
3349,3,home,13,21,8
3349,4,shop,21,22,1
3349,5,home,22,24,2
3350,1,home,0,8,8
3350,2,education,8,12,4
3350,3,home,12,20,8
3350,4,shop,20,21,1
3350,5,home,21,24,3
3351,1,home,0,7,7
3351,2,work,7,13,6
3351,3,shop,13,14,1
3351,4,work,14,20,6
3351,5,home,20,24,4
3352,1,home,0,7,7
3352,2,work,7,9,2
3352,3,home,9,15,6
3352,4,work,15,17,2
3352,5,home,17,23,6
3352,6,work,23,24,1
3353,1,home,0,7,7
3353,2,work,7,10,3
3353,3,home,10,15,5
3353,4,work,15,17,2
3353,5,home,17,24,7
3354,1,home,0,6,6
3354,2,shop,6,7,1
3354,3,home,7,13,6
3354,4,education,13,16,3
3354,5,shop,16,17,1
3354,6,home,17,24,7
3355,1,home,0,6,6
3355,2,work,6,13,7
3355,3,home,13,18,5
3355,4,shop,18,19,1
3355,5,home,19,24,5
3356,1,home,0,7,7
3356,2,work,7,14,7
3356,3,home,14,21,7
3356,4,work,21,22,1
3356,5,home,22,24,2
3357,1,home,0,6,6
3357,2,shop,6,7,1
3357,3,work,7,14,7
3357,4,shop,14,15,1
3357,5,work,15,20,5
3357,6,home,20,24,4
3358,1,home,0,6,6
3358,2,work,6,8,2
3358,3,home,8,9,1
3358,4,work,9,11,2
3358,5,home,11,17,6
3358,6,work,17,19,2
3358,7,home,19,24,5
3359,1,home,0,6,6
3359,2,work,6,8,2
3359,3,home,8,14,6
3359,4,work,14,15,1
3359,5,home,15,22,7
3359,6,work,22,23,1
3359,7,home,23,24,1
3360,1,home,0,6,6
3360,2,shop,6,7,1
3360,3,home,7,9,2
3360,4,education,9,12,3
3360,5,home,12,24,12
3361,1,home,0,8,8
3361,2,work,8,15,7
3361,3,home,15,21,6
3361,4,work,21,22,1
3361,5,home,22,24,2
3362,1,home,0,8,8
3362,2,work,8,15,7
3362,3,home,15,24,9
3363,1,home,0,7,7
3363,2,education,7,11,4
3363,3,home,11,17,6
3363,4,shop,17,19,2
3363,5,home,19,24,5
3364,1,home,0,7,7
3364,2,work,7,15,8
3364,3,home,15,24,9
3365,1,home,0,6,6
3365,2,shop,6,7,1
3365,3,home,7,13,6
3365,4,education,13,16,3
3365,5,home,16,24,8
3366,1,home,0,7,7
3366,2,work,7,14,7
3366,3,home,14,24,10
3367,1,home,0,7,7
3367,2,work,7,13,6
3367,3,shop,13,14,1
3367,4,home,14,22,8
3367,5,work,22,23,1
3367,6,home,23,24,1
3368,1,home,0,9,9
3368,2,work,9,16,7
3368,3,home,16,24,8
3369,1,home,0,6,6
3369,2,shop,6,7,1
3369,3,work,7,14,7
3369,4,shop,14,15,1
3369,5,work,15,20,5
3369,6,home,20,24,4
3370,1,home,0,7,7
3370,2,education,7,13,6
3370,3,shop,13,15,2
3370,4,home,15,24,9
3371,1,home,0,6,6
3371,2,work,6,14,8
3371,3,home,14,23,9
3371,4,work,23,24,1
3372,1,home,0,8,8
3372,2,work,8,17,9
3372,3,home,17,24,7
3373,1,home,0,7,7
3373,2,work,7,13,6
3373,3,shop,13,14,1
3373,4,education,14,16,2
3373,5,home,16,24,8
3374,1,home,0,7,7
3374,2,shop,7,8,1
3374,3,education,8,11,3
3374,4,home,11,18,7
3374,5,shop,18,20,2
3374,6,home,20,24,4
3375,1,home,0,7,7
3375,2,shop,7,8,1
3375,3,education,8,11,3
3375,4,home,11,17,6
3375,5,shop,17,18,1
3375,6,home,18,24,6
3376,1,home,0,7,7
3376,2,work,7,14,7
3376,3,shop,14,15,1
3376,4,home,15,18,3
3376,5,work,18,20,2
3376,6,home,20,24,4
3377,1,home,0,8,8
3377,2,work,8,14,6
3377,3,home,14,15,1
3377,4,work,15,20,5
3377,5,home,20,24,4
3378,1,home,0,7,7
3378,2,work,7,13,6
3378,3,home,13,24,11
3379,1,home,0,6,6
3379,2,shop,6,7,1
3379,3,home,7,9,2
3379,4,education,9,12,3
3379,5,shop,12,14,2
3379,6,home,14,20,6
3379,7,shop,20,21,1
3379,8,home,21,24,3
3380,1,home,0,6,6
3380,2,work,6,13,7
3380,3,home,13,22,9
3380,4,work,22,23,1
3380,5,home,23,24,1
3381,1,home,0,6,6
3381,2,work,6,8,2
3381,3,home,8,14,6
3381,4,work,14,16,2
3381,5,home,16,23,7
3381,6,work,23,24,1
3382,1,home,0,7,7
3382,2,work,7,14,7
3382,3,shop,14,15,1
3382,4,work,15,20,5
3382,5,home,20,24,4
3383,1,home,0,6,6
3383,2,work,6,13,7
3383,3,home,13,24,11
3384,1,home,0,8,8
3384,2,work,8,15,7
3384,3,shop,15,16,1
3384,4,work,16,20,4
3384,5,home,20,24,4
3385,1,home,0,7,7
3385,2,work,7,14,7
3385,3,shop,14,15,1
3385,4,home,15,23,8
3385,5,work,23,24,1
3386,1,home,0,6,6
3386,2,work,6,13,7
3386,3,home,13,17,4
3386,4,work,17,19,2
3386,5,home,19,24,5
3387,1,home,0,7,7
3387,2,work,7,14,7
3387,3,home,14,24,10
3388,1,home,0,7,7
3388,2,shop,7,8,1
3388,3,home,8,14,6
3388,4,work,14,20,6
3388,5,home,20,24,4
3389,1,home,0,6,6
3389,2,work,6,8,2
3389,3,home,8,12,4
3389,4,work,12,14,2
3389,5,shop,14,15,1
3389,6,work,15,17,2
3389,7,home,17,22,5
3389,8,work,22,23,1
3389,9,home,23,24,1
3390,1,home,0,8,8
3390,2,work,8,15,7
3390,3,home,15,24,9
3391,1,home,0,7,7
3391,2,shop,7,8,1
3391,3,work,8,14,6
3391,4,home,14,18,4
3391,5,work,18,20,2
3391,6,home,20,24,4
3392,1,home,0,7,7
3392,2,education,7,11,4
3392,3,home,11,13,2
3392,4,education,13,16,3
3392,5,home,16,24,8
3393,1,home,0,9,9
3393,2,work,9,17,8
3393,3,home,17,24,7
3394,1,home,0,6,6
3394,2,shop,6,7,1
3394,3,home,7,10,3
3394,4,work,10,18,8
3394,5,home,18,24,6
3395,1,home,0,7,7
3395,2,work,7,13,6
3395,3,home,13,18,5
3395,4,work,18,20,2
3395,5,home,20,24,4
3396,1,home,0,8,8
3396,2,work,8,15,7
3396,3,home,15,19,4
3396,4,shop,19,20,1
3396,5,home,20,24,4
3397,1,home,0,8,8
3397,2,work,8,15,7
3397,3,home,15,24,9
3398,1,home,0,8,8
3398,2,work,8,15,7
3398,3,home,15,24,9
3399,1,home,0,7,7
3399,2,work,7,14,7
3399,3,shop,14,15,1
3399,4,work,15,20,5
3399,5,home,20,24,4
3400,1,home,0,6,6
3400,2,work,6,13,7
3400,3,home,13,18,5
3400,4,work,18,20,2
3400,5,home,20,24,4
3401,1,home,0,6,6
3401,2,work,6,8,2
3401,3,home,8,14,6
3401,4,work,14,16,2
3401,5,home,16,23,7
3401,6,work,23,24,1
3402,1,home,0,8,8
3402,2,work,8,14,6
3402,3,home,14,24,10
3403,1,home,0,8,8
3403,2,education,8,13,5
3403,3,shop,13,14,1
3403,4,education,14,16,2
3403,5,home,16,24,8
3404,1,home,0,7,7
3404,2,work,7,14,7
3404,3,shop,14,15,1
3404,4,home,15,24,9
3405,1,home,0,8,8
3405,2,work,8,15,7
3405,3,home,15,24,9
3406,1,home,0,8,8
3406,2,work,8,14,6
3406,3,home,14,21,7
3406,4,shop,21,22,1
3406,5,home,22,24,2
3407,1,home,0,8,8
3407,2,work,8,14,6
3407,3,shop,14,15,1
3407,4,work,15,19,4
3407,5,home,19,23,4
3407,6,work,23,24,1
3408,1,home,0,7,7
3408,2,work,7,13,6
3408,3,home,13,18,5
3408,4,shop,18,19,1
3408,5,home,19,23,4
3408,6,work,23,24,1
3409,1,home,0,7,7
3409,2,work,7,14,7
3409,3,home,14,24,10
3410,1,home,0,8,8
3410,2,work,8,13,5
3410,3,home,13,18,5
3410,4,shop,18,19,1
3410,5,home,19,24,5
3411,1,home,0,7,7
3411,2,work,7,14,7
3411,3,shop,14,15,1
3411,4,home,15,24,9
3412,1,home,0,7,7
3412,2,work,7,14,7
3412,3,shop,14,15,1
3412,4,home,15,24,9
3413,1,home,0,6,6
3413,2,shop,6,7,1
3413,3,home,7,14,7
3413,4,work,14,20,6
3413,5,home,20,24,4
3414,1,home,0,7,7
3414,2,education,7,11,4
3414,3,home,11,19,8
3414,4,shop,19,20,1
3414,5,home,20,24,4
3415,1,home,0,8,8
3415,2,work,8,14,6
3415,3,shop,14,15,1
3415,4,work,15,20,5
3415,5,home,20,24,4
3416,1,home,0,7,7
3416,2,work,7,14,7
3416,3,home,14,20,6
3416,4,shop,20,21,1
3416,5,home,21,24,3
3417,1,home,0,9,9
3417,2,work,9,15,6
3417,3,home,15,20,5
3417,4,shop,20,21,1
3417,5,home,21,24,3
3418,1,home,0,6,6
3418,2,work,6,8,2
3418,3,home,8,13,5
3418,4,work,13,14,1
3418,5,home,14,21,7
3418,6,work,21,22,1
3418,7,home,22,24,2
3419,1,home,0,7,7
3419,2,education,7,10,3
3419,3,home,10,14,4
3419,4,education,14,16,2
3419,5,home,16,24,8
3420,1,home,0,6,6
3420,2,shop,6,7,1
3420,3,home,7,9,2
3420,4,education,9,12,3
3420,5,home,12,20,8
3420,6,shop,20,21,1
3420,7,home,21,24,3
3421,1,home,0,7,7
3421,2,work,7,13,6
3421,3,home,13,23,10
3421,4,work,23,24,1
3422,1,home,0,6,6
3422,2,shop,6,7,1
3422,3,work,7,13,6
3422,4,home,13,17,4
3422,5,work,17,20,3
3422,6,home,20,24,4
3423,1,home,0,7,7
3423,2,work,7,14,7
3423,3,shop,14,15,1
3423,4,home,15,23,8
3423,5,work,23,24,1
3424,1,home,0,6,6
3424,2,shop,6,7,1
3424,3,home,7,10,3
3424,4,education,10,16,6
3424,5,shop,16,18,2
3424,6,home,18,24,6
3425,1,work,0,8,8
3425,2,shop,8,9,1
3425,3,home,9,16,7
3425,4,work,16,20,4
3425,5,home,20,24,4
3426,1,home,0,7,7
3426,2,work,7,14,7
3426,3,shop,14,16,2
3426,4,work,16,20,4
3426,5,home,20,24,4
3427,1,home,0,7,7
3427,2,education,7,12,5
3427,3,shop,12,14,2
3427,4,education,14,17,3
3427,5,home,17,24,7
3428,1,home,0,6,6
3428,2,work,6,13,7
3428,3,home,13,17,4
3428,4,work,17,20,3
3428,5,home,20,24,4
3429,1,home,0,8,8
3429,2,work,8,14,6
3429,3,home,14,24,10
3430,1,home,0,9,9
3430,2,work,9,17,8
3430,3,home,17,21,4
3430,4,shop,21,22,1
3430,5,home,22,24,2
3431,1,home,0,6,6
3431,2,shop,6,7,1
3431,3,home,7,13,6
3431,4,education,13,16,3
3431,5,home,16,24,8
3432,1,home,0,7,7
3432,2,work,7,13,6
3432,3,home,13,16,3
3432,4,work,16,19,3
3432,5,home,19,24,5
3433,1,home,0,7,7
3433,2,work,7,13,6
3433,3,shop,13,14,1
3433,4,work,14,19,5
3433,5,home,19,24,5
3434,1,home,0,7,7
3434,2,education,7,11,4
3434,3,home,11,20,9
3434,4,shop,20,21,1
3434,5,home,21,24,3
3435,1,home,0,6,6
3435,2,work,6,8,2
3435,3,home,8,14,6
3435,4,work,14,16,2
3435,5,home,16,23,7
3435,6,work,23,24,1
3436,1,home,0,7,7
3436,2,work,7,9,2
3436,3,home,9,15,6
3436,4,work,15,17,2
3436,5,home,17,23,6
3436,6,work,23,24,1
3437,1,home,0,6,6
3437,2,work,6,13,7
3437,3,home,13,18,5
3437,4,work,18,20,2
3437,5,home,20,24,4
3438,1,home,0,7,7
3438,2,work,7,14,7
3438,3,shop,14,15,1
3438,4,work,15,20,5
3438,5,home,20,24,4
3439,1,home,0,7,7
3439,2,work,7,14,7
3439,3,home,14,22,8
3439,4,work,22,23,1
3439,5,home,23,24,1
3440,1,home,0,6,6
3440,2,shop,6,7,1
3440,3,work,7,13,6
3440,4,home,13,24,11
3441,1,home,0,8,8
3441,2,work,8,15,7
3441,3,home,15,24,9
3442,1,home,0,7,7
3442,2,education,7,12,5
3442,3,home,12,20,8
3442,4,shop,20,21,1
3442,5,home,21,24,3
3443,1,home,0,6,6
3443,2,work,6,13,7
3443,3,home,13,24,11
3444,1,home,0,7,7
3444,2,work,7,14,7
3444,3,shop,14,15,1
3444,4,home,15,24,9
3445,1,home,0,7,7
3445,2,work,7,13,6
3445,3,shop,13,14,1
3445,4,work,14,19,5
3445,5,home,19,24,5
3446,1,home,0,6,6
3446,2,work,6,8,2
3446,3,home,8,11,3
3446,4,work,11,13,2
3446,5,home,13,21,8
3446,6,work,21,22,1
3446,7,home,22,24,2
3447,1,home,0,6,6
3447,2,work,6,8,2
3447,3,home,8,11,3
3447,4,work,11,12,1
3447,5,home,12,21,9
3447,6,work,21,22,1
3447,7,home,22,24,2
3448,1,home,0,7,7
3448,2,work,7,13,6
3448,3,shop,13,14,1
3448,4,home,14,24,10
3449,1,home,0,6,6
3449,2,work,6,8,2
3449,3,home,8,14,6
3449,4,work,14,16,2
3449,5,home,16,24,8
3450,1,home,0,7,7
3450,2,shop,7,8,1
3450,3,education,8,12,4
3450,4,home,12,18,6
3450,5,shop,18,19,1
3450,6,home,19,24,5
3451,1,home,0,8,8
3451,2,work,8,15,7
3451,3,home,15,24,9
3452,1,home,0,7,7
3452,2,work,7,14,7
3452,3,shop,14,15,1
3452,4,home,15,24,9
3453,1,home,0,6,6
3453,2,work,6,13,7
3453,3,home,13,17,4
3453,4,work,17,20,3
3453,5,home,20,24,4
3454,1,home,0,6,6
3454,2,work,6,13,7
3454,3,shop,13,14,1
3454,4,home,14,20,6
3454,5,shop,20,21,1
3454,6,home,21,24,3
3455,1,home,0,7,7
3455,2,work,7,13,6
3455,3,home,13,24,11
3456,1,home,0,8,8
3456,2,work,8,14,6
3456,3,home,14,20,6
3456,4,shop,20,21,1
3456,5,home,21,24,3
3457,1,home,0,7,7
3457,2,work,7,14,7
3457,3,home,14,24,10
3458,1,home,0,6,6
3458,2,work,6,8,2
3458,3,home,8,13,5
3458,4,work,13,15,2
3458,5,home,15,21,6
3458,6,work,21,22,1
3458,7,home,22,24,2
3459,1,home,0,7,7
3459,2,work,7,14,7
3459,3,shop,14,15,1
3459,4,home,15,24,9
3460,1,home,0,7,7
3460,2,work,7,8,1
3460,3,home,8,10,2
3460,4,work,10,12,2
3460,5,home,12,16,4
3460,6,work,16,18,2
3460,7,home,18,22,4
3460,8,work,22,23,1
3460,9,home,23,24,1
3461,1,home,0,6,6
3461,2,shop,6,7,1
3461,3,work,7,14,7
3461,4,home,14,18,4
3461,5,work,18,19,1
3461,6,home,19,24,5
3462,1,home,0,7,7
3462,2,work,7,14,7
3462,3,home,14,22,8
3462,4,work,22,23,1
3462,5,home,23,24,1
3463,1,home,0,7,7
3463,2,work,7,14,7
3463,3,home,14,24,10
3464,1,home,0,7,7
3464,2,work,7,13,6
3464,3,home,13,21,8
3464,4,shop,21,22,1
3464,5,home,22,24,2
3465,1,home,0,7,7
3465,2,work,7,14,7
3465,3,home,14,18,4
3465,4,work,18,20,2
3465,5,home,20,24,4
3466,1,home,0,7,7
3466,2,work,7,13,6
3466,3,home,13,24,11
3467,1,home,0,8,8
3467,2,education,8,11,3
3467,3,shop,11,12,1
3467,4,work,12,17,5
3467,5,home,17,24,7
3468,1,home,0,6,6
3468,2,work,6,13,7
3468,3,shop,13,14,1
3468,4,education,14,16,2
3468,5,home,16,24,8
3469,1,home,0,7,7
3469,2,work,7,14,7
3469,3,home,14,19,5
3469,4,shop,19,20,1
3469,5,home,20,24,4
3470,1,home,0,7,7
3470,2,work,7,14,7
3470,3,home,14,24,10
3471,1,home,0,7,7
3471,2,work,7,13,6
3471,3,shop,13,14,1
3471,4,home,14,24,10
3472,1,home,0,7,7
3472,2,education,7,11,4
3472,3,home,11,19,8
3472,4,shop,19,20,1
3472,5,home,20,24,4
3473,1,home,0,6,6
3473,2,work,6,13,7
3473,3,shop,13,14,1
3473,4,work,14,20,6
3473,5,home,20,24,4
3474,1,home,0,6,6
3474,2,work,6,8,2
3474,3,home,8,9,1
3474,4,work,9,11,2
3474,5,home,11,16,5
3474,6,work,16,18,2
3474,7,home,18,22,4
3474,8,work,22,23,1
3474,9,home,23,24,1
3475,1,home,0,7,7
3475,2,work,7,14,7
3475,3,home,14,24,10
3476,1,home,0,6,6
3476,2,work,6,8,2
3476,3,home,8,14,6
3476,4,work,14,16,2
3476,5,home,16,24,8
3477,1,home,0,8,8
3477,2,work,8,15,7
3477,3,home,15,24,9
3478,1,home,0,8,8
3478,2,work,8,14,6
3478,3,home,14,21,7
3478,4,work,21,22,1
3478,5,home,22,24,2
3479,1,home,0,7,7
3479,2,work,7,13,6
3479,3,home,13,21,8
3479,4,work,21,22,1
3479,5,home,22,24,2
3480,1,home,0,7,7
3480,2,work,7,14,7
3480,3,home,14,21,7
3480,4,work,21,22,1
3480,5,home,22,24,2
3481,1,home,0,7,7
3481,2,work,7,9,2
3481,3,home,9,15,6
3481,4,work,15,17,2
3481,5,home,17,23,6
3481,6,work,23,24,1
3482,1,home,0,8,8
3482,2,work,8,14,6
3482,3,shop,14,15,1
3482,4,home,15,21,6
3482,5,shop,21,22,1
3482,6,home,22,24,2
3483,1,home,0,8,8
3483,2,work,8,14,6
3483,3,home,14,18,4
3483,4,work,18,20,2
3483,5,home,20,24,4
3484,1,home,0,6,6
3484,2,work,6,13,7
3484,3,shop,13,14,1
3484,4,home,14,18,4
3484,5,shop,18,19,1
3484,6,home,19,24,5
3485,1,home,0,6,6
3485,2,shop,6,7,1
3485,3,home,7,9,2
3485,4,education,9,12,3
3485,5,shop,12,14,2
3485,6,home,14,21,7
3485,7,shop,21,22,1
3485,8,home,22,24,2
3486,1,home,0,6,6
3486,2,work,6,13,7
3486,3,shop,13,14,1
3486,4,work,14,19,5
3486,5,home,19,24,5
3487,1,home,0,7,7
3487,2,work,7,13,6
3487,3,home,13,20,7
3487,4,shop,20,21,1
3487,5,home,21,24,3
3488,1,home,0,7,7
3488,2,work,7,9,2
3488,3,home,9,13,4
3488,4,work,13,15,2
3488,5,home,15,21,6
3488,6,work,21,22,1
3488,7,home,22,24,2
3489,1,home,0,6,6
3489,2,work,6,13,7
3489,3,shop,13,14,1
3489,4,home,14,24,10
3490,1,home,0,7,7
3490,2,work,7,9,2
3490,3,home,9,15,6
3490,4,work,15,17,2
3490,5,home,17,23,6
3490,6,work,23,24,1
3491,1,home,0,7,7
3491,2,work,7,9,2
3491,3,home,9,15,6
3491,4,work,15,17,2
3491,5,home,17,24,7
3492,1,home,0,7,7
3492,2,shop,7,8,1
3492,3,education,8,12,4
3492,4,shop,12,13,1
3492,5,education,13,15,2
3492,6,shop,15,16,1
3492,7,home,16,24,8
3493,1,home,0,7,7
3493,2,work,7,15,8
3493,3,home,15,24,9
3494,1,home,0,6,6
3494,2,shop,6,7,1
3494,3,home,7,11,4
3494,4,work,11,18,7
3494,5,home,18,23,5
3494,6,work,23,24,1
3495,1,home,0,7,7
3495,2,work,7,14,7
3495,3,shop,14,15,1
3495,4,home,15,24,9
3496,1,home,0,7,7
3496,2,work,7,14,7
3496,3,home,14,21,7
3496,4,shop,21,22,1
3496,5,home,22,24,2
3497,1,home,0,7,7
3497,2,work,7,15,8
3497,3,home,15,24,9
3498,1,home,0,8,8
3498,2,work,8,13,5
3498,3,home,13,17,4
3498,4,work,17,20,3
3498,5,home,20,24,4
3499,1,home,0,7,7
3499,2,shop,7,8,1
3499,3,home,8,13,5
3499,4,education,13,16,3
3499,5,home,16,24,8
3500,1,home,0,7,7
3500,2,work,7,14,7
3500,3,shop,14,15,1
3500,4,home,15,21,6
3500,5,work,21,22,1
3500,6,home,22,24,2
3501,1,home,0,8,8
3501,2,work,8,14,6
3501,3,home,14,19,5
3501,4,shop,19,20,1
3501,5,home,20,24,4
3502,1,home,0,7,7
3502,2,work,7,14,7
3502,3,shop,14,15,1
3502,4,home,15,24,9
3503,1,home,0,6,6
3503,2,work,6,8,2
3503,3,home,8,9,1
3503,4,work,9,11,2
3503,5,home,11,16,5
3503,6,work,16,18,2
3503,7,home,18,22,4
3503,8,work,22,23,1
3503,9,home,23,24,1
3504,1,home,0,7,7
3504,2,education,7,11,4
3504,3,home,11,17,6
3504,4,shop,17,18,1
3504,5,home,18,24,6
3505,1,home,0,7,7
3505,2,work,7,14,7
3505,3,home,14,24,10
3506,1,home,0,9,9
3506,2,shop,9,10,1
3506,3,home,10,22,12
3506,4,work,22,23,1
3506,5,home,23,24,1
3507,1,home,0,8,8
3507,2,work,8,15,7
3507,3,home,15,20,5
3507,4,shop,20,21,1
3507,5,home,21,24,3
3508,1,home,0,7,7
3508,2,work,7,14,7
3508,3,home,14,24,10
3509,1,home,0,6,6
3509,2,shop,6,7,1
3509,3,work,7,14,7
3509,4,home,14,24,10
3510,1,home,0,7,7
3510,2,work,7,14,7
3510,3,home,14,18,4
3510,4,work,18,20,2
3510,5,home,20,24,4
3511,1,home,0,6,6
3511,2,shop,6,8,2
3511,3,work,8,15,7
3511,4,home,15,24,9
3512,1,home,0,7,7
3512,2,work,7,13,6
3512,3,shop,13,14,1
3512,4,home,14,24,10
3513,1,home,0,6,6
3513,2,shop,6,7,1
3513,3,work,7,14,7
3513,4,home,14,24,10
3514,1,home,0,6,6
3514,2,shop,6,7,1
3514,3,work,7,13,6
3514,4,shop,13,14,1
3514,5,home,14,18,4
3514,6,work,18,20,2
3514,7,home,20,24,4
3515,1,home,0,7,7
3515,2,work,7,13,6
3515,3,shop,13,14,1
3515,4,work,14,20,6
3515,5,home,20,24,4
3516,1,home,0,7,7
3516,2,work,7,13,6
3516,3,home,13,24,11
3517,1,home,0,7,7
3517,2,education,7,11,4
3517,3,home,11,18,7
3517,4,shop,18,19,1
3517,5,home,19,24,5
3518,1,home,0,7,7
3518,2,work,7,13,6
3518,3,shop,13,14,1
3518,4,work,14,19,5
3518,5,home,19,24,5
3519,1,home,0,8,8
3519,2,work,8,15,7
3519,3,home,15,24,9
3520,1,home,0,7,7
3520,2,work,7,13,6
3520,3,shop,13,14,1
3520,4,work,14,19,5
3520,5,home,19,24,5
3521,1,home,0,7,7
3521,2,work,7,14,7
3521,3,home,14,18,4
3521,4,work,18,19,1
3521,5,home,19,24,5
3522,1,home,0,8,8
3522,2,work,8,14,6
3522,3,shop,14,15,1
3522,4,home,15,24,9
3523,1,home,0,7,7
3523,2,work,7,14,7
3523,3,home,14,24,10
3524,1,home,0,6,6
3524,2,shop,6,7,1
3524,3,home,7,13,6
3524,4,education,13,16,3
3524,5,shop,16,18,2
3524,6,home,18,24,6
3525,1,home,0,7,7
3525,2,education,7,11,4
3525,3,home,11,21,10
3525,4,shop,21,22,1
3525,5,home,22,24,2
3526,1,home,0,7,7
3526,2,work,7,9,2
3526,3,home,9,13,4
3526,4,work,13,15,2
3526,5,home,15,21,6
3526,6,work,21,22,1
3526,7,home,22,24,2
3527,1,home,0,7,7
3527,2,work,7,13,6
3527,3,shop,13,14,1
3527,4,home,14,23,9
3527,5,work,23,24,1
3528,1,home,0,6,6
3528,2,work,6,13,7
3528,3,home,13,17,4
3528,4,work,17,20,3
3528,5,home,20,24,4
3529,1,home,0,6,6
3529,2,work,6,8,2
3529,3,home,8,11,3
3529,4,work,11,13,2
3529,5,home,13,17,4
3529,6,work,17,18,1
3529,7,home,18,24,6
3530,1,home,0,6,6
3530,2,work,6,13,7
3530,3,home,13,24,11
3531,1,home,0,6,6
3531,2,work,6,8,2
3531,3,home,8,9,1
3531,4,work,9,11,2
3531,5,home,11,17,6
3531,6,work,17,19,2
3531,7,home,19,24,5
3532,1,home,0,7,7
3532,2,work,7,9,2
3532,3,home,9,12,3
3532,4,work,12,13,1
3532,5,shop,13,14,1
3532,6,work,14,16,2
3532,7,home,16,23,7
3532,8,work,23,24,1
3533,1,home,0,7,7
3533,2,work,7,14,7
3533,3,shop,14,16,2
3533,4,home,16,23,7
3533,5,work,23,24,1
3534,1,home,0,7,7
3534,2,work,7,13,6
3534,3,shop,13,14,1
3534,4,home,14,24,10
3535,1,home,0,8,8
3535,2,education,8,11,3
3535,3,home,11,18,7
3535,4,shop,18,19,1
3535,5,home,19,24,5
3536,1,home,0,7,7
3536,2,work,7,14,7
3536,3,home,14,24,10
3537,1,home,0,8,8
3537,2,work,8,16,8
3537,3,home,16,24,8
3538,1,home,0,6,6
3538,2,shop,6,7,1
3538,3,home,7,10,3
3538,4,education,10,13,3
3538,5,shop,13,14,1
3538,6,education,14,16,2
3538,7,home,16,24,8
3539,1,home,0,10,10
3539,2,work,10,17,7
3539,3,home,17,21,4
3539,4,work,21,22,1
3539,5,home,22,24,2
3540,1,home,0,7,7
3540,2,work,7,13,6
3540,3,home,13,24,11
3541,1,home,0,7,7
3541,2,work,7,14,7
3541,3,home,14,18,4
3541,4,shop,18,19,1
3541,5,home,19,24,5
3542,1,home,0,9,9
3542,2,shop,9,10,1
3542,3,work,10,17,7
3542,4,home,17,24,7
3543,1,home,0,7,7
3543,2,work,7,14,7
3543,3,home,14,18,4
3543,4,shop,18,19,1
3543,5,home,19,24,5
3544,1,home,0,6,6
3544,2,work,6,8,2
3544,3,home,8,13,5
3544,4,work,13,15,2
3544,5,home,15,22,7
3544,6,work,22,23,1
3544,7,home,23,24,1
3545,1,home,0,8,8
3545,2,work,8,14,6
3545,3,home,14,18,4
3545,4,shop,18,19,1
3545,5,home,19,24,5
3546,1,home,0,6,6
3546,2,work,6,13,7
3546,3,home,13,24,11
3547,1,home,0,6,6
3547,2,work,6,13,7
3547,3,shop,13,14,1
3547,4,work,14,20,6
3547,5,home,20,24,4
3548,1,home,0,7,7
3548,2,work,7,13,6
3548,3,home,13,17,4
3548,4,work,17,20,3
3548,5,home,20,24,4
3549,1,home,0,6,6
3549,2,shop,6,7,1
3549,3,home,7,10,3
3549,4,education,10,13,3
3549,5,shop,13,15,2
3549,6,home,15,24,9
3550,1,home,0,6,6
3550,2,work,6,13,7
3550,3,shop,13,14,1
3550,4,work,14,19,5
3550,5,home,19,24,5
3551,1,home,0,7,7
3551,2,shop,7,9,2
3551,3,education,9,12,3
3551,4,shop,12,13,1
3551,5,education,13,16,3
3551,6,home,16,24,8
3552,1,home,0,6,6
3552,2,work,6,13,7
3552,3,home,13,17,4
3552,4,work,17,20,3
3552,5,home,20,24,4
3553,1,home,0,6,6
3553,2,shop,6,7,1
3553,3,work,7,13,6
3553,4,home,13,24,11
3554,1,home,0,6,6
3554,2,shop,6,7,1
3554,3,home,7,9,2
3554,4,education,9,12,3
3554,5,home,12,17,5
3554,6,shop,17,18,1
3554,7,home,18,24,6
3555,1,home,0,6,6
3555,2,work,6,13,7
3555,3,home,13,17,4
3555,4,work,17,20,3
3555,5,home,20,24,4
3556,1,home,0,6,6
3556,2,work,6,13,7
3556,3,home,13,17,4
3556,4,work,17,20,3
3556,5,home,20,24,4
3557,1,home,0,6,6
3557,2,work,6,13,7
3557,3,shop,13,14,1
3557,4,work,14,20,6
3557,5,home,20,24,4
3558,1,home,0,8,8
3558,2,work,8,15,7
3558,3,home,15,23,8
3558,4,work,23,24,1
3559,1,home,0,7,7
3559,2,work,7,13,6
3559,3,home,13,24,11
3560,1,home,0,6,6
3560,2,work,6,8,2
3560,3,home,8,9,1
3560,4,work,9,11,2
3560,5,home,11,15,4
3560,6,shop,15,16,1
3560,7,home,16,22,6
3560,8,work,22,23,1
3560,9,home,23,24,1
3561,1,home,0,6,6
3561,2,shop,6,7,1
3561,3,home,7,9,2
3561,4,education,9,12,3
3561,5,shop,12,14,2
3561,6,education,14,15,1
3561,7,shop,15,16,1
3561,8,home,16,24,8
3562,1,home,0,9,9
3562,2,education,9,12,3
3562,3,home,12,17,5
3562,4,work,17,20,3
3562,5,home,20,24,4
3563,1,home,0,6,6
3563,2,work,6,14,8
3563,3,home,14,24,10
3564,1,home,0,6,6
3564,2,shop,6,7,1
3564,3,home,7,12,5
3564,4,work,12,19,7
3564,5,home,19,24,5
3565,1,home,0,7,7
3565,2,work,7,9,2
3565,3,home,9,15,6
3565,4,work,15,18,3
3565,5,home,18,24,6
3566,1,home,0,8,8
3566,2,work,8,12,4
3566,3,shop,12,13,1
3566,4,work,13,19,6
3566,5,home,19,24,5
3567,1,home,0,7,7
3567,2,work,7,13,6
3567,3,shop,13,14,1
3567,4,home,14,24,10
3568,1,home,0,8,8
3568,2,education,8,12,4
3568,3,home,12,16,4
3568,4,shop,16,18,2
3568,5,home,18,24,6
3569,1,home,0,6,6
3569,2,shop,6,7,1
3569,3,home,7,13,6
3569,4,education,13,16,3
3569,5,home,16,24,8
3570,1,home,0,7,7
3570,2,work,7,13,6
3570,3,home,13,24,11
3571,1,home,0,8,8
3571,2,work,8,15,7
3571,3,shop,15,16,1
3571,4,work,16,19,3
3571,5,home,19,24,5
3572,1,home,0,8,8
3572,2,work,8,14,6
3572,3,shop,14,15,1
3572,4,home,15,24,9
3573,1,home,0,6,6
3573,2,work,6,13,7
3573,3,home,13,24,11
3574,1,home,0,6,6
3574,2,shop,6,7,1
3574,3,work,7,13,6
3574,4,shop,13,14,1
3574,5,work,14,19,5
3574,6,home,19,24,5
3575,1,home,0,8,8
3575,2,work,8,14,6
3575,3,home,14,24,10
3576,1,home,0,8,8
3576,2,work,8,15,7
3576,3,home,15,24,9
3577,1,home,0,7,7
3577,2,work,7,13,6
3577,3,home,13,17,4
3577,4,shop,17,18,1
3577,5,home,18,24,6
3578,1,home,0,6,6
3578,2,work,6,13,7
3578,3,shop,13,14,1
3578,4,home,14,24,10
3579,1,home,0,7,7
3579,2,work,7,14,7
3579,3,home,14,24,10
3580,1,home,0,7,7
3580,2,work,7,14,7
3580,3,home,14,22,8
3580,4,work,22,23,1
3580,5,home,23,24,1
3581,1,home,0,7,7
3581,2,work,7,13,6
3581,3,home,13,21,8
3581,4,shop,21,22,1
3581,5,home,22,24,2
3582,1,home,0,6,6
3582,2,work,6,8,2
3582,3,home,8,9,1
3582,4,work,9,11,2
3582,5,home,11,15,4
3582,6,work,15,17,2
3582,7,home,17,24,7
3583,1,home,0,7,7
3583,2,work,7,14,7
3583,3,home,14,24,10
3584,1,home,0,7,7
3584,2,work,7,13,6
3584,3,home,13,24,11
3585,1,home,0,7,7
3585,2,work,7,14,7
3585,3,home,14,24,10
3586,1,home,0,7,7
3586,2,education,7,11,4
3586,3,home,11,19,8
3586,4,shop,19,20,1
3586,5,home,20,24,4
3587,1,home,0,7,7
3587,2,education,7,11,4
3587,3,home,11,18,7
3587,4,shop,18,19,1
3587,5,home,19,24,5
3588,1,home,0,7,7
3588,2,shop,7,8,1
3588,3,education,8,11,3
3588,4,home,11,19,8
3588,5,shop,19,21,2
3588,6,home,21,24,3
3589,1,home,0,7,7
3589,2,work,7,13,6
3589,3,home,13,17,4
3589,4,work,17,20,3
3589,5,home,20,24,4
3590,1,home,0,7,7
3590,2,work,7,9,2
3590,3,shop,9,10,1
3590,4,home,10,23,13
3590,5,work,23,24,1
3591,1,home,0,6,6
3591,2,work,6,13,7
3591,3,home,13,20,7
3591,4,shop,20,21,1
3591,5,home,21,24,3
3592,1,home,0,8,8
3592,2,education,8,11,3
3592,3,home,11,17,6
3592,4,work,17,20,3
3592,5,home,20,24,4
3593,1,home,0,8,8
3593,2,education,8,11,3
3593,3,home,11,21,10
3593,4,shop,21,22,1
3593,5,home,22,24,2
3594,1,home,0,7,7
3594,2,work,7,13,6
3594,3,home,13,22,9
3594,4,work,22,23,1
3594,5,home,23,24,1
3595,1,home,0,7,7
3595,2,shop,7,8,1
3595,3,education,8,11,3
3595,4,home,11,17,6
3595,5,shop,17,18,1
3595,6,home,18,24,6
3596,1,home,0,7,7
3596,2,work,7,13,6
3596,3,shop,13,14,1
3596,4,work,14,19,5
3596,5,home,19,24,5
3597,1,home,0,8,8
3597,2,work,8,16,8
3597,3,home,16,24,8
3598,1,home,0,7,7
3598,2,work,7,14,7
3598,3,shop,14,15,1
3598,4,home,15,23,8
3598,5,work,23,24,1
3599,1,home,0,8,8
3599,2,work,8,15,7
3599,3,shop,15,17,2
3599,4,work,17,20,3
3599,5,home,20,24,4
3600,1,home,0,6,6
3600,2,shop,6,7,1
3600,3,work,7,9,2
3600,4,home,9,15,6
3600,5,work,15,17,2
3600,6,home,17,23,6
3600,7,work,23,24,1
3601,1,home,0,7,7
3601,2,work,7,9,2
3601,3,home,9,13,4
3601,4,work,13,15,2
3601,5,home,15,22,7
3601,6,work,22,23,1
3601,7,home,23,24,1
3602,1,home,0,6,6
3602,2,shop,6,7,1
3602,3,home,7,9,2
3602,4,education,9,12,3
3602,5,home,12,20,8
3602,6,shop,20,21,1
3602,7,home,21,24,3
3603,1,home,0,7,7
3603,2,work,7,13,6
3603,3,shop,13,14,1
3603,4,home,14,16,2
3603,5,work,16,20,4
3603,6,home,20,24,4
3604,1,home,0,6,6
3604,2,shop,6,7,1
3604,3,home,7,13,6
3604,4,education,13,16,3
3604,5,home,16,24,8
3605,1,home,0,7,7
3605,2,education,7,12,5
3605,3,home,12,19,7
3605,4,shop,19,20,1
3605,5,home,20,24,4
3606,1,home,0,6,6
3606,2,work,6,8,2
3606,3,home,8,12,4
3606,4,work,12,13,1
3606,5,home,13,22,9
3606,6,work,22,23,1
3606,7,home,23,24,1
3607,1,home,0,6,6
3607,2,shop,6,7,1
3607,3,home,7,10,3
3607,4,education,10,12,2
3607,5,home,12,19,7
3607,6,shop,19,21,2
3607,7,home,21,24,3
3608,1,home,0,8,8
3608,2,work,8,16,8
3608,3,home,16,24,8
3609,1,home,0,8,8
3609,2,work,8,15,7
3609,3,home,15,23,8
3609,4,work,23,24,1
3610,1,home,0,6,6
3610,2,shop,6,7,1
3610,3,home,7,13,6
3610,4,education,13,16,3
3610,5,home,16,20,4
3610,6,shop,20,21,1
3610,7,home,21,24,3
3611,1,home,0,6,6
3611,2,work,6,13,7
3611,3,home,13,16,3
3611,4,work,16,20,4
3611,5,home,20,24,4
3612,1,home,0,6,6
3612,2,work,6,8,2
3612,3,home,8,12,4
3612,4,work,12,14,2
3612,5,home,14,17,3
3612,6,work,17,19,2
3612,7,home,19,23,4
3612,8,work,23,24,1
3613,1,home,0,6,6
3613,2,work,6,13,7
3613,3,home,13,17,4
3613,4,work,17,20,3
3613,5,home,20,24,4
3614,1,home,0,8,8
3614,2,work,8,14,6
3614,3,home,14,24,10
3615,1,home,0,7,7
3615,2,work,7,13,6
3615,3,home,13,24,11
3616,1,home,0,8,8
3616,2,work,8,14,6
3616,3,home,14,18,4
3616,4,work,18,19,1
3616,5,home,19,24,5
3617,1,home,0,8,8
3617,2,work,8,16,8
3617,3,home,16,23,7
3617,4,work,23,24,1
3618,1,home,0,7,7
3618,2,work,7,14,7
3618,3,home,14,24,10
3619,1,home,0,6,6
3619,2,shop,6,7,1
3619,3,home,7,9,2
3619,4,education,9,12,3
3619,5,home,12,19,7
3619,6,shop,19,21,2
3619,7,home,21,24,3
3620,1,home,0,8,8
3620,2,work,8,15,7
3620,3,home,15,21,6
3620,4,shop,21,22,1
3620,5,home,22,24,2
3621,1,home,0,6,6
3621,2,shop,6,8,2
3621,3,home,8,15,7
3621,4,work,15,20,5
3621,5,home,20,24,4
3622,1,home,0,6,6
3622,2,work,6,13,7
3622,3,home,13,17,4
3622,4,work,17,19,2
3622,5,home,19,24,5
3623,1,home,0,7,7
3623,2,work,7,13,6
3623,3,home,13,24,11
3624,1,home,0,7,7
3624,2,work,7,14,7
3624,3,shop,14,15,1
3624,4,home,15,24,9
3625,1,home,0,6,6
3625,2,work,6,12,6
3625,3,shop,12,13,1
3625,4,work,13,19,6
3625,5,home,19,24,5
3626,1,home,0,7,7
3626,2,work,7,13,6
3626,3,shop,13,14,1
3626,4,work,14,19,5
3626,5,home,19,24,5
3627,1,home,0,7,7
3627,2,shop,7,8,1
3627,3,education,8,11,3
3627,4,home,11,18,7
3627,5,shop,18,19,1
3627,6,home,19,24,5
3628,1,home,0,7,7
3628,2,work,7,14,7
3628,3,shop,14,15,1
3628,4,home,15,24,9
3629,1,home,0,8,8
3629,2,work,8,10,2
3629,3,home,10,16,6
3629,4,work,16,18,2
3629,5,home,18,24,6
3630,1,home,0,6,6
3630,2,work,6,8,2
3630,3,home,8,14,6
3630,4,work,14,16,2
3630,5,home,16,21,5
3630,6,work,21,22,1
3630,7,home,22,24,2
3631,1,home,0,8,8
3631,2,work,8,14,6
3631,3,home,14,24,10
3632,1,home,0,7,7
3632,2,work,7,13,6
3632,3,shop,13,14,1
3632,4,work,14,20,6
3632,5,home,20,24,4
3633,1,home,0,7,7
3633,2,work,7,14,7
3633,3,home,14,24,10
3634,1,home,0,9,9
3634,2,work,9,16,7
3634,3,shop,16,17,1
3634,4,home,17,24,7
3635,1,home,0,6,6
3635,2,work,6,8,2
3635,3,home,8,15,7
3635,4,work,15,18,3
3635,5,home,18,24,6
3636,1,home,0,7,7
3636,2,work,7,13,6
3636,3,shop,13,14,1
3636,4,home,14,18,4
3636,5,work,18,20,2
3636,6,home,20,24,4
3637,1,home,0,7,7
3637,2,work,7,13,6
3637,3,shop,13,14,1
3637,4,home,14,24,10
3638,1,home,0,6,6
3638,2,work,6,13,7
3638,3,home,13,24,11
3639,1,home,0,6,6
3639,2,work,6,13,7
3639,3,home,13,17,4
3639,4,work,17,20,3
3639,5,home,20,24,4
3640,1,home,0,6,6
3640,2,work,6,13,7
3640,3,home,13,17,4
3640,4,work,17,19,2
3640,5,home,19,24,5
3641,1,home,0,7,7
3641,2,work,7,14,7
3641,3,home,14,22,8
3641,4,work,22,23,1
3641,5,home,23,24,1
3642,1,home,0,6,6
3642,2,work,6,13,7
3642,3,shop,13,14,1
3642,4,work,14,19,5
3642,5,home,19,24,5
3643,1,home,0,7,7
3643,2,education,7,8,1
3643,3,home,8,14,6
3643,4,education,14,16,2
3643,5,shop,16,17,1
3643,6,home,17,21,4
3643,7,shop,21,22,1
3643,8,home,22,24,2
3644,1,home,0,7,7
3644,2,education,7,11,4
3644,3,home,11,14,3
3644,4,education,14,16,2
3644,5,home,16,24,8
3645,1,home,0,8,8
3645,2,work,8,14,6
3645,3,home,14,21,7
3645,4,shop,21,22,1
3645,5,home,22,24,2
3646,1,home,0,9,9
3646,2,education,9,12,3
3646,3,home,12,24,12
3647,1,home,0,8,8
3647,2,work,8,15,7
3647,3,home,15,24,9
3648,1,home,0,7,7
3648,2,work,7,13,6
3648,3,home,13,24,11
3649,1,home,0,7,7
3649,2,work,7,9,2
3649,3,home,9,13,4
3649,4,work,13,15,2
3649,5,home,15,21,6
3649,6,work,21,22,1
3649,7,home,22,24,2
3650,1,home,0,8,8
3650,2,shop,8,9,1
3650,3,home,9,14,5
3650,4,work,14,20,6
3650,5,home,20,24,4
3651,1,home,0,6,6
3651,2,work,6,12,6
3651,3,shop,12,13,1
3651,4,work,13,19,6
3651,5,home,19,24,5
3652,1,home,0,7,7
3652,2,shop,7,9,2
3652,3,education,9,11,2
3652,4,home,11,18,7
3652,5,shop,18,19,1
3652,6,home,19,24,5
3653,1,home,0,7,7
3653,2,shop,7,8,1
3653,3,education,8,12,4
3653,4,home,12,19,7
3653,5,shop,19,20,1
3653,6,home,20,24,4
3654,1,home,0,6,6
3654,2,shop,6,7,1
3654,3,home,7,8,1
3654,4,education,8,11,3
3654,5,home,11,17,6
3654,6,shop,17,18,1
3654,7,home,18,24,6
3655,1,home,0,7,7
3655,2,work,7,9,2
3655,3,home,9,13,4
3655,4,work,13,15,2
3655,5,home,15,23,8
3655,6,work,23,24,1
3656,1,home,0,6,6
3656,2,work,6,13,7
3656,3,home,13,22,9
3656,4,work,22,23,1
3656,5,home,23,24,1
3657,1,home,0,8,8
3657,2,education,8,14,6
3657,3,shop,14,15,1
3657,4,home,15,24,9
3658,1,home,0,6,6
3658,2,work,6,13,7
3658,3,home,13,15,2
3658,4,work,15,19,4
3658,5,home,19,24,5
3659,1,home,0,6,6
3659,2,shop,6,7,1
3659,3,home,7,9,2
3659,4,education,9,12,3
3659,5,home,12,20,8
3659,6,shop,20,21,1
3659,7,home,21,24,3
3660,1,home,0,7,7
3660,2,work,7,13,6
3660,3,home,13,21,8
3660,4,work,21,22,1
3660,5,home,22,24,2
3661,1,home,0,6,6
3661,2,work,6,14,8
3661,3,home,14,24,10
3662,1,home,0,6,6
3662,2,work,6,8,2
3662,3,home,8,13,5
3662,4,work,13,15,2
3662,5,home,15,21,6
3662,6,work,21,22,1
3662,7,home,22,24,2
3663,1,home,0,8,8
3663,2,work,8,13,5
3663,3,shop,13,14,1
3663,4,work,14,20,6
3663,5,home,20,24,4
3664,1,home,0,7,7
3664,2,work,7,14,7
3664,3,home,14,21,7
3664,4,shop,21,22,1
3664,5,home,22,24,2
3665,1,home,0,7,7
3665,2,shop,7,8,1
3665,3,education,8,11,3
3665,4,home,11,16,5
3665,5,shop,16,17,1
3665,6,home,17,24,7
3666,1,home,0,6,6
3666,2,work,6,8,2
3666,3,home,8,14,6
3666,4,work,14,16,2
3666,5,home,16,23,7
3666,6,work,23,24,1
3667,1,home,0,7,7
3667,2,work,7,14,7
3667,3,home,14,21,7
3667,4,work,21,22,1
3667,5,home,22,24,2
3668,1,home,0,7,7
3668,2,work,7,13,6
3668,3,home,13,24,11
3669,1,home,0,6,6
3669,2,work,6,13,7
3669,3,home,13,24,11
3670,1,home,0,6,6
3670,2,work,6,12,6
3670,3,shop,12,13,1
3670,4,education,13,16,3
3670,5,home,16,24,8
3671,1,home,0,8,8
3671,2,education,8,11,3
3671,3,home,11,19,8
3671,4,shop,19,20,1
3671,5,home,20,24,4
3672,1,home,0,7,7
3672,2,work,7,14,7
3672,3,home,14,24,10
3673,1,home,0,8,8
3673,2,work,8,15,7
3673,3,home,15,24,9
3674,1,home,0,7,7
3674,2,work,7,14,7
3674,3,home,14,22,8
3674,4,work,22,23,1
3674,5,home,23,24,1
3675,1,home,0,6,6
3675,2,work,6,13,7
3675,3,home,13,24,11
3676,1,home,0,8,8
3676,2,work,8,14,6
3676,3,home,14,24,10
3677,1,home,0,7,7
3677,2,education,7,11,4
3677,3,home,11,18,7
3677,4,shop,18,19,1
3677,5,home,19,24,5
3678,1,home,0,7,7
3678,2,work,7,13,6
3678,3,shop,13,14,1
3678,4,work,14,19,5
3678,5,home,19,24,5
3679,1,home,0,8,8
3679,2,work,8,15,7
3679,3,shop,15,16,1
3679,4,home,16,22,6
3679,5,work,22,23,1
3679,6,home,23,24,1
3680,1,home,0,7,7
3680,2,work,7,13,6
3680,3,home,13,16,3
3680,4,shop,16,18,2
3680,5,home,18,24,6
3681,1,home,0,7,7
3681,2,work,7,14,7
3681,3,shop,14,15,1
3681,4,home,15,24,9
3682,1,home,0,6,6
3682,2,work,6,13,7
3682,3,home,13,15,2
3682,4,work,15,20,5
3682,5,home,20,24,4
3683,1,home,0,8,8
3683,2,education,8,11,3
3683,3,home,11,16,5
3683,4,work,16,20,4
3683,5,home,20,24,4
3684,1,home,0,6,6
3684,2,work,6,13,7
3684,3,home,13,24,11
3685,1,home,0,6,6
3685,2,work,6,13,7
3685,3,home,13,20,7
3685,4,shop,20,21,1
3685,5,home,21,24,3
3686,1,home,0,7,7
3686,2,shop,7,8,1
3686,3,education,8,12,4
3686,4,shop,12,14,2
3686,5,education,14,16,2
3686,6,home,16,24,8
3687,1,home,0,8,8
3687,2,education,8,11,3
3687,3,home,11,18,7
3687,4,shop,18,19,1
3687,5,home,19,24,5
3688,1,home,0,6,6
3688,2,work,6,13,7
3688,3,shop,13,14,1
3688,4,work,14,19,5
3688,5,home,19,24,5
3689,1,home,0,6,6
3689,2,work,6,12,6
3689,3,shop,12,13,1
3689,4,work,13,18,5
3689,5,home,18,24,6
3690,1,home,0,7,7
3690,2,work,7,14,7
3690,3,shop,14,15,1
3690,4,home,15,24,9
3691,1,home,0,6,6
3691,2,work,6,8,2
3691,3,home,8,15,7
3691,4,work,15,17,2
3691,5,home,17,24,7
3692,1,home,0,8,8
3692,2,work,8,15,7
3692,3,shop,15,16,1
3692,4,home,16,22,6
3692,5,work,22,23,1
3692,6,home,23,24,1
3693,1,home,0,7,7
3693,2,education,7,11,4
3693,3,home,11,15,4
3693,4,shop,15,16,1
3693,5,home,16,24,8
3694,1,home,0,8,8
3694,2,work,8,16,8
3694,3,home,16,24,8
3695,1,home,0,7,7
3695,2,work,7,13,6
3695,3,home,13,22,9
3695,4,work,22,23,1
3695,5,home,23,24,1
3696,1,home,0,6,6
3696,2,work,6,13,7
3696,3,home,13,24,11
3697,1,home,0,8,8
3697,2,work,8,15,7
3697,3,home,15,24,9
3698,1,home,0,6,6
3698,2,work,6,13,7
3698,3,home,13,21,8
3698,4,shop,21,22,1
3698,5,home,22,24,2
3699,1,home,0,7,7
3699,2,work,7,13,6
3699,3,home,13,17,4
3699,4,work,17,20,3
3699,5,home,20,24,4
3700,1,home,0,8,8
3700,2,education,8,13,5
3700,3,home,13,19,6
3700,4,shop,19,20,1
3700,5,home,20,24,4
3701,1,home,0,7,7
3701,2,work,7,13,6
3701,3,home,13,17,4
3701,4,work,17,20,3
3701,5,home,20,24,4
3702,1,home,0,6,6
3702,2,shop,6,7,1
3702,3,work,7,13,6
3702,4,home,13,16,3
3702,5,work,16,20,4
3702,6,home,20,24,4
3703,1,home,0,7,7
3703,2,education,7,12,5
3703,3,shop,12,14,2
3703,4,education,14,16,2
3703,5,home,16,20,4
3703,6,shop,20,21,1
3703,7,home,21,24,3
3704,1,home,0,8,8
3704,2,work,8,14,6
3704,3,shop,14,15,1
3704,4,work,15,20,5
3704,5,home,20,24,4
3705,1,home,0,7,7
3705,2,work,7,13,6
3705,3,home,13,24,11
3706,1,home,0,7,7
3706,2,work,7,13,6
3706,3,home,13,24,11
3707,1,home,0,8,8
3707,2,work,8,15,7
3707,3,shop,15,16,1
3707,4,home,16,24,8
3708,1,home,0,6,6
3708,2,work,6,8,2
3708,3,home,8,9,1
3708,4,work,9,11,2
3708,5,home,11,16,5
3708,6,work,16,18,2
3708,7,home,18,24,6
3709,1,home,0,6,6
3709,2,shop,6,7,1
3709,3,home,7,13,6
3709,4,education,13,16,3
3709,5,home,16,24,8
3710,1,home,0,9,9
3710,2,work,9,16,7
3710,3,shop,16,17,1
3710,4,home,17,24,7
3711,1,home,0,8,8
3711,2,education,8,11,3
3711,3,home,11,17,6
3711,4,shop,17,18,1
3711,5,home,18,24,6
3712,1,home,0,6,6
3712,2,shop,6,7,1
3712,3,home,7,9,2
3712,4,work,9,17,8
3712,5,home,17,24,7
3713,1,home,0,7,7
3713,2,work,7,13,6
3713,3,shop,13,14,1
3713,4,home,14,24,10
3714,1,home,0,8,8
3714,2,education,8,11,3
3714,3,home,11,16,5
3714,4,work,16,20,4
3714,5,home,20,24,4
3715,1,home,0,6,6
3715,2,work,6,13,7
3715,3,home,13,24,11
3716,1,home,0,6,6
3716,2,work,6,11,5
3716,3,shop,11,12,1
3716,4,work,12,19,7
3716,5,home,19,24,5
3717,1,home,0,8,8
3717,2,work,8,15,7
3717,3,shop,15,16,1
3717,4,home,16,24,8
3718,1,home,0,8,8
3718,2,work,8,15,7
3718,3,home,15,22,7
3718,4,work,22,23,1
3718,5,home,23,24,1
3719,1,home,0,6,6
3719,2,shop,6,7,1
3719,3,home,7,13,6
3719,4,education,13,16,3
3719,5,home,16,24,8
3720,1,home,0,7,7
3720,2,education,7,11,4
3720,3,home,11,18,7
3720,4,shop,18,19,1
3720,5,home,19,24,5
3721,1,home,0,8,8
3721,2,work,8,14,6
3721,3,shop,14,15,1
3721,4,work,15,20,5
3721,5,home,20,24,4
3722,1,home,0,7,7
3722,2,education,7,11,4
3722,3,home,11,14,3
3722,4,education,14,16,2
3722,5,home,16,24,8
3723,1,home,0,9,9
3723,2,work,9,16,7
3723,3,shop,16,17,1
3723,4,work,17,20,3
3723,5,home,20,24,4
3724,1,home,0,7,7
3724,2,work,7,14,7
3724,3,home,14,19,5
3724,4,shop,19,20,1
3724,5,home,20,24,4
3725,1,home,0,8,8
3725,2,work,8,15,7
3725,3,home,15,24,9
3726,1,home,0,6,6
3726,2,work,6,13,7
3726,3,home,13,18,5
3726,4,work,18,20,2
3726,5,home,20,24,4
3727,1,home,0,8,8
3727,2,work,8,14,6
3727,3,home,14,18,4
3727,4,shop,18,19,1
3727,5,home,19,24,5
3728,1,home,0,6,6
3728,2,shop,6,7,1
3728,3,home,7,14,7
3728,4,work,14,20,6
3728,5,home,20,24,4
3729,1,home,0,7,7
3729,2,shop,7,8,1
3729,3,education,8,12,4
3729,4,home,12,19,7
3729,5,shop,19,21,2
3729,6,home,21,24,3
3730,1,home,0,8,8
3730,2,work,8,15,7
3730,3,shop,15,16,1
3730,4,home,16,24,8
3731,1,home,0,8,8
3731,2,work,8,15,7
3731,3,home,15,19,4
3731,4,shop,19,20,1
3731,5,home,20,24,4
3732,1,home,0,8,8
3732,2,work,8,15,7
3732,3,home,15,24,9
3733,1,home,0,6,6
3733,2,work,6,13,7
3733,3,shop,13,14,1
3733,4,work,14,20,6
3733,5,home,20,24,4
3734,1,home,0,6,6
3734,2,work,6,13,7
3734,3,shop,13,14,1
3734,4,home,14,24,10
3735,1,home,0,7,7
3735,2,work,7,14,7
3735,3,shop,14,15,1
3735,4,home,15,20,5
3735,5,shop,20,21,1
3735,6,home,21,24,3
3736,1,home,0,6,6
3736,2,work,6,13,7
3736,3,home,13,24,11
3737,1,home,0,8,8
3737,2,work,8,14,6
3737,3,home,14,22,8
3737,4,work,22,23,1
3737,5,home,23,24,1
3738,1,home,0,7,7
3738,2,work,7,15,8
3738,3,home,15,24,9
3739,1,home,0,7,7
3739,2,work,7,13,6
3739,3,shop,13,14,1
3739,4,home,14,24,10
3740,1,home,0,7,7
3740,2,work,7,13,6
3740,3,shop,13,14,1
3740,4,home,14,24,10
3741,1,home,0,7,7
3741,2,work,7,13,6
3741,3,home,13,17,4
3741,4,work,17,20,3
3741,5,home,20,24,4
3742,1,home,0,7,7
3742,2,shop,7,9,2
3742,3,education,9,12,3
3742,4,shop,12,14,2
3742,5,home,14,20,6
3742,6,shop,20,21,1
3742,7,home,21,24,3
3743,1,home,0,7,7
3743,2,work,7,14,7
3743,3,home,14,19,5
3743,4,shop,19,20,1
3743,5,home,20,24,4
3744,1,home,0,8,8
3744,2,work,8,14,6
3744,3,home,14,24,10
3745,1,home,0,6,6
3745,2,work,6,13,7
3745,3,shop,13,14,1
3745,4,work,14,20,6
3745,5,home,20,24,4
3746,1,home,0,6,6
3746,2,work,6,13,7
3746,3,shop,13,14,1
3746,4,home,14,24,10
3747,1,home,0,6,6
3747,2,work,6,7,1
3747,3,home,7,11,4
3747,4,work,11,13,2
3747,5,home,13,21,8
3747,6,work,21,22,1
3747,7,home,22,24,2
3748,1,home,0,8,8
3748,2,work,8,15,7
3748,3,home,15,24,9
3749,1,home,0,8,8
3749,2,shop,8,9,1
3749,3,home,9,22,13
3749,4,work,22,23,1
3749,5,home,23,24,1
3750,1,home,0,6,6
3750,2,work,6,13,7
3750,3,shop,13,14,1
3750,4,work,14,19,5
3750,5,home,19,24,5
3751,1,home,0,6,6
3751,2,work,6,13,7
3751,3,home,13,24,11
3752,1,home,0,6,6
3752,2,work,6,13,7
3752,3,home,13,17,4
3752,4,work,17,20,3
3752,5,home,20,24,4
3753,1,home,0,6,6
3753,2,work,6,13,7
3753,3,home,13,24,11
3754,1,home,0,6,6
3754,2,work,6,13,7
3754,3,shop,13,15,2
3754,4,work,15,20,5
3754,5,home,20,24,4
3755,1,home,0,7,7
3755,2,education,7,11,4
3755,3,home,11,18,7
3755,4,shop,18,19,1
3755,5,home,19,24,5
3756,1,home,0,8,8
3756,2,work,8,14,6
3756,3,shop,14,15,1
3756,4,home,15,19,4
3756,5,shop,19,20,1
3756,6,home,20,24,4
3757,1,home,0,7,7
3757,2,work,7,13,6
3757,3,home,13,24,11
3758,1,home,0,7,7
3758,2,work,7,13,6
3758,3,home,13,16,3
3758,4,work,16,20,4
3758,5,home,20,24,4
3759,1,home,0,6,6
3759,2,work,6,13,7
3759,3,home,13,24,11
3760,1,home,0,8,8
3760,2,education,8,11,3
3760,3,home,11,17,6
3760,4,shop,17,18,1
3760,5,home,18,24,6
3761,1,home,0,6,6
3761,2,work,6,13,7
3761,3,shop,13,14,1
3761,4,work,14,19,5
3761,5,home,19,24,5
3762,1,home,0,7,7
3762,2,work,7,14,7
3762,3,shop,14,15,1
3762,4,home,15,22,7
3762,5,work,22,23,1
3762,6,home,23,24,1
3763,1,home,0,6,6
3763,2,shop,6,7,1
3763,3,home,7,10,3
3763,4,education,10,12,2
3763,5,shop,12,14,2
3763,6,home,14,24,10
3764,1,home,0,7,7
3764,2,work,7,14,7
3764,3,shop,14,15,1
3764,4,home,15,21,6
3764,5,work,21,22,1
3764,6,home,22,24,2
3765,1,home,0,7,7
3765,2,work,7,13,6
3765,3,home,13,24,11
3766,1,home,0,7,7
3766,2,work,7,14,7
3766,3,shop,14,15,1
3766,4,home,15,24,9
3767,1,home,0,7,7
3767,2,shop,7,8,1
3767,3,education,8,13,5
3767,4,shop,13,15,2
3767,5,home,15,21,6
3767,6,shop,21,22,1
3767,7,home,22,24,2
3768,1,home,0,8,8
3768,2,work,8,15,7
3768,3,home,15,17,2
3768,4,work,17,20,3
3768,5,home,20,24,4
3769,1,home,0,6,6
3769,2,shop,6,7,1
3769,3,home,7,10,3
3769,4,education,10,11,1
3769,5,home,11,18,7
3769,6,shop,18,20,2
3769,7,home,20,24,4
3770,1,home,0,8,8
3770,2,work,8,14,6
3770,3,shop,14,15,1
3770,4,home,15,17,2
3770,5,work,17,20,3
3770,6,home,20,24,4
3771,1,home,0,6,6
3771,2,work,6,13,7
3771,3,home,13,21,8
3771,4,shop,21,22,1
3771,5,home,22,24,2
3772,1,home,0,6,6
3772,2,shop,6,7,1
3772,3,work,7,14,7
3772,4,shop,14,15,1
3772,5,home,15,23,8
3772,6,work,23,24,1
3773,1,home,0,7,7
3773,2,shop,7,8,1
3773,3,work,8,15,7
3773,4,home,15,24,9
3774,1,home,0,8,8
3774,2,work,8,14,6
3774,3,home,14,24,10
3775,1,home,0,7,7
3775,2,education,7,11,4
3775,3,home,11,19,8
3775,4,shop,19,20,1
3775,5,home,20,24,4
3776,1,home,0,6,6
3776,2,work,6,8,2
3776,3,home,8,14,6
3776,4,work,14,16,2
3776,5,home,16,21,5
3776,6,work,21,22,1
3776,7,home,22,24,2
3777,1,home,0,7,7
3777,2,work,7,14,7
3777,3,home,14,24,10
3778,1,home,0,6,6
3778,2,work,6,7,1
3778,3,home,7,9,2
3778,4,work,9,10,1
3778,5,home,10,13,3
3778,6,work,13,15,2
3778,7,home,15,21,6
3778,8,work,21,22,1
3778,9,home,22,24,2
3779,1,home,0,6,6
3779,2,shop,6,7,1
3779,3,home,7,10,3
3779,4,education,10,12,2
3779,5,home,12,16,4
3779,6,shop,16,17,1
3779,7,home,17,24,7
3780,1,home,0,7,7
3780,2,work,7,14,7
3780,3,home,14,24,10
3781,1,home,0,8,8
3781,2,work,8,15,7
3781,3,shop,15,16,1
3781,4,home,16,22,6
3781,5,work,22,23,1
3781,6,home,23,24,1
3782,1,home,0,8,8
3782,2,work,8,15,7
3782,3,shop,15,16,1
3782,4,home,16,23,7
3782,5,work,23,24,1
3783,1,home,0,9,9
3783,2,work,9,15,6
3783,3,home,15,24,9
3784,1,home,0,6,6
3784,2,shop,6,7,1
3784,3,home,7,9,2
3784,4,education,9,12,3
3784,5,work,12,19,7
3784,6,home,19,24,5
3785,1,home,0,6,6
3785,2,work,6,13,7
3785,3,home,13,17,4
3785,4,work,17,19,2
3785,5,home,19,24,5
3786,1,home,0,9,9
3786,2,work,9,16,7
3786,3,shop,16,18,2
3786,4,home,18,24,6
3787,1,home,0,8,8
3787,2,education,8,12,4
3787,3,home,12,17,5
3787,4,work,17,20,3
3787,5,home,20,24,4
3788,1,home,0,7,7
3788,2,work,7,9,2
3788,3,home,9,13,4
3788,4,work,13,15,2
3788,5,home,15,21,6
3788,6,work,21,22,1
3788,7,home,22,24,2
3789,1,home,0,6,6
3789,2,work,6,13,7
3789,3,home,13,24,11
3790,1,home,0,7,7
3790,2,education,7,11,4
3790,3,home,11,17,6
3790,4,shop,17,18,1
3790,5,home,18,24,6
3791,1,home,0,6,6
3791,2,work,6,8,2
3791,3,home,8,9,1
3791,4,work,9,11,2
3791,5,home,11,17,6
3791,6,work,17,19,2
3791,7,home,19,24,5
3792,1,home,0,6,6
3792,2,work,6,8,2
3792,3,home,8,13,5
3792,4,work,13,15,2
3792,5,home,15,23,8
3792,6,work,23,24,1
3793,1,home,0,6,6
3793,2,work,6,8,2
3793,3,home,8,13,5
3793,4,work,13,15,2
3793,5,home,15,21,6
3793,6,work,21,22,1
3793,7,home,22,24,2
3794,1,home,0,6,6
3794,2,work,6,13,7
3794,3,shop,13,14,1
3794,4,home,14,24,10
3795,1,home,0,7,7
3795,2,shop,7,8,1
3795,3,home,8,13,5
3795,4,education,13,16,3
3795,5,shop,16,17,1
3795,6,home,17,23,6
3795,7,work,23,24,1
3796,1,home,0,6,6
3796,2,work,6,13,7
3796,3,shop,13,14,1
3796,4,work,14,19,5
3796,5,home,19,24,5
3797,1,home,0,8,8
3797,2,education,8,12,4
3797,3,home,12,14,2
3797,4,education,14,16,2
3797,5,home,16,24,8
3798,1,home,0,8,8
3798,2,work,8,13,5
3798,3,shop,13,14,1
3798,4,work,14,19,5
3798,5,home,19,24,5
3799,1,home,0,7,7
3799,2,shop,7,8,1
3799,3,education,8,11,3
3799,4,home,11,15,4
3799,5,shop,15,16,1
3799,6,home,16,24,8
3800,1,home,0,8,8
3800,2,work,8,15,7
3800,3,home,15,24,9
3801,1,home,0,8,8
3801,2,work,8,15,7
3801,3,home,15,24,9
3802,1,home,0,8,8
3802,2,work,8,15,7
3802,3,shop,15,16,1
3802,4,work,16,20,4
3802,5,home,20,24,4
3803,1,home,0,8,8
3803,2,work,8,15,7
3803,3,home,15,24,9
3804,1,home,0,8,8
3804,2,work,8,14,6
3804,3,shop,14,15,1
3804,4,work,15,19,4
3804,5,home,19,24,5
3805,1,home,0,6,6
3805,2,shop,6,7,1
3805,3,home,7,12,5
3805,4,work,12,19,7
3805,5,home,19,24,5
3806,1,home,0,7,7
3806,2,work,7,14,7
3806,3,home,14,21,7
3806,4,shop,21,22,1
3806,5,home,22,24,2
3807,1,home,0,6,6
3807,2,shop,6,7,1
3807,3,home,7,10,3
3807,4,education,10,11,1
3807,5,home,11,17,6
3807,6,shop,17,18,1
3807,7,home,18,24,6
3808,1,home,0,6,6
3808,2,work,6,12,6
3808,3,shop,12,13,1
3808,4,work,13,19,6
3808,5,home,19,24,5
3809,1,home,0,7,7
3809,2,shop,7,8,1
3809,3,education,8,12,4
3809,4,home,12,18,6
3809,5,shop,18,19,1
3809,6,home,19,24,5
3810,1,home,0,7,7
3810,2,work,7,14,7
3810,3,home,14,23,9
3810,4,work,23,24,1
3811,1,home,0,7,7
3811,2,work,7,13,6
3811,3,shop,13,14,1
3811,4,home,14,22,8
3811,5,work,22,23,1
3811,6,home,23,24,1
3812,1,home,0,6,6
3812,2,work,6,13,7
3812,3,home,13,18,5
3812,4,work,18,20,2
3812,5,home,20,24,4
3813,1,home,0,7,7
3813,2,work,7,14,7
3813,3,shop,14,15,1
3813,4,home,15,24,9
3814,1,home,0,8,8
3814,2,work,8,15,7
3814,3,home,15,23,8
3814,4,work,23,24,1
3815,1,home,0,7,7
3815,2,work,7,14,7
3815,3,shop,14,15,1
3815,4,work,15,20,5
3815,5,home,20,24,4
3816,1,home,0,6,6
3816,2,work,6,8,2
3816,3,home,8,14,6
3816,4,work,14,16,2
3816,5,home,16,21,5
3816,6,work,21,22,1
3816,7,home,22,24,2
3817,1,home,0,6,6
3817,2,shop,6,7,1
3817,3,home,7,10,3
3817,4,education,10,12,2
3817,5,shop,12,13,1
3817,6,education,13,16,3
3817,7,home,16,24,8
3818,1,home,0,7,7
3818,2,work,7,13,6
3818,3,shop,13,14,1
3818,4,work,14,19,5
3818,5,home,19,24,5
3819,1,home,0,6,6
3819,2,work,6,8,2
3819,3,home,8,12,4
3819,4,work,12,14,2
3819,5,home,14,18,4
3819,6,work,18,20,2
3819,7,home,20,24,4
3820,1,home,0,6,6
3820,2,shop,6,7,1
3820,3,home,7,12,5
3820,4,education,12,16,4
3820,5,shop,16,18,2
3820,6,home,18,24,6
3821,1,home,0,7,7
3821,2,work,7,15,8
3821,3,home,15,19,4
3821,4,shop,19,20,1
3821,5,home,20,24,4
3822,1,home,0,7,7
3822,2,work,7,13,6
3822,3,home,13,24,11
3823,1,home,0,6,6
3823,2,work,6,13,7
3823,3,shop,13,14,1
3823,4,work,14,19,5
3823,5,home,19,24,5
3824,1,home,0,6,6
3824,2,work,6,13,7
3824,3,shop,13,14,1
3824,4,work,14,20,6
3824,5,home,20,24,4
3825,1,home,0,6,6
3825,2,shop,6,7,1
3825,3,home,7,10,3
3825,4,education,10,12,2
3825,5,home,12,20,8
3825,6,shop,20,21,1
3825,7,home,21,24,3
3826,1,home,0,8,8
3826,2,work,8,15,7
3826,3,home,15,24,9
3827,1,home,0,6,6
3827,2,shop,6,7,1
3827,3,work,7,13,6
3827,4,home,13,17,4
3827,5,work,17,20,3
3827,6,home,20,24,4
3828,1,home,0,6,6
3828,2,work,6,14,8
3828,3,home,14,24,10
3829,1,home,0,6,6
3829,2,work,6,13,7
3829,3,home,13,22,9
3829,4,work,22,23,1
3829,5,home,23,24,1
3830,1,home,0,7,7
3830,2,work,7,9,2
3830,3,home,9,15,6
3830,4,work,15,17,2
3830,5,home,17,23,6
3830,6,work,23,24,1
3831,1,home,0,6,6
3831,2,work,6,13,7
3831,3,home,13,17,4
3831,4,shop,17,18,1
3831,5,home,18,24,6
3832,1,home,0,7,7
3832,2,work,7,14,7
3832,3,home,14,24,10
3833,1,home,0,7,7
3833,2,work,7,13,6
3833,3,home,13,24,11
3834,1,home,0,7,7
3834,2,education,7,10,3
3834,3,home,10,17,7
3834,4,shop,17,18,1
3834,5,home,18,24,6
3835,1,home,0,8,8
3835,2,work,8,14,6
3835,3,shop,14,15,1
3835,4,work,15,19,4
3835,5,home,19,24,5
3836,1,home,0,7,7
3836,2,work,7,13,6
3836,3,shop,13,14,1
3836,4,work,14,19,5
3836,5,home,19,24,5
3837,1,home,0,8,8
3837,2,education,8,13,5
3837,3,work,13,19,6
3837,4,home,19,24,5
3838,1,home,0,6,6
3838,2,work,6,13,7
3838,3,shop,13,14,1
3838,4,home,14,24,10
3839,1,home,0,7,7
3839,2,shop,7,8,1
3839,3,education,8,11,3
3839,4,home,11,18,7
3839,5,shop,18,19,1
3839,6,home,19,24,5
3840,1,home,0,6,6
3840,2,work,6,13,7
3840,3,shop,13,15,2
3840,4,work,15,19,4
3840,5,home,19,24,5
3841,1,home,0,6,6
3841,2,shop,6,7,1
3841,3,work,7,14,7
3841,4,home,14,22,8
3841,5,work,22,23,1
3841,6,home,23,24,1
3842,1,home,0,6,6
3842,2,work,6,7,1
3842,3,home,7,11,4
3842,4,work,11,13,2
3842,5,home,13,21,8
3842,6,work,21,22,1
3842,7,home,22,24,2
3843,1,home,0,7,7
3843,2,work,7,14,7
3843,3,home,14,18,4
3843,4,shop,18,19,1
3843,5,home,19,24,5
3844,1,home,0,7,7
3844,2,work,7,14,7
3844,3,home,14,24,10
3845,1,home,0,7,7
3845,2,work,7,8,1
3845,3,home,8,14,6
3845,4,work,14,18,4
3845,5,home,18,23,5
3845,6,work,23,24,1
3846,1,home,0,7,7
3846,2,work,7,14,7
3846,3,shop,14,15,1
3846,4,home,15,24,9
3847,1,home,0,7,7
3847,2,shop,7,8,1
3847,3,education,8,11,3
3847,4,home,11,18,7
3847,5,shop,18,20,2
3847,6,home,20,24,4
3848,1,home,0,7,7
3848,2,work,7,14,7
3848,3,shop,14,15,1
3848,4,home,15,24,9
3849,1,home,0,6,6
3849,2,shop,6,7,1
3849,3,home,7,9,2
3849,4,education,9,12,3
3849,5,home,12,24,12
3850,1,home,0,8,8
3850,2,work,8,15,7
3850,3,shop,15,16,1
3850,4,home,16,20,4
3850,5,shop,20,21,1
3850,6,home,21,24,3
3851,1,home,0,8,8
3851,2,work,8,15,7
3851,3,home,15,24,9
3852,1,home,0,6,6
3852,2,shop,6,7,1
3852,3,home,7,13,6
3852,4,education,13,16,3
3852,5,shop,16,18,2
3852,6,home,18,24,6
3853,1,home,0,7,7
3853,2,education,7,11,4
3853,3,home,11,18,7
3853,4,shop,18,19,1
3853,5,home,19,24,5
3854,1,home,0,9,9
3854,2,shop,9,10,1
3854,3,work,10,17,7
3854,4,home,17,24,7
3855,1,home,0,8,8
3855,2,work,8,13,5
3855,3,home,13,17,4
3855,4,shop,17,18,1
3855,5,home,18,24,6
3856,1,home,0,7,7
3856,2,work,7,13,6
3856,3,shop,13,14,1
3856,4,home,14,24,10
3857,1,home,0,6,6
3857,2,work,6,13,7
3857,3,shop,13,14,1
3857,4,home,14,24,10
3858,1,home,0,8,8
3858,2,shop,8,10,2
3858,3,home,10,14,4
3858,4,education,14,17,3
3858,5,shop,17,18,1
3858,6,home,18,24,6
3859,1,home,0,8,8
3859,2,work,8,15,7
3859,3,shop,15,16,1
3859,4,work,16,20,4
3859,5,home,20,24,4
3860,1,home,0,6,6
3860,2,work,6,13,7
3860,3,shop,13,14,1
3860,4,education,14,18,4
3860,5,home,18,24,6
3861,1,home,0,7,7
3861,2,shop,7,9,2
3861,3,education,9,12,3
3861,4,shop,12,13,1
3861,5,home,13,19,6
3861,6,shop,19,20,1
3861,7,home,20,24,4
3862,1,home,0,7,7
3862,2,work,7,13,6
3862,3,shop,13,14,1
3862,4,work,14,19,5
3862,5,home,19,24,5
3863,1,home,0,7,7
3863,2,work,7,13,6
3863,3,home,13,24,11
3864,1,home,0,6,6
3864,2,shop,6,7,1
3864,3,home,7,9,2
3864,4,education,9,11,2
3864,5,home,11,18,7
3864,6,shop,18,19,1
3864,7,home,19,24,5
3865,1,home,0,6,6
3865,2,work,6,13,7
3865,3,shop,13,14,1
3865,4,work,14,19,5
3865,5,home,19,24,5
3866,1,home,0,8,8
3866,2,work,8,15,7
3866,3,shop,15,16,1
3866,4,work,16,20,4
3866,5,home,20,24,4
3867,1,home,0,6,6
3867,2,work,6,13,7
3867,3,home,13,22,9
3867,4,work,22,23,1
3867,5,home,23,24,1
3868,1,home,0,6,6
3868,2,shop,6,7,1
3868,3,home,7,10,3
3868,4,education,10,12,2
3868,5,shop,12,14,2
3868,6,education,14,16,2
3868,7,home,16,24,8
3869,1,home,0,6,6
3869,2,work,6,8,2
3869,3,home,8,9,1
3869,4,work,9,11,2
3869,5,home,11,18,7
3869,6,work,18,20,2
3869,7,home,20,24,4
3870,1,home,0,7,7
3870,2,work,7,14,7
3870,3,shop,14,16,2
3870,4,work,16,19,3
3870,5,home,19,24,5
3871,1,home,0,7,7
3871,2,work,7,13,6
3871,3,shop,13,14,1
3871,4,work,14,19,5
3871,5,home,19,24,5
3872,1,home,0,7,7
3872,2,work,7,13,6
3872,3,shop,13,14,1
3872,4,home,14,24,10
3873,1,home,0,7,7
3873,2,shop,7,9,2
3873,3,education,9,12,3
3873,4,shop,12,14,2
3873,5,education,14,16,2
3873,6,home,16,24,8
3874,1,home,0,7,7
3874,2,work,7,13,6
3874,3,home,13,18,5
3874,4,shop,18,19,1
3874,5,home,19,24,5
3875,1,home,0,8,8
3875,2,work,8,13,5
3875,3,home,13,24,11
3876,1,home,0,6,6
3876,2,shop,6,7,1
3876,3,home,7,10,3
3876,4,education,10,12,2
3876,5,shop,12,14,2
3876,6,education,14,16,2
3876,7,shop,16,17,1
3876,8,home,17,24,7
3877,1,home,0,7,7
3877,2,work,7,14,7
3877,3,home,14,24,10
3878,1,home,0,7,7
3878,2,shop,7,8,1
3878,3,home,8,13,5
3878,4,education,13,16,3
3878,5,home,16,24,8
3879,1,home,0,7,7
3879,2,education,7,12,5
3879,3,home,12,20,8
3879,4,shop,20,21,1
3879,5,home,21,24,3
3880,1,home,0,6,6
3880,2,shop,6,7,1
3880,3,home,7,9,2
3880,4,education,9,11,2
3880,5,home,11,14,3
3880,6,education,14,15,1
3880,7,shop,15,16,1
3880,8,home,16,24,8
3881,1,home,0,7,7
3881,2,work,7,8,1
3881,3,home,8,13,5
3881,4,work,13,15,2
3881,5,home,15,21,6
3881,6,work,21,22,1
3881,7,home,22,24,2
3882,1,home,0,9,9
3882,2,work,9,16,7
3882,3,home,16,24,8
3883,1,home,0,7,7
3883,2,work,7,13,6
3883,3,shop,13,14,1
3883,4,work,14,20,6
3883,5,home,20,24,4
3884,1,home,0,7,7
3884,2,shop,7,9,2
3884,3,education,9,12,3
3884,4,home,12,18,6
3884,5,shop,18,19,1
3884,6,home,19,24,5
3885,1,home,0,7,7
3885,2,work,7,13,6
3885,3,home,13,18,5
3885,4,shop,18,19,1
3885,5,home,19,24,5
3886,1,home,0,7,7
3886,2,education,7,11,4
3886,3,home,11,14,3
3886,4,education,14,16,2
3886,5,shop,16,17,1
3886,6,home,17,24,7
3887,1,home,0,8,8
3887,2,work,8,14,6
3887,3,shop,14,15,1
3887,4,home,15,24,9
3888,1,home,0,6,6
3888,2,work,6,13,7
3888,3,home,13,24,11
3889,1,home,0,6,6
3889,2,work,6,7,1
3889,3,home,7,11,4
3889,4,work,11,12,1
3889,5,home,12,18,6
3889,6,work,18,20,2
3889,7,home,20,24,4
3890,1,home,0,8,8
3890,2,work,8,14,6
3890,3,home,14,24,10
3891,1,home,0,6,6
3891,2,work,6,13,7
3891,3,shop,13,14,1
3891,4,work,14,19,5
3891,5,home,19,24,5
3892,1,home,0,7,7
3892,2,work,7,13,6
3892,3,home,13,24,11
3893,1,home,0,6,6
3893,2,shop,6,7,1
3893,3,home,7,13,6
3893,4,work,13,20,7
3893,5,home,20,24,4
3894,1,home,0,7,7
3894,2,work,7,13,6
3894,3,shop,13,14,1
3894,4,home,14,24,10
3895,1,home,0,6,6
3895,2,shop,6,7,1
3895,3,home,7,13,6
3895,4,education,13,16,3
3895,5,home,16,24,8
3896,1,home,0,8,8
3896,2,work,8,14,6
3896,3,home,14,24,10
3897,1,home,0,8,8
3897,2,work,8,15,7
3897,3,shop,15,16,1
3897,4,work,16,19,3
3897,5,home,19,24,5
3898,1,home,0,6,6
3898,2,work,6,8,2
3898,3,home,8,13,5
3898,4,work,13,15,2
3898,5,home,15,21,6
3898,6,work,21,22,1
3898,7,home,22,24,2
3899,1,home,0,7,7
3899,2,education,7,11,4
3899,3,home,11,18,7
3899,4,shop,18,19,1
3899,5,home,19,24,5
3900,1,home,0,8,8
3900,2,education,8,14,6
3900,3,shop,14,15,1
3900,4,work,15,20,5
3900,5,home,20,24,4
3901,1,work,0,6,6
3901,2,shop,6,7,1
3901,3,work,7,13,6
3901,4,home,13,24,11
3902,1,home,0,8,8
3902,2,shop,8,9,1
3902,3,home,9,13,4
3902,4,work,13,19,6
3902,5,home,19,24,5
3903,1,home,0,7,7
3903,2,work,7,13,6
3903,3,shop,13,14,1
3903,4,work,14,19,5
3903,5,home,19,24,5
3904,1,home,0,9,9
3904,2,work,9,17,8
3904,3,home,17,24,7
3905,1,home,0,7,7
3905,2,work,7,8,1
3905,3,home,8,12,4
3905,4,work,12,14,2
3905,5,home,14,21,7
3905,6,work,21,22,1
3905,7,home,22,24,2
3906,1,home,0,7,7
3906,2,work,7,14,7
3906,3,home,14,18,4
3906,4,work,18,20,2
3906,5,home,20,24,4
3907,1,home,0,6,6
3907,2,shop,6,7,1
3907,3,work,7,10,3
3907,4,home,10,16,6
3907,5,work,16,18,2
3907,6,home,18,24,6
3908,1,home,0,6,6
3908,2,work,6,8,2
3908,3,home,8,14,6
3908,4,work,14,17,3
3908,5,home,17,24,7
3909,1,home,0,9,9
3909,2,work,9,15,6
3909,3,home,15,24,9
3910,1,home,0,7,7
3910,2,education,7,10,3
3910,3,home,10,17,7
3910,4,shop,17,18,1
3910,5,home,18,24,6
3911,1,home,0,8,8
3911,2,education,8,11,3
3911,3,home,11,19,8
3911,4,shop,19,20,1
3911,5,home,20,24,4
3912,1,home,0,7,7
3912,2,work,7,13,6
3912,3,shop,13,15,2
3912,4,home,15,24,9
3913,1,home,0,7,7
3913,2,shop,7,8,1
3913,3,education,8,12,4
3913,4,home,12,19,7
3913,5,shop,19,20,1
3913,6,home,20,24,4
3914,1,home,0,7,7
3914,2,work,7,14,7
3914,3,shop,14,15,1
3914,4,home,15,23,8
3914,5,work,23,24,1
3915,1,home,0,6,6
3915,2,work,6,13,7
3915,3,home,13,24,11
3916,1,home,0,7,7
3916,2,work,7,14,7
3916,3,home,14,18,4
3916,4,work,18,20,2
3916,5,home,20,24,4
3917,1,home,0,7,7
3917,2,work,7,14,7
3917,3,home,14,17,3
3917,4,work,17,20,3
3917,5,home,20,24,4
3918,1,home,0,7,7
3918,2,work,7,10,3
3918,3,home,10,13,3
3918,4,work,13,15,2
3918,5,home,15,23,8
3918,6,work,23,24,1
3919,1,home,0,8,8
3919,2,shop,8,9,1
3919,3,home,9,13,4
3919,4,work,13,19,6
3919,5,home,19,24,5
3920,1,home,0,7,7
3920,2,work,7,13,6
3920,3,home,13,24,11
3921,1,home,0,7,7
3921,2,education,7,11,4
3921,3,home,11,21,10
3921,4,shop,21,22,1
3921,5,home,22,24,2
3922,1,home,0,8,8
3922,2,work,8,13,5
3922,3,home,13,24,11
3923,1,home,0,8,8
3923,2,work,8,14,6
3923,3,shop,14,15,1
3923,4,work,15,20,5
3923,5,home,20,24,4
3924,1,home,0,8,8
3924,2,work,8,15,7
3924,3,home,15,24,9
3925,1,home,0,6,6
3925,2,work,6,13,7
3925,3,shop,13,14,1
3925,4,work,14,19,5
3925,5,home,19,24,5
3926,1,home,0,7,7
3926,2,shop,7,8,1
3926,3,work,8,15,7
3926,4,home,15,24,9
3927,1,home,0,7,7
3927,2,work,7,14,7
3927,3,home,14,24,10
3928,1,home,0,6,6
3928,2,work,6,9,3
3928,3,home,9,10,1
3928,4,work,10,11,1
3928,5,home,11,16,5
3928,6,work,16,19,3
3928,7,home,19,23,4
3928,8,work,23,24,1
3929,1,home,0,7,7
3929,2,education,7,12,5
3929,3,shop,12,14,2
3929,4,home,14,24,10
3930,1,home,0,6,6
3930,2,work,6,14,8
3930,3,shop,14,15,1
3930,4,work,15,19,4
3930,5,home,19,24,5
3931,1,home,0,7,7
3931,2,education,7,11,4
3931,3,home,11,19,8
3931,4,shop,19,20,1
3931,5,home,20,24,4
3932,1,home,0,6,6
3932,2,work,6,7,1
3932,3,home,7,9,2
3932,4,work,9,11,2
3932,5,home,11,18,7
3932,6,work,18,20,2
3932,7,home,20,24,4
3933,1,home,0,8,8
3933,2,work,8,13,5
3933,3,home,13,24,11
3934,1,home,0,7,7
3934,2,work,7,13,6
3934,3,shop,13,14,1
3934,4,work,14,19,5
3934,5,home,19,24,5
3935,1,home,0,7,7
3935,2,work,7,14,7
3935,3,home,14,24,10
3936,1,home,0,7,7
3936,2,education,7,11,4
3936,3,home,11,18,7
3936,4,shop,18,20,2
3936,5,home,20,24,4
3937,1,home,0,7,7
3937,2,work,7,9,2
3937,3,home,9,15,6
3937,4,work,15,17,2
3937,5,home,17,23,6
3937,6,work,23,24,1
3938,1,home,0,7,7
3938,2,work,7,13,6
3938,3,home,13,24,11
3939,1,home,0,7,7
3939,2,shop,7,8,1
3939,3,work,8,15,7
3939,4,home,15,24,9
3940,1,home,0,7,7
3940,2,education,7,13,6
3940,3,shop,13,15,2
3940,4,home,15,24,9
3941,1,home,0,6,6
3941,2,shop,6,7,1
3941,3,home,7,9,2
3941,4,work,9,15,6
3941,5,home,15,24,9
3942,1,home,0,6,6
3942,2,work,6,14,8
3942,3,home,14,24,10
3943,1,home,0,9,9
3943,2,work,9,14,5
3943,3,home,14,21,7
3943,4,work,21,22,1
3943,5,home,22,24,2
3944,1,home,0,7,7
3944,2,education,7,11,4
3944,3,home,11,18,7
3944,4,shop,18,19,1
3944,5,home,19,24,5
3945,1,home,0,8,8
3945,2,work,8,14,6
3945,3,shop,14,15,1
3945,4,home,15,21,6
3945,5,work,21,22,1
3945,6,home,22,24,2
3946,1,home,0,6,6
3946,2,shop,6,7,1
3946,3,home,7,8,1
3946,4,education,8,11,3
3946,5,home,11,18,7
3946,6,shop,18,19,1
3946,7,home,19,24,5
3947,1,home,0,8,8
3947,2,work,8,14,6
3947,3,home,14,24,10
3948,1,home,0,7,7
3948,2,work,7,13,6
3948,3,shop,13,14,1
3948,4,work,14,20,6
3948,5,home,20,24,4
3949,1,home,0,7,7
3949,2,shop,7,8,1
3949,3,work,8,15,7
3949,4,home,15,24,9
3950,1,home,0,8,8
3950,2,work,8,14,6
3950,3,home,14,21,7
3950,4,shop,21,22,1
3950,5,home,22,24,2
3951,1,home,0,8,8
3951,2,work,8,16,8
3951,3,home,16,24,8
3952,1,home,0,7,7
3952,2,work,7,9,2
3952,3,home,9,15,6
3952,4,work,15,17,2
3952,5,home,17,23,6
3952,6,work,23,24,1
3953,1,home,0,8,8
3953,2,education,8,11,3
3953,3,home,11,18,7
3953,4,shop,18,19,1
3953,5,home,19,24,5
3954,1,home,0,8,8
3954,2,work,8,14,6
3954,3,shop,14,15,1
3954,4,work,15,20,5
3954,5,home,20,24,4
3955,1,home,0,6,6
3955,2,work,6,13,7
3955,3,home,13,17,4
3955,4,shop,17,18,1
3955,5,home,18,24,6
3956,1,home,0,9,9
3956,2,work,9,16,7
3956,3,shop,16,17,1
3956,4,home,17,24,7
3957,1,work,0,1,1
3957,2,home,1,8,7
3957,3,education,8,11,3
3957,4,home,11,18,7
3957,5,shop,18,20,2
3957,6,home,20,24,4
3958,1,home,0,6,6
3958,2,work,6,13,7
3958,3,shop,13,14,1
3958,4,home,14,18,4
3958,5,work,18,19,1
3958,6,home,19,22,3
3958,7,work,22,23,1
3958,8,home,23,24,1
3959,1,home,0,7,7
3959,2,work,7,15,8
3959,3,shop,15,16,1
3959,4,work,16,20,4
3959,5,home,20,24,4
3960,1,home,0,8,8
3960,2,work,8,14,6
3960,3,home,14,24,10
3961,1,home,0,6,6
3961,2,work,6,13,7
3961,3,home,13,17,4
3961,4,work,17,20,3
3961,5,home,20,24,4
3962,1,home,0,8,8
3962,2,work,8,15,7
3962,3,shop,15,16,1
3962,4,work,16,19,3
3962,5,home,19,24,5
3963,1,home,0,7,7
3963,2,work,7,14,7
3963,3,shop,14,15,1
3963,4,home,15,24,9
3964,1,home,0,7,7
3964,2,work,7,14,7
3964,3,home,14,18,4
3964,4,work,18,19,1
3964,5,home,19,24,5
3965,1,home,0,7,7
3965,2,shop,7,8,1
3965,3,home,8,20,12
3965,4,shop,20,21,1
3965,5,home,21,24,3
3966,1,home,0,6,6
3966,2,work,6,8,2
3966,3,home,8,13,5
3966,4,work,13,16,3
3966,5,home,16,22,6
3966,6,work,22,23,1
3966,7,home,23,24,1
3967,1,home,0,8,8
3967,2,work,8,13,5
3967,3,home,13,24,11
3968,1,home,0,6,6
3968,2,work,6,8,2
3968,3,home,8,13,5
3968,4,work,13,15,2
3968,5,home,15,22,7
3968,6,work,22,23,1
3968,7,home,23,24,1
3969,1,home,0,6,6
3969,2,work,6,13,7
3969,3,home,13,15,2
3969,4,work,15,20,5
3969,5,home,20,24,4
3970,1,home,0,8,8
3970,2,work,8,16,8
3970,3,shop,16,17,1
3970,4,home,17,24,7
3971,1,home,0,8,8
3971,2,education,8,13,5
3971,3,shop,13,15,2
3971,4,home,15,24,9
3972,1,home,0,7,7
3972,2,work,7,14,7
3972,3,shop,14,15,1
3972,4,home,15,24,9
3973,1,home,0,6,6
3973,2,shop,6,7,1
3973,3,work,7,13,6
3973,4,home,13,24,11
3974,1,home,0,7,7
3974,2,work,7,14,7
3974,3,shop,14,15,1
3974,4,home,15,24,9
3975,1,home,0,6,6
3975,2,shop,6,7,1
3975,3,home,7,8,1
3975,4,work,8,11,3
3975,5,home,11,15,4
3975,6,work,15,17,2
3975,7,home,17,21,4
3975,8,work,21,22,1
3975,9,home,22,24,2
3976,1,home,0,6,6
3976,2,work,6,13,7
3976,3,shop,13,14,1
3976,4,home,14,24,10
3977,1,home,0,8,8
3977,2,work,8,15,7
3977,3,home,15,24,9
3978,1,home,0,7,7
3978,2,work,7,14,7
3978,3,home,14,17,3
3978,4,work,17,19,2
3978,5,home,19,24,5
3979,1,home,0,8,8
3979,2,shop,8,9,1
3979,3,home,9,13,4
3979,4,work,13,19,6
3979,5,home,19,24,5
3980,1,home,0,7,7
3980,2,work,7,14,7
3980,3,shop,14,15,1
3980,4,home,15,21,6
3980,5,work,21,22,1
3980,6,home,22,24,2
3981,1,home,0,8,8
3981,2,work,8,14,6
3981,3,shop,14,15,1
3981,4,home,15,24,9
3982,1,home,0,7,7
3982,2,work,7,14,7
3982,3,home,14,23,9
3982,4,work,23,24,1
3983,1,home,0,6,6
3983,2,work,6,13,7
3983,3,home,13,16,3
3983,4,work,16,20,4
3983,5,home,20,24,4
3984,1,home,0,6,6
3984,2,shop,6,7,1
3984,3,work,7,13,6
3984,4,home,13,24,11
3985,1,home,0,6,6
3985,2,shop,6,7,1
3985,3,work,7,14,7
3985,4,shop,14,15,1
3985,5,home,15,23,8
3985,6,work,23,24,1
3986,1,home,0,6,6
3986,2,work,6,13,7
3986,3,shop,13,14,1
3986,4,home,14,24,10
3987,1,home,0,6,6
3987,2,work,6,13,7
3987,3,shop,13,14,1
3987,4,work,14,19,5
3987,5,home,19,24,5
3988,1,home,0,8,8
3988,2,work,8,15,7
3988,3,home,15,24,9
3989,1,home,0,7,7
3989,2,shop,7,9,2
3989,3,education,9,11,2
3989,4,home,11,17,6
3989,5,shop,17,18,1
3989,6,home,18,24,6
3990,1,home,0,6,6
3990,2,work,6,13,7
3990,3,shop,13,14,1
3990,4,work,14,19,5
3990,5,home,19,24,5
3991,1,home,0,7,7
3991,2,shop,7,8,1
3991,3,home,8,14,6
3991,4,work,14,20,6
3991,5,home,20,24,4
3992,1,home,0,8,8
3992,2,work,8,15,7
3992,3,home,15,23,8
3992,4,work,23,24,1
3993,1,home,0,7,7
3993,2,work,7,13,6
3993,3,home,13,21,8
3993,4,work,21,22,1
3993,5,home,22,24,2
3994,1,home,0,7,7
3994,2,education,7,11,4
3994,3,home,11,17,6
3994,4,shop,17,18,1
3994,5,home,18,24,6
3995,1,home,0,8,8
3995,2,work,8,14,6
3995,3,home,14,24,10
3996,1,home,0,8,8
3996,2,shop,8,9,1
3996,3,home,9,17,8
3996,4,work,17,20,3
3996,5,home,20,24,4
3997,1,home,0,7,7
3997,2,work,7,14,7
3997,3,home,14,24,10
3998,1,home,0,8,8
3998,2,work,8,15,7
3998,3,home,15,22,7
3998,4,work,22,23,1
3998,5,home,23,24,1
3999,1,home,0,7,7
3999,2,work,7,13,6
3999,3,home,13,24,11
4000,1,home,0,7,7
4000,2,education,7,12,5
4000,3,shop,12,13,1
4000,4,education,13,15,2
4000,5,shop,15,17,2
4000,6,home,17,24,7
4001,1,home,0,6,6
4001,2,work,6,8,2
4001,3,home,8,9,1
4001,4,work,9,10,1
4001,5,home,10,15,5
4001,6,work,15,17,2
4001,7,home,17,21,4
4001,8,work,21,22,1
4001,9,home,22,24,2
4002,1,home,0,6,6
4002,2,shop,6,7,1
4002,3,home,7,13,6
4002,4,education,13,16,3
4002,5,shop,16,18,2
4002,6,home,18,24,6
4003,1,home,0,6,6
4003,2,work,6,8,2
4003,3,home,8,10,2
4003,4,work,10,12,2
4003,5,home,12,21,9
4003,6,work,21,22,1
4003,7,home,22,24,2
4004,1,home,0,6,6
4004,2,shop,6,7,1
4004,3,home,7,14,7
4004,4,education,14,16,2
4004,5,home,16,24,8
4005,1,home,0,7,7
4005,2,work,7,13,6
4005,3,shop,13,15,2
4005,4,work,15,20,5
4005,5,home,20,24,4
4006,1,home,0,6,6
4006,2,work,6,13,7
4006,3,home,13,24,11
4007,1,home,0,8,8
4007,2,work,8,15,7
4007,3,home,15,23,8
4007,4,work,23,24,1
4008,1,home,0,6,6
4008,2,work,6,13,7
4008,3,shop,13,14,1
4008,4,home,14,23,9
4008,5,work,23,24,1
4009,1,home,0,7,7
4009,2,work,7,14,7
4009,3,shop,14,15,1
4009,4,home,15,24,9
4010,1,home,0,6,6
4010,2,work,6,12,6
4010,3,shop,12,13,1
4010,4,education,13,16,3
4010,5,shop,16,17,1
4010,6,home,17,24,7
4011,1,home,0,6,6
4011,2,work,6,13,7
4011,3,home,13,17,4
4011,4,work,17,19,2
4011,5,home,19,24,5
4012,1,home,0,8,8
4012,2,work,8,15,7
4012,3,home,15,24,9
4013,1,home,0,8,8
4013,2,work,8,13,5
4013,3,shop,13,14,1
4013,4,home,14,24,10
4014,1,home,0,8,8
4014,2,work,8,14,6
4014,3,home,14,20,6
4014,4,shop,20,21,1
4014,5,home,21,24,3
4015,1,home,0,8,8
4015,2,work,8,16,8
4015,3,shop,16,17,1
4015,4,home,17,24,7
4016,1,home,0,7,7
4016,2,work,7,13,6
4016,3,shop,13,14,1
4016,4,home,14,24,10
4017,1,home,0,6,6
4017,2,work,6,13,7
4017,3,shop,13,14,1
4017,4,work,14,19,5
4017,5,home,19,24,5
4018,1,home,0,6,6
4018,2,work,6,7,1
4018,3,home,7,11,4
4018,4,work,11,13,2
4018,5,shop,13,14,1
4018,6,home,14,22,8
4018,7,work,22,23,1
4018,8,home,23,24,1
4019,1,home,0,8,8
4019,2,work,8,15,7
4019,3,home,15,24,9
4020,1,home,0,6,6
4020,2,shop,6,7,1
4020,3,work,7,14,7
4020,4,home,14,24,10
4021,1,home,0,6,6
4021,2,shop,6,7,1
4021,3,work,7,14,7
4021,4,home,14,24,10
4022,1,home,0,7,7
4022,2,education,7,11,4
4022,3,home,11,18,7
4022,4,shop,18,19,1
4022,5,home,19,24,5
4023,1,home,0,7,7
4023,2,education,7,12,5
4023,3,home,12,20,8
4023,4,shop,20,21,1
4023,5,home,21,24,3
4024,1,home,0,10,10
4024,2,work,10,13,3
4024,3,home,13,24,11
4025,1,home,0,8,8
4025,2,work,8,14,6
4025,3,home,14,21,7
4025,4,work,21,22,1
4025,5,home,22,24,2
4026,1,home,0,4,4
4026,2,work,4,12,8
4026,3,shop,12,13,1
4026,4,work,13,19,6
4026,5,home,19,24,5
4027,1,home,0,8,8
4027,2,work,8,15,7
4027,3,home,15,24,9
4028,1,home,0,8,8
4028,2,work,8,16,8
4028,3,home,16,24,8
4029,1,home,0,7,7
4029,2,shop,7,9,2
4029,3,education,9,12,3
4029,4,shop,12,14,2
4029,5,education,14,16,2
4029,6,shop,16,17,1
4029,7,home,17,24,7
4030,1,home,0,6,6
4030,2,work,6,7,1
4030,3,home,7,10,3
4030,4,work,10,11,1
4030,5,home,11,16,5
4030,6,work,16,18,2
4030,7,home,18,22,4
4030,8,work,22,23,1
4030,9,home,23,24,1
4031,1,home,0,6,6
4031,2,work,6,13,7
4031,3,shop,13,14,1
4031,4,work,14,19,5
4031,5,home,19,24,5
4032,1,home,0,7,7
4032,2,work,7,13,6
4032,3,shop,13,14,1
4032,4,work,14,20,6
4032,5,home,20,24,4
4033,1,home,0,6,6
4033,2,work,6,13,7
4033,3,shop,13,14,1
4033,4,home,14,24,10
4034,1,home,0,7,7
4034,2,shop,7,8,1
4034,3,home,8,13,5
4034,4,education,13,16,3
4034,5,home,16,24,8
4035,1,home,0,7,7
4035,2,work,7,14,7
4035,3,shop,14,15,1
4035,4,work,15,20,5
4035,5,home,20,24,4
4036,1,home,0,7,7
4036,2,work,7,8,1
4036,3,home,8,13,5
4036,4,work,13,15,2
4036,5,home,15,23,8
4036,6,work,23,24,1
4037,1,home,0,6,6
4037,2,shop,6,7,1
4037,3,home,7,13,6
4037,4,education,13,16,3
4037,5,home,16,24,8
4038,1,home,0,8,8
4038,2,work,8,15,7
4038,3,home,15,24,9
4039,1,home,0,6,6
4039,2,work,6,13,7
4039,3,shop,13,14,1
4039,4,home,14,24,10
4040,1,home,0,7,7
4040,2,shop,7,8,1
4040,3,education,8,11,3
4040,4,home,11,18,7
4040,5,shop,18,20,2
4040,6,home,20,24,4
4041,1,home,0,8,8
4041,2,work,8,15,7
4041,3,shop,15,16,1
4041,4,home,16,24,8
4042,1,home,0,6,6
4042,2,shop,6,7,1
4042,3,work,7,13,6
4042,4,home,13,21,8
4042,5,shop,21,22,1
4042,6,home,22,24,2
4043,1,home,0,7,7
4043,2,work,7,13,6
4043,3,shop,13,14,1
4043,4,home,14,15,1
4043,5,work,15,19,4
4043,6,home,19,24,5
4044,1,home,0,7,7
4044,2,work,7,14,7
4044,3,home,14,22,8
4044,4,work,22,23,1
4044,5,home,23,24,1
4045,1,home,0,8,8
4045,2,shop,8,9,1
4045,3,home,9,14,5
4045,4,work,14,19,5
4045,5,home,19,24,5
4046,1,home,0,7,7
4046,2,work,7,9,2
4046,3,home,9,13,4
4046,4,work,13,15,2
4046,5,home,15,23,8
4046,6,work,23,24,1
4047,1,home,0,7,7
4047,2,work,7,13,6
4047,3,shop,13,14,1
4047,4,home,14,18,4
4047,5,work,18,20,2
4047,6,home,20,24,4
4048,1,home,0,7,7
4048,2,work,7,14,7
4048,3,shop,14,15,1
4048,4,home,15,24,9
4049,1,home,0,7,7
4049,2,education,7,11,4
4049,3,home,11,16,5
4049,4,shop,16,17,1
4049,5,home,17,24,7
4050,1,home,0,7,7
4050,2,education,7,12,5
4050,3,shop,12,14,2
4050,4,education,14,17,3
4050,5,home,17,24,7
4051,1,home,0,8,8
4051,2,shop,8,9,1
4051,3,work,9,15,6
4051,4,home,15,24,9
4052,1,home,0,7,7
4052,2,education,7,11,4
4052,3,home,11,18,7
4052,4,shop,18,19,1
4052,5,home,19,24,5
4053,1,home,0,7,7
4053,2,work,7,13,6
4053,3,home,13,23,10
4053,4,work,23,24,1
4054,1,home,0,6,6
4054,2,work,6,13,7
4054,3,shop,13,14,1
4054,4,education,14,17,3
4054,5,home,17,24,7
4055,1,home,0,6,6
4055,2,shop,6,7,1
4055,3,work,7,15,8
4055,4,home,15,24,9
4056,1,home,0,8,8
4056,2,work,8,15,7
4056,3,home,15,21,6
4056,4,work,21,22,1
4056,5,home,22,24,2
4057,1,home,0,6,6
4057,2,work,6,13,7
4057,3,home,13,17,4
4057,4,shop,17,18,1
4057,5,home,18,24,6
4058,1,home,0,7,7
4058,2,work,7,15,8
4058,3,home,15,24,9
4059,1,home,0,7,7
4059,2,education,7,11,4
4059,3,home,11,17,6
4059,4,shop,17,18,1
4059,5,home,18,24,6
4060,1,home,0,8,8
4060,2,education,8,11,3
4060,3,home,11,20,9
4060,4,shop,20,21,1
4060,5,home,21,24,3
4061,1,home,0,7,7
4061,2,work,7,9,2
4061,3,home,9,13,4
4061,4,work,13,15,2
4061,5,home,15,22,7
4061,6,work,22,23,1
4061,7,home,23,24,1
4062,1,home,0,7,7
4062,2,work,7,13,6
4062,3,home,13,17,4
4062,4,work,17,20,3
4062,5,home,20,24,4
4063,1,home,0,8,8
4063,2,education,8,13,5
4063,3,home,13,24,11
4064,1,home,0,7,7
4064,2,work,7,13,6
4064,3,shop,13,14,1
4064,4,education,14,16,2
4064,5,home,16,24,8
4065,1,home,0,6,6
4065,2,work,6,14,8
4065,3,home,14,24,10
4066,1,home,0,6,6
4066,2,shop,6,7,1
4066,3,home,7,10,3
4066,4,education,10,12,2
4066,5,shop,12,15,3
4066,6,home,15,24,9
4067,1,home,0,6,6
4067,2,work,6,13,7
4067,3,home,13,24,11
4068,1,home,0,7,7
4068,2,work,7,13,6
4068,3,shop,13,14,1
4068,4,work,14,20,6
4068,5,home,20,24,4
4069,1,home,0,7,7
4069,2,shop,7,9,2
4069,3,education,9,12,3
4069,4,shop,12,13,1
4069,5,education,13,14,1
4069,6,shop,14,15,1
4069,7,home,15,24,9
4070,1,home,0,8,8
4070,2,work,8,15,7
4070,3,home,15,23,8
4070,4,work,23,24,1
4071,1,home,0,7,7
4071,2,education,7,13,6
4071,3,shop,13,15,2
4071,4,home,15,24,9
4072,1,home,0,7,7
4072,2,education,7,11,4
4072,3,home,11,19,8
4072,4,shop,19,20,1
4072,5,home,20,24,4
4073,1,home,0,9,9
4073,2,education,9,12,3
4073,3,shop,12,14,2
4073,4,education,14,16,2
4073,5,home,16,24,8
4074,1,home,0,6,6
4074,2,shop,6,7,1
4074,3,home,7,10,3
4074,4,education,10,16,6
4074,5,home,16,24,8
4075,1,home,0,6,6
4075,2,work,6,13,7
4075,3,shop,13,14,1
4075,4,work,14,17,3
4075,5,home,17,24,7
4076,1,home,0,7,7
4076,2,work,7,15,8
4076,3,shop,15,16,1
4076,4,home,16,21,5
4076,5,shop,21,22,1
4076,6,home,22,24,2
4077,1,home,0,7,7
4077,2,shop,7,8,1
4077,3,education,8,12,4
4077,4,home,12,20,8
4077,5,shop,20,21,1
4077,6,home,21,24,3
4078,1,home,0,6,6
4078,2,work,6,13,7
4078,3,home,13,17,4
4078,4,shop,17,18,1
4078,5,home,18,22,4
4078,6,work,22,23,1
4078,7,home,23,24,1
4079,1,home,0,6,6
4079,2,shop,6,7,1
4079,3,home,7,13,6
4079,4,education,13,16,3
4079,5,shop,16,17,1
4079,6,home,17,24,7
4080,1,home,0,7,7
4080,2,work,7,13,6
4080,3,home,13,18,5
4080,4,work,18,20,2
4080,5,home,20,24,4
4081,1,home,0,8,8
4081,2,education,8,12,4
4081,3,home,12,20,8
4081,4,shop,20,21,1
4081,5,home,21,24,3
4082,1,home,0,7,7
4082,2,work,7,13,6
4082,3,home,13,18,5
4082,4,work,18,20,2
4082,5,home,20,24,4
4083,1,home,0,8,8
4083,2,work,8,15,7
4083,3,home,15,24,9
4084,1,home,0,8,8
4084,2,work,8,15,7
4084,3,home,15,18,3
4084,4,work,18,20,2
4084,5,home,20,24,4
4085,1,home,0,7,7
4085,2,shop,7,8,1
4085,3,education,8,11,3
4085,4,home,11,14,3
4085,5,education,14,16,2
4085,6,home,16,24,8
4086,1,home,0,7,7
4086,2,work,7,13,6
4086,3,home,13,24,11
4087,1,home,0,7,7
4087,2,work,7,13,6
4087,3,home,13,24,11
4088,1,home,0,8,8
4088,2,work,8,14,6
4088,3,home,14,24,10
4089,1,home,0,6,6
4089,2,work,6,12,6
4089,3,shop,12,13,1
4089,4,work,13,19,6
4089,5,home,19,24,5
4090,1,home,0,8,8
4090,2,work,8,16,8
4090,3,home,16,24,8
4091,1,home,0,8,8
4091,2,education,8,11,3
4091,3,home,11,17,6
4091,4,shop,17,18,1
4091,5,home,18,24,6
4092,1,home,0,7,7
4092,2,work,7,14,7
4092,3,home,14,22,8
4092,4,work,22,23,1
4092,5,home,23,24,1
4093,1,home,0,7,7
4093,2,shop,7,8,1
4093,3,home,8,9,1
4093,4,education,9,13,4
4093,5,shop,13,14,1
4093,6,home,14,22,8
4093,7,work,22,23,1
4093,8,home,23,24,1
4094,1,home,0,7,7
4094,2,shop,7,8,1
4094,3,education,8,12,4
4094,4,home,12,15,3
4094,5,shop,15,16,1
4094,6,home,16,24,8
4095,1,home,0,8,8
4095,2,work,8,14,6
4095,3,home,14,24,10
4096,1,home,0,7,7
4096,2,work,7,14,7
4096,3,home,14,22,8
4096,4,work,22,23,1
4096,5,home,23,24,1
4097,1,home,0,7,7
4097,2,education,7,11,4
4097,3,home,11,16,5
4097,4,shop,16,17,1
4097,5,home,17,21,4
4097,6,shop,21,22,1
4097,7,home,22,24,2
4098,1,home,0,8,8
4098,2,work,8,15,7
4098,3,shop,15,16,1
4098,4,work,16,20,4
4098,5,home,20,24,4
4099,1,home,0,6,6
4099,2,work,6,8,2
4099,3,home,8,12,4
4099,4,work,12,14,2
4099,5,home,14,21,7
4099,6,work,21,22,1
4099,7,home,22,24,2
4100,1,home,0,8,8
4100,2,work,8,16,8
4100,3,home,16,21,5
4100,4,shop,21,22,1
4100,5,home,22,24,2
4101,1,home,0,6,6
4101,2,work,6,8,2
4101,3,home,8,12,4
4101,4,work,12,14,2
4101,5,home,14,21,7
4101,6,work,21,22,1
4101,7,home,22,24,2
4102,1,home,0,6,6
4102,2,work,6,13,7
4102,3,home,13,24,11
4103,1,home,0,6,6
4103,2,work,6,8,2
4103,3,home,8,9,1
4103,4,work,9,11,2
4103,5,home,11,18,7
4103,6,work,18,19,1
4103,7,home,19,24,5
4104,1,home,0,6,6
4104,2,work,6,13,7
4104,3,home,13,24,11
4105,1,home,0,6,6
4105,2,work,6,12,6
4105,3,shop,12,13,1
4105,4,education,13,16,3
4105,5,shop,16,17,1
4105,6,home,17,21,4
4105,7,work,21,22,1
4105,8,home,22,24,2
4106,1,home,0,6,6
4106,2,work,6,13,7
4106,3,home,13,18,5
4106,4,work,18,20,2
4106,5,home,20,24,4
4107,1,home,0,6,6
4107,2,work,6,12,6
4107,3,shop,12,13,1
4107,4,work,13,19,6
4107,5,home,19,24,5
4108,1,home,0,8,8
4108,2,education,8,13,5
4108,3,shop,13,14,1
4108,4,work,14,20,6
4108,5,home,20,24,4
4109,1,home,0,6,6
4109,2,shop,6,7,1
4109,3,home,7,10,3
4109,4,education,10,12,2
4109,5,shop,12,14,2
4109,6,education,14,16,2
4109,7,shop,16,17,1
4109,8,home,17,24,7
4110,1,home,0,7,7
4110,2,work,7,14,7
4110,3,home,14,24,10
4111,1,home,0,8,8
4111,2,education,8,11,3
4111,3,home,11,17,6
4111,4,shop,17,18,1
4111,5,home,18,24,6
4112,1,home,0,9,9
4112,2,work,9,17,8
4112,3,home,17,24,7
4113,1,home,0,6,6
4113,2,work,6,13,7
4113,3,home,13,24,11
4114,1,home,0,6,6
4114,2,shop,6,7,1
4114,3,home,7,10,3
4114,4,work,10,18,8
4114,5,home,18,24,6
4115,1,home,0,8,8
4115,2,work,8,15,7
4115,3,home,15,21,6
4115,4,shop,21,22,1
4115,5,home,22,24,2
4116,1,home,0,8,8
4116,2,work,8,14,6
4116,3,shop,14,15,1
4116,4,work,15,20,5
4116,5,home,20,24,4
4117,1,home,0,8,8
4117,2,shop,8,9,1
4117,3,education,9,12,3
4117,4,home,12,19,7
4117,5,shop,19,20,1
4117,6,home,20,24,4
4118,1,home,0,7,7
4118,2,education,7,11,4
4118,3,home,11,19,8
4118,4,shop,19,21,2
4118,5,home,21,24,3
4119,1,home,0,7,7
4119,2,work,7,13,6
4119,3,home,13,24,11
4120,1,home,0,7,7
4120,2,work,7,9,2
4120,3,home,9,13,4
4120,4,work,13,15,2
4120,5,home,15,21,6
4120,6,work,21,22,1
4120,7,home,22,24,2
4121,1,home,0,9,9
4121,2,work,9,16,7
4121,3,home,16,24,8
4122,1,home,0,7,7
4122,2,shop,7,8,1
4122,3,education,8,12,4
4122,4,shop,12,14,2
4122,5,education,14,16,2
4122,6,home,16,24,8
4123,1,home,0,6,6
4123,2,work,6,13,7
4123,3,shop,13,14,1
4123,4,work,14,19,5
4123,5,home,19,24,5
4124,1,home,0,7,7
4124,2,work,7,14,7
4124,3,shop,14,15,1
4124,4,home,15,22,7
4124,5,work,22,23,1
4124,6,home,23,24,1
4125,1,home,0,6,6
4125,2,shop,6,7,1
4125,3,home,7,10,3
4125,4,education,10,16,6
4125,5,home,16,24,8
4126,1,home,0,7,7
4126,2,work,7,14,7
4126,3,home,14,22,8
4126,4,work,22,23,1
4126,5,home,23,24,1
4127,1,home,0,6,6
4127,2,shop,6,7,1
4127,3,home,7,8,1
4127,4,education,8,11,3
4127,5,home,11,16,5
4127,6,shop,16,17,1
4127,7,home,17,24,7
4128,1,home,0,6,6
4128,2,work,6,13,7
4128,3,home,13,24,11
4129,1,work,0,7,7
4129,2,shop,7,8,1
4129,3,work,8,15,7
4129,4,home,15,24,9
4130,1,home,0,7,7
4130,2,work,7,14,7
4130,3,home,14,24,10
4131,1,home,0,8,8
4131,2,shop,8,9,1
4131,3,work,9,17,8
4131,4,home,17,24,7
4132,1,home,0,7,7
4132,2,shop,7,8,1
4132,3,work,8,15,7
4132,4,home,15,24,9
4133,1,home,0,8,8
4133,2,work,8,15,7
4133,3,home,15,24,9
4134,1,home,0,7,7
4134,2,work,7,14,7
4134,3,shop,14,15,1
4134,4,home,15,17,2
4134,5,work,17,20,3
4134,6,home,20,24,4
4135,1,home,0,8,8
4135,2,work,8,15,7
4135,3,home,15,24,9
4136,1,home,0,8,8
4136,2,work,8,14,6
4136,3,home,14,21,7
4136,4,shop,21,22,1
4136,5,home,22,24,2
4137,1,home,0,7,7
4137,2,work,7,13,6
4137,3,shop,13,14,1
4137,4,work,14,20,6
4137,5,home,20,24,4
4138,1,home,0,6,6
4138,2,work,6,8,2
4138,3,home,8,9,1
4138,4,work,9,11,2
4138,5,home,11,14,3
4138,6,work,14,16,2
4138,7,home,16,21,5
4138,8,work,21,22,1
4138,9,home,22,24,2
4139,1,home,0,6,6
4139,2,work,6,13,7
4139,3,shop,13,15,2
4139,4,work,15,20,5
4139,5,home,20,24,4
4140,1,home,0,8,8
4140,2,education,8,11,3
4140,3,home,11,13,2
4140,4,education,13,15,2
4140,5,shop,15,17,2
4140,6,home,17,24,7
4141,1,home,0,6,6
4141,2,work,6,13,7
4141,3,home,13,17,4
4141,4,work,17,20,3
4141,5,home,20,24,4
4142,1,home,0,6,6
4142,2,shop,6,7,1
4142,3,home,7,9,2
4142,4,education,9,11,2
4142,5,home,11,18,7
4142,6,shop,18,19,1
4142,7,home,19,24,5
4143,1,home,0,7,7
4143,2,shop,7,8,1
4143,3,education,8,11,3
4143,4,home,11,16,5
4143,5,shop,16,17,1
4143,6,home,17,24,7
4144,1,home,0,6,6
4144,2,work,6,13,7
4144,3,home,13,18,5
4144,4,work,18,20,2
4144,5,home,20,24,4
4145,1,home,0,7,7
4145,2,work,7,13,6
4145,3,shop,13,14,1
4145,4,home,14,24,10
4146,1,home,0,7,7
4146,2,work,7,14,7
4146,3,home,14,24,10
4147,1,home,0,7,7
4147,2,work,7,14,7
4147,3,shop,14,15,1
4147,4,home,15,21,6
4147,5,work,21,22,1
4147,6,home,22,24,2
4148,1,home,0,6,6
4148,2,work,6,14,8
4148,3,home,14,18,4
4148,4,shop,18,19,1
4148,5,home,19,24,5
4149,1,home,0,8,8
4149,2,education,8,14,6
4149,3,shop,14,15,1
4149,4,home,15,23,8
4149,5,work,23,24,1
4150,1,home,0,6,6
4150,2,work,6,13,7
4150,3,home,13,17,4
4150,4,work,17,18,1
4150,5,home,18,24,6
4151,1,home,0,7,7
4151,2,work,7,13,6
4151,3,shop,13,14,1
4151,4,work,14,19,5
4151,5,home,19,24,5
4152,1,home,0,6,6
4152,2,shop,6,7,1
4152,3,work,7,13,6
4152,4,home,13,17,4
4152,5,work,17,20,3
4152,6,home,20,24,4
4153,1,home,0,7,7
4153,2,work,7,13,6
4153,3,home,13,21,8
4153,4,work,21,22,1
4153,5,home,22,24,2
4154,1,home,0,7,7
4154,2,shop,7,8,1
4154,3,education,8,11,3
4154,4,home,11,17,6
4154,5,shop,17,19,2
4154,6,home,19,24,5
4155,1,home,0,9,9
4155,2,shop,9,10,1
4155,3,work,10,17,7
4155,4,home,17,24,7
4156,1,home,0,8,8
4156,2,work,8,14,6
4156,3,shop,14,16,2
4156,4,home,16,24,8
4157,1,home,0,8,8
4157,2,work,8,14,6
4157,3,shop,14,15,1
4157,4,home,15,24,9
4158,1,home,0,7,7
4158,2,work,7,14,7
4158,3,home,14,24,10
4159,1,home,0,6,6
4159,2,work,6,13,7
4159,3,home,13,21,8
4159,4,work,21,22,1
4159,5,home,22,24,2
4160,1,home,0,7,7
4160,2,work,7,14,7
4160,3,home,14,21,7
4160,4,work,21,22,1
4160,5,home,22,24,2
4161,1,home,0,7,7
4161,2,work,7,14,7
4161,3,shop,14,15,1
4161,4,home,15,24,9
4162,1,home,0,7,7
4162,2,work,7,13,6
4162,3,shop,13,14,1
4162,4,work,14,20,6
4162,5,home,20,24,4
4163,1,home,0,6,6
4163,2,work,6,7,1
4163,3,home,7,11,4
4163,4,work,11,13,2
4163,5,home,13,22,9
4163,6,work,22,23,1
4163,7,home,23,24,1
4164,1,home,0,6,6
4164,2,work,6,7,1
4164,3,home,7,13,6
4164,4,work,13,15,2
4164,5,home,15,21,6
4164,6,work,21,22,1
4164,7,home,22,24,2
4165,1,home,0,6,6
4165,2,work,6,13,7
4165,3,shop,13,14,1
4165,4,home,14,21,7
4165,5,work,21,22,1
4165,6,home,22,24,2
4166,1,home,0,8,8
4166,2,work,8,15,7
4166,3,home,15,22,7
4166,4,work,22,23,1
4166,5,home,23,24,1
4167,1,home,0,8,8
4167,2,work,8,15,7
4167,3,home,15,24,9
4168,1,home,0,7,7
4168,2,work,7,14,7
4168,3,home,14,24,10
4169,1,home,0,8,8
4169,2,work,8,15,7
4169,3,home,15,24,9
4170,1,home,0,7,7
4170,2,work,7,16,9
4170,3,home,16,24,8
4171,1,home,0,7,7
4171,2,work,7,13,6
4171,3,shop,13,14,1
4171,4,work,14,20,6
4171,5,home,20,24,4
4172,1,home,0,8,8
4172,2,work,8,13,5
4172,3,shop,13,14,1
4172,4,home,14,24,10
4173,1,home,0,9,9
4173,2,shop,9,10,1
4173,3,work,10,17,7
4173,4,home,17,22,5
4173,5,work,22,23,1
4173,6,home,23,24,1
4174,1,home,0,8,8
4174,2,work,8,15,7
4174,3,shop,15,16,1
4174,4,work,16,20,4
4174,5,home,20,24,4
4175,1,home,0,6,6
4175,2,work,6,14,8
4175,3,home,14,24,10
4176,1,home,0,8,8
4176,2,work,8,15,7
4176,3,home,15,16,1
4176,4,work,16,20,4
4176,5,home,20,24,4
4177,1,home,0,7,7
4177,2,work,7,14,7
4177,3,home,14,17,3
4177,4,shop,17,18,1
4177,5,home,18,24,6
4178,1,home,0,6,6
4178,2,work,6,8,2
4178,3,home,8,14,6
4178,4,work,14,17,3
4178,5,home,17,24,7
4179,1,home,0,7,7
4179,2,work,7,13,6
4179,3,home,13,24,11
4180,1,home,0,6,6
4180,2,work,6,13,7
4180,3,home,13,24,11
4181,1,home,0,6,6
4181,2,shop,6,7,1
4181,3,home,7,13,6
4181,4,education,13,17,4
4181,5,shop,17,19,2
4181,6,home,19,24,5
4182,1,home,0,7,7
4182,2,education,7,11,4
4182,3,home,11,19,8
4182,4,shop,19,20,1
4182,5,home,20,24,4
4183,1,home,0,7,7
4183,2,work,7,15,8
4183,3,shop,15,16,1
4183,4,home,16,24,8
4184,1,home,0,7,7
4184,2,education,7,12,5
4184,3,home,12,19,7
4184,4,shop,19,21,2
4184,5,home,21,24,3
4185,1,home,0,7,7
4185,2,work,7,14,7
4185,3,home,14,24,10
4186,1,home,0,7,7
4186,2,work,7,9,2
4186,3,home,9,13,4
4186,4,work,13,15,2
4186,5,home,15,17,2
4186,6,work,17,19,2
4186,7,home,19,23,4
4186,8,work,23,24,1
4187,1,home,0,7,7
4187,2,work,7,14,7
4187,3,home,14,22,8
4187,4,work,22,23,1
4187,5,home,23,24,1
4188,1,home,0,6,6
4188,2,shop,6,7,1
4188,3,home,7,10,3
4188,4,education,10,14,4
4188,5,work,14,20,6
4188,6,home,20,24,4
4189,1,home,0,7,7
4189,2,work,7,8,1
4189,3,home,8,12,4
4189,4,work,12,15,3
4189,5,home,15,21,6
4189,6,work,21,22,1
4189,7,home,22,24,2
4190,1,home,0,6,6
4190,2,work,6,13,7
4190,3,home,13,16,3
4190,4,work,16,20,4
4190,5,home,20,24,4
4191,1,home,0,8,8
4191,2,work,8,15,7
4191,3,home,15,22,7
4191,4,work,22,23,1
4191,5,home,23,24,1
4192,1,home,0,6,6
4192,2,work,6,13,7
4192,3,shop,13,14,1
4192,4,work,14,19,5
4192,5,home,19,24,5
4193,1,home,0,7,7
4193,2,work,7,13,6
4193,3,shop,13,14,1
4193,4,work,14,20,6
4193,5,home,20,24,4
4194,1,home,0,6,6
4194,2,work,6,13,7
4194,3,shop,13,14,1
4194,4,home,14,21,7
4194,5,work,21,22,1
4194,6,home,22,24,2
4195,1,home,0,7,7
4195,2,shop,7,8,1
4195,3,home,8,13,5
4195,4,education,13,16,3
4195,5,home,16,24,8
4196,1,home,0,6,6
4196,2,work,6,13,7
4196,3,shop,13,14,1
4196,4,work,14,20,6
4196,5,home,20,24,4
4197,1,home,0,8,8
4197,2,education,8,12,4
4197,3,home,12,19,7
4197,4,shop,19,20,1
4197,5,home,20,24,4
4198,1,home,0,6,6
4198,2,shop,6,7,1
4198,3,home,7,13,6
4198,4,education,13,16,3
4198,5,shop,16,18,2
4198,6,home,18,24,6
4199,1,home,0,8,8
4199,2,work,8,15,7
4199,3,home,15,22,7
4199,4,work,22,23,1
4199,5,home,23,24,1
4200,1,home,0,7,7
4200,2,work,7,14,7
4200,3,home,14,24,10
4201,1,home,0,8,8
4201,2,work,8,14,6
4201,3,home,14,24,10
4202,1,home,0,6,6
4202,2,shop,6,7,1
4202,3,home,7,10,3
4202,4,education,10,13,3
4202,5,shop,13,15,2
4202,6,home,15,24,9
4203,1,home,0,7,7
4203,2,work,7,14,7
4203,3,home,14,24,10
4204,1,home,0,7,7
4204,2,work,7,9,2
4204,3,home,9,12,3
4204,4,work,12,14,2
4204,5,home,14,22,8
4204,6,work,22,23,1
4204,7,home,23,24,1
4205,1,home,0,9,9
4205,2,work,9,16,7
4205,3,home,16,24,8
4206,1,home,0,7,7
4206,2,work,7,13,6
4206,3,shop,13,14,1
4206,4,work,14,20,6
4206,5,home,20,24,4
4207,1,home,0,8,8
4207,2,work,8,15,7
4207,3,shop,15,16,1
4207,4,home,16,24,8
4208,1,home,0,8,8
4208,2,work,8,14,6
4208,3,shop,14,15,1
4208,4,home,15,20,5
4208,5,shop,20,21,1
4208,6,home,21,24,3
4209,1,home,0,9,9
4209,2,education,9,12,3
4209,3,work,12,19,7
4209,4,home,19,24,5
4210,1,home,0,8,8
4210,2,education,8,12,4
4210,3,shop,12,14,2
4210,4,home,14,21,7
4210,5,shop,21,22,1
4210,6,home,22,24,2
4211,1,home,0,6,6
4211,2,work,6,13,7
4211,3,shop,13,14,1
4211,4,home,14,21,7
4211,5,work,21,22,1
4211,6,home,22,24,2
4212,1,home,0,7,7
4212,2,work,7,13,6
4212,3,home,13,17,4
4212,4,shop,17,18,1
4212,5,home,18,23,5
4212,6,work,23,24,1
4213,1,home,0,7,7
4213,2,work,7,9,2
4213,3,home,9,14,5
4213,4,work,14,16,2
4213,5,home,16,23,7
4213,6,work,23,24,1
4214,1,home,0,7,7
4214,2,shop,7,8,1
4214,3,education,8,11,3
4214,4,home,11,19,8
4214,5,shop,19,20,1
4214,6,home,20,24,4
4215,1,home,0,8,8
4215,2,education,8,12,4
4215,3,home,12,22,10
4215,4,work,22,23,1
4215,5,home,23,24,1
4216,1,home,0,8,8
4216,2,education,8,11,3
4216,3,home,11,17,6
4216,4,shop,17,19,2
4216,5,home,19,24,5
4217,1,home,0,7,7
4217,2,work,7,13,6
4217,3,shop,13,14,1
4217,4,home,14,17,3
4217,5,work,17,20,3
4217,6,home,20,24,4
4218,1,home,0,8,8
4218,2,work,8,13,5
4218,3,home,13,18,5
4218,4,shop,18,19,1
4218,5,home,19,24,5
4219,1,home,0,6,6
4219,2,work,6,7,1
4219,3,home,7,9,2
4219,4,work,9,11,2
4219,5,home,11,20,9
4219,6,shop,20,21,1
4219,7,home,21,24,3
4220,1,home,0,7,7
4220,2,work,7,13,6
4220,3,home,13,18,5
4220,4,work,18,20,2
4220,5,home,20,24,4
4221,1,home,0,7,7
4221,2,work,7,14,7
4221,3,shop,14,15,1
4221,4,work,15,20,5
4221,5,home,20,24,4
4222,1,home,0,6,6
4222,2,shop,6,7,1
4222,3,home,7,10,3
4222,4,education,10,14,4
4222,5,shop,14,15,1
4222,6,home,15,24,9
4223,1,home,0,7,7
4223,2,work,7,14,7
4223,3,home,14,24,10
4224,1,home,0,6,6
4224,2,shop,6,7,1
4224,3,home,7,9,2
4224,4,work,9,17,8
4224,5,home,17,24,7
4225,1,home,0,7,7
4225,2,shop,7,8,1
4225,3,home,8,14,6
4225,4,work,14,19,5
4225,5,home,19,23,4
4225,6,work,23,24,1
4226,1,home,0,8,8
4226,2,work,8,15,7
4226,3,home,15,19,4
4226,4,shop,19,20,1
4226,5,home,20,24,4
4227,1,home,0,6,6
4227,2,work,6,13,7
4227,3,home,13,17,4
4227,4,work,17,20,3
4227,5,home,20,24,4
4228,1,home,0,7,7
4228,2,work,7,14,7
4228,3,home,14,24,10
4229,1,home,0,8,8
4229,2,shop,8,9,1
4229,3,home,9,13,4
4229,4,work,13,19,6
4229,5,home,19,24,5
4230,1,home,0,6,6
4230,2,work,6,8,2
4230,3,home,8,14,6
4230,4,work,14,17,3
4230,5,home,17,23,6
4230,6,work,23,24,1
4231,1,home,0,7,7
4231,2,work,7,14,7
4231,3,shop,14,15,1
4231,4,home,15,24,9
4232,1,home,0,6,6
4232,2,work,6,8,2
4232,3,home,8,11,3
4232,4,work,11,13,2
4232,5,home,13,18,5
4232,6,work,18,20,2
4232,7,home,20,24,4
4233,1,home,0,7,7
4233,2,work,7,13,6
4233,3,home,13,24,11
4234,1,home,0,6,6
4234,2,work,6,13,7
4234,3,shop,13,14,1
4234,4,home,14,24,10
4235,1,home,0,8,8
4235,2,education,8,11,3
4235,3,home,11,24,13
4236,1,home,0,7,7
4236,2,shop,7,9,2
4236,3,education,9,12,3
4236,4,shop,12,14,2
4236,5,education,14,16,2
4236,6,home,16,24,8
4237,1,home,0,6,6
4237,2,work,6,8,2
4237,3,home,8,13,5
4237,4,work,13,14,1
4237,5,home,14,18,4
4237,6,work,18,20,2
4237,7,home,20,24,4
4238,1,home,0,7,7
4238,2,education,7,12,5
4238,3,shop,12,14,2
4238,4,home,14,21,7
4238,5,shop,21,22,1
4238,6,home,22,24,2
4239,1,home,0,7,7
4239,2,work,7,13,6
4239,3,home,13,24,11
4240,1,home,0,7,7
4240,2,work,7,14,7
4240,3,shop,14,15,1
4240,4,work,15,20,5
4240,5,home,20,24,4
4241,1,home,0,7,7
4241,2,work,7,9,2
4241,3,home,9,13,4
4241,4,work,13,15,2
4241,5,home,15,21,6
4241,6,work,21,22,1
4241,7,home,22,24,2
4242,1,home,0,6,6
4242,2,work,6,13,7
4242,3,home,13,24,11
4243,1,home,0,6,6
4243,2,work,6,8,2
4243,3,home,8,14,6
4243,4,work,14,16,2
4243,5,home,16,23,7
4243,6,work,23,24,1
4244,1,home,0,6,6
4244,2,shop,6,7,1
4244,3,home,7,13,6
4244,4,education,13,16,3
4244,5,shop,16,17,1
4244,6,home,17,24,7
4245,1,home,0,8,8
4245,2,work,8,15,7
4245,3,home,15,24,9
4246,1,home,0,8,8
4246,2,work,8,14,6
4246,3,shop,14,15,1
4246,4,home,15,24,9
4247,1,home,0,7,7
4247,2,work,7,13,6
4247,3,shop,13,14,1
4247,4,work,14,20,6
4247,5,home,20,24,4
4248,1,home,0,7,7
4248,2,work,7,14,7
4248,3,home,14,24,10
4249,1,home,0,6,6
4249,2,work,6,13,7
4249,3,shop,13,14,1
4249,4,education,14,17,3
4249,5,home,17,22,5
4249,6,work,22,23,1
4249,7,home,23,24,1
4250,1,home,0,7,7
4250,2,shop,7,8,1
4250,3,education,8,11,3
4250,4,home,11,14,3
4250,5,education,14,16,2
4250,6,home,16,24,8
4251,1,home,0,8,8
4251,2,education,8,12,4
4251,3,shop,12,13,1
4251,4,work,13,19,6
4251,5,home,19,24,5
4252,1,home,0,6,6
4252,2,shop,6,7,1
4252,3,home,7,13,6
4252,4,education,13,16,3
4252,5,home,16,21,5
4252,6,shop,21,22,1
4252,7,home,22,24,2
4253,1,home,0,7,7
4253,2,work,7,13,6
4253,3,shop,13,14,1
4253,4,home,14,24,10
4254,1,home,0,7,7
4254,2,work,7,13,6
4254,3,shop,13,14,1
4254,4,home,14,24,10
4255,1,home,0,7,7
4255,2,shop,7,8,1
4255,3,home,8,15,7
4255,4,shop,15,17,2
4255,5,home,17,24,7
4256,1,home,0,6,6
4256,2,work,6,8,2
4256,3,home,8,14,6
4256,4,work,14,17,3
4256,5,home,17,24,7
4257,1,home,0,7,7
4257,2,work,7,13,6
4257,3,shop,13,14,1
4257,4,home,14,24,10
4258,1,home,0,7,7
4258,2,work,7,14,7
4258,3,home,14,18,4
4258,4,work,18,20,2
4258,5,home,20,24,4
4259,1,home,0,7,7
4259,2,education,7,11,4
4259,3,home,11,19,8
4259,4,shop,19,20,1
4259,5,home,20,24,4
4260,1,home,0,6,6
4260,2,work,6,13,7
4260,3,shop,13,14,1
4260,4,home,14,24,10
4261,1,home,0,6,6
4261,2,shop,6,7,1
4261,3,home,7,10,3
4261,4,education,10,16,6
4261,5,home,16,24,8
4262,1,home,0,6,6
4262,2,work,6,7,1
4262,3,home,7,12,5
4262,4,work,12,14,2
4262,5,home,14,21,7
4262,6,work,21,22,1
4262,7,home,22,24,2
4263,1,home,0,9,9
4263,2,work,9,15,6
4263,3,home,15,21,6
4263,4,work,21,22,1
4263,5,home,22,24,2
4264,1,home,0,6,6
4264,2,shop,6,7,1
4264,3,work,7,13,6
4264,4,home,13,24,11
4265,1,home,0,7,7
4265,2,work,7,14,7
4265,3,home,14,24,10
4266,1,home,0,6,6
4266,2,work,6,13,7
4266,3,home,13,24,11
4267,1,home,0,6,6
4267,2,work,6,13,7
4267,3,home,13,24,11
4268,1,home,0,7,7
4268,2,work,7,9,2
4268,3,home,9,13,4
4268,4,work,13,15,2
4268,5,home,15,21,6
4268,6,shop,21,22,1
4268,7,home,22,24,2
4269,1,home,0,7,7
4269,2,work,7,14,7
4269,3,shop,14,15,1
4269,4,work,15,20,5
4269,5,home,20,24,4
4270,1,home,0,7,7
4270,2,work,7,9,2
4270,3,home,9,15,6
4270,4,work,15,17,2
4270,5,home,17,23,6
4270,6,work,23,24,1
4271,1,home,0,7,7
4271,2,education,7,13,6
4271,3,shop,13,15,2
4271,4,home,15,21,6
4271,5,shop,21,22,1
4271,6,home,22,24,2
4272,1,home,0,6,6
4272,2,work,6,12,6
4272,3,shop,12,13,1
4272,4,work,13,19,6
4272,5,home,19,23,4
4272,6,work,23,24,1
4273,1,home,0,6,6
4273,2,work,6,7,1
4273,3,home,7,11,4
4273,4,work,11,13,2
4273,5,shop,13,14,1
4273,6,work,14,17,3
4273,7,home,17,23,6
4273,8,work,23,24,1
4274,1,home,0,8,8
4274,2,work,8,13,5
4274,3,home,13,24,11
4275,1,home,0,6,6
4275,2,work,6,13,7
4275,3,shop,13,14,1
4275,4,home,14,24,10
4276,1,home,0,8,8
4276,2,education,8,11,3
4276,3,home,11,22,11
4276,4,work,22,23,1
4276,5,home,23,24,1
4277,1,home,0,6,6
4277,2,work,6,13,7
4277,3,home,13,24,11
4278,1,home,0,6,6
4278,2,work,6,8,2
4278,3,home,8,11,3
4278,4,work,11,13,2
4278,5,home,13,17,4
4278,6,work,17,19,2
4278,7,home,19,24,5
4279,1,home,0,7,7
4279,2,work,7,13,6
4279,3,home,13,23,10
4279,4,work,23,24,1
4280,1,home,0,6,6
4280,2,work,6,8,2
4280,3,home,8,12,4
4280,4,work,12,14,2
4280,5,home,14,22,8
4280,6,work,22,23,1
4280,7,home,23,24,1
4281,1,home,0,7,7
4281,2,work,7,10,3
4281,3,home,10,15,5
4281,4,work,15,17,2
4281,5,home,17,23,6
4281,6,work,23,24,1
4282,1,home,0,7,7
4282,2,shop,7,8,1
4282,3,education,8,11,3
4282,4,home,11,18,7
4282,5,shop,18,19,1
4282,6,home,19,24,5
4283,1,home,0,6,6
4283,2,work,6,13,7
4283,3,shop,13,14,1
4283,4,work,14,19,5
4283,5,home,19,24,5
4284,1,home,0,6,6
4284,2,shop,6,8,2
4284,3,work,8,15,7
4284,4,shop,15,16,1
4284,5,work,16,20,4
4284,6,home,20,24,4
4285,1,home,0,6,6
4285,2,shop,6,7,1
4285,3,home,7,9,2
4285,4,work,9,16,7
4285,5,home,16,24,8
4286,1,home,0,6,6
4286,2,work,6,13,7
4286,3,shop,13,14,1
4286,4,home,14,18,4
4286,5,work,18,20,2
4286,6,home,20,24,4
4287,1,home,0,8,8
4287,2,education,8,11,3
4287,3,home,11,16,5
4287,4,work,16,20,4
4287,5,home,20,24,4
4288,1,home,0,7,7
4288,2,shop,7,8,1
4288,3,home,8,13,5
4288,4,work,13,19,6
4288,5,home,19,24,5
4289,1,home,0,7,7
4289,2,education,7,11,4
4289,3,home,11,18,7
4289,4,shop,18,19,1
4289,5,home,19,24,5
4290,1,home,0,8,8
4290,2,work,8,14,6
4290,3,home,14,24,10
4291,1,home,0,7,7
4291,2,education,7,9,2
4291,3,home,9,16,7
4291,4,shop,16,17,1
4291,5,home,17,24,7
4292,1,home,0,7,7
4292,2,work,7,13,6
4292,3,home,13,17,4
4292,4,work,17,20,3
4292,5,home,20,24,4
4293,1,home,0,8,8
4293,2,work,8,14,6
4293,3,shop,14,15,1
4293,4,work,15,20,5
4293,5,home,20,24,4
4294,1,home,0,7,7
4294,2,work,7,13,6
4294,3,home,13,21,8
4294,4,shop,21,22,1
4294,5,home,22,24,2
4295,1,home,0,6,6
4295,2,work,6,13,7
4295,3,shop,13,14,1
4295,4,home,14,24,10
4296,1,home,0,7,7
4296,2,work,7,13,6
4296,3,home,13,22,9
4296,4,work,22,23,1
4296,5,home,23,24,1
4297,1,home,0,7,7
4297,2,work,7,14,7
4297,3,home,14,22,8
4297,4,work,22,23,1
4297,5,home,23,24,1
4298,1,home,0,7,7
4298,2,shop,7,8,1
4298,3,education,8,11,3
4298,4,home,11,17,6
4298,5,shop,17,18,1
4298,6,home,18,24,6
4299,1,home,0,6,6
4299,2,work,6,7,1
4299,3,home,7,13,6
4299,4,work,13,14,1
4299,5,home,14,21,7
4299,6,shop,21,22,1
4299,7,home,22,24,2
4300,1,home,0,7,7
4300,2,shop,7,8,1
4300,3,work,8,15,7
4300,4,home,15,22,7
4300,5,work,22,23,1
4300,6,home,23,24,1
4301,1,home,0,7,7
4301,2,work,7,13,6
4301,3,home,13,19,6
4301,4,shop,19,21,2
4301,5,home,21,24,3
4302,1,home,0,8,8
4302,2,work,8,14,6
4302,3,shop,14,15,1
4302,4,home,15,24,9
4303,1,home,0,7,7
4303,2,work,7,13,6
4303,3,shop,13,14,1
4303,4,home,14,20,6
4303,5,shop,20,21,1
4303,6,home,21,24,3
4304,1,home,0,7,7
4304,2,work,7,14,7
4304,3,shop,14,15,1
4304,4,home,15,24,9
4305,1,home,0,8,8
4305,2,work,8,15,7
4305,3,home,15,24,9
4306,1,home,0,8,8
4306,2,work,8,14,6
4306,3,home,14,24,10
4307,1,home,0,6,6
4307,2,shop,6,7,1
4307,3,home,7,9,2
4307,4,work,9,13,4
4307,5,home,13,16,3
4307,6,work,16,20,4
4307,7,home,20,24,4
4308,1,home,0,7,7
4308,2,work,7,8,1
4308,3,home,8,13,5
4308,4,work,13,15,2
4308,5,home,15,20,5
4308,6,shop,20,21,1
4308,7,home,21,24,3
4309,1,home,0,8,8
4309,2,work,8,14,6
4309,3,shop,14,15,1
4309,4,work,15,20,5
4309,5,home,20,24,4
4310,1,home,0,6,6
4310,2,shop,6,7,1
4310,3,home,7,9,2
4310,4,education,9,12,3
4310,5,shop,12,14,2
4310,6,education,14,16,2
4310,7,home,16,24,8
4311,1,home,0,7,7
4311,2,work,7,14,7
4311,3,home,14,18,4
4311,4,shop,18,19,1
4311,5,home,19,24,5
4312,1,home,0,7,7
4312,2,work,7,14,7
4312,3,home,14,20,6
4312,4,shop,20,21,1
4312,5,home,21,24,3
4313,1,home,0,6,6
4313,2,work,6,13,7
4313,3,shop,13,14,1
4313,4,home,14,24,10
4314,1,home,0,9,9
4314,2,education,9,14,5
4314,3,work,14,20,6
4314,4,home,20,24,4
4315,1,home,0,7,7
4315,2,education,7,11,4
4315,3,home,11,19,8
4315,4,shop,19,20,1
4315,5,home,20,24,4
4316,1,home,0,7,7
4316,2,work,7,13,6
4316,3,shop,13,14,1
4316,4,home,14,21,7
4316,5,work,21,22,1
4316,6,home,22,24,2
4317,1,home,0,6,6
4317,2,work,6,12,6
4317,3,shop,12,13,1
4317,4,work,13,19,6
4317,5,home,19,24,5
4318,1,home,0,6,6
4318,2,shop,6,7,1
4318,3,home,7,9,2
4318,4,education,9,12,3
4318,5,shop,12,14,2
4318,6,education,14,17,3
4318,7,home,17,24,7
4319,1,home,0,6,6
4319,2,work,6,13,7
4319,3,shop,13,14,1
4319,4,work,14,19,5
4319,5,home,19,24,5
4320,1,home,0,7,7
4320,2,education,7,11,4
4320,3,home,11,16,5
4320,4,shop,16,17,1
4320,5,home,17,24,7
4321,1,home,0,7,7
4321,2,education,7,12,5
4321,3,home,12,17,5
4321,4,shop,17,18,1
4321,5,home,18,24,6
4322,1,home,0,7,7
4322,2,work,7,14,7
4322,3,home,14,24,10
4323,1,home,0,6,6
4323,2,shop,6,7,1
4323,3,home,7,10,3
4323,4,education,10,13,3
4323,5,shop,13,15,2
4323,6,home,15,21,6
4323,7,shop,21,22,1
4323,8,home,22,24,2
4324,1,home,0,8,8
4324,2,work,8,14,6
4324,3,shop,14,15,1
4324,4,work,15,19,4
4324,5,home,19,24,5
4325,1,home,0,7,7
4325,2,work,7,14,7
4325,3,shop,14,15,1
4325,4,home,15,24,9
4326,1,home,0,7,7
4326,2,education,7,11,4
4326,3,home,11,18,7
4326,4,shop,18,19,1
4326,5,home,19,24,5
4327,1,home,0,7,7
4327,2,work,7,14,7
4327,3,shop,14,15,1
4327,4,home,15,22,7
4327,5,work,22,23,1
4327,6,home,23,24,1
4328,1,home,0,7,7
4328,2,work,7,14,7
4328,3,home,14,24,10
4329,1,home,0,7,7
4329,2,work,7,14,7
4329,3,shop,14,15,1
4329,4,home,15,24,9
4330,1,home,0,7,7
4330,2,work,7,14,7
4330,3,home,14,24,10
4331,1,home,0,7,7
4331,2,work,7,14,7
4331,3,shop,14,15,1
4331,4,home,15,24,9
4332,1,home,0,8,8
4332,2,work,8,15,7
4332,3,shop,15,16,1
4332,4,home,16,22,6
4332,5,work,22,23,1
4332,6,home,23,24,1
4333,1,home,0,7,7
4333,2,work,7,13,6
4333,3,shop,13,14,1
4333,4,home,14,24,10
4334,1,home,0,8,8
4334,2,work,8,14,6
4334,3,home,14,22,8
4334,4,work,22,23,1
4334,5,home,23,24,1
4335,1,home,0,7,7
4335,2,work,7,13,6
4335,3,home,13,17,4
4335,4,work,17,19,2
4335,5,home,19,24,5
4336,1,home,0,7,7
4336,2,shop,7,8,1
4336,3,work,8,15,7
4336,4,home,15,22,7
4336,5,work,22,23,1
4336,6,home,23,24,1
4337,1,home,0,7,7
4337,2,work,7,14,7
4337,3,home,14,22,8
4337,4,work,22,23,1
4337,5,home,23,24,1
4338,1,home,0,7,7
4338,2,work,7,13,6
4338,3,home,13,20,7
4338,4,shop,20,21,1
4338,5,home,21,24,3
4339,1,home,0,7,7
4339,2,work,7,13,6
4339,3,home,13,24,11
4340,1,home,0,7,7
4340,2,work,7,14,7
4340,3,home,14,24,10
4341,1,home,0,6,6
4341,2,work,6,13,7
4341,3,shop,13,15,2
4341,4,home,15,24,9
4342,1,home,0,8,8
4342,2,work,8,14,6
4342,3,shop,14,15,1
4342,4,home,15,23,8
4342,5,work,23,24,1
4343,1,home,0,6,6
4343,2,shop,6,7,1
4343,3,home,7,13,6
4343,4,education,13,16,3
4343,5,home,16,24,8
4344,1,home,0,8,8
4344,2,work,8,14,6
4344,3,home,14,16,2
4344,4,work,16,19,3
4344,5,home,19,24,5
4345,1,home,0,6,6
4345,2,work,6,13,7
4345,3,home,13,24,11
4346,1,home,0,6,6
4346,2,work,6,8,2
4346,3,home,8,11,3
4346,4,work,11,12,1
4346,5,home,12,16,4
4346,6,work,16,18,2
4346,7,home,18,24,6
4347,1,home,0,6,6
4347,2,work,6,8,2
4347,3,home,8,15,7
4347,4,work,15,17,2
4347,5,home,17,24,7
4348,1,home,0,6,6
4348,2,work,6,13,7
4348,3,shop,13,14,1
4348,4,work,14,19,5
4348,5,home,19,24,5
4349,1,home,0,7,7
4349,2,shop,7,8,1
4349,3,education,8,12,4
4349,4,shop,12,14,2
4349,5,home,14,20,6
4349,6,shop,20,21,1
4349,7,home,21,24,3
4350,1,home,0,7,7
4350,2,shop,7,8,1
4350,3,education,8,11,3
4350,4,home,11,14,3
4350,5,education,14,16,2
4350,6,home,16,24,8
4351,1,home,0,7,7
4351,2,education,7,12,5
4351,3,shop,12,14,2
4351,4,education,14,16,2
4351,5,home,16,21,5
4351,6,shop,21,22,1
4351,7,home,22,24,2
4352,1,home,0,6,6
4352,2,work,6,9,3
4352,3,home,9,15,6
4352,4,work,15,18,3
4352,5,home,18,24,6
4353,1,home,0,7,7
4353,2,work,7,14,7
4353,3,home,14,24,10
4354,1,home,0,6,6
4354,2,work,6,8,2
4354,3,home,8,12,4
4354,4,work,12,13,1
4354,5,shop,13,14,1
4354,6,home,14,21,7
4354,7,work,21,22,1
4354,8,home,22,24,2
4355,1,home,0,7,7
4355,2,work,7,14,7
4355,3,shop,14,15,1
4355,4,home,15,24,9
4356,1,home,0,6,6
4356,2,work,6,12,6
4356,3,shop,12,13,1
4356,4,work,13,19,6
4356,5,home,19,24,5
4357,1,home,0,8,8
4357,2,education,8,11,3
4357,3,home,11,18,7
4357,4,work,18,20,2
4357,5,home,20,24,4
4358,1,home,0,6,6
4358,2,work,6,13,7
4358,3,shop,13,14,1
4358,4,work,14,19,5
4358,5,home,19,24,5
4359,1,home,0,6,6
4359,2,work,6,13,7
4359,3,home,13,24,11
4360,1,home,0,6,6
4360,2,work,6,8,2
4360,3,home,8,12,4
4360,4,work,12,14,2
4360,5,home,14,21,7
4360,6,work,21,22,1
4360,7,home,22,24,2
4361,1,home,0,7,7
4361,2,work,7,14,7
4361,3,home,14,24,10
4362,1,home,0,7,7
4362,2,work,7,14,7
4362,3,shop,14,15,1
4362,4,home,15,24,9
4363,1,home,0,8,8
4363,2,work,8,15,7
4363,3,home,15,24,9
4364,1,home,0,6,6
4364,2,shop,6,7,1
4364,3,home,7,11,4
4364,4,work,11,18,7
4364,5,home,18,24,6
4365,1,home,0,7,7
4365,2,work,7,14,7
4365,3,shop,14,15,1
4365,4,home,15,24,9
4366,1,home,0,6,6
4366,2,work,6,13,7
4366,3,shop,13,14,1
4366,4,work,14,19,5
4366,5,home,19,22,3
4366,6,work,22,23,1
4366,7,home,23,24,1
4367,1,home,0,6,6
4367,2,shop,6,7,1
4367,3,home,7,10,3
4367,4,education,10,15,5
4367,5,shop,15,16,1
4367,6,home,16,24,8
4368,1,home,0,6,6
4368,2,shop,6,7,1
4368,3,home,7,10,3
4368,4,education,10,13,3
4368,5,shop,13,15,2
4368,6,home,15,21,6
4368,7,shop,21,22,1
4368,8,home,22,24,2
4369,1,home,0,7,7
4369,2,education,7,13,6
4369,3,shop,13,14,1
4369,4,education,14,16,2
4369,5,home,16,19,3
4369,6,shop,19,20,1
4369,7,home,20,24,4
4370,1,home,0,7,7
4370,2,shop,7,8,1
4370,3,education,8,11,3
4370,4,home,11,17,6
4370,5,shop,17,18,1
4370,6,home,18,24,6
4371,1,home,0,7,7
4371,2,work,7,13,6
4371,3,home,13,18,5
4371,4,work,18,20,2
4371,5,home,20,24,4
4372,1,home,0,6,6
4372,2,shop,6,7,1
4372,3,home,7,13,6
4372,4,education,13,16,3
4372,5,home,16,24,8
4373,1,home,0,6,6
4373,2,work,6,13,7
4373,3,home,13,16,3
4373,4,work,16,20,4
4373,5,home,20,24,4
4374,1,home,0,6,6
4374,2,work,6,7,1
4374,3,home,7,12,5
4374,4,work,12,14,2
4374,5,home,14,20,6
4374,6,shop,20,21,1
4374,7,home,21,24,3
4375,1,home,0,7,7
4375,2,education,7,12,5
4375,3,shop,12,13,1
4375,4,education,13,16,3
4375,5,home,16,24,8
4376,1,home,0,6,6
4376,2,work,6,13,7
4376,3,shop,13,14,1
4376,4,home,14,24,10
4377,1,home,0,7,7
4377,2,work,7,14,7
4377,3,home,14,24,10
4378,1,home,0,8,8
4378,2,work,8,16,8
4378,3,shop,16,18,2
4378,4,work,18,20,2
4378,5,home,20,24,4
4379,1,home,0,7,7
4379,2,work,7,9,2
4379,3,home,9,13,4
4379,4,work,13,15,2
4379,5,home,15,21,6
4379,6,work,21,22,1
4379,7,home,22,24,2
4380,1,home,0,7,7
4380,2,shop,7,8,1
4380,3,work,8,15,7
4380,4,home,15,24,9
4381,1,home,0,9,9
4381,2,work,9,16,7
4381,3,home,16,21,5
4381,4,work,21,22,1
4381,5,home,22,24,2
4382,1,home,0,7,7
4382,2,work,7,13,6
4382,3,home,13,24,11
4383,1,home,0,7,7
4383,2,education,7,11,4
4383,3,home,11,14,3
4383,4,education,14,16,2
4383,5,home,16,24,8
4384,1,home,0,7,7
4384,2,work,7,13,6
4384,3,shop,13,14,1
4384,4,home,14,24,10
4385,1,home,0,6,6
4385,2,work,6,13,7
4385,3,home,13,16,3
4385,4,work,16,20,4
4385,5,home,20,24,4
4386,1,home,0,6,6
4386,2,work,6,8,2
4386,3,home,8,14,6
4386,4,work,14,16,2
4386,5,home,16,22,6
4386,6,work,22,23,1
4386,7,home,23,24,1
4387,1,home,0,7,7
4387,2,education,7,11,4
4387,3,home,11,18,7
4387,4,shop,18,20,2
4387,5,home,20,24,4
4388,1,home,0,6,6
4388,2,work,6,13,7
4388,3,shop,13,14,1
4388,4,work,14,17,3
4388,5,home,17,24,7
4389,1,home,0,6,6
4389,2,work,6,8,2
4389,3,home,8,13,5
4389,4,work,13,15,2
4389,5,home,15,22,7
4389,6,work,22,23,1
4389,7,home,23,24,1
4390,1,home,0,6,6
4390,2,shop,6,7,1
4390,3,home,7,10,3
4390,4,education,10,12,2
4390,5,shop,12,14,2
4390,6,home,14,24,10
4391,1,home,0,8,8
4391,2,work,8,15,7
4391,3,home,15,24,9
4392,1,home,0,7,7
4392,2,work,7,13,6
4392,3,home,13,17,4
4392,4,work,17,20,3
4392,5,home,20,24,4
4393,1,home,0,8,8
4393,2,work,8,14,6
4393,3,home,14,24,10
4394,1,home,0,7,7
4394,2,work,7,14,7
4394,3,home,14,22,8
4394,4,work,22,23,1
4394,5,home,23,24,1
4395,1,home,0,7,7
4395,2,education,7,12,5
4395,3,shop,12,14,2
4395,4,education,14,16,2
4395,5,home,16,24,8
4396,1,home,0,7,7
4396,2,work,7,13,6
4396,3,shop,13,14,1
4396,4,work,14,19,5
4396,5,home,19,24,5
4397,1,home,0,6,6
4397,2,shop,6,7,1
4397,3,home,7,10,3
4397,4,education,10,13,3
4397,5,home,13,19,6
4397,6,shop,19,20,1
4397,7,home,20,24,4
4398,1,home,0,8,8
4398,2,work,8,14,6
4398,3,shop,14,15,1
4398,4,home,15,17,2
4398,5,work,17,20,3
4398,6,home,20,24,4
4399,1,home,0,7,7
4399,2,work,7,14,7
4399,3,home,14,24,10
4400,1,home,0,7,7
4400,2,work,7,9,2
4400,3,home,9,16,7
4400,4,work,16,17,1
4400,5,home,17,24,7
4401,1,home,0,9,9
4401,2,work,9,16,7
4401,3,shop,16,17,1
4401,4,home,17,21,4
4401,5,work,21,22,1
4401,6,home,22,24,2
4402,1,home,0,7,7
4402,2,shop,7,9,2
4402,3,education,9,13,4
4402,4,home,13,18,5
4402,5,shop,18,19,1
4402,6,home,19,24,5
4403,1,home,0,7,7
4403,2,work,7,9,2
4403,3,home,9,13,4
4403,4,work,13,15,2
4403,5,home,15,21,6
4403,6,work,21,22,1
4403,7,home,22,24,2
4404,1,home,0,7,7
4404,2,work,7,13,6
4404,3,shop,13,14,1
4404,4,home,14,22,8
4404,5,work,22,23,1
4404,6,home,23,24,1
4405,1,home,0,6,6
4405,2,work,6,13,7
4405,3,shop,13,14,1
4405,4,education,14,17,3
4405,5,home,17,24,7
4406,1,home,0,8,8
4406,2,work,8,15,7
4406,3,home,15,24,9
4407,1,home,0,7,7
4407,2,work,7,14,7
4407,3,shop,14,15,1
4407,4,home,15,24,9
4408,1,home,0,6,6
4408,2,work,6,13,7
4408,3,shop,13,14,1
4408,4,home,14,16,2
4408,5,work,16,20,4
4408,6,home,20,24,4
4409,1,home,0,7,7
4409,2,work,7,9,2
4409,3,home,9,15,6
4409,4,work,15,17,2
4409,5,home,17,23,6
4409,6,work,23,24,1
4410,1,home,0,8,8
4410,2,work,8,15,7
4410,3,home,15,24,9
4411,1,home,0,7,7
4411,2,shop,7,8,1
4411,3,education,8,11,3
4411,4,home,11,18,7
4411,5,shop,18,19,1
4411,6,home,19,24,5
4412,1,home,0,6,6
4412,2,work,6,14,8
4412,3,shop,14,15,1
4412,4,work,15,20,5
4412,5,home,20,24,4
4413,1,home,0,9,9
4413,2,work,9,16,7
4413,3,home,16,24,8
4414,1,home,0,6,6
4414,2,work,6,13,7
4414,3,shop,13,14,1
4414,4,work,14,20,6
4414,5,home,20,24,4
4415,1,home,0,7,7
4415,2,work,7,13,6
4415,3,home,13,17,4
4415,4,work,17,20,3
4415,5,home,20,24,4
4416,1,home,0,8,8
4416,2,work,8,15,7
4416,3,home,15,20,5
4416,4,shop,20,21,1
4416,5,home,21,24,3
4417,1,home,0,7,7
4417,2,shop,7,8,1
4417,3,work,8,15,7
4417,4,home,15,24,9
4418,1,home,0,6,6
4418,2,shop,6,7,1
4418,3,home,7,10,3
4418,4,work,10,11,1
4418,5,home,11,21,10
4418,6,work,21,22,1
4418,7,home,22,24,2
4419,1,home,0,8,8
4419,2,work,8,15,7
4419,3,home,15,24,9
4420,1,home,0,7,7
4420,2,education,7,13,6
4420,3,home,13,20,7
4420,4,shop,20,21,1
4420,5,home,21,24,3
4421,1,home,0,8,8
4421,2,work,8,16,8
4421,3,home,16,24,8
4422,1,home,0,8,8
4422,2,work,8,15,7
4422,3,shop,15,16,1
4422,4,work,16,20,4
4422,5,home,20,24,4
4423,1,home,0,7,7
4423,2,work,7,9,2
4423,3,home,9,13,4
4423,4,work,13,15,2
4423,5,home,15,22,7
4423,6,work,22,23,1
4423,7,home,23,24,1
4424,1,home,0,7,7
4424,2,work,7,13,6
4424,3,home,13,20,7
4424,4,shop,20,21,1
4424,5,home,21,24,3
4425,1,home,0,8,8
4425,2,education,8,11,3
4425,3,home,11,14,3
4425,4,education,14,16,2
4425,5,home,16,24,8
4426,1,home,0,6,6
4426,2,shop,6,7,1
4426,3,work,7,15,8
4426,4,home,15,21,6
4426,5,work,21,22,1
4426,6,home,22,24,2
4427,1,home,0,6,6
4427,2,shop,6,7,1
4427,3,home,7,9,2
4427,4,education,9,13,4
4427,5,shop,13,15,2
4427,6,home,15,24,9
4428,1,home,0,5,5
4428,2,work,5,13,8
4428,3,home,13,17,4
4428,4,work,17,20,3
4428,5,home,20,24,4
4429,1,home,0,6,6
4429,2,work,6,13,7
4429,3,shop,13,15,2
4429,4,home,15,24,9
4430,1,home,0,8,8
4430,2,work,8,15,7
4430,3,shop,15,16,1
4430,4,home,16,23,7
4430,5,work,23,24,1
4431,1,home,0,8,8
4431,2,shop,8,9,1
4431,3,work,9,16,7
4431,4,home,16,24,8
4432,1,home,0,8,8
4432,2,work,8,15,7
4432,3,home,15,24,9
4433,1,home,0,8,8
4433,2,work,8,14,6
4433,3,home,14,24,10
4434,1,home,0,7,7
4434,2,shop,7,8,1
4434,3,education,8,12,4
4434,4,home,12,21,9
4434,5,shop,21,22,1
4434,6,home,22,24,2
4435,1,home,0,6,6
4435,2,shop,6,7,1
4435,3,home,7,8,1
4435,4,work,8,14,6
4435,5,shop,14,15,1
4435,6,work,15,19,4
4435,7,home,19,24,5
4436,1,home,0,8,8
4436,2,education,8,11,3
4436,3,home,11,22,11
4436,4,work,22,23,1
4436,5,home,23,24,1
4437,1,home,0,8,8
4437,2,work,8,14,6
4437,3,home,14,24,10
4438,1,home,0,7,7
4438,2,work,7,13,6
4438,3,shop,13,14,1
4438,4,home,14,24,10
4439,1,home,0,7,7
4439,2,work,7,14,7
4439,3,home,14,18,4
4439,4,work,18,20,2
4439,5,home,20,24,4
4440,1,home,0,8,8
4440,2,education,8,9,1
4440,3,home,9,16,7
4440,4,shop,16,17,1
4440,5,home,17,24,7
4441,1,home,0,6,6
4441,2,work,6,13,7
4441,3,shop,13,14,1
4441,4,home,14,23,9
4441,5,work,23,24,1
4442,1,home,0,7,7
4442,2,education,7,11,4
4442,3,home,11,17,6
4442,4,shop,17,18,1
4442,5,home,18,24,6
4443,1,home,0,9,9
4443,2,work,9,15,6
4443,3,home,15,22,7
4443,4,work,22,23,1
4443,5,home,23,24,1
4444,1,home,0,7,7
4444,2,education,7,11,4
4444,3,home,11,18,7
4444,4,shop,18,19,1
4444,5,home,19,24,5
4445,1,home,0,6,6
4445,2,work,6,13,7
4445,3,home,13,17,4
4445,4,work,17,20,3
4445,5,home,20,24,4
4446,1,home,0,7,7
4446,2,work,7,9,2
4446,3,home,9,12,3
4446,4,work,12,13,1
4446,5,home,13,21,8
4446,6,work,21,22,1
4446,7,home,22,24,2
4447,1,home,0,8,8
4447,2,work,8,14,6
4447,3,home,14,23,9
4447,4,work,23,24,1
4448,1,home,0,8,8
4448,2,work,8,15,7
4448,3,home,15,21,6
4448,4,work,21,22,1
4448,5,home,22,24,2
4449,1,home,0,6,6
4449,2,shop,6,7,1
4449,3,home,7,10,3
4449,4,education,10,12,2
4449,5,home,12,18,6
4449,6,shop,18,20,2
4449,7,home,20,24,4
4450,1,home,0,8,8
4450,2,work,8,15,7
4450,3,home,15,24,9
4451,1,home,0,6,6
4451,2,work,6,7,1
4451,3,home,7,12,5
4451,4,work,12,13,1
4451,5,home,13,18,5
4451,6,work,18,19,1
4451,7,home,19,23,4
4451,8,work,23,24,1
4452,1,home,0,8,8
4452,2,shop,8,9,1
4452,3,work,9,16,7
4452,4,home,16,21,5
4452,5,work,21,22,1
4452,6,home,22,24,2
4453,1,home,0,7,7
4453,2,education,7,12,5
4453,3,home,12,18,6
4453,4,shop,18,19,1
4453,5,home,19,24,5
4454,1,home,0,7,7
4454,2,education,7,12,5
4454,3,shop,12,13,1
4454,4,education,13,16,3
4454,5,home,16,24,8
4455,1,home,0,8,8
4455,2,education,8,12,4
4455,3,home,12,19,7
4455,4,shop,19,20,1
4455,5,home,20,24,4
4456,1,home,0,7,7
4456,2,shop,7,8,1
4456,3,education,8,12,4
4456,4,shop,12,14,2
4456,5,education,14,16,2
4456,6,home,16,24,8
4457,1,home,0,7,7
4457,2,work,7,14,7
4457,3,shop,14,15,1
4457,4,home,15,24,9
4458,1,home,0,6,6
4458,2,shop,6,7,1
4458,3,home,7,10,3
4458,4,education,10,12,2
4458,5,shop,12,13,1
4458,6,education,13,16,3
4458,7,home,16,24,8
4459,1,home,0,7,7
4459,2,work,7,9,2
4459,3,home,9,10,1
4459,4,work,10,12,2
4459,5,home,12,16,4
4459,6,work,16,18,2
4459,7,home,18,21,3
4459,8,work,21,22,1
4459,9,home,22,24,2
4460,1,home,0,8,8
4460,2,work,8,15,7
4460,3,home,15,24,9
4461,1,home,0,9,9
4461,2,work,9,15,6
4461,3,home,15,24,9
4462,1,home,0,7,7
4462,2,work,7,14,7
4462,3,shop,14,15,1
4462,4,home,15,24,9
4463,1,home,0,6,6
4463,2,work,6,13,7
4463,3,home,13,18,5
4463,4,work,18,20,2
4463,5,home,20,24,4
4464,1,home,0,7,7
4464,2,work,7,9,2
4464,3,home,9,15,6
4464,4,work,15,17,2
4464,5,home,17,24,7
4465,1,home,0,6,6
4465,2,shop,6,7,1
4465,3,home,7,10,3
4465,4,education,10,13,3
4465,5,home,13,19,6
4465,6,shop,19,20,1
4465,7,home,20,24,4
4466,1,home,0,6,6
4466,2,work,6,7,1
4466,3,home,7,12,5
4466,4,work,12,14,2
4466,5,home,14,22,8
4466,6,work,22,23,1
4466,7,home,23,24,1
4467,1,home,0,7,7
4467,2,work,7,13,6
4467,3,home,13,23,10
4467,4,work,23,24,1
4468,1,home,0,7,7
4468,2,work,7,13,6
4468,3,shop,13,14,1
4468,4,home,14,22,8
4468,5,work,22,23,1
4468,6,home,23,24,1
4469,1,home,0,8,8
4469,2,work,8,15,7
4469,3,shop,15,16,1
4469,4,home,16,24,8
4470,1,home,0,9,9
4470,2,work,9,16,7
4470,3,home,16,21,5
4470,4,work,21,22,1
4470,5,home,22,24,2
4471,1,home,0,7,7
4471,2,shop,7,8,1
4471,3,work,8,15,7
4471,4,home,15,24,9
4472,1,home,0,7,7
4472,2,work,7,14,7
4472,3,home,14,24,10
4473,1,home,0,8,8
4473,2,work,8,15,7
4473,3,home,15,24,9
4474,1,home,0,6,6
4474,2,shop,6,7,1
4474,3,home,7,13,6
4474,4,education,13,16,3
4474,5,home,16,24,8
4475,1,home,0,7,7
4475,2,work,7,9,2
4475,3,home,9,12,3
4475,4,work,12,15,3
4475,5,home,15,23,8
4475,6,work,23,24,1
4476,1,home,0,6,6
4476,2,work,6,13,7
4476,3,shop,13,15,2
4476,4,work,15,20,5
4476,5,home,20,24,4
4477,1,home,0,6,6
4477,2,work,6,13,7
4477,3,shop,13,15,2
4477,4,home,15,24,9
4478,1,home,0,8,8
4478,2,work,8,16,8
4478,3,home,16,17,1
4478,4,work,17,20,3
4478,5,home,20,24,4
4479,1,home,0,9,9
4479,2,education,9,12,3
4479,3,work,12,18,6
4479,4,home,18,23,5
4479,5,work,23,24,1
4480,1,home,0,7,7
4480,2,work,7,13,6
4480,3,shop,13,14,1
4480,4,home,14,24,10
4481,1,home,0,8,8
4481,2,work,8,15,7
4481,3,home,15,24,9
4482,1,home,0,6,6
4482,2,shop,6,7,1
4482,3,home,7,13,6
4482,4,education,13,17,4
4482,5,home,17,22,5
4482,6,work,22,23,1
4482,7,home,23,24,1
4483,1,home,0,8,8
4483,2,work,8,15,7
4483,3,shop,15,16,1
4483,4,home,16,21,5
4483,5,work,21,22,1
4483,6,home,22,24,2
4484,1,home,0,7,7
4484,2,education,7,11,4
4484,3,home,11,19,8
4484,4,shop,19,20,1
4484,5,home,20,24,4
4485,1,home,0,7,7
4485,2,work,7,13,6
4485,3,shop,13,14,1
4485,4,home,14,24,10
4486,1,home,0,6,6
4486,2,shop,6,7,1
4486,3,home,7,9,2
4486,4,education,9,11,2
4486,5,home,11,15,4
4486,6,shop,15,16,1
4486,7,home,16,24,8
4487,1,home,0,6,6
4487,2,work,6,13,7
4487,3,home,13,24,11
4488,1,home,0,7,7
4488,2,shop,7,8,1
4488,3,work,8,14,6
4488,4,home,14,24,10
4489,1,home,0,6,6
4489,2,work,6,13,7
4489,3,shop,13,14,1
4489,4,work,14,19,5
4489,5,home,19,24,5
4490,1,home,0,6,6
4490,2,work,6,7,1
4490,3,home,7,11,4
4490,4,work,11,13,2
4490,5,home,13,18,5
4490,6,work,18,19,1
4490,7,home,19,24,5
4491,1,home,0,9,9
4491,2,work,9,16,7
4491,3,home,16,20,4
4491,4,shop,20,21,1
4491,5,home,21,24,3
4492,1,home,0,6,6
4492,2,work,6,13,7
4492,3,home,13,24,11
4493,1,home,0,8,8
4493,2,work,8,14,6
4493,3,shop,14,15,1
4493,4,home,15,24,9
4494,1,home,0,6,6
4494,2,work,6,8,2
4494,3,home,8,12,4
4494,4,work,12,14,2
4494,5,home,14,21,7
4494,6,work,21,22,1
4494,7,home,22,24,2
4495,1,home,0,8,8
4495,2,work,8,15,7
4495,3,shop,15,16,1
4495,4,home,16,24,8
4496,1,home,0,8,8
4496,2,work,8,13,5
4496,3,home,13,23,10
4496,4,work,23,24,1
4497,1,home,0,8,8
4497,2,education,8,11,3
4497,3,home,11,17,6
4497,4,shop,17,18,1
4497,5,home,18,24,6
4498,1,work,0,7,7
4498,2,shop,7,8,1
4498,3,home,8,11,3
4498,4,work,11,17,6
4498,5,home,17,24,7
4499,1,home,0,7,7
4499,2,work,7,14,7
4499,3,shop,14,15,1
4499,4,home,15,24,9
4500,1,home,0,7,7
4500,2,work,7,13,6
4500,3,shop,13,14,1
4500,4,work,14,19,5
4500,5,home,19,24,5
4501,1,home,0,9,9
4501,2,work,9,15,6
4501,3,home,15,24,9
4502,1,home,0,6,6
4502,2,work,6,13,7
4502,3,home,13,24,11
4503,1,home,0,8,8
4503,2,work,8,13,5
4503,3,shop,13,14,1
4503,4,work,14,18,4
4503,5,education,18,20,2
4503,6,home,20,24,4
4504,1,home,0,7,7
4504,2,education,7,12,5
4504,3,shop,12,14,2
4504,4,education,14,16,2
4504,5,home,16,24,8
4505,1,home,0,8,8
4505,2,work,8,15,7
4505,3,home,15,22,7
4505,4,work,22,23,1
4505,5,home,23,24,1
4506,1,home,0,7,7
4506,2,work,7,13,6
4506,3,home,13,24,11
4507,1,home,0,7,7
4507,2,work,7,13,6
4507,3,home,13,24,11
4508,1,home,0,8,8
4508,2,work,8,14,6
4508,3,home,14,18,4
4508,4,work,18,20,2
4508,5,home,20,24,4
4509,1,home,0,7,7
4509,2,education,7,12,5
4509,3,shop,12,13,1
4509,4,education,13,16,3
4509,5,home,16,24,8
4510,1,home,0,8,8
4510,2,work,8,15,7
4510,3,home,15,24,9
4511,1,home,0,6,6
4511,2,shop,6,7,1
4511,3,home,7,13,6
4511,4,education,13,16,3
4511,5,home,16,24,8
4512,1,home,0,6,6
4512,2,work,6,13,7
4512,3,home,13,17,4
4512,4,work,17,19,2
4512,5,education,19,20,1
4512,6,home,20,24,4
4513,1,home,0,7,7
4513,2,work,7,13,6
4513,3,shop,13,14,1
4513,4,work,14,19,5
4513,5,home,19,24,5
4514,1,home,0,7,7
4514,2,work,7,13,6
4514,3,shop,13,14,1
4514,4,work,14,20,6
4514,5,home,20,24,4
4515,1,home,0,6,6
4515,2,work,6,12,6
4515,3,shop,12,13,1
4515,4,education,13,16,3
4515,5,home,16,24,8
4516,1,home,0,7,7
4516,2,work,7,9,2
4516,3,home,9,15,6
4516,4,work,15,18,3
4516,5,home,18,24,6
4517,1,home,0,8,8
4517,2,education,8,12,4
4517,3,shop,12,13,1
4517,4,home,13,21,8
4517,5,shop,21,22,1
4517,6,home,22,24,2
4518,1,home,0,7,7
4518,2,work,7,13,6
4518,3,shop,13,14,1
4518,4,home,14,24,10
4519,1,home,0,7,7
4519,2,work,7,14,7
4519,3,home,14,24,10
4520,1,home,0,7,7
4520,2,work,7,15,8
4520,3,home,15,24,9
4521,1,home,0,6,6
4521,2,work,6,13,7
4521,3,home,13,17,4
4521,4,shop,17,18,1
4521,5,work,18,20,2
4521,6,home,20,24,4
4522,1,home,0,6,6
4522,2,work,6,13,7
4522,3,home,13,24,11
4523,1,home,0,6,6
4523,2,work,6,13,7
4523,3,home,13,21,8
4523,4,work,21,22,1
4523,5,home,22,24,2
4524,1,home,0,6,6
4524,2,work,6,13,7
4524,3,home,13,24,11
4525,1,home,0,8,8
4525,2,work,8,15,7
4525,3,home,15,23,8
4525,4,work,23,24,1
4526,1,home,0,8,8
4526,2,work,8,15,7
4526,3,home,15,23,8
4526,4,work,23,24,1
4527,1,work,0,7,7
4527,2,shop,7,8,1
4527,3,work,8,13,5
4527,4,home,13,24,11
4528,1,home,0,7,7
4528,2,education,7,11,4
4528,3,home,11,18,7
4528,4,shop,18,19,1
4528,5,home,19,24,5
4529,1,home,0,7,7
4529,2,work,7,14,7
4529,3,home,14,18,4
4529,4,work,18,20,2
4529,5,home,20,24,4
4530,1,home,0,9,9
4530,2,work,9,18,9
4530,3,home,18,22,4
4530,4,work,22,23,1
4530,5,home,23,24,1
4531,1,home,0,8,8
4531,2,work,8,16,8
4531,3,home,16,24,8
4532,1,home,0,6,6
4532,2,work,6,13,7
4532,3,shop,13,15,2
4532,4,home,15,24,9
4533,1,home,0,8,8
4533,2,education,8,12,4
4533,3,home,12,16,4
4533,4,work,16,20,4
4533,5,home,20,24,4
4534,1,home,0,8,8
4534,2,education,8,11,3
4534,3,home,11,15,4
4534,4,work,15,19,4
4534,5,home,19,24,5
4535,1,home,0,7,7
4535,2,work,7,15,8
4535,3,home,15,21,6
4535,4,shop,21,22,1
4535,5,home,22,24,2
4536,1,home,0,7,7
4536,2,work,7,14,7
4536,3,home,14,24,10
4537,1,home,0,7,7
4537,2,work,7,13,6
4537,3,home,13,21,8
4537,4,work,21,22,1
4537,5,home,22,24,2
4538,1,work,0,9,9
4538,2,shop,9,10,1
4538,3,work,10,13,3
4538,4,home,13,24,11
4539,1,home,0,7,7
4539,2,work,7,13,6
4539,3,shop,13,14,1
4539,4,home,14,23,9
4539,5,work,23,24,1
4540,1,home,0,6,6
4540,2,shop,6,7,1
4540,3,home,7,11,4
4540,4,education,11,15,4
4540,5,shop,15,16,1
4540,6,home,16,21,5
4540,7,work,21,22,1
4540,8,home,22,24,2
4541,1,home,0,6,6
4541,2,shop,6,7,1
4541,3,home,7,10,3
4541,4,education,10,13,3
4541,5,shop,13,14,1
4541,6,education,14,17,3
4541,7,home,17,24,7
4542,1,home,0,8,8
4542,2,work,8,14,6
4542,3,home,14,24,10
4543,1,home,0,7,7
4543,2,work,7,13,6
4543,3,shop,13,14,1
4543,4,home,14,22,8
4543,5,work,22,23,1
4543,6,home,23,24,1
4544,1,home,0,7,7
4544,2,work,7,13,6
4544,3,home,13,18,5
4544,4,work,18,20,2
4544,5,home,20,24,4
4545,1,home,0,6,6
4545,2,work,6,12,6
4545,3,shop,12,13,1
4545,4,work,13,19,6
4545,5,home,19,24,5
4546,1,home,0,7,7
4546,2,work,7,12,5
4546,3,shop,12,13,1
4546,4,work,13,19,6
4546,5,home,19,24,5
4547,1,home,0,7,7
4547,2,shop,7,8,1
4547,3,work,8,15,7
4547,4,home,15,24,9
4548,1,home,0,7,7
4548,2,shop,7,8,1
4548,3,education,8,11,3
4548,4,home,11,18,7
4548,5,shop,18,19,1
4548,6,home,19,24,5
4549,1,home,0,8,8
4549,2,work,8,14,6
4549,3,shop,14,15,1
4549,4,home,15,24,9
4550,1,home,0,7,7
4550,2,work,7,9,2
4550,3,home,9,15,6
4550,4,work,15,17,2
4550,5,home,17,23,6
4550,6,work,23,24,1
4551,1,home,0,7,7
4551,2,education,7,12,5
4551,3,home,12,20,8
4551,4,shop,20,21,1
4551,5,home,21,24,3
4552,1,home,0,7,7
4552,2,education,7,11,4
4552,3,home,11,16,5
4552,4,shop,16,17,1
4552,5,home,17,24,7
4553,1,home,0,7,7
4553,2,work,7,9,2
4553,3,home,9,13,4
4553,4,work,13,15,2
4553,5,home,15,21,6
4553,6,work,21,22,1
4553,7,home,22,24,2
4554,1,home,0,6,6
4554,2,work,6,13,7
4554,3,shop,13,14,1
4554,4,home,14,24,10
4555,1,home,0,7,7
4555,2,work,7,13,6
4555,3,shop,13,14,1
4555,4,work,14,19,5
4555,5,home,19,24,5
4556,1,home,0,7,7
4556,2,work,7,13,6
4556,3,home,13,17,4
4556,4,work,17,20,3
4556,5,home,20,24,4
4557,1,home,0,7,7
4557,2,education,7,11,4
4557,3,home,11,14,3
4557,4,education,14,16,2
4557,5,home,16,24,8
4558,1,home,0,6,6
4558,2,shop,6,7,1
4558,3,home,7,10,3
4558,4,education,10,12,2
4558,5,shop,12,14,2
4558,6,education,14,16,2
4558,7,home,16,24,8
4559,1,home,0,7,7
4559,2,work,7,9,2
4559,3,home,9,13,4
4559,4,work,13,15,2
4559,5,home,15,23,8
4559,6,work,23,24,1
4560,1,home,0,6,6
4560,2,work,6,8,2
4560,3,home,8,12,4
4560,4,work,12,13,1
4560,5,home,13,15,2
4560,6,work,15,17,2
4560,7,home,17,23,6
4560,8,work,23,24,1
4561,1,home,0,7,7
4561,2,education,7,11,4
4561,3,home,11,19,8
4561,4,shop,19,20,1
4561,5,home,20,24,4
4562,1,home,0,8,8
4562,2,work,8,15,7
4562,3,shop,15,16,1
4562,4,home,16,24,8
4563,1,home,0,7,7
4563,2,education,7,11,4
4563,3,home,11,17,6
4563,4,shop,17,18,1
4563,5,home,18,24,6
4564,1,work,0,1,1
4564,2,home,1,7,6
4564,3,education,7,10,3
4564,4,home,10,14,4
4564,5,education,14,17,3
4564,6,shop,17,18,1
4564,7,home,18,24,6
4565,1,home,0,8,8
4565,2,work,8,15,7
4565,3,shop,15,16,1
4565,4,home,16,21,5
4565,5,work,21,22,1
4565,6,home,22,24,2
4566,1,home,0,6,6
4566,2,shop,6,7,1
4566,3,work,7,14,7
4566,4,home,14,24,10
4567,1,home,0,7,7
4567,2,education,7,11,4
4567,3,home,11,14,3
4567,4,education,14,16,2
4567,5,home,16,24,8
4568,1,home,0,6,6
4568,2,work,6,13,7
4568,3,home,13,22,9
4568,4,work,22,23,1
4568,5,home,23,24,1
4569,1,home,0,7,7
4569,2,work,7,13,6
4569,3,shop,13,14,1
4569,4,work,14,20,6
4569,5,home,20,24,4
4570,1,home,0,6,6
4570,2,work,6,13,7
4570,3,home,13,14,1
4570,4,work,14,20,6
4570,5,home,20,24,4
4571,1,home,0,7,7
4571,2,work,7,13,6
4571,3,shop,13,14,1
4571,4,work,14,19,5
4571,5,education,19,20,1
4571,6,home,20,24,4
4572,1,home,0,7,7
4572,2,work,7,13,6
4572,3,home,13,24,11
4573,1,home,0,8,8
4573,2,education,8,12,4
4573,3,home,12,23,11
4573,4,work,23,24,1
4574,1,home,0,7,7
4574,2,education,7,10,3
4574,3,home,10,14,4
4574,4,education,14,15,1
4574,5,shop,15,16,1
4574,6,home,16,24,8
4575,1,home,0,6,6
4575,2,work,6,13,7
4575,3,home,13,18,5
4575,4,work,18,20,2
4575,5,home,20,24,4
4576,1,home,0,6,6
4576,2,work,6,13,7
4576,3,shop,13,14,1
4576,4,work,14,20,6
4576,5,home,20,24,4
4577,1,home,0,7,7
4577,2,education,7,11,4
4577,3,home,11,19,8
4577,4,shop,19,20,1
4577,5,home,20,24,4
4578,1,home,0,6,6
4578,2,work,6,12,6
4578,3,shop,12,13,1
4578,4,work,13,19,6
4578,5,home,19,24,5
4579,1,home,0,6,6
4579,2,work,6,13,7
4579,3,home,13,21,8
4579,4,work,21,22,1
4579,5,home,22,24,2
4580,1,home,0,6,6
4580,2,work,6,13,7
4580,3,shop,13,14,1
4580,4,home,14,18,4
4580,5,work,18,20,2
4580,6,home,20,24,4
4581,1,home,0,8,8
4581,2,shop,8,9,1
4581,3,work,9,15,6
4581,4,home,15,24,9
4582,1,home,0,6,6
4582,2,work,6,13,7
4582,3,shop,13,14,1
4582,4,work,14,19,5
4582,5,home,19,24,5
4583,1,home,0,7,7
4583,2,shop,7,8,1
4583,3,education,8,12,4
4583,4,home,12,14,2
4583,5,education,14,16,2
4583,6,home,16,24,8
4584,1,home,0,6,6
4584,2,work,6,7,1
4584,3,home,7,11,4
4584,4,work,11,13,2
4584,5,home,13,21,8
4584,6,shop,21,22,1
4584,7,home,22,24,2
4585,1,home,0,6,6
4585,2,work,6,13,7
4585,3,shop,13,14,1
4585,4,home,14,24,10
4586,1,home,0,8,8
4586,2,work,8,14,6
4586,3,shop,14,15,1
4586,4,home,15,24,9
4587,1,home,0,8,8
4587,2,work,8,15,7
4587,3,home,15,24,9
4588,1,home,0,8,8
4588,2,work,8,15,7
4588,3,shop,15,16,1
4588,4,home,16,24,8
4589,1,home,0,6,6
4589,2,work,6,13,7
4589,3,shop,13,14,1
4589,4,home,14,24,10
4590,1,home,0,8,8
4590,2,work,8,15,7
4590,3,home,15,16,1
4590,4,work,16,20,4
4590,5,home,20,24,4
4591,1,home,0,6,6
4591,2,work,6,13,7
4591,3,shop,13,14,1
4591,4,education,14,17,3
4591,5,home,17,24,7
4592,1,home,0,7,7
4592,2,shop,7,8,1
4592,3,home,8,15,7
4592,4,work,15,20,5
4592,5,home,20,24,4
4593,1,home,0,9,9
4593,2,work,9,16,7
4593,3,home,16,22,6
4593,4,work,22,23,1
4593,5,home,23,24,1
4594,1,home,0,7,7
4594,2,work,7,9,2
4594,3,home,9,16,7
4594,4,work,16,18,2
4594,5,home,18,24,6
4595,1,home,0,8,8
4595,2,shop,8,9,1
4595,3,home,9,13,4
4595,4,work,13,20,7
4595,5,home,20,24,4
4596,1,home,0,6,6
4596,2,shop,6,7,1
4596,3,work,7,13,6
4596,4,home,13,17,4
4596,5,work,17,20,3
4596,6,home,20,24,4
4597,1,home,0,7,7
4597,2,work,7,13,6
4597,3,home,13,16,3
4597,4,shop,16,17,1
4597,5,home,17,24,7
4598,1,home,0,7,7
4598,2,shop,7,9,2
4598,3,education,9,12,3
4598,4,shop,12,14,2
4598,5,education,14,16,2
4598,6,home,16,24,8
4599,1,home,0,6,6
4599,2,work,6,13,7
4599,3,shop,13,14,1
4599,4,work,14,19,5
4599,5,home,19,24,5
4600,1,home,0,7,7
4600,2,work,7,14,7
4600,3,home,14,22,8
4600,4,work,22,23,1
4600,5,home,23,24,1
4601,1,home,0,8,8
4601,2,education,8,11,3
4601,3,home,11,17,6
4601,4,shop,17,18,1
4601,5,home,18,24,6
4602,1,home,0,6,6
4602,2,work,6,12,6
4602,3,shop,12,13,1
4602,4,education,13,16,3
4602,5,home,16,24,8
4603,1,home,0,8,8
4603,2,work,8,15,7
4603,3,home,15,21,6
4603,4,work,21,22,1
4603,5,home,22,24,2
4604,1,home,0,9,9
4604,2,work,9,18,9
4604,3,home,18,24,6
4605,1,home,0,7,7
4605,2,work,7,14,7
4605,3,shop,14,15,1
4605,4,home,15,24,9
4606,1,home,0,7,7
4606,2,work,7,13,6
4606,3,shop,13,14,1
4606,4,work,14,19,5
4606,5,home,19,24,5
4607,1,home,0,7,7
4607,2,work,7,13,6
4607,3,home,13,24,11
4608,1,home,0,8,8
4608,2,work,8,15,7
4608,3,home,15,24,9
4609,1,home,0,7,7
4609,2,work,7,14,7
4609,3,home,14,24,10
4610,1,home,0,8,8
4610,2,education,8,12,4
4610,3,home,12,16,4
4610,4,shop,16,17,1
4610,5,home,17,24,7
4611,1,home,0,8,8
4611,2,work,8,15,7
4611,3,home,15,22,7
4611,4,work,22,23,1
4611,5,home,23,24,1
4612,1,home,0,8,8
4612,2,work,8,15,7
4612,3,home,15,24,9
4613,1,home,0,9,9
4613,2,work,9,16,7
4613,3,home,16,21,5
4613,4,work,21,22,1
4613,5,home,22,24,2
4614,1,home,0,8,8
4614,2,shop,8,9,1
4614,3,work,9,18,9
4614,4,home,18,24,6
4615,1,home,0,7,7
4615,2,shop,7,8,1
4615,3,education,8,11,3
4615,4,home,11,18,7
4615,5,shop,18,20,2
4615,6,home,20,24,4
4616,1,home,0,7,7
4616,2,work,7,13,6
4616,3,home,13,21,8
4616,4,shop,21,22,1
4616,5,home,22,24,2
4617,1,home,0,7,7
4617,2,education,7,12,5
4617,3,shop,12,14,2
4617,4,education,14,16,2
4617,5,home,16,24,8
4618,1,home,0,8,8
4618,2,education,8,11,3
4618,3,home,11,24,13
4619,1,home,0,6,6
4619,2,work,6,8,2
4619,3,home,8,12,4
4619,4,work,12,14,2
4619,5,home,14,18,4
4619,6,work,18,19,1
4619,7,home,19,23,4
4619,8,work,23,24,1
4620,1,home,0,8,8
4620,2,work,8,17,9
4620,3,home,17,24,7
4621,1,home,0,7,7
4621,2,education,7,11,4
4621,3,home,11,18,7
4621,4,shop,18,19,1
4621,5,home,19,24,5
4622,1,home,0,7,7
4622,2,education,7,12,5
4622,3,home,12,18,6
4622,4,shop,18,20,2
4622,5,home,20,24,4
4623,1,home,0,6,6
4623,2,shop,6,7,1
4623,3,home,7,11,4
4623,4,work,11,18,7
4623,5,home,18,24,6
4624,1,home,0,6,6
4624,2,work,6,13,7
4624,3,shop,13,14,1
4624,4,home,14,23,9
4624,5,work,23,24,1
4625,1,home,0,6,6
4625,2,shop,6,7,1
4625,3,work,7,13,6
4625,4,home,13,24,11
4626,1,home,0,8,8
4626,2,work,8,14,6
4626,3,shop,14,15,1
4626,4,home,15,24,9
4627,1,home,0,8,8
4627,2,education,8,11,3
4627,3,home,11,17,6
4627,4,shop,17,18,1
4627,5,home,18,24,6
4628,1,home,0,6,6
4628,2,work,6,13,7
4628,3,home,13,24,11
4629,1,home,0,7,7
4629,2,education,7,12,5
4629,3,home,12,18,6
4629,4,shop,18,20,2
4629,5,home,20,24,4
4630,1,home,0,7,7
4630,2,work,7,13,6
4630,3,home,13,24,11
4631,1,home,0,7,7
4631,2,work,7,14,7
4631,3,home,14,20,6
4631,4,shop,20,21,1
4631,5,home,21,24,3
4632,1,home,0,6,6
4632,2,work,6,13,7
4632,3,home,13,20,7
4632,4,shop,20,21,1
4632,5,home,21,24,3
4633,1,home,0,7,7
4633,2,shop,7,8,1
4633,3,education,8,10,2
4633,4,home,10,14,4
4633,5,education,14,16,2
4633,6,shop,16,17,1
4633,7,home,17,24,7
4634,1,home,0,6,6
4634,2,work,6,13,7
4634,3,shop,13,14,1
4634,4,home,14,24,10
4635,1,home,0,8,8
4635,2,work,8,14,6
4635,3,home,14,23,9
4635,4,work,23,24,1
4636,1,home,0,6,6
4636,2,work,6,13,7
4636,3,home,13,17,4
4636,4,shop,17,18,1
4636,5,home,18,24,6
4637,1,home,0,7,7
4637,2,education,7,11,4
4637,3,home,11,13,2
4637,4,education,13,16,3
4637,5,home,16,24,8
4638,1,home,0,7,7
4638,2,work,7,9,2
4638,3,home,9,15,6
4638,4,work,15,18,3
4638,5,home,18,24,6
4639,1,home,0,9,9
4639,2,education,9,14,5
4639,3,work,14,20,6
4639,4,home,20,24,4
4640,1,home,0,8,8
4640,2,work,8,13,5
4640,3,home,13,24,11
4641,1,home,0,8,8
4641,2,work,8,15,7
4641,3,home,15,24,9
4642,1,home,0,6,6
4642,2,work,6,8,2
4642,3,home,8,9,1
4642,4,work,9,11,2
4642,5,home,11,16,5
4642,6,work,16,18,2
4642,7,home,18,24,6
4643,1,home,0,8,8
4643,2,education,8,12,4
4643,3,work,12,19,7
4643,4,home,19,24,5
4644,1,home,0,8,8
4644,2,work,8,13,5
4644,3,shop,13,14,1
4644,4,home,14,24,10
4645,1,home,0,7,7
4645,2,education,7,11,4
4645,3,home,11,18,7
4645,4,shop,18,19,1
4645,5,home,19,24,5
4646,1,home,0,9,9
4646,2,work,9,16,7
4646,3,home,16,24,8
4647,1,home,0,6,6
4647,2,work,6,13,7
4647,3,home,13,18,5
4647,4,shop,18,19,1
4647,5,home,19,24,5
4648,1,home,0,8,8
4648,2,work,8,14,6
4648,3,home,14,24,10
4649,1,home,0,8,8
4649,2,work,8,13,5
4649,3,home,13,24,11
4650,1,home,0,7,7
4650,2,education,7,12,5
4650,3,home,12,19,7
4650,4,shop,19,20,1
4650,5,home,20,24,4
4651,1,home,0,8,8
4651,2,education,8,12,4
4651,3,shop,12,14,2
4651,4,education,14,16,2
4651,5,home,16,20,4
4651,6,shop,20,21,1
4651,7,home,21,24,3
4652,1,home,0,6,6
4652,2,shop,6,7,1
4652,3,home,7,10,3
4652,4,work,10,17,7
4652,5,home,17,21,4
4652,6,work,21,22,1
4652,7,home,22,24,2
4653,1,home,0,7,7
4653,2,shop,7,8,1
4653,3,work,8,15,7
4653,4,home,15,24,9
4654,1,home,0,6,6
4654,2,work,6,8,2
4654,3,home,8,10,2
4654,4,work,10,11,1
4654,5,home,11,17,6
4654,6,work,17,19,2
4654,7,home,19,24,5
4655,1,home,0,8,8
4655,2,work,8,14,6
4655,3,home,14,18,4
4655,4,work,18,20,2
4655,5,home,20,24,4
4656,1,home,0,7,7
4656,2,shop,7,8,1
4656,3,education,8,11,3
4656,4,home,11,19,8
4656,5,shop,19,21,2
4656,6,home,21,24,3
4657,1,home,0,7,7
4657,2,education,7,12,5
4657,3,shop,12,14,2
4657,4,education,14,16,2
4657,5,home,16,24,8
4658,1,home,0,8,8
4658,2,shop,8,9,1
4658,3,work,9,15,6
4658,4,home,15,24,9
4659,1,home,0,7,7
4659,2,work,7,14,7
4659,3,shop,14,15,1
4659,4,work,15,19,4
4659,5,home,19,24,5
4660,1,home,0,7,7
4660,2,work,7,13,6
4660,3,shop,13,14,1
4660,4,home,14,24,10
4661,1,home,0,7,7
4661,2,work,7,14,7
4661,3,home,14,23,9
4661,4,work,23,24,1
4662,1,home,0,6,6
4662,2,work,6,8,2
4662,3,home,8,12,4
4662,4,work,12,14,2
4662,5,home,14,20,6
4662,6,shop,20,21,1
4662,7,home,21,24,3
4663,1,work,0,1,1
4663,2,shop,1,2,1
4663,3,home,2,8,6
4663,4,shop,8,9,1
4663,5,education,9,12,3
4663,6,shop,12,14,2
4663,7,home,14,21,7
4663,8,shop,21,22,1
4663,9,home,22,24,2
4664,1,home,0,6,6
4664,2,shop,6,7,1
4664,3,home,7,13,6
4664,4,education,13,16,3
4664,5,home,16,24,8
4665,1,home,0,7,7
4665,2,education,7,8,1
4665,3,home,8,13,5
4665,4,education,13,16,3
4665,5,home,16,24,8
4666,1,home,0,6,6
4666,2,work,6,8,2
4666,3,home,8,10,2
4666,4,work,10,12,2
4666,5,home,12,17,5
4666,6,work,17,19,2
4666,7,home,19,24,5
4667,1,home,0,6,6
4667,2,work,6,13,7
4667,3,home,13,15,2
4667,4,shop,15,16,1
4667,5,home,16,23,7
4667,6,work,23,24,1
4668,1,home,0,8,8
4668,2,education,8,11,3
4668,3,shop,11,12,1
4668,4,home,12,16,4
4668,5,work,16,20,4
4668,6,home,20,24,4
4669,1,home,0,6,6
4669,2,work,6,13,7
4669,3,home,13,17,4
4669,4,work,17,20,3
4669,5,home,20,24,4
4670,1,home,0,7,7
4670,2,work,7,13,6
4670,3,shop,13,14,1
4670,4,home,14,24,10
4671,1,home,0,6,6
4671,2,work,6,8,2
4671,3,home,8,12,4
4671,4,work,12,13,1
4671,5,home,13,15,2
4671,6,work,15,17,2
4671,7,home,17,24,7
4672,1,home,0,7,7
4672,2,work,7,14,7
4672,3,home,14,24,10
4673,1,home,0,8,8
4673,2,education,8,14,6
4673,3,shop,14,16,2
4673,4,home,16,24,8
4674,1,home,0,7,7
4674,2,work,7,8,1
4674,3,home,8,14,6
4674,4,work,14,15,1
4674,5,home,15,21,6
4674,6,work,21,22,1
4674,7,home,22,24,2
4675,1,home,0,6,6
4675,2,shop,6,7,1
4675,3,home,7,10,3
4675,4,education,10,12,2
4675,5,shop,12,14,2
4675,6,education,14,16,2
4675,7,shop,16,17,1
4675,8,home,17,24,7
4676,1,home,0,6,6
4676,2,work,6,14,8
4676,3,home,14,21,7
4676,4,work,21,22,1
4676,5,home,22,24,2
4677,1,home,0,6,6
4677,2,work,6,13,7
4677,3,shop,13,14,1
4677,4,work,14,19,5
4677,5,home,19,24,5
4678,1,home,0,6,6
4678,2,shop,6,7,1
4678,3,work,7,13,6
4678,4,shop,13,14,1
4678,5,work,14,20,6
4678,6,home,20,24,4
4679,1,home,0,7,7
4679,2,work,7,13,6
4679,3,shop,13,14,1
4679,4,work,14,20,6
4679,5,home,20,24,4
4680,1,home,0,8,8
4680,2,work,8,15,7
4680,3,home,15,21,6
4680,4,work,21,22,1
4680,5,home,22,24,2
4681,1,home,0,7,7
4681,2,education,7,13,6
4681,3,home,13,21,8
4681,4,shop,21,22,1
4681,5,home,22,24,2
4682,1,home,0,6,6
4682,2,shop,6,7,1
4682,3,work,7,13,6
4682,4,home,13,24,11
4683,1,home,0,6,6
4683,2,shop,6,7,1
4683,3,home,7,13,6
4683,4,education,13,16,3
4683,5,home,16,24,8
4684,1,home,0,7,7
4684,2,work,7,13,6
4684,3,home,13,18,5
4684,4,shop,18,19,1
4684,5,home,19,24,5
4685,1,home,0,7,7
4685,2,work,7,13,6
4685,3,home,13,20,7
4685,4,shop,20,21,1
4685,5,home,21,24,3
4686,1,home,0,7,7
4686,2,shop,7,8,1
4686,3,education,8,11,3
4686,4,home,11,19,8
4686,5,shop,19,21,2
4686,6,home,21,24,3
4687,1,home,0,6,6
4687,2,work,6,7,1
4687,3,home,7,9,2
4687,4,work,9,11,2
4687,5,home,11,19,8
4687,6,shop,19,20,1
4687,7,home,20,24,4
4688,1,home,0,7,7
4688,2,work,7,14,7
4688,3,home,14,24,10
4689,1,home,0,7,7
4689,2,education,7,11,4
4689,3,home,11,14,3
4689,4,education,14,16,2
4689,5,home,16,24,8
4690,1,home,0,7,7
4690,2,work,7,13,6
4690,3,shop,13,14,1
4690,4,work,14,20,6
4690,5,home,20,24,4
4691,1,home,0,8,8
4691,2,work,8,15,7
4691,3,home,15,24,9
4692,1,home,0,7,7
4692,2,work,7,13,6
4692,3,shop,13,14,1
4692,4,home,14,24,10
4693,1,home,0,7,7
4693,2,work,7,13,6
4693,3,shop,13,14,1
4693,4,home,14,24,10
4694,1,home,0,7,7
4694,2,education,7,11,4
4694,3,home,11,18,7
4694,4,shop,18,19,1
4694,5,home,19,24,5
4695,1,home,0,7,7
4695,2,work,7,14,7
4695,3,home,14,24,10
4696,1,home,0,9,9
4696,2,education,9,12,3
4696,3,shop,12,13,1
4696,4,work,13,19,6
4696,5,home,19,24,5
4697,1,home,0,6,6
4697,2,shop,6,7,1
4697,3,work,7,13,6
4697,4,home,13,24,11
4698,1,home,0,8,8
4698,2,work,8,15,7
4698,3,home,15,17,2
4698,4,work,17,19,2
4698,5,home,19,24,5
4699,1,home,0,7,7
4699,2,work,7,13,6
4699,3,home,13,24,11
4700,1,home,0,8,8
4700,2,work,8,15,7
4700,3,home,15,23,8
4700,4,work,23,24,1
4701,1,home,0,7,7
4701,2,work,7,13,6
4701,3,shop,13,14,1
4701,4,work,14,19,5
4701,5,home,19,24,5
4702,1,home,0,6,6
4702,2,work,6,7,1
4702,3,home,7,9,2
4702,4,work,9,11,2
4702,5,home,11,17,6
4702,6,work,17,19,2
4702,7,home,19,24,5
4703,1,home,0,7,7
4703,2,work,7,13,6
4703,3,home,13,24,11
4704,1,home,0,7,7
4704,2,work,7,14,7
4704,3,home,14,16,2
4704,4,work,16,20,4
4704,5,home,20,24,4
4705,1,home,0,8,8
4705,2,education,8,12,4
4705,3,work,12,18,6
4705,4,home,18,24,6
4706,1,home,0,6,6
4706,2,work,6,13,7
4706,3,home,13,18,5
4706,4,shop,18,19,1
4706,5,home,19,24,5
4707,1,home,0,7,7
4707,2,work,7,13,6
4707,3,shop,13,14,1
4707,4,work,14,19,5
4707,5,home,19,24,5
4708,1,home,0,7,7
4708,2,work,7,13,6
4708,3,home,13,19,6
4708,4,shop,19,20,1
4708,5,home,20,24,4
4709,1,home,0,6,6
4709,2,shop,6,7,1
4709,3,work,7,9,2
4709,4,home,9,15,6
4709,5,work,15,17,2
4709,6,home,17,22,5
4709,7,work,22,23,1
4709,8,home,23,24,1
4710,1,home,0,7,7
4710,2,work,7,13,6
4710,3,home,13,17,4
4710,4,work,17,20,3
4710,5,home,20,24,4
4711,1,home,0,6,6
4711,2,work,6,12,6
4711,3,shop,12,13,1
4711,4,work,13,19,6
4711,5,home,19,24,5
4712,1,home,0,6,6
4712,2,shop,6,7,1
4712,3,home,7,13,6
4712,4,education,13,16,3
4712,5,home,16,24,8
4713,1,home,0,7,7
4713,2,work,7,15,8
4713,3,home,15,19,4
4713,4,shop,19,20,1
4713,5,home,20,24,4
4714,1,home,0,8,8
4714,2,work,8,15,7
4714,3,home,15,21,6
4714,4,work,21,22,1
4714,5,home,22,24,2
4715,1,home,0,8,8
4715,2,work,8,15,7
4715,3,home,15,24,9
4716,1,home,0,6,6
4716,2,work,6,9,3
4716,3,home,9,15,6
4716,4,work,15,18,3
4716,5,home,18,24,6
4717,1,home,0,6,6
4717,2,shop,6,7,1
4717,3,work,7,13,6
4717,4,home,13,18,5
4717,5,work,18,20,2
4717,6,home,20,24,4
4718,1,home,0,8,8
4718,2,work,8,15,7
4718,3,home,15,24,9
4719,1,home,0,8,8
4719,2,work,8,15,7
4719,3,home,15,21,6
4719,4,shop,21,22,1
4719,5,home,22,24,2
4720,1,home,0,7,7
4720,2,work,7,13,6
4720,3,shop,13,14,1
4720,4,work,14,19,5
4720,5,home,19,24,5
4721,1,home,0,7,7
4721,2,work,7,13,6
4721,3,home,13,24,11
4722,1,home,0,8,8
4722,2,work,8,14,6
4722,3,shop,14,15,1
4722,4,work,15,20,5
4722,5,home,20,24,4
4723,1,home,0,8,8
4723,2,work,8,15,7
4723,3,home,15,19,4
4723,4,shop,19,20,1
4723,5,home,20,24,4
4724,1,home,0,6,6
4724,2,shop,6,7,1
4724,3,work,7,14,7
4724,4,home,14,24,10
4725,1,home,0,7,7
4725,2,education,7,11,4
4725,3,home,11,18,7
4725,4,shop,18,20,2
4725,5,home,20,24,4
4726,1,home,0,8,8
4726,2,work,8,14,6
4726,3,home,14,24,10
4727,1,home,0,7,7
4727,2,shop,7,8,1
4727,3,education,8,11,3
4727,4,home,11,18,7
4727,5,shop,18,20,2
4727,6,home,20,24,4
4728,1,home,0,7,7
4728,2,work,7,13,6
4728,3,home,13,22,9
4728,4,work,22,23,1
4728,5,home,23,24,1
4729,1,home,0,7,7
4729,2,education,7,12,5
4729,3,home,12,14,2
4729,4,education,14,16,2
4729,5,home,16,21,5
4729,6,shop,21,22,1
4729,7,home,22,24,2
4730,1,home,0,6,6
4730,2,work,6,13,7
4730,3,home,13,22,9
4730,4,work,22,23,1
4730,5,home,23,24,1
4731,1,home,0,7,7
4731,2,education,7,12,5
4731,3,shop,12,14,2
4731,4,education,14,16,2
4731,5,shop,16,17,1
4731,6,home,17,24,7
4732,1,home,0,6,6
4732,2,shop,6,7,1
4732,3,home,7,9,2
4732,4,education,9,12,3
4732,5,home,12,21,9
4732,6,shop,21,22,1
4732,7,home,22,24,2
4733,1,home,0,8,8
4733,2,work,8,14,6
4733,3,home,14,18,4
4733,4,work,18,20,2
4733,5,home,20,24,4
4734,1,home,0,8,8
4734,2,work,8,15,7
4734,3,home,15,24,9
4735,1,home,0,6,6
4735,2,work,6,13,7
4735,3,home,13,24,11
4736,1,home,0,6,6
4736,2,shop,6,7,1
4736,3,home,7,9,2
4736,4,work,9,13,4
4736,5,shop,13,14,1
4736,6,work,14,18,4
4736,7,education,18,20,2
4736,8,home,20,24,4
4737,1,home,0,6,6
4737,2,work,6,13,7
4737,3,shop,13,14,1
4737,4,work,14,20,6
4737,5,home,20,24,4
4738,1,home,0,8,8
4738,2,shop,8,10,2
4738,3,education,10,13,3
4738,4,shop,13,15,2
4738,5,home,15,24,9
4739,1,home,0,8,8
4739,2,work,8,14,6
4739,3,shop,14,15,1
4739,4,work,15,20,5
4739,5,home,20,24,4
4740,1,home,0,7,7
4740,2,work,7,14,7
4740,3,shop,14,15,1
4740,4,home,15,24,9
4741,1,home,0,8,8
4741,2,work,8,15,7
4741,3,home,15,21,6
4741,4,shop,21,22,1
4741,5,home,22,24,2
4742,1,home,0,6,6
4742,2,work,6,8,2
4742,3,home,8,10,2
4742,4,work,10,11,1
4742,5,home,11,16,5
4742,6,work,16,18,2
4742,7,home,18,21,3
4742,8,work,21,22,1
4742,9,home,22,24,2
4743,1,home,0,7,7
4743,2,education,7,12,5
4743,3,shop,12,14,2
4743,4,education,14,16,2
4743,5,home,16,24,8
4744,1,home,0,7,7
4744,2,work,7,14,7
4744,3,home,14,22,8
4744,4,work,22,23,1
4744,5,home,23,24,1
4745,1,home,0,8,8
4745,2,education,8,12,4
4745,3,work,12,20,8
4745,4,home,20,24,4
4746,1,home,0,6,6
4746,2,shop,6,7,1
4746,3,home,7,9,2
4746,4,education,9,12,3
4746,5,shop,12,13,1
4746,6,home,13,21,8
4746,7,shop,21,22,1
4746,8,home,22,24,2
4747,1,home,0,6,6
4747,2,work,6,14,8
4747,3,shop,14,15,1
4747,4,home,15,24,9
4748,1,home,0,7,7
4748,2,work,7,14,7
4748,3,home,14,18,4
4748,4,shop,18,19,1
4748,5,home,19,24,5
4749,1,home,0,6,6
4749,2,work,6,13,7
4749,3,home,13,24,11
4750,1,home,0,7,7
4750,2,work,7,13,6
4750,3,home,13,16,3
4750,4,work,16,20,4
4750,5,home,20,24,4
4751,1,home,0,7,7
4751,2,work,7,15,8
4751,3,shop,15,16,1
4751,4,home,16,24,8
4752,1,home,0,8,8
4752,2,work,8,15,7
4752,3,shop,15,16,1
4752,4,home,16,24,8
4753,1,home,0,6,6
4753,2,shop,6,7,1
4753,3,home,7,10,3
4753,4,education,10,12,2
4753,5,home,12,19,7
4753,6,shop,19,20,1
4753,7,home,20,24,4
4754,1,home,0,6,6
4754,2,work,6,13,7
4754,3,home,13,18,5
4754,4,shop,18,19,1
4754,5,home,19,24,5
4755,1,home,0,8,8
4755,2,work,8,14,6
4755,3,shop,14,15,1
4755,4,home,15,24,9
4756,1,work,0,9,9
4756,2,shop,9,10,1
4756,3,home,10,14,4
4756,4,work,14,19,5
4756,5,home,19,24,5
4757,1,home,0,7,7
4757,2,work,7,13,6
4757,3,home,13,23,10
4757,4,work,23,24,1
4758,1,home,0,8,8
4758,2,education,8,11,3
4758,3,home,11,16,5
4758,4,work,16,20,4
4758,5,home,20,24,4
4759,1,home,0,8,8
4759,2,work,8,15,7
4759,3,shop,15,16,1
4759,4,work,16,20,4
4759,5,home,20,24,4
4760,1,home,0,7,7
4760,2,shop,7,9,2
4760,3,education,9,12,3
4760,4,home,12,18,6
4760,5,shop,18,19,1
4760,6,home,19,24,5
4761,1,home,0,6,6
4761,2,work,6,8,2
4761,3,home,8,12,4
4761,4,work,12,14,2
4761,5,home,14,21,7
4761,6,work,21,22,1
4761,7,home,22,24,2
4762,1,home,0,6,6
4762,2,work,6,13,7
4762,3,shop,13,14,1
4762,4,work,14,19,5
4762,5,home,19,24,5
4763,1,home,0,8,8
4763,2,work,8,15,7
4763,3,home,15,24,9
4764,1,home,0,6,6
4764,2,work,6,13,7
4764,3,shop,13,14,1
4764,4,work,14,19,5
4764,5,home,19,24,5
4765,1,home,0,6,6
4765,2,work,6,13,7
4765,3,home,13,17,4
4765,4,shop,17,18,1
4765,5,home,18,24,6
4766,1,home,0,6,6
4766,2,shop,6,7,1
4766,3,work,7,14,7
4766,4,home,14,24,10
4767,1,home,0,8,8
4767,2,shop,8,9,1
4767,3,work,9,17,8
4767,4,home,17,23,6
4767,5,work,23,24,1
4768,1,home,0,7,7
4768,2,work,7,13,6
4768,3,shop,13,14,1
4768,4,home,14,22,8
4768,5,work,22,23,1
4768,6,home,23,24,1
4769,1,home,0,7,7
4769,2,work,7,13,6
4769,3,home,13,17,4
4769,4,work,17,20,3
4769,5,home,20,24,4
4770,1,home,0,7,7
4770,2,work,7,13,6
4770,3,home,13,24,11
4771,1,home,0,8,8
4771,2,work,8,15,7
4771,3,home,15,24,9
4772,1,home,0,7,7
4772,2,shop,7,8,1
4772,3,home,8,13,5
4772,4,work,13,19,6
4772,5,home,19,24,5
4773,1,home,0,7,7
4773,2,work,7,13,6
4773,3,shop,13,14,1
4773,4,home,14,24,10
4774,1,home,0,6,6
4774,2,work,6,8,2
4774,3,home,8,9,1
4774,4,work,9,10,1
4774,5,home,10,13,3
4774,6,work,13,15,2
4774,7,home,15,21,6
4774,8,work,21,22,1
4774,9,home,22,24,2
4775,1,home,0,6,6
4775,2,shop,6,7,1
4775,3,home,7,10,3
4775,4,education,10,12,2
4775,5,home,12,19,7
4775,6,shop,19,21,2
4775,7,home,21,24,3
4776,1,home,0,6,6
4776,2,shop,6,7,1
4776,3,work,7,13,6
4776,4,shop,13,14,1
4776,5,home,14,24,10
4777,1,home,0,8,8
4777,2,education,8,11,3
4777,3,home,11,17,6
4777,4,shop,17,19,2
4777,5,home,19,24,5
4778,1,home,0,7,7
4778,2,shop,7,9,2
4778,3,education,9,12,3
4778,4,shop,12,14,2
4778,5,education,14,16,2
4778,6,shop,16,17,1
4778,7,home,17,24,7
4779,1,home,0,7,7
4779,2,work,7,13,6
4779,3,home,13,18,5
4779,4,work,18,20,2
4779,5,home,20,24,4
4780,1,home,0,6,6
4780,2,work,6,13,7
4780,3,home,13,22,9
4780,4,work,22,23,1
4780,5,home,23,24,1
4781,1,home,0,6,6
4781,2,work,6,13,7
4781,3,home,13,23,10
4781,4,work,23,24,1
4782,1,home,0,8,8
4782,2,work,8,16,8
4782,3,home,16,24,8
4783,1,home,0,7,7
4783,2,work,7,13,6
4783,3,shop,13,14,1
4783,4,work,14,19,5
4783,5,home,19,24,5
4784,1,home,0,6,6
4784,2,work,6,13,7
4784,3,home,13,18,5
4784,4,work,18,20,2
4784,5,home,20,24,4
4785,1,home,0,7,7
4785,2,work,7,14,7
4785,3,home,14,18,4
4785,4,shop,18,19,1
4785,5,home,19,24,5
4786,1,home,0,7,7
4786,2,work,7,13,6
4786,3,shop,13,14,1
4786,4,work,14,19,5
4786,5,home,19,24,5
4787,1,home,0,7,7
4787,2,work,7,13,6
4787,3,home,13,17,4
4787,4,work,17,20,3
4787,5,home,20,24,4
4788,1,home,0,6,6
4788,2,shop,6,7,1
4788,3,home,7,10,3
4788,4,work,10,17,7
4788,5,home,17,24,7
4789,1,home,0,8,8
4789,2,work,8,14,6
4789,3,home,14,15,1
4789,4,shop,15,16,1
4789,5,work,16,20,4
4789,6,home,20,24,4
4790,1,home,0,9,9
4790,2,work,9,16,7
4790,3,home,16,24,8
4791,1,home,0,7,7
4791,2,shop,7,9,2
4791,3,home,9,13,4
4791,4,work,13,20,7
4791,5,home,20,24,4
4792,1,home,0,7,7
4792,2,work,7,13,6
4792,3,shop,13,14,1
4792,4,home,14,23,9
4792,5,work,23,24,1
4793,1,home,0,7,7
4793,2,education,7,12,5
4793,3,home,12,14,2
4793,4,education,14,15,1
4793,5,shop,15,16,1
4793,6,home,16,21,5
4793,7,shop,21,22,1
4793,8,home,22,24,2
4794,1,home,0,7,7
4794,2,work,7,13,6
4794,3,shop,13,14,1
4794,4,work,14,19,5
4794,5,home,19,24,5
4795,1,home,0,7,7
4795,2,work,7,9,2
4795,3,home,9,12,3
4795,4,work,12,14,2
4795,5,home,14,18,4
4795,6,work,18,19,1
4795,7,home,19,24,5
4796,1,home,0,7,7
4796,2,work,7,13,6
4796,3,home,13,24,11
4797,1,home,0,9,9
4797,2,work,9,16,7
4797,3,home,16,24,8
4798,1,home,0,6,6
4798,2,work,6,13,7
4798,3,home,13,24,11
4799,1,home,0,7,7
4799,2,work,7,14,7
4799,3,home,14,24,10
4800,1,home,0,8,8
4800,2,work,8,14,6
4800,3,shop,14,16,2
4800,4,work,16,20,4
4800,5,home,20,24,4
4801,1,home,0,8,8
4801,2,work,8,15,7
4801,3,home,15,24,9
4802,1,home,0,7,7
4802,2,work,7,14,7
4802,3,home,14,24,10
4803,1,home,0,7,7
4803,2,work,7,13,6
4803,3,home,13,24,11
4804,1,home,0,9,9
4804,2,work,9,17,8
4804,3,home,17,24,7
4805,1,home,0,7,7
4805,2,education,7,11,4
4805,3,home,11,16,5
4805,4,shop,16,17,1
4805,5,home,17,24,7
4806,1,home,0,7,7
4806,2,work,7,13,6
4806,3,home,13,21,8
4806,4,work,21,22,1
4806,5,home,22,24,2
4807,1,home,0,8,8
4807,2,work,8,15,7
4807,3,home,15,24,9
4808,1,home,0,8,8
4808,2,work,8,15,7
4808,3,home,15,17,2
4808,4,work,17,20,3
4808,5,home,20,24,4
4809,1,home,0,7,7
4809,2,education,7,11,4
4809,3,home,11,18,7
4809,4,shop,18,19,1
4809,5,home,19,24,5
4810,1,home,0,8,8
4810,2,work,8,15,7
4810,3,home,15,20,5
4810,4,shop,20,21,1
4810,5,home,21,24,3
4811,1,home,0,6,6
4811,2,work,6,13,7
4811,3,home,13,20,7
4811,4,shop,20,21,1
4811,5,home,21,24,3
4812,1,home,0,7,7
4812,2,shop,7,8,1
4812,3,home,8,13,5
4812,4,work,13,19,6
4812,5,home,19,24,5
4813,1,home,0,7,7
4813,2,education,7,12,5
4813,3,home,12,24,12
4814,1,home,0,7,7
4814,2,work,7,13,6
4814,3,shop,13,14,1
4814,4,work,14,19,5
4814,5,home,19,24,5
4815,1,home,0,7,7
4815,2,shop,7,8,1
4815,3,home,8,9,1
4815,4,work,9,15,6
4815,5,home,15,24,9
4816,1,home,0,7,7
4816,2,shop,7,8,1
4816,3,home,8,14,6
4816,4,work,14,20,6
4816,5,home,20,24,4
4817,1,home,0,7,7
4817,2,work,7,13,6
4817,3,home,13,24,11
4818,1,home,0,8,8
4818,2,work,8,15,7
4818,3,home,15,21,6
4818,4,work,21,22,1
4818,5,home,22,24,2
4819,1,home,0,6,6
4819,2,work,6,13,7
4819,3,home,13,16,3
4819,4,work,16,20,4
4819,5,home,20,24,4
4820,1,home,0,7,7
4820,2,work,7,14,7
4820,3,home,14,24,10
4821,1,home,0,7,7
4821,2,work,7,13,6
4821,3,home,13,17,4
4821,4,work,17,20,3
4821,5,home,20,24,4
4822,1,home,0,7,7
4822,2,education,7,12,5
4822,3,shop,12,14,2
4822,4,home,14,24,10
4823,1,home,0,9,9
4823,2,education,9,12,3
4823,3,shop,12,13,1
4823,4,work,13,20,7
4823,5,home,20,24,4
4824,1,home,0,8,8
4824,2,shop,8,10,2
4824,3,education,10,13,3
4824,4,shop,13,15,2
4824,5,home,15,24,9
4825,1,home,0,7,7
4825,2,work,7,14,7
4825,3,home,14,18,4
4825,4,work,18,20,2
4825,5,home,20,24,4
4826,1,home,0,7,7
4826,2,shop,7,8,1
4826,3,work,8,16,8
4826,4,home,16,24,8
4827,1,home,0,7,7
4827,2,work,7,14,7
4827,3,home,14,24,10
4828,1,home,0,6,6
4828,2,shop,6,7,1
4828,3,home,7,10,3
4828,4,education,10,13,3
4828,5,shop,13,14,1
4828,6,home,14,24,10
4829,1,home,0,7,7
4829,2,work,7,13,6
4829,3,shop,13,14,1
4829,4,work,14,19,5
4829,5,education,19,20,1
4829,6,home,20,24,4
4830,1,home,0,6,6
4830,2,work,6,8,2
4830,3,home,8,13,5
4830,4,work,13,16,3
4830,5,home,16,22,6
4830,6,work,22,23,1
4830,7,home,23,24,1
4831,1,home,0,6,6
4831,2,work,6,13,7
4831,3,shop,13,14,1
4831,4,work,14,19,5
4831,5,home,19,24,5
4832,1,home,0,7,7
4832,2,education,7,12,5
4832,3,shop,12,15,3
4832,4,home,15,24,9
4833,1,home,0,6,6
4833,2,work,6,7,1
4833,3,home,7,14,7
4833,4,work,14,16,2
4833,5,home,16,22,6
4833,6,work,22,23,1
4833,7,home,23,24,1
4834,1,home,0,7,7
4834,2,work,7,8,1
4834,3,home,8,9,1
4834,4,work,9,11,2
4834,5,home,11,18,7
4834,6,work,18,19,1
4834,7,home,19,24,5
4835,1,home,0,7,7
4835,2,shop,7,8,1
4835,3,home,8,9,1
4835,4,education,9,13,4
4835,5,work,13,19,6
4835,6,home,19,23,4
4835,7,work,23,24,1
4836,1,home,0,7,7
4836,2,work,7,13,6
4836,3,shop,13,14,1
4836,4,work,14,20,6
4836,5,home,20,24,4
4837,1,home,0,6,6
4837,2,shop,6,7,1
4837,3,home,7,11,4
4837,4,education,11,15,4
4837,5,shop,15,17,2
4837,6,home,17,24,7
4838,1,home,0,8,8
4838,2,work,8,14,6
4838,3,shop,14,15,1
4838,4,home,15,23,8
4838,5,work,23,24,1
4839,1,home,0,8,8
4839,2,work,8,15,7
4839,3,home,15,17,2
4839,4,work,17,20,3
4839,5,home,20,24,4
4840,1,home,0,8,8
4840,2,work,8,15,7
4840,3,home,15,24,9
4841,1,home,0,7,7
4841,2,work,7,13,6
4841,3,shop,13,14,1
4841,4,home,14,23,9
4841,5,work,23,24,1
4842,1,home,0,7,7
4842,2,shop,7,8,1
4842,3,education,8,11,3
4842,4,home,11,17,6
4842,5,shop,17,18,1
4842,6,home,18,24,6
4843,1,home,0,9,9
4843,2,work,9,16,7
4843,3,home,16,24,8
4844,1,home,0,7,7
4844,2,education,7,12,5
4844,3,home,12,19,7
4844,4,shop,19,20,1
4844,5,home,20,24,4
4845,1,home,0,8,8
4845,2,education,8,11,3
4845,3,home,11,14,3
4845,4,education,14,16,2
4845,5,shop,16,17,1
4845,6,home,17,24,7
4846,1,home,0,6,6
4846,2,work,6,11,5
4846,3,shop,11,12,1
4846,4,work,12,18,6
4846,5,home,18,24,6
4847,1,home,0,8,8
4847,2,work,8,14,6
4847,3,home,14,18,4
4847,4,work,18,20,2
4847,5,home,20,24,4
4848,1,home,0,6,6
4848,2,shop,6,7,1
4848,3,home,7,13,6
4848,4,education,13,16,3
4848,5,home,16,24,8
4849,1,home,0,6,6
4849,2,shop,6,7,1
4849,3,work,7,14,7
4849,4,home,14,18,4
4849,5,work,18,20,2
4849,6,home,20,24,4
4850,1,home,0,8,8
4850,2,education,8,11,3
4850,3,home,11,17,6
4850,4,shop,17,18,1
4850,5,home,18,24,6
4851,1,home,0,7,7
4851,2,education,7,11,4
4851,3,home,11,18,7
4851,4,shop,18,20,2
4851,5,home,20,24,4
4852,1,home,0,6,6
4852,2,work,6,8,2
4852,3,home,8,12,4
4852,4,work,12,15,3
4852,5,home,15,17,2
4852,6,work,17,19,2
4852,7,home,19,24,5
4853,1,home,0,8,8
4853,2,work,8,14,6
4853,3,shop,14,15,1
4853,4,work,15,19,4
4853,5,home,19,24,5
4854,1,home,0,7,7
4854,2,work,7,15,8
4854,3,home,15,19,4
4854,4,shop,19,20,1
4854,5,home,20,24,4
4855,1,home,0,6,6
4855,2,work,6,14,8
4855,3,shop,14,15,1
4855,4,home,15,24,9
4856,1,home,0,6,6
4856,2,work,6,8,2
4856,3,home,8,13,5
4856,4,work,13,15,2
4856,5,home,15,21,6
4856,6,work,21,22,1
4856,7,home,22,24,2
4857,1,home,0,8,8
4857,2,work,8,16,8
4857,3,shop,16,17,1
4857,4,home,17,24,7
4858,1,home,0,8,8
4858,2,work,8,15,7
4858,3,shop,15,17,2
4858,4,home,17,24,7
4859,1,home,0,6,6
4859,2,shop,6,7,1
4859,3,home,7,13,6
4859,4,work,13,19,6
4859,5,home,19,24,5
4860,1,home,0,6,6
4860,2,work,6,13,7
4860,3,shop,13,14,1
4860,4,education,14,16,2
4860,5,home,16,24,8
4861,1,home,0,8,8
4861,2,work,8,14,6
4861,3,home,14,24,10
4862,1,home,0,7,7
4862,2,work,7,9,2
4862,3,home,9,14,5
4862,4,work,14,16,2
4862,5,home,16,22,6
4862,6,work,22,23,1
4862,7,home,23,24,1
4863,1,home,0,6,6
4863,2,work,6,13,7
4863,3,home,13,16,3
4863,4,work,16,20,4
4863,5,home,20,24,4
4864,1,home,0,6,6
4864,2,shop,6,7,1
4864,3,home,7,13,6
4864,4,education,13,16,3
4864,5,home,16,24,8
4865,1,home,0,7,7
4865,2,shop,7,8,1
4865,3,education,8,14,6
4865,4,shop,14,16,2
4865,5,home,16,24,8
4866,1,home,0,7,7
4866,2,work,7,13,6
4866,3,home,13,21,8
4866,4,work,21,22,1
4866,5,home,22,24,2
4867,1,home,0,8,8
4867,2,work,8,15,7
4867,3,shop,15,16,1
4867,4,home,16,22,6
4867,5,work,22,23,1
4867,6,home,23,24,1
4868,1,home,0,6,6
4868,2,work,6,13,7
4868,3,shop,13,14,1
4868,4,home,14,24,10
4869,1,home,0,8,8
4869,2,work,8,15,7
4869,3,home,15,24,9
4870,1,home,0,6,6
4870,2,shop,6,7,1
4870,3,home,7,10,3
4870,4,education,10,13,3
4870,5,home,13,20,7
4870,6,shop,20,21,1
4870,7,home,21,24,3
4871,1,home,0,8,8
4871,2,work,8,15,7
4871,3,home,15,24,9
4872,1,home,0,7,7
4872,2,work,7,14,7
4872,3,home,14,24,10
4873,1,home,0,8,8
4873,2,education,8,11,3
4873,3,home,11,19,8
4873,4,shop,19,21,2
4873,5,home,21,24,3
4874,1,home,0,8,8
4874,2,shop,8,9,1
4874,3,work,9,15,6
4874,4,home,15,24,9
4875,1,home,0,8,8
4875,2,work,8,13,5
4875,3,home,13,17,4
4875,4,work,17,20,3
4875,5,home,20,24,4
4876,1,home,0,6,6
4876,2,work,6,13,7
4876,3,home,13,17,4
4876,4,work,17,19,2
4876,5,home,19,24,5
4877,1,home,0,7,7
4877,2,work,7,13,6
4877,3,home,13,16,3
4877,4,shop,16,17,1
4877,5,home,17,24,7
4878,1,home,0,7,7
4878,2,shop,7,8,1
4878,3,home,8,9,1
4878,4,work,9,16,7
4878,5,home,16,24,8
4879,1,home,0,7,7
4879,2,work,7,14,7
4879,3,shop,14,15,1
4879,4,home,15,24,9
4880,1,home,0,7,7
4880,2,education,7,11,4
4880,3,home,11,17,6
4880,4,shop,17,18,1
4880,5,home,18,24,6
4881,1,home,0,7,7
4881,2,work,7,13,6
4881,3,home,13,24,11
4882,1,home,0,7,7
4882,2,shop,7,8,1
4882,3,education,8,11,3
4882,4,home,11,18,7
4882,5,shop,18,19,1
4882,6,home,19,24,5
4883,1,home,0,6,6
4883,2,work,6,7,1
4883,3,home,7,13,6
4883,4,work,13,15,2
4883,5,home,15,23,8
4883,6,work,23,24,1
4884,1,home,0,6,6
4884,2,work,6,13,7
4884,3,home,13,21,8
4884,4,shop,21,22,1
4884,5,home,22,24,2
4885,1,home,0,7,7
4885,2,work,7,14,7
4885,3,home,14,24,10
4886,1,home,0,7,7
4886,2,work,7,13,6
4886,3,shop,13,14,1
4886,4,home,14,24,10
4887,1,home,0,7,7
4887,2,work,7,13,6
4887,3,home,13,16,3
4887,4,work,16,20,4
4887,5,home,20,24,4
4888,1,home,0,8,8
4888,2,work,8,15,7
4888,3,home,15,24,9
4889,1,home,0,7,7
4889,2,work,7,13,6
4889,3,shop,13,14,1
4889,4,home,14,18,4
4889,5,work,18,20,2
4889,6,home,20,24,4
4890,1,home,0,6,6
4890,2,work,6,13,7
4890,3,home,13,17,4
4890,4,work,17,20,3
4890,5,home,20,24,4
4891,1,home,0,6,6
4891,2,shop,6,7,1
4891,3,work,7,13,6
4891,4,home,13,24,11
4892,1,home,0,7,7
4892,2,shop,7,8,1
4892,3,home,8,9,1
4892,4,education,9,13,4
4892,5,home,13,22,9
4892,6,work,22,23,1
4892,7,home,23,24,1
4893,1,home,0,7,7
4893,2,work,7,13,6
4893,3,shop,13,14,1
4893,4,home,14,18,4
4893,5,work,18,20,2
4893,6,home,20,24,4
4894,1,home,0,7,7
4894,2,work,7,14,7
4894,3,home,14,18,4
4894,4,work,18,20,2
4894,5,home,20,24,4
4895,1,home,0,7,7
4895,2,work,7,14,7
4895,3,home,14,24,10
4896,1,home,0,7,7
4896,2,work,7,13,6
4896,3,shop,13,14,1
4896,4,work,14,19,5
4896,5,home,19,24,5
4897,1,home,0,6,6
4897,2,work,6,14,8
4897,3,home,14,24,10
4898,1,home,0,6,6
4898,2,work,6,8,2
4898,3,home,8,13,5
4898,4,work,13,15,2
4898,5,home,15,21,6
4898,6,work,21,22,1
4898,7,home,22,24,2
4899,1,home,0,7,7
4899,2,work,7,13,6
4899,3,shop,13,14,1
4899,4,home,14,23,9
4899,5,work,23,24,1
4900,1,home,0,8,8
4900,2,education,8,11,3
4900,3,home,11,15,4
4900,4,work,15,20,5
4900,5,home,20,24,4
4901,1,home,0,6,6
4901,2,shop,6,7,1
4901,3,home,7,10,3
4901,4,education,10,16,6
4901,5,home,16,21,5
4901,6,shop,21,22,1
4901,7,home,22,24,2
4902,1,home,0,9,9
4902,2,education,9,15,6
4902,3,work,15,20,5
4902,4,home,20,24,4
4903,1,home,0,8,8
4903,2,work,8,15,7
4903,3,home,15,21,6
4903,4,work,21,22,1
4903,5,home,22,24,2
4904,1,home,0,6,6
4904,2,shop,6,7,1
4904,3,home,7,10,3
4904,4,education,10,13,3
4904,5,shop,13,15,2
4904,6,home,15,24,9
4905,1,home,0,8,8
4905,2,work,8,14,6
4905,3,home,14,21,7
4905,4,shop,21,22,1
4905,5,home,22,24,2
4906,1,home,0,8,8
4906,2,education,8,11,3
4906,3,home,11,15,4
4906,4,work,15,20,5
4906,5,home,20,24,4
4907,1,home,0,6,6
4907,2,work,6,8,2
4907,3,home,8,14,6
4907,4,work,14,16,2
4907,5,home,16,22,6
4907,6,work,22,23,1
4907,7,home,23,24,1
4908,1,home,0,6,6
4908,2,work,6,13,7
4908,3,home,13,17,4
4908,4,work,17,19,2
4908,5,home,19,24,5
4909,1,home,0,6,6
4909,2,shop,6,7,1
4909,3,home,7,13,6
4909,4,education,13,15,2
4909,5,shop,15,17,2
4909,6,home,17,24,7
4910,1,home,0,7,7
4910,2,work,7,14,7
4910,3,home,14,20,6
4910,4,shop,20,21,1
4910,5,home,21,24,3
4911,1,home,0,7,7
4911,2,work,7,13,6
4911,3,home,13,20,7
4911,4,shop,20,21,1
4911,5,home,21,24,3
4912,1,home,0,8,8
4912,2,work,8,15,7
4912,3,shop,15,16,1
4912,4,work,16,19,3
4912,5,home,19,24,5
4913,1,home,0,6,6
4913,2,work,6,13,7
4913,3,home,13,16,3
4913,4,work,16,19,3
4913,5,home,19,22,3
4913,6,work,22,23,1
4913,7,home,23,24,1
4914,1,home,0,8,8
4914,2,education,8,11,3
4914,3,home,11,16,5
4914,4,shop,16,18,2
4914,5,home,18,24,6
4915,1,home,0,7,7
4915,2,shop,7,8,1
4915,3,work,8,15,7
4915,4,home,15,24,9
4916,1,home,0,7,7
4916,2,work,7,13,6
4916,3,shop,13,14,1
4916,4,home,14,24,10
4917,1,home,0,7,7
4917,2,work,7,13,6
4917,3,shop,13,14,1
4917,4,work,14,20,6
4917,5,home,20,24,4
4918,1,home,0,8,8
4918,2,shop,8,9,1
4918,3,education,9,12,3
4918,4,shop,12,13,1
4918,5,education,13,15,2
4918,6,shop,15,16,1
4918,7,home,16,20,4
4918,8,shop,20,21,1
4918,9,home,21,24,3
4919,1,home,0,6,6
4919,2,shop,6,7,1
4919,3,work,7,14,7
4919,4,home,14,22,8
4919,5,work,22,23,1
4919,6,home,23,24,1
4920,1,home,0,8,8
4920,2,education,8,11,3
4920,3,home,11,19,8
4920,4,shop,19,21,2
4920,5,home,21,24,3
4921,1,home,0,7,7
4921,2,education,7,12,5
4921,3,shop,12,14,2
4921,4,education,14,15,1
4921,5,shop,15,16,1
4921,6,home,16,24,8
4922,1,home,0,7,7
4922,2,education,7,12,5
4922,3,home,12,20,8
4922,4,shop,20,21,1
4922,5,home,21,24,3
4923,1,home,0,6,6
4923,2,work,6,12,6
4923,3,shop,12,13,1
4923,4,work,13,19,6
4923,5,home,19,23,4
4923,6,work,23,24,1
4924,1,home,0,8,8
4924,2,education,8,12,4
4924,3,shop,12,13,1
4924,4,education,13,16,3
4924,5,home,16,24,8
4925,1,home,0,7,7
4925,2,education,7,12,5
4925,3,shop,12,14,2
4925,4,education,14,16,2
4925,5,shop,16,17,1
4925,6,home,17,24,7
4926,1,home,0,7,7
4926,2,education,7,11,4
4926,3,home,11,15,4
4926,4,shop,15,16,1
4926,5,home,16,24,8
4927,1,home,0,6,6
4927,2,shop,6,7,1
4927,3,work,7,14,7
4927,4,home,14,18,4
4927,5,work,18,20,2
4927,6,home,20,24,4
4928,1,home,0,8,8
4928,2,work,8,14,6
4928,3,home,14,24,10
4929,1,home,0,7,7
4929,2,shop,7,8,1
4929,3,education,8,11,3
4929,4,home,11,18,7
4929,5,shop,18,21,3
4929,6,home,21,24,3
4930,1,home,0,6,6
4930,2,work,6,13,7
4930,3,home,13,17,4
4930,4,work,17,20,3
4930,5,home,20,24,4
4931,1,home,0,6,6
4931,2,work,6,13,7
4931,3,shop,13,14,1
4931,4,home,14,24,10
4932,1,home,0,6,6
4932,2,work,6,8,2
4932,3,home,8,12,4
4932,4,work,12,14,2
4932,5,home,14,21,7
4932,6,work,21,22,1
4932,7,home,22,24,2
4933,1,home,0,7,7
4933,2,education,7,12,5
4933,3,home,12,19,7
4933,4,shop,19,21,2
4933,5,home,21,24,3
4934,1,home,0,6,6
4934,2,shop,6,8,2
4934,3,work,8,15,7
4934,4,home,15,24,9
4935,1,home,0,7,7
4935,2,work,7,14,7
4935,3,home,14,21,7
4935,4,work,21,22,1
4935,5,home,22,24,2
4936,1,home,0,8,8
4936,2,education,8,11,3
4936,3,home,11,15,4
4936,4,shop,15,16,1
4936,5,home,16,22,6
4936,6,work,22,23,1
4936,7,home,23,24,1
4937,1,home,0,8,8
4937,2,work,8,14,6
4937,3,home,14,23,9
4937,4,work,23,24,1
4938,1,home,0,8,8
4938,2,work,8,15,7
4938,3,home,15,21,6
4938,4,shop,21,22,1
4938,5,home,22,24,2
4939,1,home,0,7,7
4939,2,shop,7,8,1
4939,3,work,8,15,7
4939,4,home,15,23,8
4939,5,work,23,24,1
4940,1,home,0,8,8
4940,2,work,8,15,7
4940,3,home,15,24,9
4941,1,home,0,6,6
4941,2,shop,6,7,1
4941,3,work,7,13,6
4941,4,home,13,24,11
4942,1,home,0,7,7
4942,2,shop,7,8,1
4942,3,education,8,11,3
4942,4,home,11,17,6
4942,5,shop,17,18,1
4942,6,home,18,24,6
4943,1,home,0,8,8
4943,2,work,8,15,7
4943,3,home,15,24,9
4944,1,home,0,7,7
4944,2,education,7,11,4
4944,3,home,11,17,6
4944,4,shop,17,18,1
4944,5,home,18,24,6
4945,1,home,0,8,8
4945,2,work,8,14,6
4945,3,shop,14,15,1
4945,4,home,15,22,7
4945,5,work,22,23,1
4945,6,home,23,24,1
4946,1,home,0,7,7
4946,2,work,7,15,8
4946,3,home,15,23,8
4946,4,work,23,24,1
4947,1,home,0,9,9
4947,2,work,9,15,6
4947,3,home,15,24,9
4948,1,home,0,6,6
4948,2,work,6,8,2
4948,3,home,8,14,6
4948,4,work,14,16,2
4948,5,home,16,23,7
4948,6,work,23,24,1
4949,1,home,0,7,7
4949,2,work,7,14,7
4949,3,home,14,24,10
4950,1,home,0,8,8
4950,2,work,8,15,7
4950,3,shop,15,16,1
4950,4,home,16,24,8
4951,1,home,0,7,7
4951,2,shop,7,8,1
4951,3,home,8,16,8
4951,4,work,16,20,4
4951,5,home,20,24,4
4952,1,home,0,7,7
4952,2,education,7,11,4
4952,3,home,11,19,8
4952,4,shop,19,20,1
4952,5,home,20,24,4
4953,1,home,0,8,8
4953,2,work,8,15,7
4953,3,home,15,21,6
4953,4,work,21,22,1
4953,5,home,22,24,2
4954,1,home,0,6,6
4954,2,work,6,13,7
4954,3,shop,13,14,1
4954,4,work,14,19,5
4954,5,home,19,24,5
4955,1,home,0,7,7
4955,2,shop,7,9,2
4955,3,education,9,12,3
4955,4,home,12,20,8
4955,5,shop,20,21,1
4955,6,home,21,24,3
4956,1,home,0,8,8
4956,2,work,8,14,6
4956,3,shop,14,15,1
4956,4,work,15,19,4
4956,5,home,19,24,5
4957,1,home,0,7,7
4957,2,work,7,14,7
4957,3,home,14,23,9
4957,4,work,23,24,1
4958,1,home,0,7,7
4958,2,work,7,8,1
4958,3,home,8,9,1
4958,4,work,9,11,2
4958,5,home,11,17,6
4958,6,work,17,19,2
4958,7,home,19,24,5
4959,1,home,0,6,6
4959,2,work,6,13,7
4959,3,home,13,18,5
4959,4,work,18,20,2
4959,5,home,20,24,4
4960,1,home,0,7,7
4960,2,work,7,14,7
4960,3,home,14,22,8
4960,4,work,22,23,1
4960,5,home,23,24,1
4961,1,home,0,6,6
4961,2,work,6,8,2
4961,3,home,8,14,6
4961,4,work,14,16,2
4961,5,home,16,22,6
4961,6,work,22,23,1
4961,7,home,23,24,1
4962,1,home,0,6,6
4962,2,shop,6,7,1
4962,3,work,7,13,6
4962,4,home,13,24,11
4963,1,home,0,9,9
4963,2,work,9,16,7
4963,3,home,16,24,8
4964,1,home,0,8,8
4964,2,work,8,14,6
4964,3,home,14,23,9
4964,4,work,23,24,1
4965,1,home,0,7,7
4965,2,work,7,14,7
4965,3,shop,14,15,1
4965,4,home,15,24,9
4966,1,home,0,8,8
4966,2,work,8,14,6
4966,3,home,14,24,10
4967,1,home,0,6,6
4967,2,work,6,13,7
4967,3,home,13,21,8
4967,4,shop,21,22,1
4967,5,home,22,24,2
4968,1,home,0,7,7
4968,2,work,7,9,2
4968,3,home,9,15,6
4968,4,work,15,18,3
4968,5,home,18,24,6
4969,1,home,0,8,8
4969,2,education,8,12,4
4969,3,work,12,19,7
4969,4,home,19,24,5
4970,1,home,0,7,7
4970,2,education,7,11,4
4970,3,home,11,17,6
4970,4,shop,17,18,1
4970,5,home,18,24,6
4971,1,home,0,7,7
4971,2,work,7,14,7
4971,3,shop,14,15,1
4971,4,home,15,21,6
4971,5,work,21,22,1
4971,6,home,22,24,2
4972,1,home,0,6,6
4972,2,shop,6,7,1
4972,3,home,7,12,5
4972,4,work,12,19,7
4972,5,home,19,24,5
4973,1,home,0,8,8
4973,2,work,8,15,7
4973,3,home,15,21,6
4973,4,work,21,22,1
4973,5,home,22,24,2
4974,1,home,0,7,7
4974,2,work,7,13,6
4974,3,shop,13,14,1
4974,4,home,14,24,10
4975,1,home,0,7,7
4975,2,education,7,11,4
4975,3,home,11,17,6
4975,4,shop,17,18,1
4975,5,home,18,24,6
4976,1,home,0,8,8
4976,2,education,8,13,5
4976,3,shop,13,14,1
4976,4,home,14,21,7
4976,5,shop,21,22,1
4976,6,home,22,24,2
4977,1,home,0,8,8
4977,2,education,8,13,5
4977,3,home,13,24,11
4978,1,home,0,6,6
4978,2,shop,6,7,1
4978,3,home,7,10,3
4978,4,education,10,13,3
4978,5,shop,13,15,2
4978,6,home,15,24,9
4979,1,home,0,7,7
4979,2,education,7,12,5
4979,3,shop,12,13,1
4979,4,education,13,16,3
4979,5,shop,16,17,1
4979,6,home,17,24,7
4980,1,home,0,6,6
4980,2,work,6,13,7
4980,3,shop,13,14,1
4980,4,work,14,19,5
4980,5,home,19,24,5
4981,1,home,0,6,6
4981,2,work,6,8,2
4981,3,home,8,14,6
4981,4,work,14,17,3
4981,5,home,17,23,6
4981,6,work,23,24,1
4982,1,home,0,6,6
4982,2,shop,6,7,1
4982,3,home,7,10,3
4982,4,education,10,12,2
4982,5,shop,12,14,2
4982,6,education,14,16,2
4982,7,shop,16,17,1
4982,8,home,17,24,7
4983,1,home,0,6,6
4983,2,shop,6,7,1
4983,3,home,7,10,3
4983,4,education,10,16,6
4983,5,shop,16,17,1
4983,6,home,17,24,7
4984,1,home,0,8,8
4984,2,work,8,15,7
4984,3,home,15,24,9
4985,1,home,0,7,7
4985,2,work,7,13,6
4985,3,home,13,17,4
4985,4,shop,17,18,1
4985,5,home,18,24,6
4986,1,home,0,6,6
4986,2,work,6,13,7
4986,3,shop,13,14,1
4986,4,work,14,18,4
4986,5,home,18,24,6
4987,1,home,0,7,7
4987,2,work,7,13,6
4987,3,home,13,24,11
4988,1,home,0,7,7
4988,2,work,7,14,7
4988,3,home,14,18,4
4988,4,shop,18,19,1
4988,5,home,19,23,4
4988,6,work,23,24,1
4989,1,home,0,7,7
4989,2,education,7,12,5
4989,3,home,12,18,6
4989,4,shop,18,20,2
4989,5,home,20,24,4
4990,1,home,0,6,6
4990,2,work,6,13,7
4990,3,home,13,16,3
4990,4,work,16,20,4
4990,5,home,20,24,4
4991,1,home,0,7,7
4991,2,shop,7,8,1
4991,3,education,8,11,3
4991,4,home,11,18,7
4991,5,shop,18,19,1
4991,6,home,19,24,5
4992,1,home,0,7,7
4992,2,work,7,14,7
4992,3,home,14,18,4
4992,4,shop,18,19,1
4992,5,home,19,24,5
4993,1,home,0,7,7
4993,2,work,7,14,7
4993,3,home,14,21,7
4993,4,shop,21,22,1
4993,5,home,22,24,2
4994,1,home,0,7,7
4994,2,work,7,13,6
4994,3,home,13,24,11
4995,1,home,0,6,6
4995,2,work,6,7,1
4995,3,home,7,9,2
4995,4,work,9,12,3
4995,5,home,12,18,6
4995,6,work,18,19,1
4995,7,home,19,24,5
4996,1,home,0,7,7
4996,2,work,7,13,6
4996,3,shop,13,14,1
4996,4,education,14,17,3
4996,5,home,17,22,5
4996,6,work,22,23,1
4996,7,home,23,24,1
4997,1,home,0,7,7
4997,2,work,7,14,7
4997,3,home,14,24,10
4998,1,home,0,7,7
4998,2,shop,7,8,1
4998,3,home,8,12,4
4998,4,work,12,18,6
4998,5,home,18,21,3
4998,6,work,21,22,1
4998,7,home,22,24,2
4999,1,home,0,6,6
4999,2,work,6,13,7
4999,3,home,13,24,11
5000,1,home,0,8,8
5000,2,shop,8,9,1
5000,3,home,9,21,12
5000,4,work,21,22,1
5000,5,home,22,24,2
5001,1,home,0,8,8
5001,2,work,8,15,7
5001,3,home,15,24,9
5002,1,home,0,6,6
5002,2,work,6,12,6
5002,3,shop,12,13,1
5002,4,work,13,19,6
5002,5,home,19,24,5
5003,1,home,0,7,7
5003,2,work,7,14,7
5003,3,home,14,21,7
5003,4,work,21,22,1
5003,5,home,22,24,2
5004,1,home,0,6,6
5004,2,work,6,7,1
5004,3,home,7,12,5
5004,4,work,12,13,1
5004,5,shop,13,14,1
5004,6,work,14,17,3
5004,7,home,17,22,5
5004,8,work,22,23,1
5004,9,home,23,24,1
5005,1,home,0,7,7
5005,2,work,7,13,6
5005,3,shop,13,14,1
5005,4,education,14,16,2
5005,5,home,16,24,8
5006,1,home,0,7,7
5006,2,work,7,13,6
5006,3,shop,13,14,1
5006,4,work,14,20,6
5006,5,home,20,24,4
5007,1,home,0,7,7
5007,2,work,7,13,6
5007,3,home,13,24,11
5008,1,home,0,7,7
5008,2,work,7,14,7
5008,3,shop,14,15,1
5008,4,work,15,20,5
5008,5,home,20,24,4
5009,1,home,0,7,7
5009,2,shop,7,8,1
5009,3,education,8,11,3
5009,4,home,11,14,3
5009,5,education,14,16,2
5009,6,shop,16,17,1
5009,7,home,17,24,7
5010,1,home,0,7,7
5010,2,education,7,12,5
5010,3,shop,12,14,2
5010,4,education,14,16,2
5010,5,home,16,24,8
5011,1,home,0,6,6
5011,2,shop,6,7,1
5011,3,home,7,13,6
5011,4,education,13,16,3
5011,5,home,16,24,8
5012,1,home,0,6,6
5012,2,shop,6,7,1
5012,3,home,7,10,3
5012,4,education,10,11,1
5012,5,home,11,13,2
5012,6,education,13,16,3
5012,7,home,16,24,8
5013,1,home,0,6,6
5013,2,work,6,8,2
5013,3,home,8,12,4
5013,4,work,12,14,2
5013,5,home,14,21,7
5013,6,work,21,22,1
5013,7,home,22,24,2
5014,1,home,0,6,6
5014,2,work,6,8,2
5014,3,home,8,14,6
5014,4,work,14,15,1
5014,5,home,15,21,6
5014,6,work,21,22,1
5014,7,home,22,24,2
5015,1,home,0,6,6
5015,2,work,6,8,2
5015,3,home,8,13,5
5015,4,work,13,15,2
5015,5,home,15,21,6
5015,6,work,21,22,1
5015,7,home,22,24,2
5016,1,home,0,6,6
5016,2,work,6,7,1
5016,3,home,7,12,5
5016,4,work,12,13,1
5016,5,home,13,21,8
5016,6,work,21,22,1
5016,7,home,22,24,2
5017,1,home,0,6,6
5017,2,shop,6,7,1
5017,3,home,7,10,3
5017,4,education,10,13,3
5017,5,shop,13,15,2
5017,6,home,15,24,9
5018,1,home,0,7,7
5018,2,education,7,11,4
5018,3,home,11,17,6
5018,4,shop,17,18,1
5018,5,home,18,24,6
5019,1,home,0,8,8
5019,2,work,8,15,7
5019,3,home,15,19,4
5019,4,shop,19,20,1
5019,5,home,20,24,4
5020,1,home,0,8,8
5020,2,work,8,14,6
5020,3,shop,14,15,1
5020,4,home,15,24,9
5021,1,home,0,9,9
5021,2,education,9,12,3
5021,3,home,12,19,7
5021,4,shop,19,20,1
5021,5,home,20,24,4
5022,1,home,0,6,6
5022,2,work,6,13,7
5022,3,shop,13,14,1
5022,4,work,14,20,6
5022,5,home,20,24,4
5023,1,home,0,8,8
5023,2,work,8,15,7
5023,3,shop,15,16,1
5023,4,home,16,24,8
5024,1,home,0,7,7
5024,2,work,7,14,7
5024,3,home,14,24,10
5025,1,home,0,7,7
5025,2,education,7,12,5
5025,3,home,12,21,9
5025,4,shop,21,22,1
5025,5,home,22,24,2
5026,1,home,0,7,7
5026,2,work,7,13,6
5026,3,home,13,16,3
5026,4,work,16,20,4
5026,5,home,20,24,4
5027,1,home,0,8,8
5027,2,work,8,15,7
5027,3,shop,15,16,1
5027,4,home,16,23,7
5027,5,work,23,24,1
5028,1,home,0,7,7
5028,2,education,7,11,4
5028,3,home,11,18,7
5028,4,shop,18,20,2
5028,5,home,20,24,4
5029,1,home,0,8,8
5029,2,work,8,15,7
5029,3,home,15,24,9
5030,1,home,0,6,6
5030,2,work,6,13,7
5030,3,home,13,17,4
5030,4,shop,17,18,1
5030,5,home,18,24,6
5031,1,home,0,7,7
5031,2,education,7,11,4
5031,3,home,11,20,9
5031,4,shop,20,21,1
5031,5,home,21,24,3
5032,1,home,0,6,6
5032,2,work,6,13,7
5032,3,home,13,18,5
5032,4,shop,18,19,1
5032,5,home,19,24,5
5033,1,home,0,9,9
5033,2,education,9,12,3
5033,3,home,12,19,7
5033,4,shop,19,20,1
5033,5,home,20,24,4
5034,1,home,0,9,9
5034,2,education,9,14,5
5034,3,home,14,21,7
5034,4,shop,21,22,1
5034,5,home,22,24,2
5035,1,home,0,7,7
5035,2,work,7,14,7
5035,3,home,14,24,10
5036,1,home,0,7,7
5036,2,work,7,13,6
5036,3,shop,13,14,1
5036,4,home,14,24,10
5037,1,home,0,6,6
5037,2,shop,6,7,1
5037,3,home,7,10,3
5037,4,education,10,12,2
5037,5,home,12,18,6
5037,6,shop,18,19,1
5037,7,home,19,24,5
5038,1,home,0,6,6
5038,2,work,6,8,2
5038,3,home,8,14,6
5038,4,work,14,15,1
5038,5,shop,15,16,1
5038,6,home,16,21,5
5038,7,work,21,22,1
5038,8,home,22,24,2
5039,1,home,0,7,7
5039,2,work,7,13,6
5039,3,home,13,24,11
5040,1,home,0,8,8
5040,2,work,8,16,8
5040,3,home,16,24,8
5041,1,home,0,6,6
5041,2,work,6,13,7
5041,3,shop,13,14,1
5041,4,home,14,24,10
5042,1,home,0,7,7
5042,2,work,7,9,2
5042,3,home,9,15,6
5042,4,work,15,17,2
5042,5,home,17,23,6
5042,6,work,23,24,1
5043,1,home,0,7,7
5043,2,work,7,13,6
5043,3,home,13,24,11
5044,1,home,0,7,7
5044,2,shop,7,9,2
5044,3,education,9,12,3
5044,4,home,12,18,6
5044,5,shop,18,19,1
5044,6,home,19,24,5
5045,1,home,0,7,7
5045,2,work,7,14,7
5045,3,shop,14,15,1
5045,4,home,15,24,9
5046,1,home,0,6,6
5046,2,shop,6,7,1
5046,3,work,7,14,7
5046,4,home,14,24,10
5047,1,home,0,6,6
5047,2,work,6,13,7
5047,3,home,13,24,11
5048,1,home,0,8,8
5048,2,work,8,14,6
5048,3,home,14,22,8
5048,4,work,22,23,1
5048,5,home,23,24,1
5049,1,home,0,7,7
5049,2,work,7,14,7
5049,3,shop,14,16,2
5049,4,work,16,18,2
5049,5,home,18,24,6
5050,1,home,0,7,7
5050,2,work,7,13,6
5050,3,home,13,21,8
5050,4,shop,21,22,1
5050,5,home,22,24,2
5051,1,home,0,7,7
5051,2,work,7,14,7
5051,3,home,14,24,10
5052,1,home,0,6,6
5052,2,work,6,13,7
5052,3,home,13,21,8
5052,4,work,21,22,1
5052,5,home,22,24,2
5053,1,home,0,7,7
5053,2,work,7,13,6
5053,3,home,13,24,11
5054,1,home,0,6,6
5054,2,work,6,13,7
5054,3,home,13,24,11
5055,1,home,0,6,6
5055,2,work,6,13,7
5055,3,shop,13,14,1
5055,4,work,14,17,3
5055,5,home,17,24,7
5056,1,home,0,7,7
5056,2,shop,7,8,1
5056,3,home,8,9,1
5056,4,education,9,11,2
5056,5,home,11,18,7
5056,6,shop,18,20,2
5056,7,home,20,24,4
5057,1,home,0,7,7
5057,2,education,7,11,4
5057,3,home,11,17,6
5057,4,shop,17,18,1
5057,5,home,18,24,6
5058,1,home,0,7,7
5058,2,work,7,13,6
5058,3,shop,13,14,1
5058,4,home,14,24,10
5059,1,home,0,6,6
5059,2,work,6,13,7
5059,3,shop,13,14,1
5059,4,work,14,19,5
5059,5,home,19,24,5
5060,1,home,0,7,7
5060,2,work,7,14,7
5060,3,home,14,24,10
5061,1,home,0,6,6
5061,2,work,6,13,7
5061,3,shop,13,14,1
5061,4,home,14,24,10
5062,1,home,0,7,7
5062,2,work,7,14,7
5062,3,home,14,18,4
5062,4,work,18,20,2
5062,5,home,20,24,4
5063,1,home,0,7,7
5063,2,work,7,13,6
5063,3,home,13,24,11
5064,1,home,0,8,8
5064,2,work,8,15,7
5064,3,shop,15,16,1
5064,4,home,16,24,8
5065,1,home,0,7,7
5065,2,education,7,12,5
5065,3,home,12,20,8
5065,4,shop,20,21,1
5065,5,home,21,24,3
5066,1,home,0,6,6
5066,2,work,6,13,7
5066,3,home,13,24,11
5067,1,home,0,7,7
5067,2,work,7,13,6
5067,3,home,13,18,5
5067,4,shop,18,19,1
5067,5,home,19,24,5
5068,1,home,0,7,7
5068,2,education,7,11,4
5068,3,home,11,17,6
5068,4,shop,17,18,1
5068,5,home,18,24,6
5069,1,home,0,9,9
5069,2,work,9,16,7
5069,3,home,16,22,6
5069,4,work,22,23,1
5069,5,home,23,24,1
5070,1,home,0,7,7
5070,2,work,7,14,7
5070,3,home,14,24,10
5071,1,home,0,8,8
5071,2,education,8,12,4
5071,3,home,12,21,9
5071,4,shop,21,22,1
5071,5,home,22,24,2
5072,1,home,0,7,7
5072,2,work,7,14,7
5072,3,shop,14,15,1
5072,4,home,15,24,9
5073,1,home,0,6,6
5073,2,shop,6,7,1
5073,3,home,7,9,2
5073,4,education,9,12,3
5073,5,home,12,14,2
5073,6,education,14,16,2
5073,7,home,16,24,8
5074,1,home,0,8,8
5074,2,work,8,14,6
5074,3,home,14,18,4
5074,4,work,18,20,2
5074,5,home,20,24,4
5075,1,home,0,7,7
5075,2,education,7,11,4
5075,3,home,11,18,7
5075,4,shop,18,20,2
5075,5,home,20,24,4
5076,1,home,0,8,8
5076,2,work,8,14,6
5076,3,shop,14,15,1
5076,4,home,15,24,9
5077,1,home,0,8,8
5077,2,work,8,15,7
5077,3,shop,15,16,1
5077,4,work,16,20,4
5077,5,home,20,24,4
5078,1,home,0,7,7
5078,2,education,7,11,4
5078,3,home,11,17,6
5078,4,shop,17,18,1
5078,5,home,18,24,6
5079,1,home,0,9,9
5079,2,education,9,12,3
5079,3,work,12,19,7
5079,4,home,19,24,5
5080,1,home,0,6,6
5080,2,work,6,14,8
5080,3,shop,14,15,1
5080,4,home,15,21,6
5080,5,work,21,22,1
5080,6,home,22,24,2
5081,1,home,0,8,8
5081,2,work,8,15,7
5081,3,home,15,18,3
5081,4,work,18,20,2
5081,5,home,20,24,4
5082,1,home,0,7,7
5082,2,shop,7,8,1
5082,3,home,8,9,1
5082,4,work,9,16,7
5082,5,home,16,23,7
5082,6,work,23,24,1
5083,1,home,0,9,9
5083,2,work,9,16,7
5083,3,home,16,24,8
5084,1,home,0,6,6
5084,2,work,6,12,6
5084,3,shop,12,13,1
5084,4,work,13,19,6
5084,5,home,19,24,5
5085,1,home,0,7,7
5085,2,education,7,11,4
5085,3,home,11,16,5
5085,4,shop,16,17,1
5085,5,home,17,24,7
5086,1,home,0,7,7
5086,2,work,7,13,6
5086,3,home,13,17,4
5086,4,shop,17,18,1
5086,5,home,18,24,6
5087,1,home,0,6,6
5087,2,work,6,13,7
5087,3,home,13,24,11
5088,1,home,0,6,6
5088,2,work,6,13,7
5088,3,shop,13,14,1
5088,4,work,14,20,6
5088,5,home,20,24,4
5089,1,home,0,7,7
5089,2,shop,7,8,1
5089,3,work,8,14,6
5089,4,home,14,23,9
5089,5,work,23,24,1
5090,1,home,0,7,7
5090,2,work,7,14,7
5090,3,home,14,24,10
5091,1,home,0,6,6
5091,2,work,6,13,7
5091,3,home,13,16,3
5091,4,work,16,20,4
5091,5,home,20,24,4
5092,1,home,0,7,7
5092,2,work,7,13,6
5092,3,home,13,24,11
5093,1,home,0,7,7
5093,2,work,7,13,6
5093,3,home,13,18,5
5093,4,work,18,19,1
5093,5,home,19,24,5
5094,1,home,0,6,6
5094,2,work,6,7,1
5094,3,home,7,9,2
5094,4,work,9,11,2
5094,5,home,11,21,10
5094,6,work,21,22,1
5094,7,home,22,24,2
5095,1,home,0,7,7
5095,2,work,7,14,7
5095,3,home,14,15,1
5095,4,work,15,20,5
5095,5,home,20,24,4
5096,1,home,0,7,7
5096,2,work,7,13,6
5096,3,shop,13,14,1
5096,4,work,14,20,6
5096,5,home,20,24,4
5097,1,home,0,7,7
5097,2,work,7,9,2
5097,3,home,9,15,6
5097,4,work,15,18,3
5097,5,home,18,24,6
5098,1,home,0,7,7
5098,2,work,7,14,7
5098,3,home,14,24,10
5099,1,home,0,8,8
5099,2,work,8,14,6
5099,3,shop,14,15,1
5099,4,home,15,24,9
5100,1,home,0,7,7
5100,2,work,7,14,7
5100,3,home,14,24,10
5101,1,home,0,6,6
5101,2,shop,6,7,1
5101,3,home,7,13,6
5101,4,education,13,16,3
5101,5,home,16,24,8
5102,1,home,0,7,7
5102,2,shop,7,8,1
5102,3,work,8,15,7
5102,4,home,15,24,9
5103,1,home,0,6,6
5103,2,work,6,13,7
5103,3,shop,13,15,2
5103,4,work,15,20,5
5103,5,home,20,24,4
5104,1,home,0,6,6
5104,2,work,6,7,1
5104,3,home,7,9,2
5104,4,work,9,11,2
5104,5,home,11,15,4
5104,6,work,15,17,2
5104,7,home,17,23,6
5104,8,work,23,24,1
5105,1,home,0,6,6
5105,2,work,6,13,7
5105,3,home,13,24,11
5106,1,home,0,6,6
5106,2,work,6,8,2
5106,3,home,8,13,5
5106,4,work,13,15,2
5106,5,home,15,22,7
5106,6,work,22,23,1
5106,7,home,23,24,1
5107,1,home,0,7,7
5107,2,work,7,13,6
5107,3,home,13,18,5
5107,4,shop,18,19,1
5107,5,home,19,24,5
5108,1,home,0,7,7
5108,2,work,7,14,7
5108,3,home,14,24,10
5109,1,home,0,6,6
5109,2,shop,6,7,1
5109,3,home,7,10,3
5109,4,work,10,17,7
5109,5,home,17,22,5
5109,6,work,22,23,1
5109,7,home,23,24,1
5110,1,home,0,7,7
5110,2,work,7,13,6
5110,3,home,13,17,4
5110,4,shop,17,18,1
5110,5,home,18,22,4
5110,6,work,22,23,1
5110,7,home,23,24,1
5111,1,home,0,6,6
5111,2,shop,6,7,1
5111,3,home,7,10,3
5111,4,work,10,17,7
5111,5,home,17,24,7
5112,1,home,0,6,6
5112,2,work,6,13,7
5112,3,home,13,18,5
5112,4,work,18,20,2
5112,5,home,20,24,4
5113,1,home,0,7,7
5113,2,work,7,14,7
5113,3,home,14,24,10
5114,1,home,0,7,7
5114,2,work,7,9,2
5114,3,home,9,14,5
5114,4,work,14,16,2
5114,5,home,16,22,6
5114,6,work,22,23,1
5114,7,home,23,24,1
5115,1,home,0,7,7
5115,2,work,7,13,6
5115,3,home,13,24,11
5116,1,home,0,7,7
5116,2,work,7,14,7
5116,3,home,14,23,9
5116,4,work,23,24,1
5117,1,home,0,8,8
5117,2,work,8,15,7
5117,3,home,15,24,9
5118,1,home,0,8,8
5118,2,work,8,15,7
5118,3,shop,15,16,1
5118,4,work,16,20,4
5118,5,home,20,24,4
5119,1,home,0,7,7
5119,2,work,7,9,2
5119,3,home,9,13,4
5119,4,work,13,15,2
5119,5,home,15,22,7
5119,6,work,22,23,1
5119,7,home,23,24,1
5120,1,home,0,8,8
5120,2,work,8,15,7
5120,3,home,15,24,9
5121,1,home,0,8,8
5121,2,work,8,15,7
5121,3,shop,15,16,1
5121,4,work,16,20,4
5121,5,home,20,24,4
5122,1,home,0,7,7
5122,2,work,7,12,5
5122,3,shop,12,14,2
5122,4,education,14,17,3
5122,5,home,17,24,7
5123,1,home,0,7,7
5123,2,work,7,14,7
5123,3,shop,14,15,1
5123,4,home,15,24,9
5124,1,home,0,7,7
5124,2,work,7,14,7
5124,3,shop,14,15,1
5124,4,work,15,20,5
5124,5,home,20,24,4
5125,1,home,0,7,7
5125,2,work,7,13,6
5125,3,home,13,24,11
5126,1,home,0,6,6
5126,2,work,6,8,2
5126,3,home,8,14,6
5126,4,work,14,17,3
5126,5,home,17,21,4
5126,6,work,21,22,1
5126,7,home,22,24,2
5127,1,home,0,8,8
5127,2,work,8,15,7
5127,3,home,15,21,6
5127,4,shop,21,22,1
5127,5,home,22,24,2
5128,1,home,0,7,7
5128,2,work,7,14,7
5128,3,home,14,19,5
5128,4,shop,19,20,1
5128,5,home,20,24,4
5129,1,home,0,6,6
5129,2,work,6,13,7
5129,3,home,13,24,11
5130,1,home,0,7,7
5130,2,work,7,14,7
5130,3,home,14,24,10
5131,1,home,0,7,7
5131,2,shop,7,8,1
5131,3,home,8,13,5
5131,4,education,13,16,3
5131,5,shop,16,17,1
5131,6,home,17,24,7
5132,1,home,0,7,7
5132,2,education,7,13,6
5132,3,shop,13,15,2
5132,4,home,15,21,6
5132,5,shop,21,22,1
5132,6,home,22,24,2
5133,1,home,0,7,7
5133,2,shop,7,8,1
5133,3,education,8,11,3
5133,4,home,11,19,8
5133,5,shop,19,20,1
5133,6,home,20,24,4
5134,1,home,0,6,6
5134,2,shop,6,7,1
5134,3,home,7,8,1
5134,4,work,8,15,7
5134,5,home,15,24,9
5135,1,home,0,6,6
5135,2,work,6,12,6
5135,3,shop,12,13,1
5135,4,work,13,19,6
5135,5,home,19,24,5
5136,1,home,0,8,8
5136,2,work,8,15,7
5136,3,home,15,24,9
5137,1,home,0,7,7
5137,2,work,7,15,8
5137,3,home,15,24,9
5138,1,home,0,8,8
5138,2,work,8,14,6
5138,3,shop,14,15,1
5138,4,home,15,24,9
5139,1,home,0,6,6
5139,2,work,6,8,2
5139,3,home,8,13,5
5139,4,work,13,15,2
5139,5,home,15,22,7
5139,6,work,22,23,1
5139,7,home,23,24,1
5140,1,home,0,7,7
5140,2,shop,7,8,1
5140,3,home,8,10,2
5140,4,education,10,12,2
5140,5,home,12,18,6
5140,6,shop,18,19,1
5140,7,home,19,24,5
5141,1,home,0,6,6
5141,2,work,6,13,7
5141,3,shop,13,14,1
5141,4,work,14,19,5
5141,5,home,19,24,5
5142,1,home,0,6,6
5142,2,shop,6,7,1
5142,3,work,7,13,6
5142,4,home,13,21,8
5142,5,work,21,22,1
5142,6,home,22,24,2
5143,1,home,0,8,8
5143,2,work,8,15,7
5143,3,shop,15,16,1
5143,4,home,16,22,6
5143,5,work,22,23,1
5143,6,home,23,24,1
5144,1,home,0,8,8
5144,2,work,8,15,7
5144,3,home,15,21,6
5144,4,work,21,22,1
5144,5,home,22,24,2
5145,1,home,0,6,6
5145,2,work,6,13,7
5145,3,home,13,17,4
5145,4,work,17,20,3
5145,5,home,20,24,4
5146,1,home,0,7,7
5146,2,work,7,13,6
5146,3,shop,13,14,1
5146,4,home,14,24,10
5147,1,home,0,6,6
5147,2,work,6,8,2
5147,3,home,8,14,6
5147,4,work,14,16,2
5147,5,home,16,22,6
5147,6,work,22,23,1
5147,7,home,23,24,1
5148,1,home,0,8,8
5148,2,work,8,14,6
5148,3,home,14,24,10
5149,1,home,0,7,7
5149,2,education,7,11,4
5149,3,home,11,18,7
5149,4,shop,18,20,2
5149,5,home,20,24,4
5150,1,home,0,6,6
5150,2,work,6,8,2
5150,3,home,8,14,6
5150,4,work,14,17,3
5150,5,home,17,23,6
5150,6,work,23,24,1
5151,1,home,0,8,8
5151,2,education,8,12,4
5151,3,shop,12,13,1
5151,4,education,13,16,3
5151,5,home,16,24,8
5152,1,home,0,8,8
5152,2,work,8,16,8
5152,3,home,16,24,8
5153,1,home,0,8,8
5153,2,work,8,15,7
5153,3,home,15,21,6
5153,4,work,21,22,1
5153,5,home,22,24,2
5154,1,home,0,6,6
5154,2,shop,6,7,1
5154,3,home,7,9,2
5154,4,education,9,11,2
5154,5,home,11,18,7
5154,6,shop,18,19,1
5154,7,home,19,24,5
5155,1,home,0,7,7
5155,2,work,7,13,6
5155,3,shop,13,14,1
5155,4,home,14,24,10
5156,1,home,0,8,8
5156,2,education,8,11,3
5156,3,home,11,13,2
5156,4,education,13,16,3
5156,5,home,16,24,8
5157,1,home,0,6,6
5157,2,shop,6,7,1
5157,3,home,7,18,11
5157,4,work,18,20,2
5157,5,home,20,24,4
5158,1,home,0,6,6
5158,2,work,6,8,2
5158,3,home,8,14,6
5158,4,work,14,16,2
5158,5,home,16,23,7
5158,6,work,23,24,1
5159,1,home,0,8,8
5159,2,work,8,14,6
5159,3,shop,14,15,1
5159,4,home,15,23,8
5159,5,work,23,24,1
5160,1,home,0,6,6
5160,2,work,6,7,1
5160,3,home,7,9,2
5160,4,work,9,11,2
5160,5,home,11,15,4
5160,6,work,15,17,2
5160,7,home,17,24,7
5161,1,home,0,7,7
5161,2,work,7,9,2
5161,3,home,9,13,4
5161,4,work,13,16,3
5161,5,home,16,22,6
5161,6,work,22,23,1
5161,7,home,23,24,1
5162,1,home,0,7,7
5162,2,work,7,13,6
5162,3,home,13,24,11
5163,1,home,0,7,7
5163,2,work,7,13,6
5163,3,home,13,18,5
5163,4,work,18,20,2
5163,5,home,20,24,4
5164,1,home,0,8,8
5164,2,work,8,15,7
5164,3,home,15,24,9
5165,1,home,0,6,6
5165,2,work,6,8,2
5165,3,home,8,12,4
5165,4,work,12,15,3
5165,5,home,15,21,6
5165,6,work,21,22,1
5165,7,home,22,24,2
5166,1,home,0,8,8
5166,2,education,8,11,3
5166,3,home,11,17,6
5166,4,work,17,20,3
5166,5,home,20,24,4
5167,1,home,0,6,6
5167,2,shop,6,7,1
5167,3,home,7,10,3
5167,4,education,10,11,1
5167,5,home,11,18,7
5167,6,shop,18,19,1
5167,7,home,19,24,5
5168,1,home,0,6,6
5168,2,work,6,13,7
5168,3,home,13,24,11
5169,1,home,0,7,7
5169,2,work,7,13,6
5169,3,shop,13,15,2
5169,4,work,15,20,5
5169,5,home,20,24,4
5170,1,home,0,8,8
5170,2,work,8,15,7
5170,3,shop,15,16,1
5170,4,home,16,24,8
5171,1,home,0,7,7
5171,2,work,7,13,6
5171,3,shop,13,14,1
5171,4,home,14,20,6
5171,5,shop,20,21,1
5171,6,home,21,24,3
5172,1,home,0,9,9
5172,2,education,9,12,3
5172,3,work,12,19,7
5172,4,home,19,23,4
5172,5,work,23,24,1
5173,1,home,0,7,7
5173,2,work,7,13,6
5173,3,home,13,22,9
5173,4,work,22,23,1
5173,5,home,23,24,1
5174,1,home,0,7,7
5174,2,work,7,9,2
5174,3,home,9,14,5
5174,4,work,14,16,2
5174,5,home,16,24,8
5175,1,home,0,7,7
5175,2,education,7,11,4
5175,3,home,11,14,3
5175,4,education,14,16,2
5175,5,shop,16,17,1
5175,6,home,17,24,7
5176,1,home,0,6,6
5176,2,work,6,13,7
5176,3,shop,13,14,1
5176,4,work,14,20,6
5176,5,home,20,24,4
5177,1,home,0,9,9
5177,2,education,9,13,4
5177,3,shop,13,14,1
5177,4,home,14,24,10
5178,1,home,0,7,7
5178,2,shop,7,9,2
5178,3,education,9,15,6
5178,4,shop,15,17,2
5178,5,home,17,24,7
5179,1,home,0,7,7
5179,2,work,7,14,7
5179,3,home,14,24,10
5180,1,home,0,6,6
5180,2,work,6,7,1
5180,3,home,7,9,2
5180,4,work,9,11,2
5180,5,home,11,16,5
5180,6,work,16,18,2
5180,7,home,18,24,6
5181,1,home,0,6,6
5181,2,work,6,13,7
5181,3,shop,13,14,1
5181,4,home,14,24,10
5182,1,home,0,8,8
5182,2,work,8,14,6
5182,3,shop,14,15,1
5182,4,home,15,24,9
5183,1,home,0,10,10
5183,2,work,10,17,7
5183,3,home,17,24,7
5184,1,home,0,6,6
5184,2,work,6,11,5
5184,3,shop,11,12,1
5184,4,home,12,16,4
5184,5,work,16,20,4
5184,6,home,20,24,4
5185,1,home,0,6,6
5185,2,work,6,9,3
5185,3,home,9,10,1
5185,4,work,10,11,1
5185,5,home,11,15,4
5185,6,work,15,18,3
5185,7,home,18,24,6
5186,1,home,0,7,7
5186,2,education,7,11,4
5186,3,home,11,19,8
5186,4,shop,19,20,1
5186,5,home,20,24,4
5187,1,home,0,7,7
5187,2,education,7,11,4
5187,3,home,11,18,7
5187,4,shop,18,19,1
5187,5,home,19,24,5
5188,1,home,0,10,10
5188,2,shop,10,11,1
5188,3,work,11,17,6
5188,4,home,17,24,7
5189,1,home,0,8,8
5189,2,work,8,16,8
5189,3,shop,16,17,1
5189,4,home,17,21,4
5189,5,work,21,22,1
5189,6,home,22,24,2
5190,1,home,0,6,6
5190,2,work,6,8,2
5190,3,home,8,9,1
5190,4,work,9,11,2
5190,5,home,11,16,5
5190,6,work,16,18,2
5190,7,home,18,23,5
5190,8,work,23,24,1
5191,1,home,0,8,8
5191,2,work,8,15,7
5191,3,shop,15,16,1
5191,4,home,16,24,8
5192,1,work,0,8,8
5192,2,shop,8,9,1
5192,3,work,9,14,5
5192,4,home,14,24,10
5193,1,home,0,7,7
5193,2,work,7,9,2
5193,3,home,9,14,5
5193,4,work,14,16,2
5193,5,home,16,21,5
5193,6,work,21,22,1
5193,7,home,22,24,2
5194,1,home,0,6,6
5194,2,work,6,8,2
5194,3,home,8,13,5
5194,4,work,13,15,2
5194,5,home,15,18,3
5194,6,work,18,19,1
5194,7,home,19,24,5
5195,1,home,0,7,7
5195,2,work,7,13,6
5195,3,home,13,22,9
5195,4,work,22,23,1
5195,5,home,23,24,1
5196,1,home,0,7,7
5196,2,work,7,14,7
5196,3,shop,14,15,1
5196,4,home,15,24,9
5197,1,home,0,6,6
5197,2,shop,6,7,1
5197,3,home,7,10,3
5197,4,education,10,13,3
5197,5,shop,13,15,2
5197,6,home,15,21,6
5197,7,shop,21,22,1
5197,8,home,22,24,2
5198,1,home,0,6,6
5198,2,shop,6,7,1
5198,3,home,7,14,7
5198,4,work,14,18,4
5198,5,home,18,23,5
5198,6,work,23,24,1
5199,1,home,0,7,7
5199,2,work,7,14,7
5199,3,shop,14,15,1
5199,4,work,15,19,4
5199,5,home,19,24,5
5200,1,home,0,8,8
5200,2,work,8,14,6
5200,3,home,14,22,8
5200,4,work,22,23,1
5200,5,home,23,24,1
5201,1,home,0,6,6
5201,2,shop,6,7,1
5201,3,home,7,9,2
5201,4,education,9,13,4
5201,5,home,13,14,1
5201,6,education,14,15,1
5201,7,shop,15,16,1
5201,8,home,16,24,8
5202,1,home,0,6,6
5202,2,work,6,8,2
5202,3,home,8,12,4
5202,4,work,12,15,3
5202,5,home,15,22,7
5202,6,work,22,23,1
5202,7,home,23,24,1
5203,1,home,0,7,7
5203,2,work,7,13,6
5203,3,home,13,22,9
5203,4,work,22,23,1
5203,5,home,23,24,1
5204,1,home,0,6,6
5204,2,shop,6,7,1
5204,3,work,7,13,6
5204,4,home,13,24,11
5205,1,home,0,6,6
5205,2,work,6,8,2
5205,3,home,8,15,7
5205,4,work,15,17,2
5205,5,home,17,24,7
5206,1,home,0,6,6
5206,2,work,6,13,7
5206,3,home,13,24,11
5207,1,home,0,8,8
5207,2,work,8,16,8
5207,3,home,16,24,8
5208,1,home,0,7,7
5208,2,work,7,9,2
5208,3,home,9,12,3
5208,4,work,12,13,1
5208,5,home,13,21,8
5208,6,work,21,22,1
5208,7,home,22,24,2
5209,1,home,0,8,8
5209,2,work,8,14,6
5209,3,home,14,21,7
5209,4,shop,21,22,1
5209,5,home,22,24,2
5210,1,home,0,8,8
5210,2,work,8,15,7
5210,3,home,15,24,9
5211,1,home,0,7,7
5211,2,education,7,11,4
5211,3,home,11,14,3
5211,4,education,14,15,1
5211,5,shop,15,17,2
5211,6,home,17,24,7
5212,1,home,0,7,7
5212,2,education,7,12,5
5212,3,home,12,19,7
5212,4,shop,19,21,2
5212,5,home,21,24,3
5213,1,home,0,8,8
5213,2,work,8,13,5
5213,3,home,13,17,4
5213,4,shop,17,18,1
5213,5,home,18,22,4
5213,6,work,22,23,1
5213,7,home,23,24,1
5214,1,home,0,7,7
5214,2,education,7,12,5
5214,3,shop,12,14,2
5214,4,home,14,21,7
5214,5,shop,21,22,1
5214,6,home,22,24,2
5215,1,home,0,7,7
5215,2,work,7,13,6
5215,3,shop,13,14,1
5215,4,education,14,16,2
5215,5,home,16,18,2
5215,6,work,18,20,2
5215,7,home,20,24,4
5216,1,home,0,6,6
5216,2,shop,6,7,1
5216,3,home,7,10,3
5216,4,education,10,12,2
5216,5,shop,12,14,2
5216,6,home,14,21,7
5216,7,shop,21,22,1
5216,8,home,22,24,2
5217,1,home,0,6,6
5217,2,work,6,8,2
5217,3,home,8,12,4
5217,4,work,12,14,2
5217,5,home,14,21,7
5217,6,work,21,22,1
5217,7,home,22,24,2
5218,1,home,0,6,6
5218,2,shop,6,7,1
5218,3,home,7,13,6
5218,4,education,13,16,3
5218,5,home,16,24,8
5219,1,home,0,7,7
5219,2,work,7,9,2
5219,3,home,9,12,3
5219,4,work,12,15,3
5219,5,home,15,22,7
5219,6,work,22,23,1
5219,7,home,23,24,1
5220,1,home,0,7,7
5220,2,work,7,14,7
5220,3,home,14,23,9
5220,4,work,23,24,1
5221,1,home,0,7,7
5221,2,work,7,13,6
5221,3,home,13,21,8
5221,4,work,21,22,1
5221,5,home,22,24,2
5222,1,home,0,6,6
5222,2,work,6,8,2
5222,3,home,8,11,3
5222,4,work,11,13,2
5222,5,home,13,21,8
5222,6,work,21,22,1
5222,7,home,22,24,2
5223,1,home,0,6,6
5223,2,work,6,13,7
5223,3,home,13,24,11
5224,1,home,0,7,7
5224,2,work,7,13,6
5224,3,home,13,18,5
5224,4,shop,18,19,1
5224,5,home,19,24,5
5225,1,home,0,8,8
5225,2,work,8,14,6
5225,3,shop,14,15,1
5225,4,home,15,24,9
5226,1,home,0,7,7
5226,2,work,7,13,6
5226,3,home,13,20,7
5226,4,shop,20,21,1
5226,5,home,21,24,3
5227,1,home,0,7,7
5227,2,work,7,14,7
5227,3,shop,14,15,1
5227,4,work,15,20,5
5227,5,home,20,24,4
5228,1,home,0,6,6
5228,2,work,6,13,7
5228,3,home,13,16,3
5228,4,work,16,19,3
5228,5,home,19,24,5
5229,1,home,0,6,6
5229,2,work,6,13,7
5229,3,shop,13,15,2
5229,4,work,15,20,5
5229,5,home,20,24,4
5230,1,home,0,7,7
5230,2,shop,7,9,2
5230,3,education,9,12,3
5230,4,home,12,18,6
5230,5,shop,18,19,1
5230,6,home,19,24,5
5231,1,home,0,7,7
5231,2,work,7,14,7
5231,3,shop,14,15,1
5231,4,work,15,20,5
5231,5,home,20,24,4
5232,1,home,0,8,8
5232,2,work,8,15,7
5232,3,home,15,21,6
5232,4,work,21,22,1
5232,5,home,22,24,2
5233,1,home,0,7,7
5233,2,work,7,13,6
5233,3,home,13,18,5
5233,4,work,18,20,2
5233,5,home,20,24,4
5234,1,home,0,6,6
5234,2,shop,6,7,1
5234,3,home,7,10,3
5234,4,education,10,14,4
5234,5,shop,14,16,2
5234,6,home,16,24,8
5235,1,home,0,7,7
5235,2,work,7,9,2
5235,3,home,9,13,4
5235,4,work,13,15,2
5235,5,home,15,21,6
5235,6,shop,21,22,1
5235,7,home,22,24,2
5236,1,home,0,7,7
5236,2,work,7,14,7
5236,3,home,14,24,10
5237,1,home,0,7,7
5237,2,work,7,15,8
5237,3,home,15,24,9
5238,1,home,0,7,7
5238,2,shop,7,8,1
5238,3,education,8,12,4
5238,4,home,12,20,8
5238,5,shop,20,21,1
5238,6,home,21,24,3
5239,1,home,0,8,8
5239,2,work,8,15,7
5239,3,home,15,24,9
5240,1,home,0,6,6
5240,2,shop,6,7,1
5240,3,work,7,14,7
5240,4,home,14,23,9
5240,5,work,23,24,1
5241,1,home,0,7,7
5241,2,work,7,13,6
5241,3,shop,13,14,1
5241,4,work,14,19,5
5241,5,home,19,24,5
5242,1,home,0,7,7
5242,2,work,7,14,7
5242,3,home,14,17,3
5242,4,work,17,20,3
5242,5,home,20,24,4
5243,1,home,0,6,6
5243,2,work,6,8,2
5243,3,home,8,14,6
5243,4,work,14,16,2
5243,5,home,16,23,7
5243,6,work,23,24,1
5244,1,home,0,7,7
5244,2,work,7,9,2
5244,3,home,9,16,7
5244,4,work,16,17,1
5244,5,home,17,21,4
5244,6,work,21,22,1
5244,7,home,22,24,2
5245,1,home,0,6,6
5245,2,work,6,13,7
5245,3,home,13,17,4
5245,4,work,17,20,3
5245,5,home,20,24,4
5246,1,home,0,8,8
5246,2,work,8,14,6
5246,3,home,14,24,10
5247,1,home,0,6,6
5247,2,work,6,13,7
5247,3,home,13,24,11
5248,1,home,0,7,7
5248,2,education,7,12,5
5248,3,shop,12,14,2
5248,4,education,14,18,4
5248,5,home,18,24,6
5249,1,home,0,7,7
5249,2,work,7,13,6
5249,3,home,13,24,11
5250,1,home,0,8,8
5250,2,work,8,15,7
5250,3,shop,15,16,1
5250,4,work,16,20,4
5250,5,home,20,24,4
5251,1,home,0,6,6
5251,2,work,6,13,7
5251,3,home,13,17,4
5251,4,work,17,20,3
5251,5,home,20,24,4
5252,1,home,0,6,6
5252,2,work,6,13,7
5252,3,home,13,24,11
5253,1,home,0,8,8
5253,2,work,8,14,6
5253,3,home,14,18,4
5253,4,work,18,20,2
5253,5,home,20,24,4
5254,1,home,0,6,6
5254,2,work,6,12,6
5254,3,shop,12,13,1
5254,4,work,13,19,6
5254,5,home,19,24,5
5255,1,home,0,7,7
5255,2,education,7,11,4
5255,3,home,11,17,6
5255,4,shop,17,18,1
5255,5,home,18,24,6
5256,1,home,0,7,7
5256,2,work,7,14,7
5256,3,shop,14,15,1
5256,4,home,15,16,1
5256,5,work,16,19,3
5256,6,home,19,24,5
5257,1,home,0,6,6
5257,2,work,6,8,2
5257,3,home,8,9,1
5257,4,work,9,11,2
5257,5,home,11,17,6
5257,6,work,17,19,2
5257,7,home,19,24,5
5258,1,home,0,8,8
5258,2,education,8,11,3
5258,3,home,11,16,5
5258,4,shop,16,17,1
5258,5,home,17,24,7
5259,1,home,0,7,7
5259,2,work,7,12,5
5259,3,shop,12,13,1
5259,4,work,13,19,6
5259,5,home,19,24,5
5260,1,home,0,7,7
5260,2,work,7,13,6
5260,3,shop,13,14,1
5260,4,work,14,19,5
5260,5,home,19,24,5
5261,1,home,0,6,6
5261,2,shop,6,7,1
5261,3,home,7,13,6
5261,4,education,13,16,3
5261,5,shop,16,17,1
5261,6,home,17,24,7
5262,1,home,0,6,6
5262,2,work,6,12,6
5262,3,shop,12,13,1
5262,4,education,13,16,3
5262,5,shop,16,17,1
5262,6,home,17,24,7
5263,1,home,0,7,7
5263,2,work,7,15,8
5263,3,home,15,24,9
5264,1,home,0,6,6
5264,2,work,6,8,2
5264,3,home,8,10,2
5264,4,work,10,12,2
5264,5,home,12,16,4
5264,6,work,16,18,2
5264,7,home,18,24,6
5265,1,home,0,7,7
5265,2,work,7,13,6
5265,3,shop,13,14,1
5265,4,work,14,20,6
5265,5,home,20,24,4
5266,1,home,0,7,7
5266,2,education,7,12,5
5266,3,shop,12,13,1
5266,4,education,13,15,2
5266,5,shop,15,16,1
5266,6,home,16,24,8
5267,1,home,0,6,6
5267,2,work,6,13,7
5267,3,home,13,16,3
5267,4,work,16,20,4
5267,5,home,20,24,4
5268,1,home,0,7,7
5268,2,work,7,10,3
5268,3,home,10,15,5
5268,4,work,15,17,2
5268,5,home,17,22,5
5268,6,work,22,23,1
5268,7,home,23,24,1
5269,1,home,0,6,6
5269,2,work,6,7,1
5269,3,home,7,12,5
5269,4,work,12,14,2
5269,5,home,14,21,7
5269,6,work,21,22,1
5269,7,home,22,24,2
5270,1,home,0,8,8
5270,2,work,8,15,7
5270,3,home,15,24,9
5271,1,home,0,6,6
5271,2,work,6,13,7
5271,3,home,13,22,9
5271,4,work,22,23,1
5271,5,home,23,24,1
5272,1,home,0,6,6
5272,2,work,6,13,7
5272,3,shop,13,14,1
5272,4,work,14,20,6
5272,5,home,20,24,4
5273,1,home,0,6,6
5273,2,shop,6,7,1
5273,3,home,7,13,6
5273,4,education,13,16,3
5273,5,home,16,24,8
5274,1,home,0,8,8
5274,2,education,8,11,3
5274,3,shop,11,12,1
5274,4,work,12,18,6
5274,5,home,18,24,6
5275,1,home,0,8,8
5275,2,shop,8,9,1
5275,3,home,9,17,8
5275,4,work,17,20,3
5275,5,home,20,24,4
5276,1,home,0,6,6
5276,2,work,6,13,7
5276,3,home,13,16,3
5276,4,work,16,20,4
5276,5,home,20,24,4
5277,1,home,0,6,6
5277,2,work,6,13,7
5277,3,shop,13,14,1
5277,4,home,14,24,10
5278,1,home,0,8,8
5278,2,shop,8,9,1
5278,3,work,9,15,6
5278,4,home,15,23,8
5278,5,work,23,24,1
5279,1,home,0,8,8
5279,2,work,8,14,6
5279,3,shop,14,15,1
5279,4,work,15,17,2
5279,5,home,17,24,7
5280,1,home,0,6,6
5280,2,work,6,8,2
5280,3,home,8,14,6
5280,4,work,14,17,3
5280,5,home,17,21,4
5280,6,work,21,22,1
5280,7,home,22,24,2
5281,1,home,0,7,7
5281,2,work,7,13,6
5281,3,home,13,22,9
5281,4,work,22,23,1
5281,5,home,23,24,1
5282,1,home,0,6,6
5282,2,work,6,13,7
5282,3,home,13,17,4
5282,4,work,17,20,3
5282,5,home,20,24,4
5283,1,home,0,8,8
5283,2,work,8,15,7
5283,3,shop,15,16,1
5283,4,work,16,20,4
5283,5,home,20,24,4
5284,1,home,0,6,6
5284,2,shop,6,7,1
5284,3,home,7,10,3
5284,4,education,10,13,3
5284,5,shop,13,14,1
5284,6,education,14,16,2
5284,7,home,16,24,8
5285,1,home,0,7,7
5285,2,work,7,13,6
5285,3,home,13,24,11
5286,1,home,0,8,8
5286,2,work,8,14,6
5286,3,shop,14,15,1
5286,4,home,15,24,9
5287,1,home,0,6,6
5287,2,shop,6,7,1
5287,3,home,7,9,2
5287,4,education,9,12,3
5287,5,home,12,16,4
5287,6,shop,16,18,2
5287,7,home,18,24,6
5288,1,home,0,6,6
5288,2,shop,6,7,1
5288,3,work,7,13,6
5288,4,home,13,24,11
5289,1,home,0,8,8
5289,2,education,8,13,5
5289,3,shop,13,15,2
5289,4,home,15,24,9
5290,1,home,0,7,7
5290,2,shop,7,8,1
5290,3,education,8,12,4
5290,4,shop,12,13,1
5290,5,home,13,21,8
5290,6,shop,21,22,1
5290,7,home,22,24,2
5291,1,home,0,6,6
5291,2,work,6,8,2
5291,3,home,8,14,6
5291,4,work,14,17,3
5291,5,home,17,23,6
5291,6,work,23,24,1
5292,1,home,0,6,6
5292,2,shop,6,7,1
5292,3,home,7,12,5
5292,4,education,12,16,4
5292,5,home,16,20,4
5292,6,shop,20,21,1
5292,7,home,21,24,3
5293,1,home,0,6,6
5293,2,shop,6,7,1
5293,3,work,7,8,1
5293,4,home,8,9,1
5293,5,work,9,11,2
5293,6,home,11,15,4
5293,7,work,15,17,2
5293,8,home,17,23,6
5293,9,work,23,24,1
5294,1,home,0,7,7
5294,2,work,7,9,2
5294,3,home,9,15,6
5294,4,work,15,17,2
5294,5,home,17,24,7
5295,1,home,0,8,8
5295,2,shop,8,9,1
5295,3,home,9,12,3
5295,4,work,12,19,7
5295,5,home,19,24,5
5296,1,home,0,6,6
5296,2,work,6,8,2
5296,3,home,8,9,1
5296,4,work,9,11,2
5296,5,home,11,15,4
5296,6,work,15,17,2
5296,7,home,17,18,1
5296,8,work,18,19,1
5296,9,home,19,24,5
5297,1,home,0,6,6
5297,2,work,6,13,7
5297,3,home,13,20,7
5297,4,shop,20,21,1
5297,5,home,21,24,3
5298,1,home,0,8,8
5298,2,work,8,16,8
5298,3,home,16,24,8
5299,1,home,0,7,7
5299,2,work,7,15,8
5299,3,shop,15,16,1
5299,4,home,16,24,8
5300,1,home,0,7,7
5300,2,work,7,9,2
5300,3,home,9,12,3
5300,4,work,12,14,2
5300,5,home,14,21,7
5300,6,work,21,22,1
5300,7,home,22,24,2
5301,1,home,0,8,8
5301,2,work,8,15,7
5301,3,shop,15,16,1
5301,4,home,16,23,7
5301,5,work,23,24,1
5302,1,home,0,8,8
5302,2,work,8,14,6
5302,3,home,14,23,9
5302,4,work,23,24,1
5303,1,home,0,7,7
5303,2,work,7,13,6
5303,3,home,13,24,11
5304,1,home,0,8,8
5304,2,work,8,14,6
5304,3,shop,14,15,1
5304,4,work,15,19,4
5304,5,education,19,20,1
5304,6,home,20,24,4
5305,1,home,0,7,7
5305,2,work,7,14,7
5305,3,shop,14,15,1
5305,4,home,15,24,9
5306,1,home,0,7,7
5306,2,work,7,14,7
5306,3,shop,14,15,1
5306,4,home,15,24,9
5307,1,home,0,6,6
5307,2,shop,6,7,1
5307,3,home,7,10,3
5307,4,education,10,13,3
5307,5,shop,13,15,2
5307,6,home,15,21,6
5307,7,shop,21,22,1
5307,8,home,22,24,2
5308,1,home,0,6,6
5308,2,work,6,13,7
5308,3,home,13,24,11
5309,1,home,0,6,6
5309,2,work,6,13,7
5309,3,shop,13,14,1
5309,4,work,14,19,5
5309,5,home,19,24,5
5310,1,home,0,7,7
5310,2,work,7,13,6
5310,3,home,13,24,11
5311,1,home,0,8,8
5311,2,work,8,14,6
5311,3,shop,14,15,1
5311,4,work,15,20,5
5311,5,home,20,24,4
5312,1,home,0,8,8
5312,2,work,8,15,7
5312,3,home,15,24,9
5313,1,home,0,7,7
5313,2,work,7,14,7
5313,3,home,14,24,10
5314,1,home,0,8,8
5314,2,education,8,11,3
5314,3,shop,11,12,1
5314,4,work,12,20,8
5314,5,home,20,24,4
5315,1,work,0,10,10
5315,2,shop,10,11,1
5315,3,work,11,18,7
5315,4,education,18,20,2
5315,5,home,20,24,4
5316,1,home,0,6,6
5316,2,shop,6,7,1
5316,3,home,7,10,3
5316,4,education,10,13,3
5316,5,shop,13,15,2
5316,6,home,15,24,9
5317,1,home,0,6,6
5317,2,work,6,13,7
5317,3,home,13,17,4
5317,4,work,17,20,3
5317,5,home,20,24,4
5318,1,home,0,8,8
5318,2,education,8,13,5
5318,3,work,13,19,6
5318,4,home,19,24,5
5319,1,home,0,6,6
5319,2,work,6,13,7
5319,3,home,13,18,5
5319,4,work,18,20,2
5319,5,home,20,24,4
5320,1,home,0,8,8
5320,2,education,8,11,3
5320,3,home,11,19,8
5320,4,shop,19,21,2
5320,5,home,21,24,3
5321,1,home,0,6,6
5321,2,work,6,13,7
5321,3,shop,13,14,1
5321,4,home,14,24,10
5322,1,home,0,6,6
5322,2,shop,6,7,1
5322,3,work,7,14,7
5322,4,home,14,24,10
5323,1,home,0,6,6
5323,2,work,6,8,2
5323,3,home,8,9,1
5323,4,work,9,10,1
5323,5,home,10,15,5
5323,6,work,15,17,2
5323,7,home,17,23,6
5323,8,work,23,24,1
5324,1,home,0,7,7
5324,2,work,7,13,6
5324,3,shop,13,14,1
5324,4,work,14,20,6
5324,5,home,20,24,4
5325,1,home,0,6,6
5325,2,work,6,9,3
5325,3,shop,9,10,1
5325,4,work,10,17,7
5325,5,home,17,24,7
5326,1,home,0,7,7
5326,2,education,7,11,4
5326,3,home,11,19,8
5326,4,shop,19,20,1
5326,5,home,20,24,4
5327,1,home,0,6,6
5327,2,work,6,13,7
5327,3,shop,13,14,1
5327,4,home,14,24,10
5328,1,home,0,7,7
5328,2,education,7,12,5
5328,3,home,12,20,8
5328,4,shop,20,21,1
5328,5,home,21,24,3
5329,1,home,0,7,7
5329,2,work,7,13,6
5329,3,shop,13,14,1
5329,4,home,14,24,10
5330,1,home,0,8,8
5330,2,education,8,12,4
5330,3,home,12,18,6
5330,4,shop,18,19,1
5330,5,home,19,22,3
5330,6,work,22,23,1
5330,7,home,23,24,1
5331,1,home,0,6,6
5331,2,work,6,13,7
5331,3,home,13,24,11
5332,1,home,0,7,7
5332,2,work,7,14,7
5332,3,home,14,18,4
5332,4,work,18,20,2
5332,5,home,20,24,4
5333,1,home,0,7,7
5333,2,work,7,14,7
5333,3,home,14,23,9
5333,4,work,23,24,1
5334,1,home,0,6,6
5334,2,work,6,13,7
5334,3,home,13,24,11
5335,1,home,0,7,7
5335,2,work,7,14,7
5335,3,home,14,24,10
5336,1,home,0,6,6
5336,2,work,6,13,7
5336,3,home,13,19,6
5336,4,shop,19,20,1
5336,5,home,20,24,4
5337,1,home,0,8,8
5337,2,work,8,14,6
5337,3,shop,14,15,1
5337,4,home,15,21,6
5337,5,work,21,22,1
5337,6,home,22,24,2
5338,1,home,0,6,6
5338,2,work,6,8,2
5338,3,home,8,14,6
5338,4,work,14,17,3
5338,5,home,17,24,7
5339,1,home,0,9,9
5339,2,work,9,16,7
5339,3,home,16,20,4
5339,4,shop,20,21,1
5339,5,home,21,24,3
5340,1,home,0,7,7
5340,2,education,7,11,4
5340,3,home,11,14,3
5340,4,education,14,16,2
5340,5,home,16,24,8
5341,1,home,0,7,7
5341,2,education,7,12,5
5341,3,home,12,16,4
5341,4,shop,16,17,1
5341,5,home,17,24,7
5342,1,home,0,7,7
5342,2,work,7,9,2
5342,3,home,9,10,1
5342,4,work,10,12,2
5342,5,home,12,20,8
5342,6,shop,20,21,1
5342,7,home,21,24,3
5343,1,home,0,7,7
5343,2,work,7,14,7
5343,3,shop,14,15,1
5343,4,home,15,24,9
5344,1,home,0,7,7
5344,2,work,7,13,6
5344,3,shop,13,14,1
5344,4,work,14,20,6
5344,5,home,20,24,4
5345,1,home,0,7,7
5345,2,work,7,13,6
5345,3,shop,13,14,1
5345,4,work,14,19,5
5345,5,home,19,24,5
5346,1,home,0,7,7
5346,2,work,7,8,1
5346,3,home,8,9,1
5346,4,work,9,10,1
5346,5,home,10,15,5
5346,6,work,15,17,2
5346,7,home,17,23,6
5346,8,work,23,24,1
5347,1,home,0,8,8
5347,2,education,8,12,4
5347,3,home,12,16,4
5347,4,work,16,19,3
5347,5,home,19,24,5
5348,1,home,0,7,7
5348,2,work,7,13,6
5348,3,home,13,18,5
5348,4,work,18,20,2
5348,5,home,20,24,4
5349,1,home,0,8,8
5349,2,education,8,11,3
5349,3,shop,11,12,1
5349,4,work,12,19,7
5349,5,home,19,24,5
5350,1,home,0,7,7
5350,2,work,7,14,7
5350,3,shop,14,15,1
5350,4,work,15,19,4
5350,5,home,19,24,5
5351,1,home,0,7,7
5351,2,work,7,14,7
5351,3,shop,14,15,1
5351,4,work,15,20,5
5351,5,home,20,24,4
5352,1,home,0,8,8
5352,2,shop,8,9,1
5352,3,work,9,15,6
5352,4,home,15,16,1
5352,5,work,16,20,4
5352,6,home,20,24,4
5353,1,home,0,7,7
5353,2,work,7,14,7
5353,3,shop,14,16,2
5353,4,home,16,22,6
5353,5,work,22,23,1
5353,6,home,23,24,1
5354,1,home,0,6,6
5354,2,work,6,13,7
5354,3,home,13,17,4
5354,4,shop,17,18,1
5354,5,home,18,23,5
5354,6,work,23,24,1
5355,1,home,0,8,8
5355,2,education,8,15,7
5355,3,shop,15,16,1
5355,4,home,16,24,8
5356,1,home,0,7,7
5356,2,work,7,13,6
5356,3,shop,13,14,1
5356,4,work,14,17,3
5356,5,home,17,24,7
5357,1,home,0,7,7
5357,2,education,7,11,4
5357,3,home,11,19,8
5357,4,shop,19,20,1
5357,5,home,20,24,4
5358,1,home,0,7,7
5358,2,work,7,14,7
5358,3,shop,14,15,1
5358,4,home,15,24,9
5359,1,home,0,7,7
5359,2,work,7,14,7
5359,3,home,14,21,7
5359,4,work,21,22,1
5359,5,home,22,24,2
5360,1,home,0,6,6
5360,2,work,6,8,2
5360,3,home,8,12,4
5360,4,work,12,14,2
5360,5,home,14,21,7
5360,6,work,21,22,1
5360,7,home,22,24,2
5361,1,home,0,6,6
5361,2,work,6,13,7
5361,3,shop,13,14,1
5361,4,work,14,19,5
5361,5,home,19,24,5
5362,1,home,0,7,7
5362,2,work,7,14,7
5362,3,home,14,18,4
5362,4,work,18,20,2
5362,5,home,20,24,4
5363,1,home,0,7,7
5363,2,work,7,13,6
5363,3,home,13,24,11
5364,1,home,0,7,7
5364,2,work,7,13,6
5364,3,shop,13,14,1
5364,4,work,14,19,5
5364,5,home,19,24,5
5365,1,home,0,6,6
5365,2,shop,6,8,2
5365,3,home,8,11,3
5365,4,work,11,18,7
5365,5,education,18,19,1
5365,6,work,19,20,1
5365,7,home,20,24,4
5366,1,home,0,7,7
5366,2,work,7,13,6
5366,3,home,13,16,3
5366,4,work,16,20,4
5366,5,home,20,24,4
5367,1,home,0,7,7
5367,2,shop,7,9,2
5367,3,home,9,13,4
5367,4,work,13,19,6
5367,5,home,19,24,5
5368,1,home,0,7,7
5368,2,work,7,14,7
5368,3,home,14,24,10
5369,1,home,0,7,7
5369,2,work,7,14,7
5369,3,shop,14,15,1
5369,4,work,15,20,5
5369,5,home,20,24,4
5370,1,home,0,7,7
5370,2,work,7,14,7
5370,3,home,14,24,10
5371,1,home,0,7,7
5371,2,shop,7,9,2
5371,3,education,9,12,3
5371,4,shop,12,14,2
5371,5,education,14,17,3
5371,6,home,17,24,7
5372,1,home,0,8,8
5372,2,work,8,15,7
5372,3,home,15,24,9
5373,1,home,0,7,7
5373,2,work,7,14,7
5373,3,shop,14,15,1
5373,4,home,15,20,5
5373,5,shop,20,21,1
5373,6,home,21,24,3
5374,1,home,0,6,6
5374,2,work,6,13,7
5374,3,home,13,19,6
5374,4,shop,19,20,1
5374,5,home,20,24,4
5375,1,home,0,8,8
5375,2,work,8,15,7
5375,3,home,15,24,9
5376,1,home,0,7,7
5376,2,shop,7,8,1
5376,3,education,8,11,3
5376,4,home,11,14,3
5376,5,education,14,17,3
5376,6,home,17,24,7
5377,1,home,0,8,8
5377,2,work,8,14,6
5377,3,home,14,24,10
5378,1,home,0,8,8
5378,2,work,8,15,7
5378,3,shop,15,16,1
5378,4,home,16,24,8
5379,1,home,0,7,7
5379,2,work,7,14,7
5379,3,home,14,24,10
5380,1,home,0,6,6
5380,2,work,6,13,7
5380,3,shop,13,14,1
5380,4,home,14,23,9
5380,5,work,23,24,1
5381,1,home,0,6,6
5381,2,shop,6,7,1
5381,3,home,7,10,3
5381,4,education,10,12,2
5381,5,shop,12,14,2
5381,6,home,14,24,10
5382,1,home,0,7,7
5382,2,work,7,8,1
5382,3,home,8,12,4
5382,4,work,12,13,1
5382,5,home,13,21,8
5382,6,work,21,22,1
5382,7,home,22,24,2
5383,1,home,0,7,7
5383,2,education,7,12,5
5383,3,home,12,20,8
5383,4,shop,20,21,1
5383,5,home,21,24,3
5384,1,home,0,7,7
5384,2,education,7,11,4
5384,3,home,11,19,8
5384,4,shop,19,21,2
5384,5,home,21,24,3
5385,1,home,0,9,9
5385,2,work,9,15,6
5385,3,home,15,24,9
5386,1,home,0,6,6
5386,2,work,6,8,2
5386,3,home,8,15,7
5386,4,work,15,16,1
5386,5,home,16,21,5
5386,6,work,21,22,1
5386,7,home,22,24,2
5387,1,home,0,6,6
5387,2,shop,6,8,2
5387,3,work,8,10,2
5387,4,home,10,14,4
5387,5,work,14,16,2
5387,6,home,16,21,5
5387,7,work,21,22,1
5387,8,home,22,24,2
5388,1,home,0,8,8
5388,2,work,8,15,7
5388,3,home,15,24,9
5389,1,home,0,7,7
5389,2,work,7,13,6
5389,3,home,13,24,11
5390,1,home,0,7,7
5390,2,education,7,12,5
5390,3,home,12,18,6
5390,4,shop,18,20,2
5390,5,home,20,24,4
5391,1,home,0,8,8
5391,2,work,8,15,7
5391,3,home,15,23,8
5391,4,work,23,24,1
5392,1,home,0,6,6
5392,2,work,6,13,7
5392,3,home,13,18,5
5392,4,work,18,20,2
5392,5,home,20,24,4
5393,1,home,0,7,7
5393,2,work,7,13,6
5393,3,home,13,16,3
5393,4,work,16,19,3
5393,5,home,19,24,5
5394,1,home,0,8,8
5394,2,work,8,17,9
5394,3,home,17,22,5
5394,4,work,22,23,1
5394,5,home,23,24,1
5395,1,home,0,8,8
5395,2,education,8,12,4
5395,3,shop,12,14,2
5395,4,education,14,16,2
5395,5,shop,16,17,1
5395,6,home,17,24,7
5396,1,home,0,7,7
5396,2,education,7,11,4
5396,3,home,11,17,6
5396,4,shop,17,19,2
5396,5,home,19,24,5
5397,1,home,0,6,6
5397,2,work,6,8,2
5397,3,home,8,12,4
5397,4,work,12,14,2
5397,5,home,14,18,4
5397,6,work,18,20,2
5397,7,home,20,24,4
5398,1,home,0,8,8
5398,2,work,8,15,7
5398,3,home,15,24,9
5399,1,home,0,6,6
5399,2,work,6,13,7
5399,3,home,13,24,11
5400,1,home,0,6,6
5400,2,shop,6,7,1
5400,3,home,7,11,4
5400,4,education,11,12,1
5400,5,home,12,16,4
5400,6,shop,16,17,1
5400,7,home,17,24,7
5401,1,home,0,6,6
5401,2,work,6,8,2
5401,3,home,8,12,4
5401,4,work,12,14,2
5401,5,home,14,21,7
5401,6,work,21,22,1
5401,7,home,22,24,2
5402,1,home,0,6,6
5402,2,work,6,13,7
5402,3,home,13,22,9
5402,4,work,22,23,1
5402,5,home,23,24,1
5403,1,home,0,7,7
5403,2,education,7,12,5
5403,3,shop,12,13,1
5403,4,education,13,15,2
5403,5,shop,15,16,1
5403,6,home,16,24,8
5404,1,home,0,7,7
5404,2,work,7,14,7
5404,3,shop,14,15,1
5404,4,work,15,19,4
5404,5,home,19,24,5
5405,1,home,0,6,6
5405,2,work,6,13,7
5405,3,home,13,24,11
5406,1,home,0,7,7
5406,2,education,7,12,5
5406,3,shop,12,14,2
5406,4,education,14,16,2
5406,5,home,16,24,8
5407,1,home,0,6,6
5407,2,work,6,13,7
5407,3,shop,13,14,1
5407,4,work,14,19,5
5407,5,home,19,24,5
5408,1,home,0,7,7
5408,2,work,7,8,1
5408,3,home,8,12,4
5408,4,work,12,14,2
5408,5,home,14,20,6
5408,6,shop,20,21,1
5408,7,home,21,24,3
5409,1,home,0,7,7
5409,2,work,7,14,7
5409,3,shop,14,15,1
5409,4,home,15,24,9
5410,1,home,0,6,6
5410,2,work,6,13,7
5410,3,home,13,24,11
5411,1,home,0,6,6
5411,2,work,6,13,7
5411,3,shop,13,14,1
5411,4,home,14,20,6
5411,5,shop,20,21,1
5411,6,home,21,24,3
5412,1,home,0,8,8
5412,2,work,8,13,5
5412,3,home,13,17,4
5412,4,work,17,20,3
5412,5,home,20,24,4
5413,1,home,0,7,7
5413,2,work,7,14,7
5413,3,home,14,24,10
5414,1,home,0,7,7
5414,2,work,7,9,2
5414,3,home,9,16,7
5414,4,work,16,19,3
5414,5,home,19,24,5
5415,1,home,0,6,6
5415,2,shop,6,7,1
5415,3,home,7,9,2
5415,4,education,9,12,3
5415,5,work,12,18,6
5415,6,home,18,24,6
5416,1,work,0,11,11
5416,2,shop,11,12,1
5416,3,work,12,18,6
5416,4,home,18,24,6
5417,1,home,0,6,6
5417,2,work,6,9,3
5417,3,home,9,14,5
5417,4,work,14,16,2
5417,5,home,16,22,6
5417,6,work,22,23,1
5417,7,home,23,24,1
5418,1,home,0,7,7
5418,2,education,7,12,5
5418,3,shop,12,13,1
5418,4,education,13,16,3
5418,5,home,16,24,8
5419,1,home,0,7,7
5419,2,work,7,13,6
5419,3,home,13,21,8
5419,4,work,21,22,1
5419,5,home,22,24,2
5420,1,home,0,6,6
5420,2,shop,6,7,1
5420,3,home,7,13,6
5420,4,education,13,17,4
5420,5,home,17,24,7
5421,1,home,0,6,6
5421,2,shop,6,7,1
5421,3,home,7,13,6
5421,4,education,13,16,3
5421,5,shop,16,17,1
5421,6,home,17,24,7
5422,1,home,0,7,7
5422,2,shop,7,9,2
5422,3,education,9,12,3
5422,4,home,12,18,6
5422,5,shop,18,19,1
5422,6,home,19,24,5
5423,1,home,0,7,7
5423,2,education,7,11,4
5423,3,home,11,17,6
5423,4,shop,17,19,2
5423,5,home,19,24,5
5424,1,home,0,8,8
5424,2,work,8,15,7
5424,3,home,15,24,9
5425,1,home,0,6,6
5425,2,shop,6,7,1
5425,3,home,7,10,3
5425,4,education,10,16,6
5425,5,home,16,24,8
5426,1,home,0,8,8
5426,2,work,8,15,7
5426,3,home,15,24,9
5427,1,home,0,7,7
5427,2,work,7,13,6
5427,3,home,13,24,11
5428,1,home,0,8,8
5428,2,work,8,15,7
5428,3,home,15,24,9
5429,1,home,0,6,6
5429,2,work,6,8,2
5429,3,home,8,14,6
5429,4,work,14,18,4
5429,5,home,18,24,6
5430,1,home,0,6,6
5430,2,shop,6,7,1
5430,3,home,7,9,2
5430,4,education,9,11,2
5430,5,home,11,18,7
5430,6,shop,18,19,1
5430,7,home,19,24,5
5431,1,home,0,7,7
5431,2,work,7,13,6
5431,3,home,13,23,10
5431,4,work,23,24,1
5432,1,home,0,7,7
5432,2,work,7,14,7
5432,3,shop,14,15,1
5432,4,work,15,20,5
5432,5,home,20,24,4
5433,1,home,0,7,7
5433,2,education,7,11,4
5433,3,home,11,15,4
5433,4,shop,15,16,1
5433,5,home,16,24,8
5434,1,home,0,6,6
5434,2,shop,6,7,1
5434,3,home,7,10,3
5434,4,education,10,12,2
5434,5,home,12,18,6
5434,6,shop,18,19,1
5434,7,home,19,24,5
5435,1,home,0,8,8
5435,2,work,8,15,7
5435,3,home,15,24,9
5436,1,home,0,6,6
5436,2,work,6,13,7
5436,3,shop,13,14,1
5436,4,work,14,20,6
5436,5,home,20,24,4
5437,1,home,0,7,7
5437,2,work,7,13,6
5437,3,home,13,23,10
5437,4,work,23,24,1
5438,1,home,0,6,6
5438,2,work,6,14,8
5438,3,shop,14,15,1
5438,4,home,15,22,7
5438,5,work,22,23,1
5438,6,home,23,24,1
5439,1,home,0,8,8
5439,2,work,8,15,7
5439,3,shop,15,16,1
5439,4,home,16,23,7
5439,5,work,23,24,1
5440,1,home,0,8,8
5440,2,work,8,14,6
5440,3,home,14,22,8
5440,4,work,22,23,1
5440,5,home,23,24,1
5441,1,home,0,7,7
5441,2,education,7,11,4
5441,3,home,11,14,3
5441,4,education,14,16,2
5441,5,home,16,24,8
5442,1,home,0,6,6
5442,2,work,6,8,2
5442,3,home,8,11,3
5442,4,work,11,13,2
5442,5,home,13,18,5
5442,6,work,18,19,1
5442,7,home,19,24,5
5443,1,home,0,6,6
5443,2,work,6,13,7
5443,3,home,13,20,7
5443,4,shop,20,21,1
5443,5,home,21,24,3
5444,1,home,0,7,7
5444,2,education,7,11,4
5444,3,home,11,20,9
5444,4,shop,20,21,1
5444,5,home,21,24,3
5445,1,home,0,7,7
5445,2,shop,7,9,2
5445,3,home,9,12,3
5445,4,work,12,19,7
5445,5,home,19,24,5
5446,1,home,0,7,7
5446,2,work,7,14,7
5446,3,home,14,22,8
5446,4,work,22,23,1
5446,5,home,23,24,1
5447,1,home,0,6,6
5447,2,work,6,13,7
5447,3,shop,13,14,1
5447,4,work,14,20,6
5447,5,home,20,24,4
5448,1,home,0,7,7
5448,2,education,7,13,6
5448,3,home,13,19,6
5448,4,shop,19,20,1
5448,5,home,20,24,4
5449,1,home,0,6,6
5449,2,shop,6,7,1
5449,3,home,7,10,3
5449,4,education,10,13,3
5449,5,home,13,20,7
5449,6,shop,20,21,1
5449,7,home,21,24,3
5450,1,home,0,7,7
5450,2,work,7,13,6
5450,3,home,13,17,4
5450,4,work,17,20,3
5450,5,home,20,24,4
5451,1,home,0,7,7
5451,2,work,7,14,7
5451,3,home,14,23,9
5451,4,work,23,24,1
5452,1,home,0,7,7
5452,2,work,7,9,2
5452,3,home,9,13,4
5452,4,work,13,16,3
5452,5,home,16,22,6
5452,6,work,22,23,1
5452,7,home,23,24,1
5453,1,home,0,8,8
5453,2,work,8,15,7
5453,3,home,15,24,9
5454,1,home,0,6,6
5454,2,shop,6,7,1
5454,3,home,7,10,3
5454,4,education,10,12,2
5454,5,home,12,18,6
5454,6,shop,18,19,1
5454,7,home,19,24,5
5455,1,home,0,8,8
5455,2,work,8,15,7
5455,3,home,15,21,6
5455,4,work,21,22,1
5455,5,home,22,24,2
5456,1,home,0,9,9
5456,2,work,9,15,6
5456,3,home,15,24,9
5457,1,home,0,6,6
5457,2,work,6,13,7
5457,3,home,13,17,4
5457,4,work,17,20,3
5457,5,home,20,24,4
5458,1,home,0,7,7
5458,2,work,7,13,6
5458,3,shop,13,14,1
5458,4,work,14,20,6
5458,5,home,20,24,4
5459,1,home,0,6,6
5459,2,work,6,13,7
5459,3,home,13,24,11
5460,1,home,0,6,6
5460,2,work,6,12,6
5460,3,shop,12,13,1
5460,4,work,13,19,6
5460,5,home,19,24,5
5461,1,home,0,7,7
5461,2,work,7,13,6
5461,3,home,13,24,11
5462,1,home,0,8,8
5462,2,work,8,15,7
5462,3,shop,15,16,1
5462,4,home,16,24,8
5463,1,home,0,6,6
5463,2,shop,6,7,1
5463,3,home,7,13,6
5463,4,education,13,16,3
5463,5,home,16,24,8
5464,1,home,0,7,7
5464,2,work,7,14,7
5464,3,shop,14,15,1
5464,4,home,15,24,9
5465,1,home,0,7,7
5465,2,work,7,15,8
5465,3,shop,15,16,1
5465,4,work,16,19,3
5465,5,home,19,24,5
5466,1,home,0,8,8
5466,2,work,8,14,6
5466,3,home,14,24,10
5467,1,home,0,8,8
5467,2,work,8,15,7
5467,3,shop,15,16,1
5467,4,home,16,24,8
5468,1,home,0,6,6
5468,2,work,6,7,1
5468,3,home,7,14,7
5468,4,work,14,17,3
5468,5,home,17,23,6
5468,6,work,23,24,1
5469,1,home,0,7,7
5469,2,work,7,14,7
5469,3,shop,14,15,1
5469,4,home,15,23,8
5469,5,work,23,24,1
5470,1,home,0,6,6
5470,2,shop,6,7,1
5470,3,home,7,13,6
5470,4,education,13,16,3
5470,5,shop,16,17,1
5470,6,home,17,24,7
5471,1,home,0,7,7
5471,2,work,7,9,2
5471,3,home,9,15,6
5471,4,work,15,17,2
5471,5,home,17,21,4
5471,6,work,21,22,1
5471,7,home,22,24,2
5472,1,home,0,6,6
5472,2,work,6,7,1
5472,3,home,7,9,2
5472,4,work,9,11,2
5472,5,home,11,16,5
5472,6,work,16,18,2
5472,7,home,18,22,4
5472,8,work,22,23,1
5472,9,home,23,24,1
5473,1,home,0,6,6
5473,2,work,6,13,7
5473,3,home,13,16,3
5473,4,work,16,20,4
5473,5,home,20,24,4
5474,1,home,0,8,8
5474,2,work,8,15,7
5474,3,home,15,21,6
5474,4,work,21,22,1
5474,5,home,22,24,2
5475,1,home,0,6,6
5475,2,work,6,13,7
5475,3,home,13,17,4
5475,4,work,17,18,1
5475,5,home,18,24,6
5476,1,home,0,7,7
5476,2,education,7,11,4
5476,3,home,11,14,3
5476,4,education,14,16,2
5476,5,home,16,24,8
5477,1,home,0,7,7
5477,2,work,7,13,6
5477,3,home,13,20,7
5477,4,shop,20,21,1
5477,5,home,21,24,3
5478,1,home,0,8,8
5478,2,education,8,12,4
5478,3,home,12,24,12
5479,1,home,0,6,6
5479,2,work,6,7,1
5479,3,home,7,13,6
5479,4,work,13,16,3
5479,5,home,16,22,6
5479,6,work,22,23,1
5479,7,home,23,24,1
5480,1,home,0,8,8
5480,2,education,8,11,3
5480,3,home,11,14,3
5480,4,education,14,16,2
5480,5,shop,16,17,1
5480,6,home,17,24,7
5481,1,home,0,7,7
5481,2,shop,7,9,2
5481,3,education,9,12,3
5481,4,home,12,20,8
5481,5,shop,20,21,1
5481,6,home,21,24,3
5482,1,home,0,7,7
5482,2,education,7,11,4
5482,3,home,11,17,6
5482,4,shop,17,18,1
5482,5,home,18,24,6
5483,1,home,0,6,6
5483,2,shop,6,7,1
5483,3,home,7,13,6
5483,4,education,13,16,3
5483,5,home,16,20,4
5483,6,shop,20,21,1
5483,7,home,21,24,3
5484,1,home,0,8,8
5484,2,work,8,14,6
5484,3,home,14,18,4
5484,4,work,18,20,2
5484,5,home,20,24,4
5485,1,home,0,6,6
5485,2,shop,6,7,1
5485,3,work,7,13,6
5485,4,home,13,24,11
5486,1,home,0,6,6
5486,2,work,6,12,6
5486,3,shop,12,13,1
5486,4,work,13,18,5
5486,5,home,18,24,6
5487,1,home,0,7,7
5487,2,work,7,14,7
5487,3,home,14,15,1
5487,4,work,15,19,4
5487,5,home,19,24,5
5488,1,home,0,7,7
5488,2,work,7,13,6
5488,3,home,13,24,11
5489,1,home,0,8,8
5489,2,work,8,15,7
5489,3,shop,15,16,1
5489,4,work,16,19,3
5489,5,home,19,24,5
5490,1,home,0,7,7
5490,2,work,7,13,6
5490,3,shop,13,14,1
5490,4,home,14,22,8
5490,5,work,22,23,1
5490,6,home,23,24,1
5491,1,home,0,7,7
5491,2,work,7,14,7
5491,3,home,14,18,4
5491,4,work,18,20,2
5491,5,home,20,24,4
5492,1,home,0,7,7
5492,2,shop,7,8,1
5492,3,education,8,12,4
5492,4,shop,12,13,1
5492,5,home,13,24,11
5493,1,home,0,6,6
5493,2,work,6,13,7
5493,3,home,13,18,5
5493,4,work,18,20,2
5493,5,home,20,24,4
5494,1,home,0,8,8
5494,2,shop,8,9,1
5494,3,education,9,12,3
5494,4,home,12,19,7
5494,5,shop,19,20,1
5494,6,home,20,24,4
5495,1,home,0,8,8
5495,2,work,8,15,7
5495,3,home,15,24,9
5496,1,home,0,9,9
5496,2,work,9,16,7
5496,3,home,16,23,7
5496,4,work,23,24,1
5497,1,home,0,7,7
5497,2,work,7,13,6
5497,3,shop,13,14,1
5497,4,work,14,19,5
5497,5,home,19,24,5
5498,1,home,0,7,7
5498,2,shop,7,8,1
5498,3,education,8,12,4
5498,4,shop,12,14,2
5498,5,education,14,16,2
5498,6,home,16,24,8
5499,1,home,0,6,6
5499,2,shop,6,7,1
5499,3,work,7,14,7
5499,4,shop,14,15,1
5499,5,home,15,24,9
5500,1,home,0,7,7
5500,2,shop,7,8,1
5500,3,home,8,9,1
5500,4,education,9,15,6
5500,5,work,15,20,5
5500,6,home,20,24,4
5501,1,home,0,8,8
5501,2,work,8,14,6
5501,3,shop,14,15,1
5501,4,home,15,24,9
5502,1,home,0,7,7
5502,2,education,7,13,6
5502,3,shop,13,15,2
5502,4,home,15,24,9
5503,1,home,0,6,6
5503,2,work,6,13,7
5503,3,home,13,24,11
5504,1,home,0,6,6
5504,2,shop,6,7,1
5504,3,home,7,13,6
5504,4,education,13,16,3
5504,5,home,16,24,8
5505,1,home,0,7,7
5505,2,work,7,8,1
5505,3,home,8,14,6
5505,4,work,14,16,2
5505,5,home,16,23,7
5505,6,work,23,24,1
5506,1,home,0,7,7
5506,2,work,7,14,7
5506,3,shop,14,15,1
5506,4,home,15,24,9
5507,1,home,0,7,7
5507,2,education,7,12,5
5507,3,home,12,19,7
5507,4,shop,19,21,2
5507,5,home,21,24,3
5508,1,home,0,8,8
5508,2,education,8,14,6
5508,3,work,14,20,6
5508,4,home,20,24,4
5509,1,home,0,7,7
5509,2,work,7,13,6
5509,3,shop,13,14,1
5509,4,home,14,24,10
5510,1,home,0,9,9
5510,2,work,9,16,7
5510,3,shop,16,17,1
5510,4,home,17,24,7
5511,1,home,0,6,6
5511,2,shop,6,7,1
5511,3,home,7,13,6
5511,4,education,13,16,3
5511,5,home,16,24,8
5512,1,home,0,7,7
5512,2,work,7,9,2
5512,3,home,9,16,7
5512,4,work,16,18,2
5512,5,home,18,24,6
5513,1,home,0,6,6
5513,2,work,6,8,2
5513,3,home,8,13,5
5513,4,work,13,16,3
5513,5,home,16,23,7
5513,6,work,23,24,1
5514,1,home,0,8,8
5514,2,work,8,13,5
5514,3,shop,13,14,1
5514,4,home,14,21,7
5514,5,work,21,22,1
5514,6,home,22,24,2
5515,1,home,0,7,7
5515,2,work,7,13,6
5515,3,shop,13,15,2
5515,4,home,15,24,9
5516,1,home,0,7,7
5516,2,work,7,14,7
5516,3,shop,14,15,1
5516,4,work,15,20,5
5516,5,home,20,24,4
5517,1,home,0,8,8
5517,2,shop,8,9,1
5517,3,work,9,15,6
5517,4,home,15,24,9
5518,1,home,0,8,8
5518,2,education,8,11,3
5518,3,shop,11,12,1
5518,4,home,12,18,6
5518,5,work,18,20,2
5518,6,home,20,24,4
5519,1,home,0,6,6
5519,2,work,6,13,7
5519,3,home,13,16,3
5519,4,work,16,20,4
5519,5,home,20,24,4
5520,1,home,0,7,7
5520,2,work,7,13,6
5520,3,shop,13,14,1
5520,4,work,14,20,6
5520,5,home,20,24,4
5521,1,home,0,6,6
5521,2,shop,6,7,1
5521,3,work,7,14,7
5521,4,home,14,24,10
5522,1,home,0,6,6
5522,2,work,6,13,7
5522,3,home,13,24,11
5523,1,home,0,8,8
5523,2,work,8,15,7
5523,3,home,15,24,9
5524,1,home,0,6,6
5524,2,work,6,13,7
5524,3,home,13,24,11
5525,1,home,0,6,6
5525,2,work,6,13,7
5525,3,home,13,16,3
5525,4,work,16,19,3
5525,5,home,19,21,2
5525,6,work,21,22,1
5525,7,home,22,24,2
5526,1,home,0,6,6
5526,2,work,6,13,7
5526,3,shop,13,14,1
5526,4,work,14,20,6
5526,5,home,20,24,4
5527,1,home,0,7,7
5527,2,work,7,14,7
5527,3,shop,14,16,2
5527,4,work,16,20,4
5527,5,home,20,24,4
5528,1,home,0,8,8
5528,2,education,8,11,3
5528,3,home,11,16,5
5528,4,work,16,20,4
5528,5,home,20,24,4
5529,1,home,0,8,8
5529,2,shop,8,9,1
5529,3,home,9,13,4
5529,4,work,13,19,6
5529,5,education,19,20,1
5529,6,work,20,21,1
5529,7,home,21,24,3
5530,1,home,0,7,7
5530,2,education,7,12,5
5530,3,home,12,19,7
5530,4,shop,19,20,1
5530,5,home,20,24,4
5531,1,home,0,8,8
5531,2,work,8,15,7
5531,3,shop,15,16,1
5531,4,home,16,23,7
5531,5,work,23,24,1
5532,1,home,0,7,7
5532,2,work,7,15,8
5532,3,home,15,24,9
5533,1,home,0,7,7
5533,2,work,7,14,7
5533,3,home,14,18,4
5533,4,work,18,20,2
5533,5,home,20,24,4
5534,1,home,0,6,6
5534,2,work,6,8,2
5534,3,home,8,12,4
5534,4,work,12,15,3
5534,5,home,15,21,6
5534,6,work,21,22,1
5534,7,home,22,24,2
5535,1,home,0,6,6
5535,2,work,6,13,7
5535,3,shop,13,14,1
5535,4,home,14,24,10
5536,1,home,0,8,8
5536,2,work,8,15,7
5536,3,shop,15,16,1
5536,4,work,16,20,4
5536,5,home,20,24,4
5537,1,home,0,6,6
5537,2,work,6,13,7
5537,3,shop,13,14,1
5537,4,home,14,24,10
5538,1,home,0,7,7
5538,2,work,7,14,7
5538,3,home,14,24,10
5539,1,home,0,9,9
5539,2,work,9,16,7
5539,3,home,16,20,4
5539,4,shop,20,21,1
5539,5,home,21,24,3
5540,1,home,0,7,7
5540,2,work,7,13,6
5540,3,shop,13,15,2
5540,4,work,15,19,4
5540,5,home,19,24,5
5541,1,home,0,9,9
5541,2,work,9,16,7
5541,3,home,16,24,8
5542,1,home,0,7,7
5542,2,work,7,14,7
5542,3,home,14,24,10
5543,1,home,0,7,7
5543,2,education,7,11,4
5543,3,home,11,19,8
5543,4,shop,19,21,2
5543,5,home,21,24,3
5544,1,home,0,8,8
5544,2,work,8,15,7
5544,3,shop,15,16,1
5544,4,home,16,24,8
5545,1,home,0,8,8
5545,2,work,8,15,7
5545,3,home,15,24,9
5546,1,home,0,7,7
5546,2,work,7,9,2
5546,3,home,9,15,6
5546,4,work,15,17,2
5546,5,home,17,23,6
5546,6,work,23,24,1
5547,1,home,0,6,6
5547,2,work,6,8,2
5547,3,home,8,14,6
5547,4,work,14,16,2
5547,5,home,16,23,7
5547,6,work,23,24,1
5548,1,home,0,8,8
5548,2,work,8,14,6
5548,3,shop,14,15,1
5548,4,home,15,24,9
5549,1,home,0,7,7
5549,2,work,7,14,7
5549,3,home,14,21,7
5549,4,shop,21,22,1
5549,5,home,22,24,2
5550,1,home,0,7,7
5550,2,work,7,13,6
5550,3,home,13,16,3
5550,4,work,16,20,4
5550,5,home,20,24,4
5551,1,home,0,6,6
5551,2,work,6,13,7
5551,3,home,13,24,11
5552,1,home,0,7,7
5552,2,education,7,12,5
5552,3,home,12,20,8
5552,4,shop,20,21,1
5552,5,home,21,24,3
5553,1,home,0,7,7
5553,2,education,7,10,3
5553,3,home,10,17,7
5553,4,shop,17,18,1
5553,5,home,18,24,6
5554,1,home,0,7,7
5554,2,work,7,14,7
5554,3,home,14,16,2
5554,4,work,16,20,4
5554,5,home,20,24,4
5555,1,home,0,6,6
5555,2,work,6,8,2
5555,3,home,8,14,6
5555,4,work,14,16,2
5555,5,home,16,23,7
5555,6,work,23,24,1
5556,1,home,0,8,8
5556,2,work,8,15,7
5556,3,shop,15,16,1
5556,4,work,16,20,4
5556,5,home,20,24,4
5557,1,home,0,7,7
5557,2,education,7,11,4
5557,3,home,11,17,6
5557,4,shop,17,18,1
5557,5,home,18,24,6
5558,1,home,0,7,7
5558,2,shop,7,8,1
5558,3,education,8,11,3
5558,4,home,11,18,7
5558,5,shop,18,19,1
5558,6,home,19,24,5
5559,1,home,0,9,9
5559,2,work,9,17,8
5559,3,home,17,24,7
5560,1,home,0,6,6
5560,2,shop,6,7,1
5560,3,work,7,13,6
5560,4,home,13,17,4
5560,5,work,17,20,3
5560,6,home,20,24,4
5561,1,home,0,7,7
5561,2,shop,7,8,1
5561,3,work,8,15,7
5561,4,home,15,24,9
5562,1,home,0,7,7
5562,2,work,7,14,7
5562,3,home,14,18,4
5562,4,work,18,20,2
5562,5,home,20,24,4
5563,1,home,0,6,6
5563,2,shop,6,7,1
5563,3,home,7,9,2
5563,4,education,9,12,3
5563,5,home,12,18,6
5563,6,shop,18,19,1
5563,7,home,19,24,5
5564,1,home,0,6,6
5564,2,work,6,13,7
5564,3,shop,13,14,1
5564,4,home,14,18,4
5564,5,work,18,20,2
5564,6,home,20,24,4
5565,1,home,0,6,6
5565,2,work,6,8,2
5565,3,home,8,15,7
5565,4,work,15,17,2
5565,5,home,17,23,6
5565,6,work,23,24,1
5566,1,home,0,8,8
5566,2,work,8,14,6
5566,3,home,14,24,10
5567,1,home,0,8,8
5567,2,education,8,14,6
5567,3,work,14,20,6
5567,4,home,20,24,4
5568,1,home,0,6,6
5568,2,work,6,13,7
5568,3,home,13,24,11
5569,1,home,0,9,9
5569,2,education,9,13,4
5569,3,home,13,16,3
5569,4,work,16,20,4
5569,5,home,20,24,4
5570,1,home,0,8,8
5570,2,work,8,15,7
5570,3,home,15,24,9
5571,1,home,0,6,6
5571,2,shop,6,7,1
5571,3,work,7,9,2
5571,4,home,9,14,5
5571,5,work,14,16,2
5571,6,home,16,23,7
5571,7,work,23,24,1
5572,1,home,0,7,7
5572,2,education,7,11,4
5572,3,home,11,13,2
5572,4,education,13,16,3
5572,5,shop,16,17,1
5572,6,home,17,24,7
5573,1,home,0,7,7
5573,2,work,7,14,7
5573,3,home,14,24,10
5574,1,home,0,8,8
5574,2,work,8,15,7
5574,3,home,15,24,9
5575,1,home,0,9,9
5575,2,work,9,15,6
5575,3,home,15,24,9
5576,1,home,0,9,9
5576,2,education,9,12,3
5576,3,shop,12,13,1
5576,4,work,13,19,6
5576,5,home,19,24,5
5577,1,home,0,7,7
5577,2,work,7,8,1
5577,3,home,8,14,6
5577,4,work,14,15,1
5577,5,home,15,21,6
5577,6,work,21,22,1
5577,7,home,22,24,2
5578,1,home,0,6,6
5578,2,shop,6,7,1
5578,3,home,7,10,3
5578,4,education,10,13,3
5578,5,shop,13,14,1
5578,6,education,14,15,1
5578,7,shop,15,16,1
5578,8,home,16,24,8
5579,1,home,0,7,7
5579,2,work,7,13,6
5579,3,home,13,18,5
5579,4,work,18,20,2
5579,5,home,20,24,4
5580,1,home,0,6,6
5580,2,work,6,13,7
5580,3,home,13,24,11
5581,1,home,0,7,7
5581,2,work,7,13,6
5581,3,home,13,18,5
5581,4,work,18,20,2
5581,5,home,20,24,4
5582,1,home,0,7,7
5582,2,work,7,14,7
5582,3,home,14,24,10
5583,1,home,0,8,8
5583,2,education,8,14,6
5583,3,shop,14,15,1
5583,4,work,15,20,5
5583,5,home,20,24,4
5584,1,home,0,7,7
5584,2,work,7,15,8
5584,3,shop,15,16,1
5584,4,work,16,20,4
5584,5,home,20,24,4
5585,1,home,0,7,7
5585,2,education,7,12,5
5585,3,shop,12,14,2
5585,4,education,14,16,2
5585,5,shop,16,17,1
5585,6,home,17,24,7
5586,1,home,0,8,8
5586,2,work,8,14,6
5586,3,shop,14,15,1
5586,4,home,15,23,8
5586,5,work,23,24,1
5587,1,home,0,6,6
5587,2,work,6,13,7
5587,3,home,13,24,11
5588,1,home,0,7,7
5588,2,shop,7,8,1
5588,3,education,8,11,3
5588,4,home,11,18,7
5588,5,shop,18,19,1
5588,6,home,19,24,5
5589,1,home,0,7,7
5589,2,education,7,11,4
5589,3,home,11,18,7
5589,4,shop,18,19,1
5589,5,home,19,24,5
5590,1,home,0,6,6
5590,2,work,6,13,7
5590,3,shop,13,14,1
5590,4,work,14,19,5
5590,5,home,19,24,5
5591,1,home,0,6,6
5591,2,work,6,8,2
5591,3,home,8,13,5
5591,4,work,13,15,2
5591,5,home,15,21,6
5591,6,work,21,22,1
5591,7,home,22,24,2
5592,1,home,0,9,9
5592,2,work,9,15,6
5592,3,home,15,24,9
5593,1,home,0,6,6
5593,2,work,6,14,8
5593,3,shop,14,15,1
5593,4,home,15,24,9
5594,1,home,0,9,9
5594,2,work,9,17,8
5594,3,home,17,22,5
5594,4,work,22,23,1
5594,5,home,23,24,1
5595,1,home,0,7,7
5595,2,shop,7,9,2
5595,3,education,9,12,3
5595,4,home,12,17,5
5595,5,shop,17,18,1
5595,6,home,18,24,6
5596,1,home,0,7,7
5596,2,work,7,14,7
5596,3,shop,14,15,1
5596,4,home,15,24,9
5597,1,home,0,9,9
5597,2,work,9,15,6
5597,3,home,15,21,6
5597,4,work,21,22,1
5597,5,home,22,24,2
5598,1,home,0,7,7
5598,2,work,7,13,6
5598,3,shop,13,14,1
5598,4,home,14,24,10
5599,1,home,0,7,7
5599,2,shop,7,9,2
5599,3,home,9,13,4
5599,4,education,13,16,3
5599,5,home,16,24,8
5600,1,home,0,8,8
5600,2,education,8,12,4
5600,3,shop,12,14,2
5600,4,home,14,24,10
5601,1,home,0,7,7
5601,2,work,7,17,10
5601,3,home,17,24,7
5602,1,home,0,7,7
5602,2,work,7,14,7
5602,3,home,14,24,10
5603,1,home,0,7,7
5603,2,work,7,14,7
5603,3,home,14,23,9
5603,4,work,23,24,1
5604,1,home,0,8,8
5604,2,work,8,13,5
5604,3,shop,13,14,1
5604,4,work,14,19,5
5604,5,home,19,24,5
5605,1,home,0,8,8
5605,2,work,8,14,6
5605,3,home,14,21,7
5605,4,shop,21,22,1
5605,5,home,22,24,2
5606,1,home,0,7,7
5606,2,work,7,8,1
5606,3,home,8,14,6
5606,4,work,14,16,2
5606,5,home,16,22,6
5606,6,work,22,23,1
5606,7,home,23,24,1
5607,1,home,0,7,7
5607,2,work,7,14,7
5607,3,home,14,24,10
5608,1,home,0,6,6
5608,2,work,6,13,7
5608,3,shop,13,14,1
5608,4,work,14,19,5
5608,5,home,19,24,5
5609,1,home,0,7,7
5609,2,shop,7,8,1
5609,3,education,8,11,3
5609,4,home,11,16,5
5609,5,shop,16,17,1
5609,6,home,17,24,7
5610,1,home,0,8,8
5610,2,education,8,11,3
5610,3,home,11,18,7
5610,4,shop,18,19,1
5610,5,home,19,24,5
5611,1,home,0,6,6
5611,2,work,6,8,2
5611,3,home,8,13,5
5611,4,work,13,15,2
5611,5,home,15,21,6
5611,6,work,21,22,1
5611,7,home,22,24,2
5612,1,home,0,7,7
5612,2,shop,7,8,1
5612,3,education,8,12,4
5612,4,home,12,19,7
5612,5,shop,19,21,2
5612,6,home,21,24,3
5613,1,home,0,6,6
5613,2,shop,6,7,1
5613,3,work,7,13,6
5613,4,home,13,23,10
5613,5,work,23,24,1
5614,1,home,0,8,8
5614,2,work,8,14,6
5614,3,home,14,24,10
5615,1,home,0,8,8
5615,2,work,8,15,7
5615,3,home,15,24,9
5616,1,home,0,6,6
5616,2,work,6,15,9
5616,3,home,15,24,9
5617,1,home,0,9,9
5617,2,work,9,16,7
5617,3,home,16,24,8
5618,1,home,0,7,7
5618,2,shop,7,8,1
5618,3,work,8,15,7
5618,4,home,15,24,9
5619,1,home,0,6,6
5619,2,work,6,13,7
5619,3,home,13,24,11
5620,1,home,0,7,7
5620,2,work,7,13,6
5620,3,shop,13,14,1
5620,4,work,14,19,5
5620,5,home,19,24,5
5621,1,home,0,8,8
5621,2,education,8,11,3
5621,3,home,11,18,7
5621,4,shop,18,20,2
5621,5,home,20,24,4
5622,1,home,0,7,7
5622,2,shop,7,8,1
5622,3,education,8,11,3
5622,4,home,11,15,4
5622,5,shop,15,16,1
5622,6,home,16,24,8
5623,1,home,0,8,8
5623,2,education,8,11,3
5623,3,home,11,15,4
5623,4,shop,15,16,1
5623,5,home,16,24,8
5624,1,home,0,7,7
5624,2,work,7,14,7
5624,3,home,14,24,10
5625,1,home,0,7,7
5625,2,shop,7,9,2
5625,3,education,9,11,2
5625,4,home,11,17,6
5625,5,shop,17,18,1
5625,6,home,18,24,6
5626,1,home,0,6,6
5626,2,work,6,13,7
5626,3,shop,13,14,1
5626,4,home,14,24,10
5627,1,home,0,9,9
5627,2,work,9,17,8
5627,3,home,17,24,7
5628,1,home,0,7,7
5628,2,education,7,12,5
5628,3,home,12,18,6
5628,4,shop,18,20,2
5628,5,home,20,24,4
5629,1,home,0,7,7
5629,2,work,7,14,7
5629,3,home,14,24,10
5630,1,home,0,8,8
5630,2,education,8,11,3
5630,3,home,11,18,7
5630,4,shop,18,19,1
5630,5,home,19,24,5
5631,1,home,0,8,8
5631,2,work,8,15,7
5631,3,home,15,24,9
5632,1,home,0,8,8
5632,2,work,8,15,7
5632,3,home,15,24,9
5633,1,home,0,6,6
5633,2,work,6,13,7
5633,3,shop,13,14,1
5633,4,work,14,20,6
5633,5,home,20,24,4
5634,1,home,0,7,7
5634,2,education,7,12,5
5634,3,shop,12,14,2
5634,4,home,14,24,10
5635,1,home,0,8,8
5635,2,work,8,13,5
5635,3,shop,13,14,1
5635,4,work,14,20,6
5635,5,home,20,24,4
5636,1,home,0,6,6
5636,2,shop,6,7,1
5636,3,home,7,13,6
5636,4,education,13,16,3
5636,5,home,16,24,8
5637,1,home,0,8,8
5637,2,education,8,11,3
5637,3,home,11,18,7
5637,4,shop,18,19,1
5637,5,home,19,24,5
5638,1,home,0,7,7
5638,2,work,7,14,7
5638,3,shop,14,15,1
5638,4,work,15,20,5
5638,5,home,20,24,4
5639,1,home,0,8,8
5639,2,work,8,14,6
5639,3,home,14,22,8
5639,4,work,22,23,1
5639,5,home,23,24,1
5640,1,home,0,9,9
5640,2,shop,9,10,1
5640,3,home,10,15,5
5640,4,work,15,20,5
5640,5,home,20,24,4
5641,1,home,0,6,6
5641,2,shop,6,7,1
5641,3,work,7,13,6
5641,4,home,13,16,3
5641,5,work,16,20,4
5641,6,home,20,24,4
5642,1,home,0,6,6
5642,2,work,6,13,7
5642,3,shop,13,14,1
5642,4,home,14,24,10
5643,1,home,0,6,6
5643,2,work,6,13,7
5643,3,home,13,24,11
5644,1,home,0,8,8
5644,2,education,8,15,7
5644,3,shop,15,17,2
5644,4,work,17,20,3
5644,5,home,20,24,4
5645,1,home,0,8,8
5645,2,education,8,10,2
5645,3,home,10,14,4
5645,4,education,14,16,2
5645,5,home,16,24,8
5646,1,home,0,6,6
5646,2,shop,6,7,1
5646,3,home,7,8,1
5646,4,education,8,12,4
5646,5,shop,12,13,1
5646,6,home,13,20,7
5646,7,shop,20,21,1
5646,8,home,21,24,3
5647,1,home,0,6,6
5647,2,shop,6,7,1
5647,3,home,7,13,6
5647,4,education,13,16,3
5647,5,home,16,24,8
5648,1,home,0,8,8
5648,2,work,8,15,7
5648,3,shop,15,16,1
5648,4,work,16,20,4
5648,5,home,20,24,4
5649,1,home,0,7,7
5649,2,work,7,9,2
5649,3,home,9,15,6
5649,4,work,15,17,2
5649,5,home,17,21,4
5649,6,work,21,22,1
5649,7,home,22,24,2
5650,1,home,0,6,6
5650,2,shop,6,7,1
5650,3,home,7,10,3
5650,4,education,10,14,4
5650,5,shop,14,16,2
5650,6,home,16,24,8
5651,1,home,0,7,7
5651,2,work,7,14,7
5651,3,home,14,21,7
5651,4,shop,21,22,1
5651,5,home,22,24,2
5652,1,home,0,7,7
5652,2,work,7,13,6
5652,3,home,13,24,11
5653,1,home,0,8,8
5653,2,education,8,11,3
5653,3,home,11,23,12
5653,4,work,23,24,1
5654,1,home,0,6,6
5654,2,work,6,13,7
5654,3,shop,13,14,1
5654,4,home,14,24,10
5655,1,home,0,6,6
5655,2,shop,6,7,1
5655,3,home,7,9,2
5655,4,education,9,12,3
5655,5,home,12,18,6
5655,6,shop,18,19,1
5655,7,home,19,24,5
5656,1,home,0,7,7
5656,2,work,7,13,6
5656,3,home,13,24,11
5657,1,home,0,6,6
5657,2,work,6,8,2
5657,3,home,8,9,1
5657,4,work,9,10,1
5657,5,home,10,16,6
5657,6,work,16,18,2
5657,7,home,18,22,4
5657,8,work,22,23,1
5657,9,home,23,24,1
5658,1,home,0,6,6
5658,2,work,6,13,7
5658,3,shop,13,14,1
5658,4,work,14,19,5
5658,5,home,19,24,5
5659,1,home,0,7,7
5659,2,work,7,13,6
5659,3,home,13,24,11
5660,1,home,0,6,6
5660,2,work,6,13,7
5660,3,shop,13,14,1
5660,4,education,14,16,2
5660,5,home,16,17,1
5660,6,work,17,20,3
5660,7,home,20,24,4
5661,1,home,0,7,7
5661,2,work,7,14,7
5661,3,home,14,21,7
5661,4,work,21,22,1
5661,5,home,22,24,2
5662,1,home,0,8,8
5662,2,work,8,14,6
5662,3,home,14,23,9
5662,4,work,23,24,1
5663,1,home,0,8,8
5663,2,shop,8,9,1
5663,3,home,9,14,5
5663,4,work,14,20,6
5663,5,home,20,24,4
5664,1,home,0,7,7
5664,2,education,7,11,4
5664,3,home,11,19,8
5664,4,shop,19,20,1
5664,5,home,20,24,4
5665,1,home,0,6,6
5665,2,shop,6,7,1
5665,3,home,7,10,3
5665,4,work,10,17,7
5665,5,home,17,24,7
5666,1,home,0,7,7
5666,2,education,7,11,4
5666,3,home,11,13,2
5666,4,education,13,14,1
5666,5,shop,14,16,2
5666,6,home,16,24,8
5667,1,home,0,6,6
5667,2,work,6,8,2
5667,3,home,8,9,1
5667,4,work,9,11,2
5667,5,home,11,17,6
5667,6,work,17,19,2
5667,7,home,19,24,5
5668,1,home,0,8,8
5668,2,education,8,13,5
5668,3,shop,13,15,2
5668,4,home,15,24,9
5669,1,home,0,7,7
5669,2,shop,7,8,1
5669,3,home,8,12,4
5669,4,education,12,16,4
5669,5,home,16,24,8
5670,1,home,0,8,8
5670,2,work,8,14,6
5670,3,home,14,18,4
5670,4,shop,18,19,1
5670,5,home,19,24,5
5671,1,home,0,6,6
5671,2,shop,6,7,1
5671,3,home,7,10,3
5671,4,education,10,11,1
5671,5,home,11,20,9
5671,6,shop,20,21,1
5671,7,home,21,24,3
5672,1,home,0,7,7
5672,2,shop,7,8,1
5672,3,home,8,14,6
5672,4,work,14,20,6
5672,5,home,20,24,4
5673,1,home,0,9,9
5673,2,work,9,17,8
5673,3,home,17,24,7
5674,1,home,0,6,6
5674,2,work,6,7,1
5674,3,home,7,9,2
5674,4,work,9,11,2
5674,5,home,11,17,6
5674,6,work,17,19,2
5674,7,home,19,24,5
5675,1,home,0,7,7
5675,2,shop,7,8,1
5675,3,home,8,11,3
5675,4,shop,11,12,1
5675,5,work,12,19,7
5675,6,home,19,24,5
5676,1,home,0,8,8
5676,2,work,8,16,8
5676,3,home,16,23,7
5676,4,work,23,24,1
5677,1,home,0,6,6
5677,2,work,6,13,7
5677,3,home,13,17,4
5677,4,work,17,20,3
5677,5,home,20,24,4
5678,1,home,0,7,7
5678,2,work,7,13,6
5678,3,home,13,22,9
5678,4,work,22,23,1
5678,5,home,23,24,1
5679,1,home,0,8,8
5679,2,work,8,13,5
5679,3,shop,13,14,1
5679,4,work,14,19,5
5679,5,home,19,24,5
5680,1,home,0,6,6
5680,2,work,6,13,7
5680,3,shop,13,14,1
5680,4,work,14,20,6
5680,5,home,20,24,4
5681,1,home,0,7,7
5681,2,work,7,14,7
5681,3,home,14,21,7
5681,4,work,21,22,1
5681,5,home,22,24,2
5682,1,home,0,8,8
5682,2,work,8,15,7
5682,3,home,15,24,9
5683,1,home,0,7,7
5683,2,work,7,13,6
5683,3,shop,13,14,1
5683,4,work,14,19,5
5683,5,home,19,23,4
5683,6,work,23,24,1
5684,1,home,0,6,6
5684,2,shop,6,7,1
5684,3,work,7,13,6
5684,4,home,13,19,6
5684,5,shop,19,20,1
5684,6,home,20,24,4
5685,1,home,0,7,7
5685,2,work,7,13,6
5685,3,shop,13,15,2
5685,4,home,15,24,9
5686,1,home,0,7,7
5686,2,shop,7,8,1
5686,3,home,8,10,2
5686,4,work,10,17,7
5686,5,home,17,24,7
5687,1,home,0,8,8
5687,2,education,8,11,3
5687,3,shop,11,12,1
5687,4,work,12,19,7
5687,5,home,19,24,5
5688,1,home,0,6,6
5688,2,work,6,13,7
5688,3,shop,13,14,1
5688,4,home,14,24,10
5689,1,home,0,6,6
5689,2,work,6,8,2
5689,3,home,8,14,6
5689,4,work,14,17,3
5689,5,home,17,21,4
5689,6,work,21,22,1
5689,7,home,22,24,2
5690,1,home,0,8,8
5690,2,work,8,15,7
5690,3,shop,15,16,1
5690,4,home,16,24,8
5691,1,home,0,8,8
5691,2,work,8,14,6
5691,3,shop,14,15,1
5691,4,work,15,19,4
5691,5,home,19,24,5
5692,1,home,0,6,6
5692,2,work,6,13,7
5692,3,shop,13,14,1
5692,4,education,14,17,3
5692,5,home,17,24,7
5693,1,home,0,7,7
5693,2,shop,7,8,1
5693,3,education,8,11,3
5693,4,home,11,14,3
5693,5,education,14,16,2
5693,6,shop,16,18,2
5693,7,home,18,24,6
5694,1,home,0,7,7
5694,2,education,7,12,5
5694,3,shop,12,13,1
5694,4,education,13,16,3
5694,5,home,16,21,5
5694,6,shop,21,22,1
5694,7,home,22,24,2
5695,1,home,0,8,8
5695,2,work,8,10,2
5695,3,home,10,16,6
5695,4,work,16,18,2
5695,5,home,18,24,6
5696,1,home,0,8,8
5696,2,work,8,15,7
5696,3,home,15,19,4
5696,4,shop,19,20,1
5696,5,home,20,24,4
5697,1,home,0,6,6
5697,2,work,6,13,7
5697,3,home,13,24,11
5698,1,home,0,7,7
5698,2,work,7,13,6
5698,3,shop,13,15,2
5698,4,home,15,24,9
5699,1,home,0,7,7
5699,2,education,7,10,3
5699,3,home,10,17,7
5699,4,shop,17,18,1
5699,5,home,18,24,6
5700,1,home,0,8,8
5700,2,work,8,15,7
5700,3,home,15,24,9
5701,1,home,0,6,6
5701,2,work,6,13,7
5701,3,home,13,18,5
5701,4,work,18,20,2
5701,5,home,20,24,4
5702,1,home,0,6,6
5702,2,shop,6,7,1
5702,3,home,7,13,6
5702,4,education,13,15,2
5702,5,shop,15,17,2
5702,6,home,17,24,7
5703,1,home,0,8,8
5703,2,work,8,16,8
5703,3,home,16,24,8
5704,1,home,0,7,7
5704,2,work,7,13,6
5704,3,shop,13,14,1
5704,4,education,14,17,3
5704,5,home,17,22,5
5704,6,work,22,23,1
5704,7,home,23,24,1
5705,1,home,0,8,8
5705,2,work,8,15,7
5705,3,home,15,24,9
5706,1,home,0,7,7
5706,2,work,7,14,7
5706,3,home,14,21,7
5706,4,work,21,22,1
5706,5,home,22,24,2
5707,1,home,0,6,6
5707,2,work,6,8,2
5707,3,home,8,14,6
5707,4,work,14,16,2
5707,5,home,16,22,6
5707,6,work,22,23,1
5707,7,home,23,24,1
5708,1,home,0,7,7
5708,2,work,7,13,6
5708,3,home,13,16,3
5708,4,shop,16,17,1
5708,5,home,17,21,4
5708,6,work,21,22,1
5708,7,home,22,24,2
5709,1,home,0,6,6
5709,2,work,6,8,2
5709,3,home,8,13,5
5709,4,work,13,15,2
5709,5,home,15,22,7
5709,6,work,22,23,1
5709,7,home,23,24,1
5710,1,home,0,8,8
5710,2,work,8,15,7
5710,3,home,15,24,9
5711,1,home,0,7,7
5711,2,work,7,14,7
5711,3,home,14,24,10
5712,1,home,0,6,6
5712,2,shop,6,7,1
5712,3,home,7,13,6
5712,4,education,13,16,3
5712,5,home,16,20,4
5712,6,shop,20,21,1
5712,7,home,21,24,3
5713,1,home,0,9,9
5713,2,work,9,16,7
5713,3,shop,16,17,1
5713,4,home,17,24,7
5714,1,home,0,7,7
5714,2,education,7,11,4
5714,3,home,11,17,6
5714,4,shop,17,19,2
5714,5,home,19,24,5
5715,1,work,0,8,8
5715,2,shop,8,9,1
5715,3,work,9,15,6
5715,4,home,15,24,9
5716,1,home,0,6,6
5716,2,shop,6,7,1
5716,3,home,7,10,3
5716,4,education,10,16,6
5716,5,home,16,24,8
5717,1,home,0,6,6
5717,2,work,6,8,2
5717,3,home,8,9,1
5717,4,work,9,12,3
5717,5,home,12,16,4
5717,6,work,16,18,2
5717,7,home,18,22,4
5717,8,work,22,23,1
5717,9,home,23,24,1
5718,1,home,0,8,8
5718,2,work,8,15,7
5718,3,home,15,24,9
5719,1,home,0,7,7
5719,2,education,7,11,4
5719,3,home,11,18,7
5719,4,shop,18,19,1
5719,5,home,19,24,5
5720,1,home,0,8,8
5720,2,work,8,13,5
5720,3,home,13,24,11
5721,1,home,0,8,8
5721,2,work,8,14,6
5721,3,shop,14,15,1
5721,4,home,15,23,8
5721,5,work,23,24,1
5722,1,home,0,7,7
5722,2,work,7,13,6
5722,3,home,13,16,3
5722,4,shop,16,17,1
5722,5,home,17,23,6
5722,6,work,23,24,1
5723,1,home,0,7,7
5723,2,work,7,14,7
5723,3,home,14,24,10
5724,1,home,0,7,7
5724,2,work,7,13,6
5724,3,home,13,17,4
5724,4,work,17,19,2
5724,5,home,19,24,5
5725,1,home,0,8,8
5725,2,work,8,14,6
5725,3,shop,14,15,1
5725,4,home,15,21,6
5725,5,shop,21,22,1
5725,6,home,22,24,2
5726,1,home,0,8,8
5726,2,work,8,14,6
5726,3,home,14,21,7
5726,4,work,21,22,1
5726,5,home,22,24,2
5727,1,home,0,7,7
5727,2,work,7,14,7
5727,3,shop,14,15,1
5727,4,home,15,24,9
5728,1,home,0,7,7
5728,2,work,7,13,6
5728,3,shop,13,14,1
5728,4,work,14,19,5
5728,5,home,19,24,5
5729,1,home,0,6,6
5729,2,shop,6,7,1
5729,3,home,7,10,3
5729,4,education,10,13,3
5729,5,shop,13,15,2
5729,6,home,15,24,9
5730,1,home,0,6,6
5730,2,work,6,13,7
5730,3,shop,13,14,1
5730,4,home,14,24,10
5731,1,home,0,6,6
5731,2,shop,6,7,1
5731,3,work,7,15,8
5731,4,home,15,22,7
5731,5,work,22,23,1
5731,6,home,23,24,1
5732,1,home,0,7,7
5732,2,education,7,11,4
5732,3,home,11,16,5
5732,4,shop,16,17,1
5732,5,home,17,24,7
5733,1,home,0,8,8
5733,2,work,8,17,9
5733,3,home,17,24,7
5734,1,home,0,7,7
5734,2,work,7,9,2
5734,3,home,9,13,4
5734,4,work,13,16,3
5734,5,home,16,22,6
5734,6,work,22,23,1
5734,7,home,23,24,1
5735,1,home,0,6,6
5735,2,work,6,13,7
5735,3,home,13,24,11
5736,1,home,0,7,7
5736,2,work,7,13,6
5736,3,home,13,24,11
5737,1,home,0,8,8
5737,2,work,8,14,6
5737,3,home,14,17,3
5737,4,shop,17,18,1
5737,5,home,18,24,6
5738,1,home,0,6,6
5738,2,work,6,13,7
5738,3,home,13,21,8
5738,4,shop,21,22,1
5738,5,home,22,24,2
5739,1,home,0,7,7
5739,2,work,7,13,6
5739,3,home,13,17,4
5739,4,work,17,20,3
5739,5,home,20,24,4
5740,1,home,0,7,7
5740,2,shop,7,8,1
5740,3,education,8,12,4
5740,4,shop,12,14,2
5740,5,education,14,16,2
5740,6,home,16,24,8
5741,1,home,0,9,9
5741,2,education,9,12,3
5741,3,shop,12,13,1
5741,4,work,13,19,6
5741,5,home,19,24,5
5742,1,home,0,8,8
5742,2,work,8,15,7
5742,3,home,15,24,9
5743,1,home,0,7,7
5743,2,work,7,13,6
5743,3,home,13,17,4
5743,4,work,17,19,2
5743,5,home,19,24,5
5744,1,home,0,9,9
5744,2,work,9,15,6
5744,3,home,15,24,9
5745,1,home,0,6,6
5745,2,work,6,13,7
5745,3,shop,13,14,1
5745,4,work,14,20,6
5745,5,home,20,24,4
5746,1,home,0,6,6
5746,2,work,6,8,2
5746,3,home,8,12,4
5746,4,work,12,14,2
5746,5,shop,14,15,1
5746,6,home,15,22,7
5746,7,work,22,23,1
5746,8,home,23,24,1
5747,1,home,0,7,7
5747,2,work,7,14,7
5747,3,shop,14,15,1
5747,4,work,15,20,5
5747,5,home,20,24,4
5748,1,home,0,8,8
5748,2,work,8,14,6
5748,3,home,14,24,10
5749,1,home,0,6,6
5749,2,work,6,13,7
5749,3,home,13,17,4
5749,4,work,17,20,3
5749,5,home,20,24,4
5750,1,home,0,7,7
5750,2,work,7,14,7
5750,3,home,14,21,7
5750,4,shop,21,22,1
5750,5,home,22,24,2
5751,1,home,0,7,7
5751,2,shop,7,9,2
5751,3,education,9,12,3
5751,4,shop,12,13,1
5751,5,home,13,18,5
5751,6,shop,18,19,1
5751,7,home,19,24,5
5752,1,home,0,7,7
5752,2,work,7,13,6
5752,3,shop,13,14,1
5752,4,work,14,20,6
5752,5,home,20,24,4
5753,1,home,0,7,7
5753,2,work,7,14,7
5753,3,shop,14,15,1
5753,4,home,15,24,9
5754,1,home,0,7,7
5754,2,education,7,11,4
5754,3,home,11,18,7
5754,4,shop,18,20,2
5754,5,home,20,24,4
5755,1,home,0,9,9
5755,2,work,9,16,7
5755,3,shop,16,17,1
5755,4,home,17,24,7
5756,1,home,0,7,7
5756,2,work,7,13,6
5756,3,shop,13,14,1
5756,4,home,14,24,10
5757,1,home,0,6,6
5757,2,work,6,13,7
5757,3,shop,13,14,1
5757,4,home,14,24,10
5758,1,home,0,7,7
5758,2,education,7,11,4
5758,3,home,11,19,8
5758,4,shop,19,20,1
5758,5,home,20,24,4
5759,1,home,0,6,6
5759,2,work,6,7,1
5759,3,home,7,9,2
5759,4,work,9,10,1
5759,5,home,10,14,4
5759,6,work,14,15,1
5759,7,home,15,21,6
5759,8,work,21,22,1
5759,9,home,22,24,2
5760,1,home,0,8,8
5760,2,education,8,11,3
5760,3,shop,11,12,1
5760,4,work,12,19,7
5760,5,home,19,24,5
5761,1,home,0,6,6
5761,2,shop,6,7,1
5761,3,home,7,9,2
5761,4,education,9,11,2
5761,5,home,11,18,7
5761,6,shop,18,19,1
5761,7,home,19,24,5
5762,1,home,0,7,7
5762,2,work,7,14,7
5762,3,home,14,20,6
5762,4,shop,20,21,1
5762,5,home,21,24,3
5763,1,home,0,6,6
5763,2,shop,6,7,1
5763,3,home,7,10,3
5763,4,education,10,13,3
5763,5,home,13,20,7
5763,6,shop,20,21,1
5763,7,home,21,24,3
5764,1,home,0,8,8
5764,2,education,8,11,3
5764,3,home,11,20,9
5764,4,shop,20,21,1
5764,5,home,21,24,3
5765,1,home,0,7,7
5765,2,work,7,13,6
5765,3,shop,13,15,2
5765,4,work,15,19,4
5765,5,home,19,24,5
5766,1,home,0,6,6
5766,2,shop,6,7,1
5766,3,home,7,10,3
5766,4,education,10,13,3
5766,5,shop,13,14,1
5766,6,education,14,16,2
5766,7,home,16,24,8
5767,1,home,0,7,7
5767,2,education,7,11,4
5767,3,home,11,14,3
5767,4,education,14,16,2
5767,5,shop,16,17,1
5767,6,home,17,24,7
5768,1,home,0,8,8
5768,2,education,8,12,4
5768,3,shop,12,13,1
5768,4,work,13,19,6
5768,5,home,19,24,5
5769,1,home,0,6,6
5769,2,shop,6,7,1
5769,3,work,7,14,7
5769,4,home,14,24,10
5770,1,home,0,8,8
5770,2,education,8,12,4
5770,3,shop,12,13,1
5770,4,work,13,19,6
5770,5,home,19,23,4
5770,6,work,23,24,1
5771,1,home,0,6,6
5771,2,work,6,13,7
5771,3,home,13,24,11
5772,1,home,0,7,7
5772,2,work,7,14,7
5772,3,shop,14,15,1
5772,4,work,15,20,5
5772,5,home,20,24,4
5773,1,home,0,6,6
5773,2,work,6,13,7
5773,3,home,13,17,4
5773,4,work,17,20,3
5773,5,home,20,24,4
5774,1,home,0,6,6
5774,2,work,6,13,7
5774,3,shop,13,14,1
5774,4,work,14,20,6
5774,5,home,20,24,4
5775,1,home,0,7,7
5775,2,shop,7,8,1
5775,3,work,8,15,7
5775,4,home,15,24,9
5776,1,home,0,7,7
5776,2,work,7,14,7
5776,3,home,14,24,10
5777,1,home,0,8,8
5777,2,work,8,15,7
5777,3,home,15,21,6
5777,4,shop,21,22,1
5777,5,home,22,24,2
5778,1,home,0,7,7
5778,2,education,7,12,5
5778,3,home,12,20,8
5778,4,shop,20,21,1
5778,5,home,21,24,3
5779,1,home,0,7,7
5779,2,work,7,13,6
5779,3,home,13,18,5
5779,4,work,18,20,2
5779,5,home,20,24,4
5780,1,home,0,6,6
5780,2,work,6,13,7
5780,3,home,13,18,5
5780,4,work,18,20,2
5780,5,home,20,24,4
5781,1,home,0,8,8
5781,2,shop,8,9,1
5781,3,work,9,16,7
5781,4,home,16,24,8
5782,1,home,0,7,7
5782,2,shop,7,9,2
5782,3,education,9,11,2
5782,4,home,11,15,4
5782,5,shop,15,16,1
5782,6,home,16,24,8
5783,1,home,0,8,8
5783,2,work,8,17,9
5783,3,home,17,24,7
5784,1,home,0,6,6
5784,2,work,6,8,2
5784,3,home,8,12,4
5784,4,work,12,14,2
5784,5,home,14,22,8
5784,6,work,22,23,1
5784,7,home,23,24,1
5785,1,home,0,6,6
5785,2,work,6,13,7
5785,3,home,13,17,4
5785,4,work,17,20,3
5785,5,home,20,24,4
5786,1,home,0,8,8
5786,2,education,8,11,3
5786,3,home,11,19,8
5786,4,shop,19,20,1
5786,5,home,20,24,4
5787,1,home,0,8,8
5787,2,work,8,15,7
5787,3,home,15,24,9
5788,1,home,0,8,8
5788,2,work,8,15,7
5788,3,home,15,22,7
5788,4,work,22,23,1
5788,5,home,23,24,1
5789,1,home,0,7,7
5789,2,shop,7,8,1
5789,3,work,8,14,6
5789,4,home,14,21,7
5789,5,work,21,22,1
5789,6,home,22,24,2
5790,1,home,0,8,8
5790,2,work,8,15,7
5790,3,home,15,24,9
5791,1,home,0,8,8
5791,2,work,8,14,6
5791,3,shop,14,15,1
5791,4,work,15,20,5
5791,5,home,20,24,4
5792,1,home,0,6,6
5792,2,work,6,13,7
5792,3,shop,13,14,1
5792,4,home,14,17,3
5792,5,work,17,20,3
5792,6,home,20,24,4
5793,1,home,0,7,7
5793,2,work,7,13,6
5793,3,home,13,24,11
5794,1,home,0,8,8
5794,2,work,8,15,7
5794,3,home,15,19,4
5794,4,shop,19,20,1
5794,5,home,20,24,4
5795,1,home,0,6,6
5795,2,work,6,7,1
5795,3,home,7,11,4
5795,4,work,11,13,2
5795,5,home,13,18,5
5795,6,work,18,19,1
5795,7,home,19,24,5
5796,1,home,0,8,8
5796,2,work,8,16,8
5796,3,home,16,24,8
5797,1,home,0,9,9
5797,2,work,9,16,7
5797,3,home,16,23,7
5797,4,work,23,24,1
5798,1,home,0,7,7
5798,2,work,7,14,7
5798,3,home,14,23,9
5798,4,work,23,24,1
5799,1,home,0,7,7
5799,2,work,7,15,8
5799,3,shop,15,16,1
5799,4,home,16,24,8
5800,1,home,0,7,7
5800,2,shop,7,8,1
5800,3,education,8,11,3
5800,4,home,11,19,8
5800,5,shop,19,20,1
5800,6,home,20,24,4
5801,1,home,0,6,6
5801,2,work,6,13,7
5801,3,home,13,24,11
5802,1,home,0,7,7
5802,2,work,7,13,6
5802,3,shop,13,14,1
5802,4,education,14,17,3
5802,5,home,17,24,7
5803,1,home,0,10,10
5803,2,education,10,13,3
5803,3,home,13,17,4
5803,4,work,17,20,3
5803,5,home,20,24,4
5804,1,home,0,8,8
5804,2,work,8,14,6
5804,3,shop,14,15,1
5804,4,home,15,24,9
5805,1,home,0,7,7
5805,2,shop,7,8,1
5805,3,education,8,12,4
5805,4,shop,12,14,2
5805,5,education,14,17,3
5805,6,home,17,24,7
5806,1,home,0,8,8
5806,2,work,8,14,6
5806,3,home,14,22,8
5806,4,work,22,23,1
5806,5,home,23,24,1
5807,1,home,0,8,8
5807,2,work,8,15,7
5807,3,shop,15,16,1
5807,4,home,16,24,8
5808,1,home,0,8,8
5808,2,work,8,14,6
5808,3,shop,14,15,1
5808,4,home,15,24,9
5809,1,home,0,7,7
5809,2,work,7,13,6
5809,3,home,13,24,11
5810,1,home,0,6,6
5810,2,work,6,13,7
5810,3,home,13,24,11
5811,1,home,0,8,8
5811,2,work,8,15,7
5811,3,shop,15,16,1
5811,4,home,16,24,8
5812,1,home,0,7,7
5812,2,work,7,13,6
5812,3,shop,13,14,1
5812,4,home,14,24,10
5813,1,home,0,7,7
5813,2,education,7,11,4
5813,3,home,11,20,9
5813,4,shop,20,21,1
5813,5,home,21,24,3
5814,1,home,0,6,6
5814,2,shop,6,7,1
5814,3,home,7,10,3
5814,4,education,10,11,1
5814,5,home,11,17,6
5814,6,shop,17,18,1
5814,7,home,18,24,6
5815,1,home,0,6,6
5815,2,work,6,7,1
5815,3,home,7,13,6
5815,4,work,13,15,2
5815,5,home,15,23,8
5815,6,work,23,24,1
5816,1,home,0,6,6
5816,2,shop,6,7,1
5816,3,home,7,10,3
5816,4,education,10,13,3
5816,5,shop,13,15,2
5816,6,home,15,19,4
5816,7,shop,19,20,1
5816,8,home,20,24,4
5817,1,home,0,6,6
5817,2,work,6,13,7
5817,3,shop,13,14,1
5817,4,work,14,19,5
5817,5,home,19,24,5
5818,1,home,0,6,6
5818,2,work,6,7,1
5818,3,home,7,11,4
5818,4,work,11,12,1
5818,5,shop,12,13,1
5818,6,work,13,15,2
5818,7,home,15,18,3
5818,8,work,18,19,1
5818,9,home,19,24,5
5819,1,home,0,6,6
5819,2,shop,6,7,1
5819,3,home,7,10,3
5819,4,education,10,13,3
5819,5,shop,13,15,2
5819,6,home,15,24,9
5820,1,home,0,6,6
5820,2,work,6,13,7
5820,3,home,13,24,11
5821,1,home,0,7,7
5821,2,work,7,13,6
5821,3,shop,13,15,2
5821,4,work,15,20,5
5821,5,home,20,24,4
5822,1,home,0,6,6
5822,2,shop,6,7,1
5822,3,home,7,13,6
5822,4,education,13,16,3
5822,5,home,16,24,8
5823,1,home,0,8,8
5823,2,work,8,15,7
5823,3,home,15,24,9
5824,1,home,0,8,8
5824,2,shop,8,9,1
5824,3,home,9,13,4
5824,4,education,13,17,4
5824,5,home,17,24,7
5825,1,home,0,7,7
5825,2,shop,7,8,1
5825,3,education,8,11,3
5825,4,home,11,17,6
5825,5,shop,17,18,1
5825,6,home,18,24,6
5826,1,home,0,6,6
5826,2,work,6,13,7
5826,3,home,13,19,6
5826,4,shop,19,20,1
5826,5,home,20,24,4
5827,1,home,0,6,6
5827,2,work,6,13,7
5827,3,home,13,24,11
5828,1,home,0,6,6
5828,2,work,6,13,7
5828,3,shop,13,14,1
5828,4,home,14,24,10
5829,1,home,0,7,7
5829,2,work,7,13,6
5829,3,home,13,17,4
5829,4,work,17,20,3
5829,5,home,20,24,4
5830,1,home,0,7,7
5830,2,shop,7,8,1
5830,3,education,8,12,4
5830,4,home,12,14,2
5830,5,education,14,16,2
5830,6,home,16,24,8
5831,1,home,0,7,7
5831,2,shop,7,8,1
5831,3,work,8,15,7
5831,4,home,15,24,9
5832,1,home,0,8,8
5832,2,work,8,15,7
5832,3,home,15,24,9
5833,1,home,0,7,7
5833,2,education,7,12,5
5833,3,home,12,18,6
5833,4,shop,18,20,2
5833,5,home,20,24,4
5834,1,home,0,6,6
5834,2,work,6,7,1
5834,3,home,7,9,2
5834,4,work,9,11,2
5834,5,home,11,15,4
5834,6,work,15,17,2
5834,7,home,17,19,2
5834,8,shop,19,20,1
5834,9,home,20,24,4
5835,1,home,0,9,9
5835,2,work,9,14,5
5835,3,home,14,24,10
5836,1,home,0,8,8
5836,2,education,8,11,3
5836,3,shop,11,12,1
5836,4,work,12,19,7
5836,5,home,19,24,5
5837,1,home,0,6,6
5837,2,work,6,8,2
5837,3,home,8,14,6
5837,4,work,14,15,1
5837,5,shop,15,16,1
5837,6,work,16,18,2
5837,7,home,18,22,4
5837,8,work,22,23,1
5837,9,home,23,24,1
5838,1,home,0,7,7
5838,2,shop,7,9,2
5838,3,education,9,12,3
5838,4,home,12,18,6
5838,5,shop,18,20,2
5838,6,home,20,24,4
5839,1,home,0,6,6
5839,2,work,6,13,7
5839,3,shop,13,14,1
5839,4,work,14,20,6
5839,5,home,20,24,4
5840,1,home,0,7,7
5840,2,education,7,12,5
5840,3,shop,12,14,2
5840,4,education,14,17,3
5840,5,shop,17,19,2
5840,6,home,19,24,5
5841,1,home,0,8,8
5841,2,work,8,14,6
5841,3,home,14,24,10
5842,1,home,0,7,7
5842,2,work,7,14,7
5842,3,shop,14,15,1
5842,4,home,15,17,2
5842,5,work,17,20,3
5842,6,home,20,24,4
5843,1,home,0,7,7
5843,2,shop,7,8,1
5843,3,education,8,12,4
5843,4,shop,12,13,1
5843,5,home,13,16,3
5843,6,shop,16,18,2
5843,7,home,18,24,6
5844,1,home,0,7,7
5844,2,shop,7,9,2
5844,3,education,9,12,3
5844,4,shop,12,13,1
5844,5,education,13,16,3
5844,6,home,16,24,8
5845,1,home,0,6,6
5845,2,work,6,13,7
5845,3,shop,13,14,1
5845,4,home,14,24,10
5846,1,home,0,7,7
5846,2,work,7,13,6
5846,3,home,13,24,11
5847,1,home,0,7,7
5847,2,work,7,14,7
5847,3,home,14,24,10
5848,1,home,0,7,7
5848,2,work,7,14,7
5848,3,home,14,24,10
5849,1,home,0,7,7
5849,2,work,7,13,6
5849,3,home,13,24,11
5850,1,home,0,7,7
5850,2,shop,7,8,1
5850,3,education,8,11,3
5850,4,home,11,19,8
5850,5,shop,19,20,1
5850,6,home,20,24,4
5851,1,home,0,8,8
5851,2,shop,8,9,1
5851,3,work,9,17,8
5851,4,home,17,24,7
5852,1,home,0,8,8
5852,2,work,8,15,7
5852,3,home,15,24,9
5853,1,home,0,6,6
5853,2,work,6,13,7
5853,3,home,13,24,11
5854,1,home,0,7,7
5854,2,work,7,14,7
5854,3,shop,14,15,1
5854,4,work,15,19,4
5854,5,home,19,24,5
5855,1,home,0,7,7
5855,2,work,7,14,7
5855,3,home,14,22,8
5855,4,work,22,23,1
5855,5,home,23,24,1
5856,1,home,0,7,7
5856,2,work,7,13,6
5856,3,home,13,17,4
5856,4,work,17,20,3
5856,5,home,20,24,4
5857,1,home,0,7,7
5857,2,work,7,14,7
5857,3,shop,14,15,1
5857,4,work,15,20,5
5857,5,home,20,24,4
5858,1,home,0,7,7
5858,2,work,7,13,6
5858,3,shop,13,14,1
5858,4,work,14,19,5
5858,5,home,19,24,5
5859,1,home,0,8,8
5859,2,work,8,14,6
5859,3,home,14,22,8
5859,4,work,22,23,1
5859,5,home,23,24,1
5860,1,home,0,9,9
5860,2,work,9,16,7
5860,3,shop,16,17,1
5860,4,home,17,24,7
5861,1,home,0,8,8
5861,2,work,8,13,5
5861,3,shop,13,14,1
5861,4,work,14,19,5
5861,5,home,19,24,5
5862,1,home,0,8,8
5862,2,work,8,15,7
5862,3,home,15,23,8
5862,4,work,23,24,1
5863,1,home,0,7,7
5863,2,work,7,14,7
5863,3,home,14,20,6
5863,4,shop,20,21,1
5863,5,home,21,24,3
5864,1,home,0,7,7
5864,2,work,7,13,6
5864,3,home,13,21,8
5864,4,work,21,22,1
5864,5,home,22,24,2
5865,1,home,0,7,7
5865,2,work,7,13,6
5865,3,home,13,17,4
5865,4,work,17,20,3
5865,5,home,20,24,4
5866,1,home,0,8,8
5866,2,work,8,15,7
5866,3,home,15,24,9
5867,1,home,0,6,6
5867,2,shop,6,7,1
5867,3,home,7,10,3
5867,4,education,10,13,3
5867,5,shop,13,15,2
5867,6,home,15,24,9
5868,1,home,0,8,8
5868,2,work,8,16,8
5868,3,shop,16,17,1
5868,4,work,17,20,3
5868,5,home,20,24,4
5869,1,home,0,7,7
5869,2,education,7,12,5
5869,3,home,12,18,6
5869,4,shop,18,19,1
5869,5,home,19,24,5
5870,1,home,0,7,7
5870,2,shop,7,8,1
5870,3,education,8,12,4
5870,4,home,12,20,8
5870,5,shop,20,21,1
5870,6,home,21,24,3
5871,1,home,0,6,6
5871,2,shop,6,7,1
5871,3,home,7,9,2
5871,4,education,9,11,2
5871,5,home,11,19,8
5871,6,shop,19,21,2
5871,7,home,21,24,3
5872,1,home,0,6,6
5872,2,shop,6,7,1
5872,3,home,7,10,3
5872,4,education,10,13,3
5872,5,shop,13,14,1
5872,6,home,14,24,10
5873,1,home,0,7,7
5873,2,work,7,13,6
5873,3,shop,13,14,1
5873,4,work,14,19,5
5873,5,home,19,24,5
5874,1,home,0,7,7
5874,2,shop,7,9,2
5874,3,education,9,11,2
5874,4,home,11,18,7
5874,5,shop,18,20,2
5874,6,home,20,24,4
5875,1,home,0,8,8
5875,2,education,8,12,4
5875,3,work,12,19,7
5875,4,home,19,24,5
5876,1,home,0,7,7
5876,2,shop,7,9,2
5876,3,education,9,13,4
5876,4,home,13,20,7
5876,5,shop,20,21,1
5876,6,home,21,24,3
5877,1,home,0,7,7
5877,2,education,7,12,5
5877,3,home,12,19,7
5877,4,shop,19,20,1
5877,5,home,20,24,4
5878,1,home,0,7,7
5878,2,work,7,14,7
5878,3,home,14,17,3
5878,4,shop,17,18,1
5878,5,home,18,22,4
5878,6,work,22,23,1
5878,7,home,23,24,1
5879,1,home,0,6,6
5879,2,work,6,13,7
5879,3,shop,13,14,1
5879,4,home,14,21,7
5879,5,work,21,22,1
5879,6,home,22,24,2
5880,1,home,0,6,6
5880,2,work,6,13,7
5880,3,home,13,20,7
5880,4,shop,20,21,1
5880,5,home,21,24,3
5881,1,home,0,6,6
5881,2,work,6,8,2
5881,3,home,8,9,1
5881,4,work,9,11,2
5881,5,home,11,16,5
5881,6,work,16,18,2
5881,7,home,18,21,3
5881,8,work,21,22,1
5881,9,home,22,24,2
5882,1,home,0,6,6
5882,2,work,6,13,7
5882,3,home,13,14,1
5882,4,shop,14,15,1
5882,5,home,15,24,9
5883,1,home,0,6,6
5883,2,work,6,8,2
5883,3,home,8,9,1
5883,4,work,9,11,2
5883,5,home,11,15,4
5883,6,work,15,17,2
5883,7,home,17,23,6
5883,8,work,23,24,1
5884,1,home,0,6,6
5884,2,work,6,8,2
5884,3,home,8,12,4
5884,4,work,12,14,2
5884,5,home,14,21,7
5884,6,work,21,22,1
5884,7,home,22,24,2
5885,1,home,0,6,6
5885,2,work,6,8,2
5885,3,home,8,15,7
5885,4,work,15,17,2
5885,5,home,17,23,6
5885,6,work,23,24,1
5886,1,home,0,7,7
5886,2,work,7,15,8
5886,3,shop,15,16,1
5886,4,home,16,24,8
5887,1,home,0,7,7
5887,2,work,7,13,6
5887,3,shop,13,14,1
5887,4,home,14,24,10
5888,1,home,0,6,6
5888,2,shop,6,7,1
5888,3,home,7,13,6
5888,4,education,13,16,3
5888,5,home,16,24,8
5889,1,home,0,7,7
5889,2,work,7,14,7
5889,3,home,14,21,7
5889,4,shop,21,22,1
5889,5,home,22,24,2
5890,1,home,0,8,8
5890,2,shop,8,10,2
5890,3,education,10,14,4
5890,4,shop,14,15,1
5890,5,home,15,24,9
5891,1,home,0,6,6
5891,2,work,6,9,3
5891,3,home,9,16,7
5891,4,work,16,18,2
5891,5,home,18,24,6
5892,1,home,0,7,7
5892,2,work,7,13,6
5892,3,shop,13,14,1
5892,4,home,14,24,10
5893,1,home,0,7,7
5893,2,work,7,13,6
5893,3,home,13,19,6
5893,4,shop,19,20,1
5893,5,home,20,24,4
5894,1,home,0,7,7
5894,2,work,7,13,6
5894,3,home,13,24,11
5895,1,home,0,6,6
5895,2,work,6,13,7
5895,3,shop,13,14,1
5895,4,home,14,24,10
5896,1,home,0,4,4
5896,2,work,4,6,2
5896,3,home,6,9,3
5896,4,work,9,11,2
5896,5,home,11,15,4
5896,6,work,15,18,3
5896,7,home,18,22,4
5896,8,work,22,23,1
5896,9,home,23,24,1
5897,1,home,0,9,9
5897,2,work,9,16,7
5897,3,home,16,24,8
5898,1,home,0,6,6
5898,2,work,6,13,7
5898,3,shop,13,14,1
5898,4,work,14,20,6
5898,5,home,20,24,4
5899,1,home,0,8,8
5899,2,education,8,14,6
5899,3,work,14,20,6
5899,4,home,20,24,4
5900,1,home,0,7,7
5900,2,work,7,14,7
5900,3,home,14,16,2
5900,4,work,16,20,4
5900,5,home,20,24,4
5901,1,home,0,6,6
5901,2,work,6,13,7
5901,3,home,13,16,3
5901,4,work,16,20,4
5901,5,home,20,24,4
5902,1,home,0,8,8
5902,2,work,8,15,7
5902,3,shop,15,16,1
5902,4,home,16,21,5
5902,5,shop,21,22,1
5902,6,home,22,24,2
5903,1,home,0,6,6
5903,2,work,6,9,3
5903,3,home,9,14,5
5903,4,work,14,16,2
5903,5,shop,16,17,1
5903,6,home,17,24,7
5904,1,home,0,6,6
5904,2,work,6,13,7
5904,3,home,13,24,11
5905,1,home,0,7,7
5905,2,shop,7,8,1
5905,3,home,8,18,10
5905,4,shop,18,19,1
5905,5,home,19,24,5
5906,1,home,0,6,6
5906,2,work,6,13,7
5906,3,shop,13,14,1
5906,4,home,14,22,8
5906,5,work,22,23,1
5906,6,home,23,24,1
5907,1,home,0,9,9
5907,2,shop,9,11,2
5907,3,work,11,13,2
5907,4,home,13,18,5
5907,5,work,18,20,2
5907,6,home,20,24,4
5908,1,home,0,8,8
5908,2,education,8,12,4
5908,3,home,12,16,4
5908,4,work,16,20,4
5908,5,home,20,24,4
5909,1,home,0,9,9
5909,2,work,9,16,7
5909,3,shop,16,17,1
5909,4,home,17,24,7
5910,1,home,0,6,6
5910,2,shop,6,7,1
5910,3,work,7,13,6
5910,4,home,13,24,11
5911,1,home,0,8,8
5911,2,education,8,11,3
5911,3,shop,11,12,1
5911,4,work,12,19,7
5911,5,home,19,24,5
5912,1,home,0,6,6
5912,2,shop,6,7,1
5912,3,home,7,12,5
5912,4,work,12,18,6
5912,5,home,18,24,6
5913,1,home,0,6,6
5913,2,shop,6,7,1
5913,3,work,7,13,6
5913,4,home,13,24,11
5914,1,home,0,9,9
5914,2,education,9,14,5
5914,3,work,14,20,6
5914,4,home,20,24,4
5915,1,home,0,6,6
5915,2,shop,6,7,1
5915,3,home,7,10,3
5915,4,work,10,12,2
5915,5,home,12,20,8
5915,6,shop,20,21,1
5915,7,home,21,24,3
5916,1,home,0,8,8
5916,2,education,8,11,3
5916,3,shop,11,12,1
5916,4,work,12,19,7
5916,5,home,19,23,4
5916,6,work,23,24,1
5917,1,home,0,7,7
5917,2,work,7,14,7
5917,3,shop,14,15,1
5917,4,home,15,24,9
5918,1,home,0,6,6
5918,2,shop,6,7,1
5918,3,home,7,9,2
5918,4,education,9,11,2
5918,5,home,11,18,7
5918,6,shop,18,19,1
5918,7,home,19,24,5
5919,1,home,0,8,8
5919,2,work,8,14,6
5919,3,home,14,22,8
5919,4,work,22,23,1
5919,5,home,23,24,1
5920,1,home,0,7,7
5920,2,education,7,11,4
5920,3,home,11,16,5
5920,4,shop,16,17,1
5920,5,home,17,24,7
5921,1,home,0,6,6
5921,2,shop,6,7,1
5921,3,work,7,13,6
5921,4,shop,13,14,1
5921,5,education,14,17,3
5921,6,home,17,24,7
5922,1,home,0,6,6
5922,2,work,6,13,7
5922,3,shop,13,14,1
5922,4,home,14,21,7
5922,5,work,21,22,1
5922,6,home,22,24,2
5923,1,home,0,7,7
5923,2,work,7,13,6
5923,3,shop,13,14,1
5923,4,home,14,24,10
5924,1,home,0,7,7
5924,2,work,7,9,2
5924,3,home,9,16,7
5924,4,work,16,18,2
5924,5,home,18,23,5
5924,6,work,23,24,1
5925,1,home,0,7,7
5925,2,shop,7,8,1
5925,3,home,8,12,4
5925,4,work,12,20,8
5925,5,home,20,24,4
5926,1,home,0,6,6
5926,2,shop,6,7,1
5926,3,home,7,9,2
5926,4,education,9,12,3
5926,5,shop,12,14,2
5926,6,home,14,21,7
5926,7,shop,21,22,1
5926,8,home,22,24,2
5927,1,home,0,7,7
5927,2,education,7,12,5
5927,3,shop,12,14,2
5927,4,education,14,16,2
5927,5,home,16,24,8
5928,1,home,0,8,8
5928,2,work,8,14,6
5928,3,home,14,24,10
5929,1,home,0,7,7
5929,2,work,7,15,8
5929,3,home,15,21,6
5929,4,work,21,22,1
5929,5,home,22,24,2
5930,1,home,0,7,7
5930,2,shop,7,9,2
5930,3,education,9,12,3
5930,4,home,12,17,5
5930,5,shop,17,19,2
5930,6,home,19,24,5
5931,1,home,0,6,6
5931,2,shop,6,7,1
5931,3,home,7,13,6
5931,4,education,13,16,3
5931,5,shop,16,18,2
5931,6,home,18,24,6
5932,1,home,0,8,8
5932,2,work,8,15,7
5932,3,home,15,21,6
5932,4,work,21,22,1
5932,5,home,22,24,2
5933,1,home,0,9,9
5933,2,education,9,14,5
5933,3,home,14,24,10
5934,1,home,0,7,7
5934,2,shop,7,8,1
5934,3,education,8,12,4
5934,4,home,12,18,6
5934,5,shop,18,19,1
5934,6,home,19,24,5
5935,1,home,0,9,9
5935,2,work,9,16,7
5935,3,shop,16,17,1
5935,4,home,17,22,5
5935,5,work,22,23,1
5935,6,home,23,24,1
5936,1,home,0,6,6
5936,2,work,6,13,7
5936,3,home,13,14,1
5936,4,education,14,17,3
5936,5,home,17,21,4
5936,6,shop,21,22,1
5936,7,home,22,24,2
5937,1,home,0,8,8
5937,2,work,8,14,6
5937,3,home,14,24,10
5938,1,home,0,6,6
5938,2,work,6,13,7
5938,3,home,13,20,7
5938,4,shop,20,21,1
5938,5,home,21,24,3
5939,1,home,0,6,6
5939,2,work,6,8,2
5939,3,home,8,12,4
5939,4,work,12,14,2
5939,5,shop,14,15,1
5939,6,work,15,18,3
5939,7,home,18,24,6
5940,1,home,0,7,7
5940,2,work,7,13,6
5940,3,shop,13,14,1
5940,4,home,14,18,4
5940,5,work,18,20,2
5940,6,home,20,24,4
5941,1,home,0,7,7
5941,2,education,7,11,4
5941,3,home,11,19,8
5941,4,shop,19,21,2
5941,5,home,21,24,3
5942,1,home,0,7,7
5942,2,shop,7,8,1
5942,3,work,8,15,7
5942,4,home,15,24,9
5943,1,home,0,6,6
5943,2,work,6,8,2
5943,3,home,8,12,4
5943,4,work,12,14,2
5943,5,home,14,21,7
5943,6,work,21,22,1
5943,7,home,22,24,2
5944,1,home,0,6,6
5944,2,work,6,12,6
5944,3,shop,12,13,1
5944,4,work,13,19,6
5944,5,home,19,24,5
5945,1,home,0,7,7
5945,2,education,7,12,5
5945,3,shop,12,14,2
5945,4,education,14,17,3
5945,5,home,17,24,7
5946,1,home,0,7,7
5946,2,work,7,13,6
5946,3,shop,13,14,1
5946,4,work,14,19,5
5946,5,home,19,24,5
5947,1,home,0,7,7
5947,2,work,7,14,7
5947,3,home,14,24,10
5948,1,home,0,7,7
5948,2,work,7,9,2
5948,3,home,9,14,5
5948,4,work,14,18,4
5948,5,home,18,24,6
5949,1,home,0,6,6
5949,2,work,6,13,7
5949,3,shop,13,14,1
5949,4,home,14,23,9
5949,5,work,23,24,1
5950,1,home,0,7,7
5950,2,work,7,14,7
5950,3,shop,14,15,1
5950,4,home,15,24,9
5951,1,home,0,7,7
5951,2,work,7,13,6
5951,3,home,13,20,7
5951,4,shop,20,21,1
5951,5,home,21,24,3
5952,1,home,0,8,8
5952,2,shop,8,9,1
5952,3,home,9,13,4
5952,4,work,13,20,7
5952,5,home,20,24,4
5953,1,home,0,8,8
5953,2,work,8,13,5
5953,3,shop,13,14,1
5953,4,home,14,24,10
5954,1,home,0,6,6
5954,2,shop,6,7,1
5954,3,home,7,9,2
5954,4,education,9,12,3
5954,5,shop,12,13,1
5954,6,home,13,21,8
5954,7,shop,21,22,1
5954,8,home,22,24,2
5955,1,home,0,6,6
5955,2,shop,6,7,1
5955,3,work,7,13,6
5955,4,home,13,24,11
5956,1,home,0,7,7
5956,2,work,7,15,8
5956,3,home,15,24,9
5957,1,home,0,7,7
5957,2,work,7,14,7
5957,3,home,14,24,10
5958,1,home,0,8,8
5958,2,work,8,14,6
5958,3,home,14,22,8
5958,4,work,22,23,1
5958,5,home,23,24,1
5959,1,home,0,7,7
5959,2,work,7,13,6
5959,3,home,13,18,5
5959,4,shop,18,19,1
5959,5,home,19,24,5
5960,1,home,0,6,6
5960,2,shop,6,7,1
5960,3,work,7,14,7
5960,4,home,14,24,10
5961,1,home,0,7,7
5961,2,work,7,13,6
5961,3,home,13,17,4
5961,4,work,17,20,3
5961,5,home,20,24,4
5962,1,home,0,7,7
5962,2,education,7,11,4
5962,3,home,11,18,7
5962,4,shop,18,20,2
5962,5,home,20,24,4
5963,1,home,0,7,7
5963,2,work,7,15,8
5963,3,home,15,21,6
5963,4,work,21,22,1
5963,5,home,22,24,2
5964,1,home,0,7,7
5964,2,work,7,13,6
5964,3,shop,13,14,1
5964,4,work,14,19,5
5964,5,home,19,24,5
5965,1,home,0,9,9
5965,2,work,9,16,7
5965,3,home,16,23,7
5965,4,work,23,24,1
5966,1,home,0,8,8
5966,2,work,8,14,6
5966,3,shop,14,15,1
5966,4,home,15,24,9
5967,1,home,0,7,7
5967,2,work,7,9,2
5967,3,home,9,13,4
5967,4,work,13,15,2
5967,5,home,15,21,6
5967,6,work,21,22,1
5967,7,home,22,24,2
5968,1,home,0,6,6
5968,2,shop,6,7,1
5968,3,home,7,10,3
5968,4,education,10,12,2
5968,5,shop,12,13,1
5968,6,education,13,16,3
5968,7,home,16,24,8
5969,1,home,0,7,7
5969,2,shop,7,8,1
5969,3,education,8,11,3
5969,4,home,11,14,3
5969,5,education,14,16,2
5969,6,home,16,24,8
5970,1,home,0,8,8
5970,2,work,8,14,6
5970,3,home,14,24,10
5971,1,home,0,7,7
5971,2,work,7,13,6
5971,3,shop,13,14,1
5971,4,work,14,19,5
5971,5,home,19,24,5
5972,1,home,0,7,7
5972,2,shop,7,8,1
5972,3,education,8,11,3
5972,4,home,11,18,7
5972,5,shop,18,19,1
5972,6,home,19,24,5
5973,1,home,0,7,7
5973,2,work,7,13,6
5973,3,shop,13,14,1
5973,4,home,14,18,4
5973,5,work,18,19,1
5973,6,home,19,24,5
5974,1,home,0,6,6
5974,2,shop,6,7,1
5974,3,home,7,9,2
5974,4,education,9,12,3
5974,5,shop,12,14,2
5974,6,education,14,16,2
5974,7,home,16,24,8
5975,1,home,0,7,7
5975,2,shop,7,9,2
5975,3,education,9,13,4
5975,4,home,13,21,8
5975,5,shop,21,22,1
5975,6,home,22,24,2
5976,1,home,0,8,8
5976,2,work,8,15,7
5976,3,shop,15,16,1
5976,4,home,16,23,7
5976,5,work,23,24,1
5977,1,home,0,7,7
5977,2,education,7,12,5
5977,3,shop,12,14,2
5977,4,education,14,16,2
5977,5,home,16,24,8
5978,1,home,0,6,6
5978,2,work,6,13,7
5978,3,home,13,24,11
5979,1,home,0,6,6
5979,2,work,6,13,7
5979,3,shop,13,14,1
5979,4,work,14,20,6
5979,5,home,20,24,4
5980,1,home,0,8,8
5980,2,work,8,14,6
5980,3,home,14,24,10
5981,1,home,0,6,6
5981,2,work,6,8,2
5981,3,home,8,13,5
5981,4,work,13,14,1
5981,5,home,14,21,7
5981,6,work,21,22,1
5981,7,home,22,24,2
5982,1,home,0,7,7
5982,2,work,7,14,7
5982,3,home,14,24,10
5983,1,home,0,7,7
5983,2,shop,7,9,2
5983,3,education,9,11,2
5983,4,home,11,17,6
5983,5,shop,17,19,2
5983,6,home,19,24,5
5984,1,home,0,6,6
5984,2,shop,6,7,1
5984,3,home,7,13,6
5984,4,education,13,16,3
5984,5,shop,16,18,2
5984,6,home,18,24,6
5985,1,home,0,6,6
5985,2,work,6,8,2
5985,3,home,8,14,6
5985,4,work,14,18,4
5985,5,home,18,24,6
5986,1,home,0,8,8
5986,2,education,8,11,3
5986,3,home,11,17,6
5986,4,shop,17,18,1
5986,5,home,18,24,6
5987,1,home,0,6,6
5987,2,shop,6,7,1
5987,3,home,7,13,6
5987,4,education,13,17,4
5987,5,home,17,24,7
5988,1,home,0,7,7
5988,2,work,7,14,7
5988,3,shop,14,15,1
5988,4,work,15,20,5
5988,5,home,20,24,4
5989,1,home,0,7,7
5989,2,work,7,9,2
5989,3,home,9,14,5
5989,4,work,14,15,1
5989,5,home,15,21,6
5989,6,work,21,22,1
5989,7,home,22,24,2
5990,1,home,0,7,7
5990,2,shop,7,9,2
5990,3,education,9,11,2
5990,4,home,11,14,3
5990,5,education,14,15,1
5990,6,shop,15,17,2
5990,7,home,17,24,7
5991,1,home,0,6,6
5991,2,shop,6,7,1
5991,3,home,7,10,3
5991,4,education,10,16,6
5991,5,home,16,24,8
5992,1,home,0,7,7
5992,2,work,7,14,7
5992,3,home,14,24,10
5993,1,home,0,7,7
5993,2,work,7,13,6
5993,3,home,13,17,4
5993,4,work,17,20,3
5993,5,home,20,24,4
5994,1,home,0,8,8
5994,2,work,8,15,7
5994,3,home,15,24,9
5995,1,home,0,7,7
5995,2,work,7,14,7
5995,3,home,14,24,10
5996,1,home,0,6,6
5996,2,work,6,13,7
5996,3,home,13,17,4
5996,4,shop,17,18,1
5996,5,home,18,24,6
5997,1,home,0,9,9
5997,2,work,9,17,8
5997,3,home,17,24,7
5998,1,home,0,8,8
5998,2,work,8,14,6
5998,3,shop,14,15,1
5998,4,home,15,24,9
5999,1,home,0,8,8
5999,2,education,8,11,3
5999,3,home,11,22,11
5999,4,work,22,23,1
5999,5,home,23,24,1
6000,1,home,0,7,7
6000,2,shop,7,8,1
6000,3,work,8,15,7
6000,4,home,15,24,9
6001,1,home,0,7,7
6001,2,education,7,11,4
6001,3,home,11,14,3
6001,4,education,14,16,2
6001,5,shop,16,17,1
6001,6,home,17,24,7
6002,1,home,0,7,7
6002,2,work,7,13,6
6002,3,home,13,18,5
6002,4,work,18,20,2
6002,5,home,20,24,4
6003,1,home,0,9,9
6003,2,education,9,12,3
6003,3,work,12,19,7
6003,4,home,19,24,5
6004,1,home,0,6,6
6004,2,work,6,8,2
6004,3,shop,8,9,1
6004,4,home,9,13,4
6004,5,work,13,15,2
6004,6,home,15,22,7
6004,7,work,22,23,1
6004,8,home,23,24,1
6005,1,home,0,7,7
6005,2,education,7,12,5
6005,3,home,12,19,7
6005,4,shop,19,20,1
6005,5,home,20,24,4
6006,1,home,0,7,7
6006,2,education,7,11,4
6006,3,home,11,17,6
6006,4,shop,17,18,1
6006,5,home,18,24,6
6007,1,home,0,8,8
6007,2,work,8,14,6
6007,3,shop,14,15,1
6007,4,home,15,24,9
6008,1,home,0,8,8
6008,2,work,8,15,7
6008,3,home,15,24,9
6009,1,home,0,6,6
6009,2,work,6,8,2
6009,3,home,8,13,5
6009,4,work,13,15,2
6009,5,home,15,22,7
6009,6,work,22,23,1
6009,7,home,23,24,1
6010,1,home,0,7,7
6010,2,shop,7,8,1
6010,3,education,8,12,4
6010,4,shop,12,13,1
6010,5,education,13,16,3
6010,6,home,16,24,8
6011,1,home,0,6,6
6011,2,work,6,13,7
6011,3,shop,13,14,1
6011,4,home,14,24,10
6012,1,home,0,7,7
6012,2,work,7,14,7
6012,3,shop,14,15,1
6012,4,home,15,24,9
6013,1,home,0,7,7
6013,2,shop,7,8,1
6013,3,home,8,13,5
6013,4,work,13,19,6
6013,5,home,19,24,5
6014,1,home,0,6,6
6014,2,work,6,8,2
6014,3,home,8,12,4
6014,4,work,12,14,2
6014,5,home,14,21,7
6014,6,shop,21,22,1
6014,7,home,22,24,2
6015,1,home,0,9,9
6015,2,work,9,16,7
6015,3,home,16,24,8
6016,1,home,0,8,8
6016,2,shop,8,9,1
6016,3,work,9,17,8
6016,4,home,17,21,4
6016,5,work,21,22,1
6016,6,home,22,24,2
6017,1,home,0,7,7
6017,2,education,7,12,5
6017,3,shop,12,14,2
6017,4,education,14,16,2
6017,5,home,16,24,8
6018,1,home,0,7,7
6018,2,work,7,9,2
6018,3,home,9,15,6
6018,4,work,15,17,2
6018,5,home,17,21,4
6018,6,work,21,22,1
6018,7,home,22,24,2
6019,1,home,0,7,7
6019,2,shop,7,8,1
6019,3,education,8,12,4
6019,4,shop,12,14,2
6019,5,education,14,17,3
6019,6,shop,17,18,1
6019,7,home,18,24,6
6020,1,home,0,6,6
6020,2,work,6,13,7
6020,3,home,13,22,9
6020,4,work,22,23,1
6020,5,home,23,24,1
6021,1,home,0,6,6
6021,2,work,6,13,7
6021,3,home,13,24,11
6022,1,home,0,7,7
6022,2,work,7,13,6
6022,3,shop,13,14,1
6022,4,home,14,24,10
6023,1,home,0,7,7
6023,2,work,7,14,7
6023,3,shop,14,15,1
6023,4,home,15,24,9
6024,1,home,0,6,6
6024,2,work,6,13,7
6024,3,shop,13,14,1
6024,4,home,14,24,10
6025,1,home,0,7,7
6025,2,education,7,11,4
6025,3,home,11,14,3
6025,4,education,14,16,2
6025,5,home,16,24,8
6026,1,home,0,6,6
6026,2,work,6,13,7
6026,3,home,13,17,4
6026,4,work,17,20,3
6026,5,home,20,24,4
6027,1,home,0,7,7
6027,2,work,7,14,7
6027,3,home,14,24,10
6028,1,home,0,7,7
6028,2,work,7,9,2
6028,3,home,9,14,5
6028,4,work,14,16,2
6028,5,home,16,22,6
6028,6,work,22,23,1
6028,7,home,23,24,1
6029,1,home,0,7,7
6029,2,work,7,13,6
6029,3,home,13,17,4
6029,4,work,17,19,2
6029,5,home,19,24,5
6030,1,home,0,6,6
6030,2,work,6,13,7
6030,3,shop,13,14,1
6030,4,home,14,24,10
6031,1,home,0,7,7
6031,2,shop,7,8,1
6031,3,home,8,13,5
6031,4,work,13,20,7
6031,5,home,20,24,4
6032,1,home,0,6,6
6032,2,shop,6,7,1
6032,3,home,7,10,3
6032,4,education,10,12,2
6032,5,shop,12,14,2
6032,6,education,14,16,2
6032,7,home,16,24,8
6033,1,home,0,6,6
6033,2,shop,6,7,1
6033,3,home,7,9,2
6033,4,education,9,11,2
6033,5,home,11,23,12
6033,6,work,23,24,1
6034,1,home,0,8,8
6034,2,work,8,15,7
6034,3,home,15,24,9
6035,1,home,0,7,7
6035,2,education,7,12,5
6035,3,shop,12,14,2
6035,4,home,14,24,10
6036,1,home,0,6,6
6036,2,shop,6,7,1
6036,3,home,7,13,6
6036,4,education,13,16,3
6036,5,home,16,20,4
6036,6,shop,20,21,1
6036,7,home,21,24,3
6037,1,home,0,7,7
6037,2,work,7,14,7
6037,3,home,14,24,10
6038,1,home,0,8,8
6038,2,work,8,15,7
6038,3,home,15,24,9
6039,1,home,0,8,8
6039,2,education,8,14,6
6039,3,home,14,16,2
6039,4,work,16,20,4
6039,5,home,20,24,4
6040,1,home,0,4,4
6040,2,work,4,12,8
6040,3,shop,12,13,1
6040,4,work,13,19,6
6040,5,home,19,24,5
6041,1,home,0,8,8
6041,2,work,8,15,7
6041,3,home,15,24,9
6042,1,home,0,6,6
6042,2,work,6,8,2
6042,3,home,8,12,4
6042,4,work,12,14,2
6042,5,shop,14,15,1
6042,6,work,15,17,2
6042,7,home,17,21,4
6042,8,work,21,22,1
6042,9,home,22,24,2
6043,1,home,0,6,6
6043,2,work,6,13,7
6043,3,home,13,24,11
6044,1,home,0,8,8
6044,2,education,8,11,3
6044,3,home,11,24,13
6045,1,home,0,6,6
6045,2,work,6,7,1
6045,3,home,7,10,3
6045,4,work,10,11,1
6045,5,home,11,12,1
6045,6,work,12,15,3
6045,7,home,15,22,7
6045,8,work,22,23,1
6045,9,home,23,24,1
6046,1,home,0,7,7
6046,2,work,7,14,7
6046,3,home,14,18,4
6046,4,shop,18,19,1
6046,5,home,19,23,4
6046,6,work,23,24,1
6047,1,home,0,6,6
6047,2,work,6,7,1
6047,3,home,7,11,4
6047,4,work,11,13,2
6047,5,home,13,19,6
6047,6,shop,19,20,1
6047,7,home,20,24,4
6048,1,home,0,8,8
6048,2,work,8,14,6
6048,3,shop,14,15,1
6048,4,work,15,19,4
6048,5,home,19,24,5
6049,1,home,0,6,6
6049,2,work,6,13,7
6049,3,home,13,17,4
6049,4,shop,17,18,1
6049,5,home,18,22,4
6049,6,work,22,23,1
6049,7,home,23,24,1
6050,1,home,0,6,6
6050,2,work,6,13,7
6050,3,shop,13,14,1
6050,4,work,14,20,6
6050,5,home,20,24,4
6051,1,home,0,8,8
6051,2,education,8,11,3
6051,3,home,11,19,8
6051,4,shop,19,20,1
6051,5,home,20,24,4
6052,1,home,0,6,6
6052,2,work,6,13,7
6052,3,home,13,24,11
6053,1,home,0,8,8
6053,2,work,8,15,7
6053,3,home,15,24,9
6054,1,home,0,6,6
6054,2,work,6,13,7
6054,3,home,13,24,11
6055,1,home,0,8,8
6055,2,work,8,15,7
6055,3,home,15,22,7
6055,4,work,22,23,1
6055,5,home,23,24,1
6056,1,home,0,6,6
6056,2,shop,6,8,2
6056,3,work,8,15,7
6056,4,home,15,24,9
6057,1,home,0,8,8
6057,2,work,8,14,6
6057,3,home,14,18,4
6057,4,shop,18,19,1
6057,5,home,19,24,5
6058,1,home,0,7,7
6058,2,work,7,14,7
6058,3,shop,14,15,1
6058,4,home,15,24,9
6059,1,home,0,8,8
6059,2,work,8,15,7
6059,3,home,15,24,9
6060,1,home,0,8,8
6060,2,work,8,15,7
6060,3,home,15,18,3
6060,4,work,18,20,2
6060,5,home,20,24,4
6061,1,home,0,7,7
6061,2,work,7,13,6
6061,3,shop,13,14,1
6061,4,work,14,19,5
6061,5,home,19,24,5
6062,1,home,0,6,6
6062,2,work,6,13,7
6062,3,home,13,24,11
6063,1,home,0,8,8
6063,2,work,8,15,7
6063,3,home,15,22,7
6063,4,work,22,23,1
6063,5,home,23,24,1
6064,1,home,0,6,6
6064,2,work,6,8,2
6064,3,home,8,14,6
6064,4,work,14,17,3
6064,5,home,17,23,6
6064,6,work,23,24,1
6065,1,home,0,7,7
6065,2,work,7,13,6
6065,3,shop,13,14,1
6065,4,work,14,20,6
6065,5,home,20,24,4
6066,1,home,0,7,7
6066,2,work,7,8,1
6066,3,home,8,13,5
6066,4,work,13,14,1
6066,5,home,14,21,7
6066,6,work,21,22,1
6066,7,home,22,24,2
6067,1,home,0,7,7
6067,2,work,7,14,7
6067,3,shop,14,15,1
6067,4,home,15,22,7
6067,5,work,22,23,1
6067,6,home,23,24,1
6068,1,home,0,6,6
6068,2,work,6,8,2
6068,3,home,8,13,5
6068,4,work,13,15,2
6068,5,home,15,22,7
6068,6,work,22,23,1
6068,7,home,23,24,1
6069,1,home,0,7,7
6069,2,work,7,13,6
6069,3,home,13,18,5
6069,4,shop,18,19,1
6069,5,home,19,24,5
6070,1,home,0,6,6
6070,2,work,6,13,7
6070,3,shop,13,14,1
6070,4,home,14,18,4
6070,5,work,18,20,2
6070,6,home,20,24,4
6071,1,home,0,8,8
6071,2,work,8,15,7
6071,3,home,15,24,9
6072,1,home,0,7,7
6072,2,work,7,14,7
6072,3,shop,14,15,1
6072,4,work,15,20,5
6072,5,home,20,24,4
6073,1,home,0,6,6
6073,2,shop,6,7,1
6073,3,home,7,10,3
6073,4,education,10,16,6
6073,5,shop,16,18,2
6073,6,home,18,24,6
6074,1,home,0,8,8
6074,2,work,8,16,8
6074,3,shop,16,17,1
6074,4,work,17,20,3
6074,5,home,20,24,4
6075,1,home,0,6,6
6075,2,work,6,7,1
6075,3,home,7,11,4
6075,4,work,11,13,2
6075,5,home,13,21,8
6075,6,work,21,22,1
6075,7,home,22,24,2
6076,1,home,0,6,6
6076,2,shop,6,7,1
6076,3,home,7,10,3
6076,4,education,10,14,4
6076,5,shop,14,15,1
6076,6,home,15,24,9
6077,1,home,0,6,6
6077,2,work,6,13,7
6077,3,home,13,24,11
6078,1,home,0,7,7
6078,2,shop,7,8,1
6078,3,home,8,12,4
6078,4,work,12,19,7
6078,5,home,19,24,5
6079,1,home,0,6,6
6079,2,work,6,13,7
6079,3,shop,13,14,1
6079,4,work,14,20,6
6079,5,home,20,24,4
6080,1,home,0,7,7
6080,2,work,7,13,6
6080,3,shop,13,14,1
6080,4,work,14,19,5
6080,5,home,19,24,5
6081,1,home,0,6,6
6081,2,work,6,13,7
6081,3,shop,13,14,1
6081,4,work,14,18,4
6081,5,home,18,24,6
6082,1,home,0,7,7
6082,2,shop,7,8,1
6082,3,education,8,11,3
6082,4,home,11,19,8
6082,5,shop,19,20,1
6082,6,home,20,24,4
6083,1,home,0,8,8
6083,2,education,8,11,3
6083,3,home,11,15,4
6083,4,work,15,20,5
6083,5,home,20,24,4
6084,1,home,0,9,9
6084,2,work,9,16,7
6084,3,home,16,21,5
6084,4,work,21,22,1
6084,5,home,22,24,2
6085,1,home,0,7,7
6085,2,work,7,14,7
6085,3,home,14,18,4
6085,4,shop,18,19,1
6085,5,home,19,24,5
6086,1,home,0,7,7
6086,2,work,7,13,6
6086,3,home,13,23,10
6086,4,work,23,24,1
6087,1,home,0,6,6
6087,2,work,6,7,1
6087,3,home,7,8,1
6087,4,work,8,10,2
6087,5,home,10,16,6
6087,6,work,16,18,2
6087,7,home,18,24,6
6088,1,home,0,6,6
6088,2,shop,6,7,1
6088,3,home,7,13,6
6088,4,education,13,16,3
6088,5,shop,16,17,1
6088,6,home,17,24,7
6089,1,home,0,8,8
6089,2,work,8,15,7
6089,3,home,15,24,9
6090,1,home,0,6,6
6090,2,work,6,8,2
6090,3,home,8,11,3
6090,4,work,11,13,2
6090,5,home,13,17,4
6090,6,work,17,19,2
6090,7,home,19,24,5
6091,1,home,0,9,9
6091,2,shop,9,10,1
6091,3,work,10,13,3
6091,4,home,13,24,11
6092,1,home,0,7,7
6092,2,shop,7,8,1
6092,3,home,8,14,6
6092,4,work,14,20,6
6092,5,home,20,23,3
6092,6,work,23,24,1
6093,1,home,0,7,7
6093,2,education,7,11,4
6093,3,home,11,19,8
6093,4,shop,19,21,2
6093,5,home,21,24,3
6094,1,home,0,7,7
6094,2,work,7,13,6
6094,3,home,13,23,10
6094,4,work,23,24,1
6095,1,home,0,7,7
6095,2,education,7,11,4
6095,3,home,11,17,6
6095,4,shop,17,19,2
6095,5,home,19,24,5
6096,1,home,0,8,8
6096,2,shop,8,10,2
6096,3,work,10,16,6
6096,4,home,16,24,8
6097,1,home,0,6,6
6097,2,work,6,13,7
6097,3,shop,13,14,1
6097,4,work,14,20,6
6097,5,home,20,24,4
6098,1,home,0,8,8
6098,2,work,8,16,8
6098,3,home,16,24,8
6099,1,home,0,8,8
6099,2,work,8,15,7
6099,3,home,15,24,9
6100,1,home,0,7,7
6100,2,work,7,13,6
6100,3,home,13,24,11
6101,1,home,0,7,7
6101,2,work,7,13,6
6101,3,shop,13,14,1
6101,4,work,14,20,6
6101,5,home,20,24,4
6102,1,home,0,6,6
6102,2,work,6,13,7
6102,3,home,13,17,4
6102,4,work,17,20,3
6102,5,home,20,24,4
6103,1,home,0,8,8
6103,2,education,8,12,4
6103,3,shop,12,14,2
6103,4,home,14,21,7
6103,5,shop,21,22,1
6103,6,home,22,24,2
6104,1,home,0,8,8
6104,2,work,8,15,7
6104,3,home,15,24,9
6105,1,home,0,7,7
6105,2,work,7,13,6
6105,3,home,13,16,3
6105,4,work,16,20,4
6105,5,home,20,24,4
6106,1,home,0,6,6
6106,2,shop,6,7,1
6106,3,home,7,9,2
6106,4,education,9,12,3
6106,5,home,12,20,8
6106,6,shop,20,21,1
6106,7,home,21,24,3
6107,1,home,0,7,7
6107,2,work,7,14,7
6107,3,home,14,24,10
6108,1,home,0,8,8
6108,2,education,8,11,3
6108,3,home,11,17,6
6108,4,shop,17,18,1
6108,5,home,18,24,6
6109,1,home,0,10,10
6109,2,work,10,17,7
6109,3,home,17,24,7
6110,1,home,0,7,7
6110,2,work,7,13,6
6110,3,shop,13,14,1
6110,4,home,14,24,10
6111,1,home,0,6,6
6111,2,shop,6,7,1
6111,3,work,7,14,7
6111,4,home,14,21,7
6111,5,work,21,22,1
6111,6,home,22,24,2
6112,1,home,0,7,7
6112,2,work,7,14,7
6112,3,home,14,24,10
6113,1,home,0,6,6
6113,2,work,6,8,2
6113,3,home,8,12,4
6113,4,work,12,14,2
6113,5,home,14,21,7
6113,6,work,21,22,1
6113,7,home,22,24,2
6114,1,home,0,6,6
6114,2,shop,6,7,1
6114,3,work,7,14,7
6114,4,shop,14,15,1
6114,5,home,15,21,6
6114,6,work,21,22,1
6114,7,home,22,24,2
6115,1,home,0,6,6
6115,2,work,6,8,2
6115,3,home,8,14,6
6115,4,work,14,17,3
6115,5,home,17,24,7
6116,1,home,0,8,8
6116,2,education,8,11,3
6116,3,home,11,17,6
6116,4,shop,17,18,1
6116,5,home,18,24,6
6117,1,home,0,8,8
6117,2,work,8,17,9
6117,3,home,17,24,7
6118,1,home,0,6,6
6118,2,shop,6,7,1
6118,3,home,7,10,3
6118,4,education,10,13,3
6118,5,shop,13,14,1
6118,6,education,14,16,2
6118,7,home,16,24,8
6119,1,home,0,8,8
6119,2,work,8,14,6
6119,3,shop,14,15,1
6119,4,home,15,24,9
6120,1,home,0,6,6
6120,2,work,6,8,2
6120,3,home,8,10,2
6120,4,work,10,11,1
6120,5,home,11,17,6
6120,6,work,17,19,2
6120,7,home,19,24,5
6121,1,home,0,6,6
6121,2,work,6,13,7
6121,3,home,13,19,6
6121,4,shop,19,20,1
6121,5,home,20,24,4
6122,1,home,0,8,8
6122,2,work,8,15,7
6122,3,home,15,24,9
6123,1,home,0,7,7
6123,2,work,7,14,7
6123,3,shop,14,15,1
6123,4,home,15,21,6
6123,5,work,21,22,1
6123,6,home,22,24,2
6124,1,home,0,6,6
6124,2,shop,6,7,1
6124,3,home,7,10,3
6124,4,education,10,12,2
6124,5,shop,12,14,2
6124,6,education,14,16,2
6124,7,shop,16,18,2
6124,8,home,18,24,6
6125,1,home,0,7,7
6125,2,work,7,13,6
6125,3,shop,13,14,1
6125,4,work,14,20,6
6125,5,home,20,24,4
6126,1,home,0,7,7
6126,2,work,7,14,7
6126,3,home,14,21,7
6126,4,work,21,22,1
6126,5,home,22,24,2
6127,1,home,0,7,7
6127,2,education,7,12,5
6127,3,home,12,16,4
6127,4,shop,16,17,1
6127,5,home,17,24,7
6128,1,home,0,6,6
6128,2,work,6,8,2
6128,3,home,8,14,6
6128,4,work,14,17,3
6128,5,home,17,23,6
6128,6,work,23,24,1
6129,1,home,0,6,6
6129,2,shop,6,7,1
6129,3,work,7,13,6
6129,4,home,13,24,11
6130,1,home,0,8,8
6130,2,work,8,14,6
6130,3,home,14,18,4
6130,4,work,18,20,2
6130,5,home,20,24,4
6131,1,home,0,7,7
6131,2,work,7,14,7
6131,3,shop,14,15,1
6131,4,home,15,22,7
6131,5,work,22,23,1
6131,6,home,23,24,1
6132,1,home,0,8,8
6132,2,shop,8,9,1
6132,3,home,9,14,5
6132,4,work,14,19,5
6132,5,education,19,20,1
6132,6,home,20,24,4
6133,1,home,0,6,6
6133,2,shop,6,7,1
6133,3,home,7,9,2
6133,4,education,9,12,3
6133,5,shop,12,14,2
6133,6,education,14,16,2
6133,7,home,16,24,8
6134,1,home,0,7,7
6134,2,shop,7,8,1
6134,3,education,8,11,3
6134,4,home,11,19,8
6134,5,shop,19,20,1
6134,6,home,20,24,4
6135,1,home,0,6,6
6135,2,shop,6,7,1
6135,3,home,7,11,4
6135,4,education,11,16,5
6135,5,home,16,24,8
6136,1,home,0,7,7
6136,2,work,7,13,6
6136,3,shop,13,14,1
6136,4,work,14,19,5
6136,5,home,19,24,5
6137,1,home,0,7,7
6137,2,education,7,10,3
6137,3,home,10,14,4
6137,4,education,14,16,2
6137,5,home,16,21,5
6137,6,shop,21,22,1
6137,7,home,22,24,2
6138,1,home,0,7,7
6138,2,work,7,14,7
6138,3,home,14,24,10
6139,1,home,0,6,6
6139,2,work,6,13,7
6139,3,home,13,24,11
6140,1,home,0,7,7
6140,2,work,7,14,7
6140,3,shop,14,15,1
6140,4,home,15,24,9
6141,1,home,0,6,6
6141,2,shop,6,7,1
6141,3,home,7,9,2
6141,4,education,9,12,3
6141,5,shop,12,13,1
6141,6,education,13,17,4
6141,7,home,17,24,7
6142,1,home,0,7,7
6142,2,work,7,15,8
6142,3,home,15,24,9
6143,1,home,0,6,6
6143,2,work,6,8,2
6143,3,home,8,14,6
6143,4,work,14,17,3
6143,5,home,17,23,6
6143,6,work,23,24,1
6144,1,home,0,8,8
6144,2,work,8,15,7
6144,3,home,15,21,6
6144,4,shop,21,22,1
6144,5,home,22,24,2
6145,1,home,0,7,7
6145,2,work,7,14,7
6145,3,shop,14,15,1
6145,4,home,15,24,9
6146,1,home,0,9,9
6146,2,work,9,16,7
6146,3,shop,16,17,1
6146,4,work,17,20,3
6146,5,home,20,24,4
6147,1,home,0,8,8
6147,2,education,8,12,4
6147,3,shop,12,13,1
6147,4,education,13,15,2
6147,5,shop,15,16,1
6147,6,home,16,24,8
6148,1,home,0,8,8
6148,2,work,8,13,5
6148,3,shop,13,14,1
6148,4,home,14,21,7
6148,5,shop,21,22,1
6148,6,home,22,24,2
6149,1,home,0,8,8
6149,2,education,8,11,3
6149,3,home,11,18,7
6149,4,shop,18,19,1
6149,5,home,19,24,5
6150,1,home,0,7,7
6150,2,work,7,14,7
6150,3,home,14,24,10
6151,1,home,0,6,6
6151,2,work,6,12,6
6151,3,shop,12,13,1
6151,4,work,13,19,6
6151,5,home,19,24,5
6152,1,home,0,8,8
6152,2,work,8,15,7
6152,3,home,15,24,9
6153,1,home,0,9,9
6153,2,education,9,12,3
6153,3,shop,12,13,1
6153,4,work,13,19,6
6153,5,education,19,20,1
6153,6,home,20,24,4
6154,1,home,0,7,7
6154,2,education,7,12,5
6154,3,shop,12,13,1
6154,4,home,13,17,4
6154,5,shop,17,18,1
6154,6,home,18,24,6
6155,1,home,0,9,9
6155,2,work,9,16,7
6155,3,home,16,24,8
6156,1,home,0,7,7
6156,2,work,7,14,7
6156,3,shop,14,15,1
6156,4,work,15,20,5
6156,5,home,20,24,4
6157,1,home,0,8,8
6157,2,education,8,11,3
6157,3,home,11,18,7
6157,4,shop,18,19,1
6157,5,home,19,24,5
6158,1,home,0,6,6
6158,2,shop,6,7,1
6158,3,home,7,13,6
6158,4,education,13,16,3
6158,5,shop,16,17,1
6158,6,home,17,24,7
6159,1,home,0,7,7
6159,2,work,7,13,6
6159,3,home,13,24,11
6160,1,home,0,6,6
6160,2,work,6,13,7
6160,3,home,13,21,8
6160,4,shop,21,22,1
6160,5,home,22,24,2
6161,1,home,0,6,6
6161,2,shop,6,7,1
6161,3,work,7,14,7
6161,4,home,14,24,10
6162,1,home,0,7,7
6162,2,shop,7,8,1
6162,3,home,8,22,14
6162,4,work,22,23,1
6162,5,home,23,24,1
6163,1,home,0,7,7
6163,2,work,7,14,7
6163,3,shop,14,15,1
6163,4,work,15,20,5
6163,5,home,20,24,4
6164,1,home,0,9,9
6164,2,work,9,16,7
6164,3,home,16,23,7
6164,4,work,23,24,1
6165,1,home,0,8,8
6165,2,work,8,17,9
6165,3,home,17,24,7
6166,1,home,0,6,6
6166,2,work,6,13,7
6166,3,home,13,16,3
6166,4,work,16,20,4
6166,5,home,20,24,4
6167,1,home,0,8,8
6167,2,work,8,14,6
6167,3,shop,14,15,1
6167,4,home,15,24,9
6168,1,home,0,6,6
6168,2,work,6,13,7
6168,3,home,13,24,11
6169,1,home,0,6,6
6169,2,shop,6,7,1
6169,3,home,7,10,3
6169,4,education,10,16,6
6169,5,shop,16,17,1
6169,6,home,17,24,7
6170,1,home,0,6,6
6170,2,shop,6,7,1
6170,3,work,7,14,7
6170,4,home,14,24,10
6171,1,home,0,6,6
6171,2,work,6,7,1
6171,3,home,7,13,6
6171,4,work,13,15,2
6171,5,home,15,18,3
6171,6,work,18,19,1
6171,7,home,19,24,5
6172,1,home,0,8,8
6172,2,work,8,15,7
6172,3,shop,15,16,1
6172,4,work,16,20,4
6172,5,home,20,24,4
6173,1,home,0,6,6
6173,2,work,6,13,7
6173,3,shop,13,14,1
6173,4,work,14,19,5
6173,5,home,19,24,5
6174,1,home,0,7,7
6174,2,work,7,13,6
6174,3,home,13,24,11
6175,1,home,0,7,7
6175,2,work,7,13,6
6175,3,shop,13,14,1
6175,4,work,14,20,6
6175,5,home,20,24,4
6176,1,home,0,8,8
6176,2,work,8,15,7
6176,3,home,15,24,9
6177,1,home,0,7,7
6177,2,education,7,13,6
6177,3,shop,13,15,2
6177,4,home,15,20,5
6177,5,shop,20,21,1
6177,6,home,21,24,3
6178,1,home,0,7,7
6178,2,work,7,14,7
6178,3,home,14,18,4
6178,4,shop,18,19,1
6178,5,home,19,24,5
6179,1,home,0,7,7
6179,2,work,7,14,7
6179,3,shop,14,15,1
6179,4,home,15,24,9
6180,1,home,0,7,7
6180,2,work,7,14,7
6180,3,shop,14,15,1
6180,4,work,15,20,5
6180,5,home,20,24,4
6181,1,home,0,8,8
6181,2,work,8,15,7
6181,3,home,15,24,9
6182,1,home,0,8,8
6182,2,work,8,14,6
6182,3,home,14,18,4
6182,4,work,18,20,2
6182,5,home,20,24,4
6183,1,home,0,7,7
6183,2,work,7,14,7
6183,3,home,14,24,10
6184,1,home,0,8,8
6184,2,work,8,15,7
6184,3,home,15,24,9
6185,1,home,0,7,7
6185,2,work,7,13,6
6185,3,home,13,24,11
6186,1,home,0,7,7
6186,2,work,7,9,2
6186,3,home,9,14,5
6186,4,work,14,17,3
6186,5,home,17,23,6
6186,6,work,23,24,1
6187,1,home,0,8,8
6187,2,education,8,11,3
6187,3,home,11,17,6
6187,4,shop,17,18,1
6187,5,home,18,24,6
6188,1,home,0,8,8
6188,2,work,8,14,6
6188,3,home,14,24,10
6189,1,home,0,8,8
6189,2,education,8,11,3
6189,3,home,11,18,7
6189,4,shop,18,19,1
6189,5,home,19,24,5
6190,1,home,0,6,6
6190,2,work,6,13,7
6190,3,home,13,17,4
6190,4,work,17,19,2
6190,5,home,19,24,5
6191,1,home,0,6,6
6191,2,work,6,13,7
6191,3,home,13,17,4
6191,4,work,17,20,3
6191,5,home,20,24,4
6192,1,home,0,8,8
6192,2,work,8,17,9
6192,3,home,17,21,4
6192,4,shop,21,22,1
6192,5,home,22,24,2
6193,1,home,0,7,7
6193,2,education,7,11,4
6193,3,home,11,17,6
6193,4,shop,17,18,1
6193,5,home,18,24,6
6194,1,home,0,7,7
6194,2,education,7,11,4
6194,3,home,11,21,10
6194,4,shop,21,22,1
6194,5,home,22,24,2
6195,1,home,0,7,7
6195,2,work,7,13,6
6195,3,shop,13,14,1
6195,4,home,14,18,4
6195,5,work,18,20,2
6195,6,home,20,24,4
6196,1,home,0,8,8
6196,2,work,8,15,7
6196,3,home,15,24,9
6197,1,home,0,7,7
6197,2,shop,7,9,2
6197,3,work,9,17,8
6197,4,home,17,21,4
6197,5,work,21,22,1
6197,6,home,22,24,2
6198,1,home,0,8,8
6198,2,work,8,14,6
6198,3,shop,14,15,1
6198,4,home,15,24,9
6199,1,work,0,1,1
6199,2,home,1,7,6
6199,3,shop,7,8,1
6199,4,education,8,11,3
6199,5,home,11,18,7
6199,6,shop,18,19,1
6199,7,home,19,24,5
6200,1,home,0,6,6
6200,2,work,6,12,6
6200,3,shop,12,13,1
6200,4,work,13,19,6
6200,5,home,19,24,5
6201,1,home,0,8,8
6201,2,work,8,15,7
6201,3,shop,15,16,1
6201,4,home,16,24,8
6202,1,home,0,6,6
6202,2,work,6,8,2
6202,3,home,8,12,4
6202,4,shop,12,13,1
6202,5,work,13,15,2
6202,6,home,15,21,6
6202,7,work,21,22,1
6202,8,home,22,24,2
6203,1,home,0,7,7
6203,2,education,7,11,4
6203,3,home,11,20,9
6203,4,shop,20,21,1
6203,5,home,21,24,3
6204,1,home,0,7,7
6204,2,work,7,13,6
6204,3,home,13,19,6
6204,4,shop,19,20,1
6204,5,home,20,24,4
6205,1,home,0,7,7
6205,2,work,7,14,7
6205,3,shop,14,15,1
6205,4,home,15,24,9
6206,1,home,0,6,6
6206,2,work,6,13,7
6206,3,home,13,24,11
6207,1,home,0,6,6
6207,2,shop,6,7,1
6207,3,home,7,9,2
6207,4,education,9,15,6
6207,5,shop,15,17,2
6207,6,home,17,24,7
6208,1,home,0,7,7
6208,2,education,7,13,6
6208,3,shop,13,15,2
6208,4,home,15,21,6
6208,5,shop,21,22,1
6208,6,home,22,24,2
6209,1,home,0,6,6
6209,2,shop,6,7,1
6209,3,home,7,9,2
6209,4,education,9,13,4
6209,5,shop,13,15,2
6209,6,home,15,24,9
6210,1,home,0,7,7
6210,2,work,7,14,7
6210,3,home,14,24,10
6211,1,home,0,6,6
6211,2,work,6,13,7
6211,3,home,13,17,4
6211,4,work,17,20,3
6211,5,home,20,24,4
6212,1,home,0,7,7
6212,2,work,7,9,2
6212,3,home,9,16,7
6212,4,work,16,18,2
6212,5,home,18,24,6
6213,1,home,0,6,6
6213,2,shop,6,7,1
6213,3,home,7,13,6
6213,4,education,13,15,2
6213,5,shop,15,16,1
6213,6,home,16,24,8
6214,1,home,0,9,9
6214,2,work,9,16,7
6214,3,home,16,24,8
6215,1,home,0,8,8
6215,2,work,8,15,7
6215,3,home,15,24,9
6216,1,home,0,6,6
6216,2,shop,6,7,1
6216,3,home,7,9,2
6216,4,education,9,12,3
6216,5,home,12,19,7
6216,6,shop,19,21,2
6216,7,home,21,24,3
6217,1,home,0,8,8
6217,2,work,8,15,7
6217,3,home,15,19,4
6217,4,shop,19,20,1
6217,5,home,20,24,4
6218,1,home,0,6,6
6218,2,work,6,13,7
6218,3,shop,13,14,1
6218,4,home,14,22,8
6218,5,work,22,23,1
6218,6,home,23,24,1
6219,1,home,0,7,7
6219,2,education,7,15,8
6219,3,shop,15,16,1
6219,4,home,16,21,5
6219,5,shop,21,22,1
6219,6,home,22,24,2
6220,1,home,0,6,6
6220,2,work,6,8,2
6220,3,home,8,14,6
6220,4,work,14,16,2
6220,5,home,16,22,6
6220,6,work,22,23,1
6220,7,home,23,24,1
6221,1,home,0,7,7
6221,2,work,7,13,6
6221,3,home,13,17,4
6221,4,work,17,20,3
6221,5,home,20,24,4
6222,1,home,0,8,8
6222,2,work,8,15,7
6222,3,home,15,24,9
6223,1,home,0,9,9
6223,2,education,9,12,3
6223,3,shop,12,13,1
6223,4,work,13,19,6
6223,5,home,19,24,5
6224,1,home,0,6,6
6224,2,work,6,13,7
6224,3,home,13,18,5
6224,4,shop,18,19,1
6224,5,home,19,24,5
6225,1,home,0,7,7
6225,2,work,7,13,6
6225,3,home,13,19,6
6225,4,shop,19,20,1
6225,5,home,20,24,4
6226,1,home,0,7,7
6226,2,work,7,14,7
6226,3,home,14,24,10
6227,1,home,0,7,7
6227,2,work,7,13,6
6227,3,home,13,22,9
6227,4,work,22,23,1
6227,5,home,23,24,1
6228,1,home,0,9,9
6228,2,work,9,16,7
6228,3,home,16,24,8
6229,1,home,0,8,8
6229,2,shop,8,9,1
6229,3,work,9,15,6
6229,4,home,15,24,9
6230,1,home,0,7,7
6230,2,work,7,9,2
6230,3,home,9,13,4
6230,4,work,13,17,4
6230,5,home,17,24,7
6231,1,home,0,6,6
6231,2,work,6,8,2
6231,3,home,8,12,4
6231,4,work,12,14,2
6231,5,home,14,17,3
6231,6,work,17,19,2
6231,7,home,19,24,5
6232,1,home,0,7,7
6232,2,work,7,9,2
6232,3,home,9,12,3
6232,4,work,12,14,2
6232,5,shop,14,15,1
6232,6,work,15,18,3
6232,7,home,18,24,6
6233,1,home,0,8,8
6233,2,work,8,15,7
6233,3,home,15,21,6
6233,4,work,21,22,1
6233,5,home,22,24,2
6234,1,home,0,7,7
6234,2,shop,7,8,1
6234,3,home,8,13,5
6234,4,work,13,19,6
6234,5,home,19,24,5
6235,1,home,0,7,7
6235,2,work,7,13,6
6235,3,home,13,21,8
6235,4,work,21,22,1
6235,5,home,22,24,2
6236,1,home,0,8,8
6236,2,work,8,16,8
6236,3,home,16,24,8
6237,1,home,0,6,6
6237,2,work,6,13,7
6237,3,home,13,18,5
6237,4,work,18,20,2
6237,5,home,20,24,4
6238,1,home,0,6,6
6238,2,shop,6,7,1
6238,3,home,7,13,6
6238,4,education,13,16,3
6238,5,home,16,24,8
6239,1,home,0,8,8
6239,2,work,8,14,6
6239,3,home,14,18,4
6239,4,work,18,19,1
6239,5,education,19,20,1
6239,6,home,20,24,4
6240,1,home,0,7,7
6240,2,work,7,9,2
6240,3,home,9,13,4
6240,4,work,13,17,4
6240,5,home,17,23,6
6240,6,work,23,24,1
6241,1,home,0,8,8
6241,2,education,8,11,3
6241,3,home,11,23,12
6241,4,work,23,24,1
6242,1,home,0,6,6
6242,2,work,6,12,6
6242,3,shop,12,13,1
6242,4,work,13,19,6
6242,5,home,19,24,5
6243,1,home,0,6,6
6243,2,work,6,13,7
6243,3,home,13,17,4
6243,4,work,17,20,3
6243,5,home,20,24,4
6244,1,home,0,7,7
6244,2,work,7,14,7
6244,3,home,14,21,7
6244,4,work,21,22,1
6244,5,home,22,24,2
6245,1,home,0,6,6
6245,2,work,6,13,7
6245,3,home,13,16,3
6245,4,work,16,20,4
6245,5,home,20,24,4
6246,1,home,0,8,8
6246,2,work,8,14,6
6246,3,home,14,24,10
6247,1,home,0,9,9
6247,2,shop,9,10,1
6247,3,work,10,17,7
6247,4,home,17,24,7
6248,1,home,0,6,6
6248,2,shop,6,7,1
6248,3,work,7,14,7
6248,4,home,14,24,10
6249,1,home,0,8,8
6249,2,work,8,15,7
6249,3,home,15,24,9
6250,1,home,0,8,8
6250,2,work,8,16,8
6250,3,shop,16,17,1
6250,4,home,17,24,7
6251,1,home,0,8,8
6251,2,work,8,14,6
6251,3,shop,14,15,1
6251,4,work,15,20,5
6251,5,home,20,24,4
6252,1,home,0,6,6
6252,2,shop,6,7,1
6252,3,home,7,10,3
6252,4,education,10,12,2
6252,5,home,12,19,7
6252,6,shop,19,20,1
6252,7,home,20,24,4
6253,1,home,0,6,6
6253,2,work,6,13,7
6253,3,home,13,24,11
6254,1,home,0,6,6
6254,2,shop,6,7,1
6254,3,home,7,11,4
6254,4,work,11,13,2
6254,5,home,13,24,11
6255,1,home,0,8,8
6255,2,work,8,15,7
6255,3,shop,15,16,1
6255,4,work,16,20,4
6255,5,home,20,24,4
6256,1,home,0,7,7
6256,2,work,7,13,6
6256,3,home,13,17,4
6256,4,shop,17,18,1
6256,5,home,18,24,6
6257,1,home,0,8,8
6257,2,work,8,16,8
6257,3,home,16,24,8
6258,1,home,0,7,7
6258,2,shop,7,8,1
6258,3,education,8,12,4
6258,4,home,12,19,7
6258,5,shop,19,20,1
6258,6,home,20,24,4
6259,1,home,0,7,7
6259,2,work,7,16,9
6259,3,home,16,24,8
6260,1,home,0,7,7
6260,2,work,7,14,7
6260,3,shop,14,15,1
6260,4,work,15,20,5
6260,5,home,20,24,4
6261,1,home,0,7,7
6261,2,education,7,11,4
6261,3,home,11,19,8
6261,4,shop,19,20,1
6261,5,home,20,24,4
6262,1,home,0,7,7
6262,2,shop,7,8,1
6262,3,work,8,15,7
6262,4,home,15,22,7
6262,5,work,22,23,1
6262,6,home,23,24,1
6263,1,work,0,7,7
6263,2,shop,7,8,1
6263,3,work,8,15,7
6263,4,home,15,24,9
6264,1,home,0,6,6
6264,2,shop,6,7,1
6264,3,home,7,10,3
6264,4,education,10,16,6
6264,5,home,16,24,8
6265,1,home,0,6,6
6265,2,shop,6,7,1
6265,3,home,7,13,6
6265,4,education,13,16,3
6265,5,shop,16,17,1
6265,6,home,17,24,7
6266,1,home,0,6,6
6266,2,work,6,12,6
6266,3,shop,12,13,1
6266,4,work,13,15,2
6266,5,home,15,24,9
6267,1,home,0,7,7
6267,2,work,7,9,2
6267,3,home,9,13,4
6267,4,work,13,15,2
6267,5,home,15,21,6
6267,6,work,21,22,1
6267,7,home,22,24,2
6268,1,home,0,6,6
6268,2,shop,6,7,1
6268,3,home,7,9,2
6268,4,work,9,16,7
6268,5,home,16,21,5
6268,6,work,21,22,1
6268,7,home,22,24,2
6269,1,home,0,9,9
6269,2,work,9,16,7
6269,3,home,16,24,8
6270,1,home,0,7,7
6270,2,education,7,11,4
6270,3,home,11,18,7
6270,4,shop,18,19,1
6270,5,home,19,24,5
6271,1,home,0,7,7
6271,2,work,7,13,6
6271,3,shop,13,14,1
6271,4,work,14,19,5
6271,5,home,19,24,5
6272,1,home,0,6,6
6272,2,shop,6,7,1
6272,3,home,7,13,6
6272,4,education,13,16,3
6272,5,shop,16,17,1
6272,6,home,17,24,7
6273,1,home,0,7,7
6273,2,shop,7,8,1
6273,3,home,8,21,13
6273,4,work,21,22,1
6273,5,home,22,24,2
6274,1,home,0,7,7
6274,2,work,7,14,7
6274,3,shop,14,15,1
6274,4,home,15,24,9
6275,1,home,0,6,6
6275,2,work,6,13,7
6275,3,shop,13,14,1
6275,4,home,14,21,7
6275,5,work,21,22,1
6275,6,home,22,24,2
6276,1,home,0,6,6
6276,2,shop,6,7,1
6276,3,home,7,9,2
6276,4,education,9,11,2
6276,5,home,11,19,8
6276,6,shop,19,20,1
6276,7,home,20,24,4
6277,1,home,0,7,7
6277,2,work,7,13,6
6277,3,shop,13,14,1
6277,4,home,14,24,10
6278,1,home,0,6,6
6278,2,shop,6,7,1
6278,3,work,7,13,6
6278,4,home,13,24,11
6279,1,home,0,7,7
6279,2,education,7,10,3
6279,3,home,10,17,7
6279,4,shop,17,18,1
6279,5,home,18,24,6
6280,1,home,0,6,6
6280,2,work,6,14,8
6280,3,shop,14,15,1
6280,4,home,15,24,9
6281,1,home,0,7,7
6281,2,work,7,14,7
6281,3,shop,14,15,1
6281,4,home,15,21,6
6281,5,work,21,22,1
6281,6,home,22,24,2
6282,1,home,0,7,7
6282,2,education,7,11,4
6282,3,home,11,13,2
6282,4,education,13,16,3
6282,5,home,16,21,5
6282,6,shop,21,22,1
6282,7,home,22,24,2
6283,1,home,0,7,7
6283,2,education,7,11,4
6283,3,home,11,14,3
6283,4,education,14,16,2
6283,5,home,16,21,5
6283,6,shop,21,22,1
6283,7,home,22,24,2
6284,1,home,0,7,7
6284,2,work,7,14,7
6284,3,home,14,24,10
6285,1,home,0,6,6
6285,2,shop,6,7,1
6285,3,home,7,13,6
6285,4,education,13,16,3
6285,5,home,16,22,6
6285,6,work,22,23,1
6285,7,home,23,24,1
6286,1,home,0,7,7
6286,2,work,7,13,6
6286,3,home,13,16,3
6286,4,work,16,20,4
6286,5,home,20,24,4
6287,1,home,0,6,6
6287,2,work,6,7,1
6287,3,home,7,11,4
6287,4,work,11,14,3
6287,5,home,14,21,7
6287,6,work,21,22,1
6287,7,home,22,24,2
6288,1,home,0,8,8
6288,2,work,8,13,5
6288,3,shop,13,15,2
6288,4,work,15,20,5
6288,5,home,20,24,4
6289,1,home,0,8,8
6289,2,work,8,14,6
6289,3,shop,14,15,1
6289,4,home,15,24,9
6290,1,home,0,8,8
6290,2,work,8,15,7
6290,3,home,15,21,6
6290,4,work,21,22,1
6290,5,home,22,24,2
6291,1,home,0,6,6
6291,2,work,6,7,1
6291,3,home,7,9,2
6291,4,work,9,11,2
6291,5,shop,11,12,1
6291,6,work,12,15,3
6291,7,home,15,21,6
6291,8,work,21,22,1
6291,9,home,22,24,2
6292,1,home,0,7,7
6292,2,education,7,11,4
6292,3,home,11,19,8
6292,4,shop,19,20,1
6292,5,home,20,24,4
6293,1,home,0,7,7
6293,2,education,7,11,4
6293,3,home,11,18,7
6293,4,shop,18,19,1
6293,5,home,19,24,5
6294,1,home,0,8,8
6294,2,education,8,12,4
6294,3,shop,12,14,2
6294,4,home,14,21,7
6294,5,shop,21,22,1
6294,6,home,22,24,2
6295,1,home,0,8,8
6295,2,work,8,14,6
6295,3,home,14,24,10
6296,1,home,0,7,7
6296,2,work,7,13,6
6296,3,home,13,17,4
6296,4,work,17,20,3
6296,5,home,20,24,4
6297,1,home,0,7,7
6297,2,work,7,14,7
6297,3,home,14,24,10
6298,1,home,0,7,7
6298,2,shop,7,9,2
6298,3,education,9,12,3
6298,4,home,12,17,5
6298,5,shop,17,18,1
6298,6,home,18,24,6
6299,1,home,0,6,6
6299,2,work,6,12,6
6299,3,shop,12,13,1
6299,4,work,13,19,6
6299,5,home,19,24,5
6300,1,home,0,8,8
6300,2,work,8,15,7
6300,3,home,15,21,6
6300,4,work,21,22,1
6300,5,home,22,24,2
6301,1,home,0,7,7
6301,2,shop,7,8,1
6301,3,education,8,11,3
6301,4,home,11,18,7
6301,5,shop,18,20,2
6301,6,home,20,24,4
6302,1,home,0,7,7
6302,2,shop,7,8,1
6302,3,education,8,11,3
6302,4,home,11,19,8
6302,5,shop,19,20,1
6302,6,home,20,24,4
6303,1,home,0,6,6
6303,2,work,6,13,7
6303,3,shop,13,14,1
6303,4,work,14,19,5
6303,5,home,19,24,5
6304,1,home,0,9,9
6304,2,work,9,14,5
6304,3,home,14,24,10
6305,1,home,0,7,7
6305,2,education,7,10,3
6305,3,home,10,16,6
6305,4,shop,16,18,2
6305,5,home,18,24,6
6306,1,home,0,9,9
6306,2,work,9,15,6
6306,3,home,15,23,8
6306,4,work,23,24,1
6307,1,home,0,8,8
6307,2,work,8,15,7
6307,3,home,15,20,5
6307,4,shop,20,21,1
6307,5,home,21,24,3
6308,1,home,0,8,8
6308,2,education,8,11,3
6308,3,home,11,23,12
6308,4,work,23,24,1
6309,1,home,0,6,6
6309,2,work,6,13,7
6309,3,shop,13,14,1
6309,4,home,14,18,4
6309,5,work,18,20,2
6309,6,home,20,24,4
6310,1,home,0,7,7
6310,2,work,7,13,6
6310,3,home,13,21,8
6310,4,shop,21,22,1
6310,5,home,22,24,2
6311,1,home,0,7,7
6311,2,work,7,9,2
6311,3,home,9,15,6
6311,4,work,15,17,2
6311,5,home,17,24,7
6312,1,home,0,8,8
6312,2,work,8,15,7
6312,3,home,15,21,6
6312,4,work,21,22,1
6312,5,home,22,24,2
6313,1,home,0,6,6
6313,2,shop,6,7,1
6313,3,home,7,13,6
6313,4,education,13,17,4
6313,5,shop,17,18,1
6313,6,home,18,24,6
6314,1,home,0,6,6
6314,2,work,6,14,8
6314,3,home,14,19,5
6314,4,shop,19,20,1
6314,5,home,20,21,1
6314,6,work,21,22,1
6314,7,home,22,24,2
6315,1,home,0,7,7
6315,2,work,7,14,7
6315,3,home,14,16,2
6315,4,work,16,20,4
6315,5,home,20,24,4
6316,1,home,0,7,7
6316,2,shop,7,8,1
6316,3,work,8,14,6
6316,4,home,14,24,10
6317,1,home,0,8,8
6317,2,education,8,12,4
6317,3,shop,12,14,2
6317,4,home,14,21,7
6317,5,shop,21,22,1
6317,6,home,22,24,2
6318,1,home,0,7,7
6318,2,work,7,13,6
6318,3,home,13,19,6
6318,4,shop,19,20,1
6318,5,home,20,24,4
6319,1,home,0,7,7
6319,2,education,7,11,4
6319,3,home,11,18,7
6319,4,shop,18,19,1
6319,5,home,19,24,5
6320,1,home,0,8,8
6320,2,education,8,14,6
6320,3,shop,14,15,1
6320,4,home,15,24,9
6321,1,home,0,7,7
6321,2,work,7,13,6
6321,3,shop,13,14,1
6321,4,home,14,24,10
6322,1,home,0,7,7
6322,2,work,7,14,7
6322,3,home,14,17,3
6322,4,work,17,20,3
6322,5,home,20,24,4
6323,1,home,0,8,8
6323,2,education,8,11,3
6323,3,home,11,17,6
6323,4,shop,17,18,1
6323,5,home,18,24,6
6324,1,home,0,6,6
6324,2,work,6,13,7
6324,3,home,13,24,11
6325,1,home,0,6,6
6325,2,work,6,8,2
6325,3,home,8,13,5
6325,4,shop,13,14,1
6325,5,home,14,22,8
6325,6,work,22,23,1
6325,7,home,23,24,1
6326,1,home,0,7,7
6326,2,work,7,14,7
6326,3,shop,14,15,1
6326,4,work,15,20,5
6326,5,home,20,24,4
6327,1,home,0,7,7
6327,2,shop,7,8,1
6327,3,work,8,15,7
6327,4,home,15,24,9
6328,1,home,0,8,8
6328,2,work,8,14,6
6328,3,home,14,21,7
6328,4,work,21,22,1
6328,5,home,22,24,2
6329,1,home,0,7,7
6329,2,work,7,14,7
6329,3,home,14,19,5
6329,4,shop,19,20,1
6329,5,home,20,24,4
6330,1,home,0,7,7
6330,2,shop,7,8,1
6330,3,home,8,17,9
6330,4,work,17,20,3
6330,5,home,20,24,4
6331,1,home,0,7,7
6331,2,work,7,13,6
6331,3,home,13,17,4
6331,4,work,17,20,3
6331,5,home,20,24,4
6332,1,home,0,8,8
6332,2,work,8,14,6
6332,3,home,14,24,10
6333,1,home,0,8,8
6333,2,education,8,12,4
6333,3,shop,12,14,2
6333,4,home,14,24,10
6334,1,home,0,7,7
6334,2,work,7,13,6
6334,3,home,13,21,8
6334,4,work,21,22,1
6334,5,home,22,24,2
6335,1,home,0,6,6
6335,2,work,6,12,6
6335,3,shop,12,13,1
6335,4,work,13,19,6
6335,5,home,19,24,5
6336,1,home,0,8,8
6336,2,work,8,15,7
6336,3,home,15,24,9
6337,1,home,0,6,6
6337,2,work,6,13,7
6337,3,home,13,17,4
6337,4,work,17,20,3
6337,5,home,20,24,4
6338,1,home,0,7,7
6338,2,work,7,14,7
6338,3,home,14,20,6
6338,4,shop,20,21,1
6338,5,home,21,24,3
6339,1,home,0,8,8
6339,2,work,8,15,7
6339,3,shop,15,16,1
6339,4,home,16,24,8
6340,1,home,0,7,7
6340,2,education,7,12,5
6340,3,shop,12,14,2
6340,4,education,14,16,2
6340,5,home,16,21,5
6340,6,shop,21,22,1
6340,7,home,22,24,2
6341,1,home,0,8,8
6341,2,work,8,15,7
6341,3,home,15,24,9
6342,1,home,0,8,8
6342,2,education,8,11,3
6342,3,home,11,17,6
6342,4,shop,17,18,1
6342,5,home,18,24,6
6343,1,home,0,8,8
6343,2,education,8,14,6
6343,3,shop,14,15,1
6343,4,home,15,21,6
6343,5,shop,21,22,1
6343,6,home,22,24,2
6344,1,home,0,7,7
6344,2,work,7,14,7
6344,3,home,14,22,8
6344,4,work,22,23,1
6344,5,home,23,24,1
6345,1,home,0,7,7
6345,2,work,7,14,7
6345,3,shop,14,15,1
6345,4,home,15,24,9
6346,1,home,0,7,7
6346,2,work,7,13,6
6346,3,home,13,24,11
6347,1,home,0,6,6
6347,2,work,6,13,7
6347,3,home,13,21,8
6347,4,shop,21,22,1
6347,5,home,22,24,2
6348,1,home,0,6,6
6348,2,work,6,8,2
6348,3,home,8,12,4
6348,4,work,12,13,1
6348,5,shop,13,14,1
6348,6,work,14,17,3
6348,7,home,17,24,7
6349,1,home,0,6,6
6349,2,work,6,13,7
6349,3,shop,13,14,1
6349,4,work,14,20,6
6349,5,home,20,24,4
6350,1,home,0,6,6
6350,2,work,6,13,7
6350,3,shop,13,14,1
6350,4,home,14,22,8
6350,5,work,22,23,1
6350,6,home,23,24,1
6351,1,home,0,7,7
6351,2,work,7,9,2
6351,3,home,9,13,4
6351,4,work,13,15,2
6351,5,home,15,21,6
6351,6,work,21,22,1
6351,7,home,22,24,2
6352,1,home,0,7,7
6352,2,education,7,11,4
6352,3,home,11,19,8
6352,4,shop,19,20,1
6352,5,home,20,24,4
6353,1,home,0,8,8
6353,2,work,8,14,6
6353,3,home,14,17,3
6353,4,shop,17,18,1
6353,5,work,18,20,2
6353,6,home,20,24,4
6354,1,home,0,8,8
6354,2,work,8,15,7
6354,3,home,15,19,4
6354,4,shop,19,20,1
6354,5,home,20,24,4
6355,1,home,0,6,6
6355,2,work,6,13,7
6355,3,home,13,16,3
6355,4,work,16,20,4
6355,5,home,20,24,4
6356,1,home,0,7,7
6356,2,education,7,12,5
6356,3,shop,12,13,1
6356,4,education,13,16,3
6356,5,shop,16,17,1
6356,6,home,17,24,7
6357,1,home,0,6,6
6357,2,shop,6,7,1
6357,3,home,7,11,4
6357,4,work,11,17,6
6357,5,home,17,24,7
6358,1,home,0,7,7
6358,2,education,7,11,4
6358,3,home,11,19,8
6358,4,shop,19,20,1
6358,5,home,20,24,4
6359,1,home,0,7,7
6359,2,work,7,14,7
6359,3,shop,14,15,1
6359,4,work,15,20,5
6359,5,home,20,24,4
6360,1,home,0,7,7
6360,2,work,7,13,6
6360,3,home,13,17,4
6360,4,work,17,20,3
6360,5,home,20,24,4
6361,1,home,0,8,8
6361,2,work,8,13,5
6361,3,home,13,24,11
6362,1,home,0,7,7
6362,2,education,7,12,5
6362,3,shop,12,14,2
6362,4,home,14,21,7
6362,5,shop,21,22,1
6362,6,home,22,24,2
6363,1,home,0,7,7
6363,2,work,7,13,6
6363,3,shop,13,14,1
6363,4,home,14,24,10
6364,1,home,0,7,7
6364,2,education,7,11,4
6364,3,home,11,18,7
6364,4,shop,18,19,1
6364,5,home,19,24,5
6365,1,home,0,8,8
6365,2,work,8,15,7
6365,3,home,15,24,9
6366,1,home,0,6,6
6366,2,work,6,9,3
6366,3,home,9,16,7
6366,4,work,16,18,2
6366,5,home,18,24,6
6367,1,home,0,6,6
6367,2,work,6,13,7
6367,3,home,13,24,11
6368,1,home,0,6,6
6368,2,shop,6,7,1
6368,3,home,7,13,6
6368,4,education,13,14,1
6368,5,shop,14,15,1
6368,6,home,15,19,4
6368,7,shop,19,20,1
6368,8,home,20,24,4
6369,1,home,0,6,6
6369,2,work,6,8,2
6369,3,home,8,15,7
6369,4,work,15,17,2
6369,5,home,17,24,7
6370,1,home,0,4,4
6370,2,work,4,13,9
6370,3,shop,13,14,1
6370,4,work,14,19,5
6370,5,home,19,24,5
6371,1,home,0,8,8
6371,2,education,8,11,3
6371,3,home,11,15,4
6371,4,work,15,20,5
6371,5,home,20,24,4
6372,1,home,0,10,10
6372,2,work,10,18,8
6372,3,home,18,24,6
6373,1,home,0,7,7
6373,2,work,7,13,6
6373,3,shop,13,14,1
6373,4,work,14,20,6
6373,5,home,20,24,4
6374,1,home,0,7,7
6374,2,work,7,14,7
6374,3,home,14,19,5
6374,4,shop,19,20,1
6374,5,home,20,24,4
6375,1,home,0,7,7
6375,2,shop,7,8,1
6375,3,education,8,11,3
6375,4,home,11,14,3
6375,5,education,14,16,2
6375,6,home,16,24,8
6376,1,home,0,7,7
6376,2,work,7,13,6
6376,3,home,13,22,9
6376,4,work,22,23,1
6376,5,home,23,24,1
6377,1,home,0,7,7
6377,2,shop,7,9,2
6377,3,education,9,12,3
6377,4,shop,12,13,1
6377,5,home,13,21,8
6377,6,shop,21,22,1
6377,7,home,22,24,2
6378,1,home,0,8,8
6378,2,work,8,13,5
6378,3,home,13,24,11
6379,1,home,0,8,8
6379,2,work,8,14,6
6379,3,shop,14,15,1
6379,4,home,15,24,9
6380,1,home,0,7,7
6380,2,shop,7,8,1
6380,3,education,8,12,4
6380,4,shop,12,14,2
6380,5,education,14,15,1
6380,6,shop,15,16,1
6380,7,home,16,24,8
6381,1,home,0,6,6
6381,2,shop,6,7,1
6381,3,home,7,10,3
6381,4,education,10,12,2
6381,5,shop,12,14,2
6381,6,education,14,17,3
6381,7,home,17,24,7
6382,1,home,0,6,6
6382,2,shop,6,7,1
6382,3,work,7,13,6
6382,4,home,13,17,4
6382,5,work,17,20,3
6382,6,home,20,24,4
6383,1,home,0,7,7
6383,2,shop,7,8,1
6383,3,home,8,17,9
6383,4,work,17,20,3
6383,5,home,20,24,4
6384,1,home,0,7,7
6384,2,work,7,13,6
6384,3,home,13,21,8
6384,4,work,21,22,1
6384,5,home,22,24,2
6385,1,home,0,7,7
6385,2,work,7,9,2
6385,3,home,9,15,6
6385,4,work,15,17,2
6385,5,home,17,23,6
6385,6,work,23,24,1
6386,1,home,0,7,7
6386,2,work,7,13,6
6386,3,home,13,15,2
6386,4,work,15,18,3
6386,5,home,18,22,4
6386,6,work,22,23,1
6386,7,home,23,24,1
6387,1,home,0,6,6
6387,2,work,6,13,7
6387,3,shop,13,14,1
6387,4,work,14,18,4
6387,5,home,18,24,6
6388,1,home,0,7,7
6388,2,work,7,14,7
6388,3,shop,14,15,1
6388,4,home,15,24,9
6389,1,home,0,9,9
6389,2,work,9,16,7
6389,3,home,16,21,5
6389,4,work,21,22,1
6389,5,home,22,24,2
6390,1,home,0,6,6
6390,2,work,6,13,7
6390,3,home,13,22,9
6390,4,work,22,23,1
6390,5,home,23,24,1
6391,1,home,0,6,6
6391,2,work,6,13,7
6391,3,home,13,18,5
6391,4,shop,18,19,1
6391,5,home,19,24,5
6392,1,home,0,7,7
6392,2,work,7,13,6
6392,3,home,13,18,5
6392,4,work,18,20,2
6392,5,home,20,24,4
6393,1,home,0,7,7
6393,2,shop,7,8,1
6393,3,work,8,16,8
6393,4,home,16,24,8
6394,1,home,0,7,7
6394,2,work,7,13,6
6394,3,home,13,18,5
6394,4,shop,18,19,1
6394,5,home,19,24,5
6395,1,home,0,6,6
6395,2,shop,6,7,1
6395,3,home,7,11,4
6395,4,work,11,18,7
6395,5,home,18,24,6
6396,1,home,0,6,6
6396,2,shop,6,7,1
6396,3,home,7,13,6
6396,4,education,13,16,3
6396,5,home,16,24,8
6397,1,home,0,8,8
6397,2,work,8,15,7
6397,3,home,15,24,9
6398,1,home,0,6,6
6398,2,work,6,13,7
6398,3,shop,13,14,1
6398,4,work,14,19,5
6398,5,home,19,24,5
6399,1,home,0,7,7
6399,2,work,7,14,7
6399,3,home,14,18,4
6399,4,shop,18,19,1
6399,5,home,19,24,5
6400,1,home,0,6,6
6400,2,shop,6,7,1
6400,3,home,7,8,1
6400,4,work,8,14,6
6400,5,home,14,22,8
6400,6,work,22,23,1
6400,7,home,23,24,1
6401,1,home,0,8,8
6401,2,work,8,16,8
6401,3,home,16,21,5
6401,4,shop,21,22,1
6401,5,home,22,24,2
6402,1,home,0,7,7
6402,2,work,7,13,6
6402,3,home,13,24,11
6403,1,home,0,7,7
6403,2,shop,7,8,1
6403,3,work,8,17,9
6403,4,home,17,22,5
6403,5,work,22,23,1
6403,6,home,23,24,1
6404,1,home,0,7,7
6404,2,shop,7,8,1
6404,3,education,8,12,4
6404,4,shop,12,14,2
6404,5,education,14,16,2
6404,6,home,16,24,8
6405,1,home,0,8,8
6405,2,work,8,14,6
6405,3,home,14,24,10
6406,1,home,0,7,7
6406,2,work,7,15,8
6406,3,home,15,24,9
6407,1,home,0,7,7
6407,2,work,7,13,6
6407,3,shop,13,14,1
6407,4,work,14,20,6
6407,5,home,20,24,4
6408,1,home,0,9,9
6408,2,education,9,12,3
6408,3,work,12,18,6
6408,4,home,18,24,6
6409,1,home,0,7,7
6409,2,work,7,13,6
6409,3,shop,13,14,1
6409,4,work,14,19,5
6409,5,home,19,24,5
6410,1,home,0,8,8
6410,2,work,8,14,6
6410,3,shop,14,15,1
6410,4,home,15,22,7
6410,5,work,22,23,1
6410,6,home,23,24,1
6411,1,home,0,7,7
6411,2,work,7,13,6
6411,3,shop,13,14,1
6411,4,work,14,20,6
6411,5,home,20,24,4
6412,1,home,0,7,7
6412,2,shop,7,8,1
6412,3,work,8,15,7
6412,4,home,15,24,9
6413,1,home,0,7,7
6413,2,education,7,11,4
6413,3,home,11,14,3
6413,4,education,14,16,2
6413,5,shop,16,18,2
6413,6,home,18,24,6
6414,1,home,0,6,6
6414,2,work,6,13,7
6414,3,home,13,23,10
6414,4,work,23,24,1
6415,1,home,0,8,8
6415,2,work,8,15,7
6415,3,shop,15,16,1
6415,4,work,16,19,3
6415,5,home,19,24,5
6416,1,home,0,7,7
6416,2,work,7,8,1
6416,3,home,8,12,4
6416,4,work,12,14,2
6416,5,home,14,17,3
6416,6,work,17,19,2
6416,7,home,19,24,5
6417,1,home,0,7,7
6417,2,education,7,12,5
6417,3,shop,12,14,2
6417,4,home,14,24,10
6418,1,home,0,7,7
6418,2,work,7,13,6
6418,3,home,13,17,4
6418,4,work,17,19,2
6418,5,education,19,20,1
6418,6,home,20,24,4
6419,1,home,0,8,8
6419,2,work,8,14,6
6419,3,shop,14,15,1
6419,4,home,15,22,7
6419,5,work,22,23,1
6419,6,home,23,24,1
6420,1,home,0,8,8
6420,2,shop,8,9,1
6420,3,home,9,15,6
6420,4,work,15,20,5
6420,5,home,20,24,4
6421,1,home,0,7,7
6421,2,education,7,11,4
6421,3,home,11,19,8
6421,4,shop,19,21,2
6421,5,home,21,24,3
6422,1,home,0,7,7
6422,2,work,7,13,6
6422,3,shop,13,14,1
6422,4,work,14,19,5
6422,5,home,19,24,5
6423,1,home,0,7,7
6423,2,work,7,14,7
6423,3,shop,14,15,1
6423,4,work,15,20,5
6423,5,home,20,24,4
6424,1,home,0,6,6
6424,2,shop,6,7,1
6424,3,home,7,9,2
6424,4,work,9,14,5
6424,5,shop,14,15,1
6424,6,home,15,21,6
6424,7,work,21,22,1
6424,8,home,22,24,2
6425,1,home,0,7,7
6425,2,education,7,12,5
6425,3,shop,12,13,1
6425,4,education,13,16,3
6425,5,home,16,24,8
6426,1,home,0,7,7
6426,2,work,7,13,6
6426,3,shop,13,14,1
6426,4,work,14,19,5
6426,5,home,19,24,5
6427,1,home,0,6,6
6427,2,work,6,13,7
6427,3,home,13,17,4
6427,4,work,17,20,3
6427,5,home,20,24,4
6428,1,home,0,8,8
6428,2,work,8,15,7
6428,3,shop,15,16,1
6428,4,work,16,20,4
6428,5,home,20,24,4
6429,1,home,0,7,7
6429,2,work,7,14,7
6429,3,home,14,20,6
6429,4,shop,20,21,1
6429,5,home,21,24,3
6430,1,home,0,8,8
6430,2,work,8,13,5
6430,3,home,13,21,8
6430,4,shop,21,22,1
6430,5,home,22,24,2
6431,1,home,0,6,6
6431,2,work,6,8,2
6431,3,home,8,15,7
6431,4,work,15,17,2
6431,5,home,17,24,7
6432,1,home,0,7,7
6432,2,work,7,14,7
6432,3,home,14,24,10
6433,1,home,0,7,7
6433,2,work,7,14,7
6433,3,home,14,24,10
6434,1,home,0,7,7
6434,2,shop,7,8,1
6434,3,home,8,12,4
6434,4,work,12,19,7
6434,5,home,19,24,5
6435,1,home,0,6,6
6435,2,shop,6,7,1
6435,3,work,7,13,6
6435,4,home,13,17,4
6435,5,work,17,20,3
6435,6,home,20,24,4
6436,1,home,0,8,8
6436,2,work,8,15,7
6436,3,home,15,24,9
6437,1,home,0,7,7
6437,2,education,7,12,5
6437,3,home,12,18,6
6437,4,shop,18,20,2
6437,5,home,20,24,4
6438,1,home,0,10,10
6438,2,work,10,17,7
6438,3,home,17,24,7
6439,1,home,0,6,6
6439,2,shop,6,7,1
6439,3,home,7,10,3
6439,4,education,10,13,3
6439,5,shop,13,15,2
6439,6,home,15,24,9
6440,1,home,0,8,8
6440,2,work,8,15,7
6440,3,home,15,24,9
6441,1,home,0,7,7
6441,2,work,7,13,6
6441,3,shop,13,14,1
6441,4,work,14,20,6
6441,5,home,20,24,4
6442,1,home,0,8,8
6442,2,work,8,14,6
6442,3,home,14,24,10
6443,1,home,0,6,6
6443,2,work,6,13,7
6443,3,shop,13,14,1
6443,4,home,14,24,10
6444,1,home,0,8,8
6444,2,work,8,15,7
6444,3,home,15,24,9
6445,1,home,0,7,7
6445,2,work,7,13,6
6445,3,home,13,24,11
6446,1,home,0,6,6
6446,2,shop,6,7,1
6446,3,home,7,10,3
6446,4,education,10,12,2
6446,5,home,12,21,9
6446,6,shop,21,22,1
6446,7,home,22,24,2
6447,1,home,0,6,6
6447,2,shop,6,7,1
6447,3,work,7,13,6
6447,4,shop,13,14,1
6447,5,home,14,24,10
6448,1,home,0,6,6
6448,2,work,6,13,7
6448,3,shop,13,14,1
6448,4,work,14,20,6
6448,5,home,20,24,4
6449,1,home,0,8,8
6449,2,work,8,15,7
6449,3,home,15,23,8
6449,4,work,23,24,1
6450,1,home,0,7,7
6450,2,work,7,13,6
6450,3,home,13,17,4
6450,4,shop,17,18,1
6450,5,home,18,23,5
6450,6,work,23,24,1
6451,1,home,0,8,8
6451,2,education,8,11,3
6451,3,home,11,14,3
6451,4,education,14,16,2
6451,5,shop,16,17,1
6451,6,home,17,24,7
6452,1,home,0,7,7
6452,2,shop,7,9,2
6452,3,education,9,12,3
6452,4,shop,12,13,1
6452,5,home,13,20,7
6452,6,shop,20,21,1
6452,7,home,21,24,3
6453,1,home,0,8,8
6453,2,work,8,14,6
6453,3,home,14,22,8
6453,4,work,22,23,1
6453,5,home,23,24,1
6454,1,home,0,7,7
6454,2,work,7,9,2
6454,3,home,9,13,4
6454,4,work,13,15,2
6454,5,home,15,21,6
6454,6,work,21,22,1
6454,7,home,22,24,2
6455,1,home,0,8,8
6455,2,shop,8,9,1
6455,3,work,9,15,6
6455,4,home,15,24,9
6456,1,home,0,9,9
6456,2,work,9,13,4
6456,3,home,13,18,5
6456,4,shop,18,19,1
6456,5,home,19,24,5
6457,1,home,0,7,7
6457,2,work,7,14,7
6457,3,shop,14,15,1
6457,4,home,15,24,9
6458,1,home,0,8,8
6458,2,work,8,16,8
6458,3,home,16,20,4
6458,4,shop,20,21,1
6458,5,home,21,24,3
6459,1,home,0,8,8
6459,2,work,8,15,7
6459,3,home,15,24,9
6460,1,home,0,6,6
6460,2,work,6,13,7
6460,3,home,13,18,5
6460,4,shop,18,19,1
6460,5,home,19,24,5
6461,1,home,0,9,9
6461,2,work,9,16,7
6461,3,shop,16,17,1
6461,4,home,17,21,4
6461,5,work,21,22,1
6461,6,home,22,24,2
6462,1,home,0,7,7
6462,2,work,7,13,6
6462,3,home,13,24,11
6463,1,home,0,8,8
6463,2,education,8,14,6
6463,3,shop,14,15,1
6463,4,home,15,22,7
6463,5,work,22,23,1
6463,6,home,23,24,1
6464,1,home,0,9,9
6464,2,work,9,17,8
6464,3,home,17,24,7
6465,1,home,0,8,8
6465,2,work,8,14,6
6465,3,home,14,24,10
6466,1,home,0,7,7
6466,2,work,7,9,2
6466,3,home,9,15,6
6466,4,work,15,17,2
6466,5,home,17,24,7
6467,1,home,0,7,7
6467,2,work,7,13,6
6467,3,shop,13,14,1
6467,4,work,14,20,6
6467,5,home,20,24,4
6468,1,home,0,8,8
6468,2,work,8,15,7
6468,3,home,15,24,9
6469,1,home,0,6,6
6469,2,shop,6,7,1
6469,3,home,7,10,3
6469,4,education,10,15,5
6469,5,shop,15,16,1
6469,6,home,16,24,8
6470,1,home,0,8,8
6470,2,work,8,15,7
6470,3,home,15,24,9
6471,1,home,0,8,8
6471,2,education,8,14,6
6471,3,shop,14,15,1
6471,4,home,15,23,8
6471,5,work,23,24,1
6472,1,home,0,6,6
6472,2,shop,6,7,1
6472,3,home,7,10,3
6472,4,education,10,16,6
6472,5,home,16,24,8
6473,1,home,0,7,7
6473,2,work,7,13,6
6473,3,home,13,16,3
6473,4,work,16,20,4
6473,5,home,20,24,4
6474,1,home,0,7,7
6474,2,work,7,13,6
6474,3,shop,13,14,1
6474,4,work,14,19,5
6474,5,home,19,24,5
6475,1,home,0,6,6
6475,2,shop,6,7,1
6475,3,home,7,10,3
6475,4,education,10,13,3
6475,5,shop,13,15,2
6475,6,home,15,24,9
6476,1,home,0,7,7
6476,2,education,7,11,4
6476,3,home,11,14,3
6476,4,education,14,16,2
6476,5,home,16,24,8
6477,1,home,0,7,7
6477,2,shop,7,9,2
6477,3,education,9,12,3
6477,4,shop,12,13,1
6477,5,home,13,21,8
6477,6,shop,21,22,1
6477,7,home,22,24,2
6478,1,home,0,7,7
6478,2,work,7,14,7
6478,3,home,14,16,2
6478,4,work,16,19,3
6478,5,home,19,24,5
6479,1,home,0,6,6
6479,2,work,6,13,7
6479,3,home,13,17,4
6479,4,shop,17,18,1
6479,5,home,18,24,6
6480,1,home,0,7,7
6480,2,work,7,13,6
6480,3,home,13,24,11
6481,1,home,0,9,9
6481,2,education,9,12,3
6481,3,home,12,23,11
6481,4,work,23,24,1
6482,1,home,0,6,6
6482,2,work,6,8,2
6482,3,home,8,14,6
6482,4,work,14,16,2
6482,5,home,16,21,5
6482,6,work,21,22,1
6482,7,home,22,24,2
6483,1,home,0,6,6
6483,2,work,6,7,1
6483,3,home,7,9,2
6483,4,work,9,11,2
6483,5,home,11,17,6
6483,6,work,17,19,2
6483,7,home,19,24,5
6484,1,home,0,7,7
6484,2,education,7,11,4
6484,3,home,11,18,7
6484,4,shop,18,19,1
6484,5,home,19,24,5
6485,1,home,0,7,7
6485,2,shop,7,8,1
6485,3,education,8,12,4
6485,4,home,12,19,7
6485,5,shop,19,20,1
6485,6,home,20,24,4
6486,1,home,0,7,7
6486,2,work,7,15,8
6486,3,home,15,24,9
6487,1,home,0,7,7
6487,2,work,7,14,7
6487,3,shop,14,15,1
6487,4,home,15,24,9
6488,1,home,0,7,7
6488,2,work,7,13,6
6488,3,home,13,24,11
6489,1,home,0,7,7
6489,2,work,7,13,6
6489,3,shop,13,14,1
6489,4,work,14,19,5
6489,5,education,19,20,1
6489,6,home,20,24,4
6490,1,home,0,8,8
6490,2,work,8,14,6
6490,3,shop,14,15,1
6490,4,work,15,20,5
6490,5,home,20,24,4
6491,1,home,0,6,6
6491,2,work,6,13,7
6491,3,shop,13,14,1
6491,4,home,14,24,10
6492,1,home,0,6,6
6492,2,shop,6,7,1
6492,3,home,7,9,2
6492,4,education,9,12,3
6492,5,shop,12,13,1
6492,6,education,13,16,3
6492,7,shop,16,18,2
6492,8,home,18,24,6
6493,1,home,0,8,8
6493,2,shop,8,9,1
6493,3,home,9,13,4
6493,4,work,13,15,2
6493,5,shop,15,16,1
6493,6,home,16,24,8
6494,1,home,0,6,6
6494,2,work,6,13,7
6494,3,home,13,23,10
6494,4,work,23,24,1
6495,1,home,0,8,8
6495,2,work,8,13,5
6495,3,shop,13,14,1
6495,4,home,14,24,10
6496,1,home,0,7,7
6496,2,work,7,13,6
6496,3,home,13,22,9
6496,4,work,22,23,1
6496,5,home,23,24,1
6497,1,home,0,6,6
6497,2,work,6,13,7
6497,3,shop,13,14,1
6497,4,home,14,22,8
6497,5,work,22,23,1
6497,6,home,23,24,1
6498,1,home,0,7,7
6498,2,work,7,13,6
6498,3,home,13,18,5
6498,4,work,18,20,2
6498,5,home,20,24,4
6499,1,home,0,8,8
6499,2,work,8,14,6
6499,3,home,14,21,7
6499,4,work,21,22,1
6499,5,home,22,24,2
6500,1,home,0,7,7
6500,2,work,7,14,7
6500,3,home,14,24,10
6501,1,home,0,7,7
6501,2,work,7,13,6
6501,3,home,13,24,11
6502,1,home,0,6,6
6502,2,shop,6,7,1
6502,3,home,7,9,2
6502,4,education,9,11,2
6502,5,home,11,19,8
6502,6,shop,19,20,1
6502,7,home,20,24,4
6503,1,home,0,7,7
6503,2,work,7,15,8
6503,3,home,15,22,7
6503,4,work,22,23,1
6503,5,home,23,24,1
6504,1,home,0,8,8
6504,2,work,8,15,7
6504,3,home,15,24,9
6505,1,home,0,6,6
6505,2,work,6,13,7
6505,3,home,13,17,4
6505,4,work,17,20,3
6505,5,home,20,24,4
6506,1,home,0,7,7
6506,2,work,7,13,6
6506,3,home,13,23,10
6506,4,work,23,24,1
6507,1,home,0,8,8
6507,2,education,8,11,3
6507,3,home,11,14,3
6507,4,education,14,16,2
6507,5,home,16,21,5
6507,6,shop,21,22,1
6507,7,home,22,24,2
6508,1,home,0,6,6
6508,2,work,6,7,1
6508,3,home,7,11,4
6508,4,work,11,13,2
6508,5,home,13,18,5
6508,6,work,18,19,1
6508,7,home,19,23,4
6508,8,work,23,24,1
6509,1,home,0,6,6
6509,2,shop,6,7,1
6509,3,home,7,10,3
6509,4,education,10,12,2
6509,5,home,12,19,7
6509,6,shop,19,20,1
6509,7,home,20,24,4
6510,1,home,0,6,6
6510,2,work,6,8,2
6510,3,home,8,10,2
6510,4,work,10,12,2
6510,5,home,12,16,4
6510,6,work,16,19,3
6510,7,home,19,24,5
6511,1,home,0,8,8
6511,2,work,8,10,2
6511,3,home,10,13,3
6511,4,work,13,15,2
6511,5,home,15,22,7
6511,6,work,22,23,1
6511,7,home,23,24,1
6512,1,home,0,8,8
6512,2,work,8,15,7
6512,3,shop,15,16,1
6512,4,work,16,20,4
6512,5,home,20,24,4
6513,1,home,0,7,7
6513,2,shop,7,8,1
6513,3,education,8,11,3
6513,4,home,11,17,6
6513,5,shop,17,18,1
6513,6,home,18,24,6
6514,1,home,0,8,8
6514,2,work,8,13,5
6514,3,shop,13,14,1
6514,4,home,14,24,10
6515,1,home,0,6,6
6515,2,shop,6,7,1
6515,3,home,7,13,6
6515,4,education,13,16,3
6515,5,shop,16,17,1
6515,6,home,17,24,7
6516,1,home,0,6,6
6516,2,work,6,13,7
6516,3,home,13,24,11
6517,1,home,0,6,6
6517,2,shop,6,7,1
6517,3,home,7,9,2
6517,4,education,9,12,3
6517,5,home,12,18,6
6517,6,shop,18,19,1
6517,7,home,19,24,5
6518,1,home,0,7,7
6518,2,work,7,14,7
6518,3,home,14,21,7
6518,4,work,21,22,1
6518,5,home,22,24,2
6519,1,home,0,6,6
6519,2,shop,6,7,1
6519,3,home,7,9,2
6519,4,education,9,12,3
6519,5,shop,12,13,1
6519,6,education,13,14,1
6519,7,shop,14,15,1
6519,8,home,15,24,9
6520,1,home,0,6,6
6520,2,shop,6,7,1
6520,3,home,7,13,6
6520,4,education,13,16,3
6520,5,home,16,24,8
6521,1,home,0,6,6
6521,2,work,6,13,7
6521,3,home,13,18,5
6521,4,work,18,20,2
6521,5,home,20,24,4
6522,1,home,0,9,9
6522,2,shop,9,10,1
6522,3,home,10,15,5
6522,4,work,15,20,5
6522,5,home,20,24,4
6523,1,home,0,8,8
6523,2,work,8,13,5
6523,3,home,13,24,11
6524,1,home,0,7,7
6524,2,shop,7,8,1
6524,3,work,8,16,8
6524,4,home,16,24,8
6525,1,home,0,8,8
6525,2,work,8,15,7
6525,3,shop,15,16,1
6525,4,home,16,24,8
6526,1,home,0,6,6
6526,2,shop,6,8,2
6526,3,home,8,12,4
6526,4,work,12,19,7
6526,5,home,19,24,5
6527,1,home,0,7,7
6527,2,work,7,13,6
6527,3,shop,13,14,1
6527,4,education,14,16,2
6527,5,home,16,24,8
6528,1,home,0,7,7
6528,2,work,7,13,6
6528,3,shop,13,14,1
6528,4,work,14,19,5
6528,5,home,19,24,5
6529,1,home,0,7,7
6529,2,work,7,13,6
6529,3,home,13,17,4
6529,4,work,17,20,3
6529,5,home,20,24,4
6530,1,home,0,7,7
6530,2,work,7,9,2
6530,3,home,9,13,4
6530,4,work,13,15,2
6530,5,home,15,22,7
6530,6,work,22,23,1
6530,7,home,23,24,1
6531,1,home,0,8,8
6531,2,work,8,14,6
6531,3,home,14,17,3
6531,4,work,17,20,3
6531,5,home,20,24,4
6532,1,home,0,7,7
6532,2,work,7,8,1
6532,3,home,8,14,6
6532,4,work,14,16,2
6532,5,home,16,22,6
6532,6,work,22,23,1
6532,7,home,23,24,1
6533,1,home,0,6,6
6533,2,shop,6,7,1
6533,3,home,7,9,2
6533,4,education,9,12,3
6533,5,home,12,20,8
6533,6,shop,20,21,1
6533,7,home,21,24,3
6534,1,home,0,7,7
6534,2,work,7,13,6
6534,3,shop,13,14,1
6534,4,home,14,18,4
6534,5,work,18,20,2
6534,6,home,20,24,4
6535,1,home,0,8,8
6535,2,education,8,11,3
6535,3,home,11,16,5
6535,4,work,16,20,4
6535,5,home,20,24,4
6536,1,home,0,7,7
6536,2,work,7,13,6
6536,3,home,13,22,9
6536,4,work,22,23,1
6536,5,home,23,24,1
6537,1,home,0,6,6
6537,2,shop,6,7,1
6537,3,home,7,9,2
6537,4,education,9,12,3
6537,5,shop,12,14,2
6537,6,home,14,24,10
6538,1,home,0,6,6
6538,2,work,6,13,7
6538,3,home,13,14,1
6538,4,work,14,18,4
6538,5,home,18,24,6
6539,1,home,0,7,7
6539,2,education,7,12,5
6539,3,shop,12,13,1
6539,4,education,13,16,3
6539,5,home,16,24,8
6540,1,home,0,7,7
6540,2,education,7,9,2
6540,3,home,9,14,5
6540,4,education,14,16,2
6540,5,shop,16,17,1
6540,6,home,17,24,7
6541,1,home,0,6,6
6541,2,work,6,13,7
6541,3,home,13,16,3
6541,4,work,16,20,4
6541,5,home,20,24,4
6542,1,home,0,7,7
6542,2,education,7,11,4
6542,3,home,11,19,8
6542,4,shop,19,20,1
6542,5,home,20,24,4
6543,1,home,0,7,7
6543,2,work,7,13,6
6543,3,home,13,24,11
6544,1,home,0,7,7
6544,2,work,7,13,6
6544,3,home,13,24,11
6545,1,home,0,6,6
6545,2,shop,6,7,1
6545,3,work,7,14,7
6545,4,home,14,21,7
6545,5,work,21,22,1
6545,6,home,22,24,2
6546,1,home,0,8,8
6546,2,work,8,14,6
6546,3,shop,14,15,1
6546,4,home,15,24,9
6547,1,home,0,7,7
6547,2,education,7,11,4
6547,3,home,11,20,9
6547,4,shop,20,21,1
6547,5,home,21,24,3
6548,1,home,0,6,6
6548,2,shop,6,7,1
6548,3,work,7,14,7
6548,4,home,14,22,8
6548,5,work,22,23,1
6548,6,home,23,24,1
6549,1,home,0,7,7
6549,2,education,7,12,5
6549,3,shop,12,14,2
6549,4,education,14,17,3
6549,5,home,17,24,7
6550,1,home,0,7,7
6550,2,work,7,15,8
6550,3,home,15,21,6
6550,4,work,21,22,1
6550,5,home,22,24,2
6551,1,home,0,6,6
6551,2,shop,6,7,1
6551,3,home,7,9,2
6551,4,education,9,12,3
6551,5,home,12,20,8
6551,6,shop,20,21,1
6551,7,home,21,24,3
6552,1,home,0,6,6
6552,2,work,6,13,7
6552,3,home,13,22,9
6552,4,work,22,23,1
6552,5,home,23,24,1
6553,1,home,0,8,8
6553,2,education,8,11,3
6553,3,home,11,16,5
6553,4,work,16,20,4
6553,5,home,20,24,4
6554,1,home,0,8,8
6554,2,education,8,11,3
6554,3,home,11,18,7
6554,4,shop,18,19,1
6554,5,home,19,24,5
6555,1,home,0,6,6
6555,2,work,6,9,3
6555,3,home,9,13,4
6555,4,work,13,15,2
6555,5,home,15,21,6
6555,6,work,21,22,1
6555,7,home,22,24,2
6556,1,home,0,7,7
6556,2,education,7,11,4
6556,3,home,11,19,8
6556,4,shop,19,20,1
6556,5,home,20,24,4
6557,1,home,0,8,8
6557,2,work,8,17,9
6557,3,home,17,24,7
6558,1,home,0,8,8
6558,2,education,8,11,3
6558,3,shop,11,12,1
6558,4,home,12,16,4
6558,5,work,16,20,4
6558,6,home,20,24,4
6559,1,work,0,1,1
6559,2,home,1,7,6
6559,3,education,7,11,4
6559,4,home,11,14,3
6559,5,education,14,17,3
6559,6,home,17,24,7
6560,1,home,0,6,6
6560,2,shop,6,7,1
6560,3,home,7,10,3
6560,4,education,10,12,2
6560,5,shop,12,13,1
6560,6,education,13,16,3
6560,7,home,16,24,8
6561,1,home,0,6,6
6561,2,work,6,13,7
6561,3,shop,13,14,1
6561,4,work,14,20,6
6561,5,home,20,24,4
6562,1,home,0,7,7
6562,2,education,7,11,4
6562,3,home,11,18,7
6562,4,shop,18,19,1
6562,5,home,19,24,5
6563,1,home,0,7,7
6563,2,shop,7,9,2
6563,3,education,9,11,2
6563,4,home,11,19,8
6563,5,shop,19,20,1
6563,6,home,20,24,4
6564,1,home,0,6,6
6564,2,work,6,8,2
6564,3,home,8,9,1
6564,4,work,9,10,1
6564,5,home,10,13,3
6564,6,work,13,15,2
6564,7,home,15,21,6
6564,8,work,21,22,1
6564,9,home,22,24,2
6565,1,home,0,7,7
6565,2,work,7,9,2
6565,3,home,9,13,4
6565,4,work,13,15,2
6565,5,home,15,22,7
6565,6,work,22,23,1
6565,7,home,23,24,1
6566,1,home,0,6,6
6566,2,work,6,13,7
6566,3,shop,13,14,1
6566,4,home,14,18,4
6566,5,work,18,19,1
6566,6,home,19,24,5
6567,1,home,0,7,7
6567,2,work,7,13,6
6567,3,shop,13,14,1
6567,4,work,14,19,5
6567,5,home,19,24,5
6568,1,home,0,7,7
6568,2,work,7,13,6
6568,3,home,13,17,4
6568,4,shop,17,18,1
6568,5,work,18,20,2
6568,6,home,20,24,4
6569,1,home,0,8,8
6569,2,education,8,11,3
6569,3,home,11,18,7
6569,4,shop,18,19,1
6569,5,home,19,24,5
6570,1,home,0,6,6
6570,2,work,6,13,7
6570,3,home,13,17,4
6570,4,work,17,20,3
6570,5,home,20,24,4
6571,1,home,0,6,6
6571,2,shop,6,7,1
6571,3,home,7,9,2
6571,4,education,9,11,2
6571,5,home,11,18,7
6571,6,shop,18,19,1
6571,7,home,19,24,5
6572,1,home,0,6,6
6572,2,work,6,13,7
6572,3,home,13,24,11
6573,1,home,0,7,7
6573,2,work,7,14,7
6573,3,shop,14,15,1
6573,4,home,15,24,9
6574,1,home,0,7,7
6574,2,work,7,13,6
6574,3,home,13,24,11
6575,1,home,0,7,7
6575,2,work,7,13,6
6575,3,home,13,24,11
6576,1,home,0,6,6
6576,2,work,6,13,7
6576,3,shop,13,14,1
6576,4,education,14,17,3
6576,5,home,17,24,7
6577,1,home,0,7,7
6577,2,shop,7,8,1
6577,3,work,8,14,6
6577,4,home,14,24,10
6578,1,home,0,7,7
6578,2,work,7,14,7
6578,3,home,14,21,7
6578,4,work,21,22,1
6578,5,home,22,24,2
6579,1,home,0,8,8
6579,2,work,8,16,8
6579,3,shop,16,17,1
6579,4,home,17,23,6
6579,5,work,23,24,1
6580,1,home,0,8,8
6580,2,work,8,14,6
6580,3,shop,14,15,1
6580,4,work,15,20,5
6580,5,home,20,24,4
6581,1,home,0,8,8
6581,2,work,8,15,7
6581,3,home,15,24,9
6582,1,home,0,6,6
6582,2,work,6,13,7
6582,3,home,13,24,11
6583,1,home,0,6,6
6583,2,work,6,13,7
6583,3,home,13,16,3
6583,4,work,16,20,4
6583,5,home,20,24,4
6584,1,home,0,7,7
6584,2,work,7,13,6
6584,3,home,13,18,5
6584,4,shop,18,19,1
6584,5,home,19,24,5
6585,1,home,0,7,7
6585,2,work,7,14,7
6585,3,shop,14,15,1
6585,4,home,15,24,9
6586,1,home,0,6,6
6586,2,shop,6,7,1
6586,3,home,7,9,2
6586,4,work,9,16,7
6586,5,home,16,24,8
6587,1,home,0,7,7
6587,2,shop,7,8,1
6587,3,education,8,11,3
6587,4,home,11,20,9
6587,5,shop,20,21,1
6587,6,home,21,24,3
6588,1,home,0,7,7
6588,2,education,7,13,6
6588,3,shop,13,15,2
6588,4,home,15,20,5
6588,5,shop,20,21,1
6588,6,home,21,24,3
6589,1,home,0,7,7
6589,2,shop,7,8,1
6589,3,home,8,12,4
6589,4,work,12,19,7
6589,5,home,19,24,5
6590,1,home,0,7,7
6590,2,work,7,14,7
6590,3,shop,14,15,1
6590,4,home,15,24,9
6591,1,home,0,6,6
6591,2,work,6,13,7
6591,3,home,13,24,11
6592,1,home,0,7,7
6592,2,work,7,9,2
6592,3,home,9,15,6
6592,4,work,15,17,2
6592,5,home,17,23,6
6592,6,work,23,24,1
6593,1,home,0,6,6
6593,2,work,6,13,7
6593,3,shop,13,14,1
6593,4,home,14,24,10
6594,1,home,0,6,6
6594,2,work,6,13,7
6594,3,shop,13,14,1
6594,4,home,14,24,10
6595,1,home,0,7,7
6595,2,work,7,13,6
6595,3,shop,13,14,1
6595,4,work,14,19,5
6595,5,home,19,24,5
6596,1,home,0,7,7
6596,2,work,7,14,7
6596,3,home,14,24,10
6597,1,home,0,6,6
6597,2,shop,6,7,1
6597,3,home,7,10,3
6597,4,education,10,12,2
6597,5,shop,12,13,1
6597,6,education,13,16,3
6597,7,home,16,24,8
6598,1,home,0,7,7
6598,2,work,7,13,6
6598,3,home,13,18,5
6598,4,shop,18,19,1
6598,5,home,19,24,5
6599,1,home,0,7,7
6599,2,education,7,11,4
6599,3,home,11,17,6
6599,4,shop,17,19,2
6599,5,home,19,24,5
6600,1,home,0,6,6
6600,2,work,6,13,7
6600,3,home,13,24,11
6601,1,home,0,7,7
6601,2,work,7,13,6
6601,3,home,13,17,4
6601,4,work,17,20,3
6601,5,home,20,24,4
6602,1,home,0,7,7
6602,2,shop,7,8,1
6602,3,home,8,9,1
6602,4,education,9,15,6
6602,5,shop,15,16,1
6602,6,home,16,24,8
6603,1,home,0,7,7
6603,2,work,7,13,6
6603,3,shop,13,14,1
6603,4,home,14,24,10
6604,1,home,0,6,6
6604,2,shop,6,7,1
6604,3,home,7,13,6
6604,4,education,13,16,3
6604,5,home,16,24,8
6605,1,home,0,8,8
6605,2,work,8,17,9
6605,3,home,17,24,7
6606,1,home,0,6,6
6606,2,work,6,13,7
6606,3,shop,13,14,1
6606,4,home,14,24,10
6607,1,home,0,6,6
6607,2,work,6,13,7
6607,3,shop,13,15,2
6607,4,home,15,24,9
6608,1,home,0,8,8
6608,2,work,8,14,6
6608,3,home,14,21,7
6608,4,shop,21,22,1
6608,5,home,22,24,2
6609,1,home,0,7,7
6609,2,work,7,14,7
6609,3,home,14,17,3
6609,4,shop,17,18,1
6609,5,home,18,24,6
6610,1,home,0,7,7
6610,2,education,7,11,4
6610,3,home,11,14,3
6610,4,education,14,17,3
6610,5,shop,17,18,1
6610,6,home,18,24,6
6611,1,home,0,8,8
6611,2,work,8,15,7
6611,3,home,15,24,9
6612,1,home,0,8,8
6612,2,work,8,13,5
6612,3,home,13,20,7
6612,4,shop,20,21,1
6612,5,home,21,24,3
6613,1,home,0,8,8
6613,2,work,8,15,7
6613,3,home,15,24,9
6614,1,home,0,6,6
6614,2,work,6,13,7
6614,3,shop,13,14,1
6614,4,home,14,18,4
6614,5,work,18,20,2
6614,6,home,20,24,4
6615,1,home,0,7,7
6615,2,work,7,13,6
6615,3,shop,13,14,1
6615,4,home,14,24,10
6616,1,home,0,8,8
6616,2,work,8,15,7
6616,3,home,15,19,4
6616,4,shop,19,20,1
6616,5,home,20,24,4
6617,1,home,0,8,8
6617,2,work,8,15,7
6617,3,shop,15,16,1
6617,4,home,16,24,8
6618,1,home,0,7,7
6618,2,work,7,13,6
6618,3,shop,13,14,1
6618,4,work,14,19,5
6618,5,home,19,24,5
6619,1,home,0,7,7
6619,2,work,7,8,1
6619,3,home,8,9,1
6619,4,work,9,11,2
6619,5,home,11,13,2
6619,6,work,13,14,1
6619,7,home,14,18,4
6619,8,work,18,19,1
6619,9,home,19,24,5
6620,1,home,0,8,8
6620,2,education,8,12,4
6620,3,home,12,16,4
6620,4,work,16,20,4
6620,5,home,20,24,4
6621,1,home,0,6,6
6621,2,work,6,13,7
6621,3,home,13,24,11
6622,1,home,0,6,6
6622,2,shop,6,7,1
6622,3,home,7,9,2
6622,4,work,9,16,7
6622,5,home,16,23,7
6622,6,work,23,24,1
6623,1,home,0,6,6
6623,2,work,6,8,2
6623,3,home,8,9,1
6623,4,work,9,11,2
6623,5,home,11,15,4
6623,6,work,15,18,3
6623,7,home,18,24,6
6624,1,home,0,8,8
6624,2,education,8,11,3
6624,3,home,11,24,13
6625,1,home,0,8,8
6625,2,work,8,15,7
6625,3,home,15,24,9
6626,1,home,0,7,7
6626,2,education,7,11,4
6626,3,home,11,19,8
6626,4,shop,19,20,1
6626,5,home,20,24,4
6627,1,home,0,7,7
6627,2,work,7,14,7
6627,3,shop,14,15,1
6627,4,home,15,24,9
6628,1,home,0,8,8
6628,2,work,8,15,7
6628,3,shop,15,16,1
6628,4,home,16,18,2
6628,5,work,18,20,2
6628,6,home,20,24,4
6629,1,home,0,8,8
6629,2,education,8,11,3
6629,3,home,11,20,9
6629,4,shop,20,21,1
6629,5,home,21,24,3
6630,1,home,0,7,7
6630,2,education,7,12,5
6630,3,shop,12,14,2
6630,4,education,14,16,2
6630,5,home,16,24,8
6631,1,home,0,7,7
6631,2,work,7,13,6
6631,3,shop,13,14,1
6631,4,work,14,19,5
6631,5,home,19,24,5
6632,1,home,0,7,7
6632,2,education,7,12,5
6632,3,home,12,20,8
6632,4,shop,20,21,1
6632,5,home,21,24,3
6633,1,home,0,7,7
6633,2,work,7,9,2
6633,3,home,9,14,5
6633,4,work,14,16,2
6633,5,home,16,23,7
6633,6,work,23,24,1
6634,1,home,0,6,6
6634,2,work,6,8,2
6634,3,home,8,12,4
6634,4,work,12,14,2
6634,5,home,14,22,8
6634,6,work,22,23,1
6634,7,home,23,24,1
6635,1,home,0,8,8
6635,2,work,8,15,7
6635,3,home,15,21,6
6635,4,work,21,22,1
6635,5,home,22,24,2
6636,1,home,0,7,7
6636,2,work,7,13,6
6636,3,home,13,19,6
6636,4,shop,19,20,1
6636,5,home,20,24,4
6637,1,home,0,8,8
6637,2,work,8,15,7
6637,3,shop,15,16,1
6637,4,work,16,19,3
6637,5,home,19,24,5
6638,1,home,0,8,8
6638,2,work,8,15,7
6638,3,home,15,24,9
6639,1,home,0,7,7
6639,2,work,7,14,7
6639,3,shop,14,15,1
6639,4,home,15,24,9
6640,1,home,0,7,7
6640,2,work,7,13,6
6640,3,shop,13,14,1
6640,4,home,14,22,8
6640,5,work,22,23,1
6640,6,home,23,24,1
6641,1,home,0,7,7
6641,2,work,7,13,6
6641,3,shop,13,14,1
6641,4,home,14,24,10
6642,1,home,0,8,8
6642,2,education,8,12,4
6642,3,home,12,19,7
6642,4,shop,19,20,1
6642,5,home,20,24,4
6643,1,home,0,7,7
6643,2,work,7,14,7
6643,3,home,14,24,10
6644,1,home,0,7,7
6644,2,work,7,13,6
6644,3,shop,13,14,1
6644,4,work,14,20,6
6644,5,home,20,24,4
6645,1,home,0,8,8
6645,2,work,8,14,6
6645,3,home,14,22,8
6645,4,work,22,23,1
6645,5,home,23,24,1
6646,1,home,0,7,7
6646,2,work,7,13,6
6646,3,shop,13,14,1
6646,4,home,14,17,3
6646,5,work,17,20,3
6646,6,home,20,24,4
6647,1,home,0,6,6
6647,2,work,6,14,8
6647,3,home,14,20,6
6647,4,shop,20,21,1
6647,5,home,21,24,3
6648,1,home,0,8,8
6648,2,work,8,15,7
6648,3,home,15,24,9
6649,1,home,0,8,8
6649,2,work,8,15,7
6649,3,home,15,22,7
6649,4,work,22,23,1
6649,5,home,23,24,1
6650,1,home,0,8,8
6650,2,work,8,15,7
6650,3,home,15,18,3
6650,4,shop,18,19,1
6650,5,home,19,24,5
6651,1,home,0,7,7
6651,2,work,7,14,7
6651,3,home,14,21,7
6651,4,shop,21,22,1
6651,5,home,22,24,2
6652,1,home,0,7,7
6652,2,education,7,11,4
6652,3,home,11,14,3
6652,4,education,14,17,3
6652,5,home,17,24,7
6653,1,home,0,6,6
6653,2,shop,6,7,1
6653,3,home,7,12,5
6653,4,education,12,15,3
6653,5,shop,15,16,1
6653,6,home,16,24,8
6654,1,home,0,7,7
6654,2,education,7,11,4
6654,3,home,11,17,6
6654,4,shop,17,18,1
6654,5,home,18,24,6
6655,1,home,0,7,7
6655,2,shop,7,8,1
6655,3,work,8,16,8
6655,4,home,16,24,8
6656,1,home,0,8,8
6656,2,work,8,15,7
6656,3,home,15,21,6
6656,4,shop,21,22,1
6656,5,home,22,24,2
6657,1,home,0,8,8
6657,2,education,8,12,4
6657,3,shop,12,13,1
6657,4,work,13,19,6
6657,5,home,19,24,5
6658,1,home,0,7,7
6658,2,work,7,13,6
6658,3,shop,13,14,1
6658,4,work,14,20,6
6658,5,home,20,24,4
6659,1,home,0,6,6
6659,2,work,6,8,2
6659,3,home,8,9,1
6659,4,work,9,11,2
6659,5,home,11,18,7
6659,6,work,18,19,1
6659,7,home,19,24,5
6660,1,home,0,7,7
6660,2,work,7,14,7
6660,3,shop,14,15,1
6660,4,home,15,24,9
6661,1,home,0,7,7
6661,2,shop,7,8,1
6661,3,work,8,15,7
6661,4,home,15,24,9
6662,1,home,0,7,7
6662,2,education,7,11,4
6662,3,home,11,17,6
6662,4,shop,17,18,1
6662,5,home,18,24,6
6663,1,home,0,7,7
6663,2,work,7,13,6
6663,3,shop,13,15,2
6663,4,home,15,24,9
6664,1,home,0,6,6
6664,2,work,6,13,7
6664,3,home,13,22,9
6664,4,work,22,23,1
6664,5,home,23,24,1
6665,1,home,0,8,8
6665,2,work,8,15,7
6665,3,home,15,21,6
6665,4,work,21,22,1
6665,5,home,22,24,2
6666,1,home,0,7,7
6666,2,education,7,10,3
6666,3,home,10,13,3
6666,4,education,13,16,3
6666,5,home,16,24,8
6667,1,home,0,7,7
6667,2,work,7,13,6
6667,3,shop,13,14,1
6667,4,work,14,20,6
6667,5,home,20,24,4
6668,1,home,0,8,8
6668,2,work,8,15,7
6668,3,shop,15,16,1
6668,4,work,16,20,4
6668,5,home,20,24,4
6669,1,home,0,7,7
6669,2,work,7,14,7
6669,3,home,14,24,10
6670,1,home,0,9,9
6670,2,work,9,16,7
6670,3,shop,16,17,1
6670,4,work,17,19,2
6670,5,home,19,24,5
6671,1,home,0,7,7
6671,2,education,7,11,4
6671,3,home,11,19,8
6671,4,shop,19,20,1
6671,5,home,20,24,4
6672,1,home,0,8,8
6672,2,work,8,17,9
6672,3,home,17,24,7
6673,1,home,0,7,7
6673,2,work,7,14,7
6673,3,shop,14,15,1
6673,4,work,15,20,5
6673,5,home,20,24,4
6674,1,home,0,7,7
6674,2,work,7,13,6
6674,3,home,13,24,11
6675,1,home,0,7,7
6675,2,shop,7,8,1
6675,3,education,8,11,3
6675,4,home,11,13,2
6675,5,education,13,16,3
6675,6,shop,16,18,2
6675,7,home,18,24,6
6676,1,home,0,7,7
6676,2,education,7,12,5
6676,3,home,12,18,6
6676,4,shop,18,19,1
6676,5,home,19,24,5
6677,1,home,0,7,7
6677,2,work,7,13,6
6677,3,home,13,23,10
6677,4,work,23,24,1
6678,1,home,0,8,8
6678,2,education,8,13,5
6678,3,shop,13,14,1
6678,4,home,14,24,10
6679,1,home,0,8,8
6679,2,work,8,15,7
6679,3,home,15,24,9
6680,1,home,0,8,8
6680,2,work,8,15,7
6680,3,home,15,24,9
6681,1,home,0,7,7
6681,2,work,7,13,6
6681,3,home,13,24,11
6682,1,home,0,9,9
6682,2,education,9,12,3
6682,3,home,12,16,4
6682,4,work,16,20,4
6682,5,home,20,24,4
6683,1,home,0,7,7
6683,2,work,7,14,7
6683,3,home,14,20,6
6683,4,shop,20,21,1
6683,5,home,21,24,3
6684,1,home,0,8,8
6684,2,work,8,15,7
6684,3,home,15,23,8
6684,4,work,23,24,1
6685,1,home,0,8,8
6685,2,work,8,15,7
6685,3,shop,15,16,1
6685,4,work,16,20,4
6685,5,home,20,24,4
6686,1,home,0,8,8
6686,2,education,8,11,3
6686,3,home,11,17,6
6686,4,shop,17,18,1
6686,5,home,18,24,6
6687,1,home,0,7,7
6687,2,education,7,12,5
6687,3,shop,12,14,2
6687,4,home,14,21,7
6687,5,shop,21,22,1
6687,6,home,22,24,2
6688,1,home,0,7,7
6688,2,work,7,9,2
6688,3,home,9,13,4
6688,4,work,13,15,2
6688,5,home,15,22,7
6688,6,work,22,23,1
6688,7,home,23,24,1
6689,1,home,0,8,8
6689,2,work,8,13,5
6689,3,home,13,24,11
6690,1,home,0,8,8
6690,2,work,8,15,7
6690,3,shop,15,16,1
6690,4,work,16,20,4
6690,5,home,20,24,4
6691,1,home,0,6,6
6691,2,work,6,13,7
6691,3,home,13,24,11
6692,1,home,0,6,6
6692,2,shop,6,7,1
6692,3,work,7,15,8
6692,4,home,15,24,9
6693,1,home,0,7,7
6693,2,work,7,13,6
6693,3,home,13,18,5
6693,4,work,18,20,2
6693,5,home,20,24,4
6694,1,home,0,7,7
6694,2,education,7,11,4
6694,3,home,11,18,7
6694,4,shop,18,19,1
6694,5,home,19,24,5
6695,1,home,0,7,7
6695,2,work,7,14,7
6695,3,home,14,24,10
6696,1,home,0,6,6
6696,2,work,6,8,2
6696,3,home,8,14,6
6696,4,work,14,17,3
6696,5,home,17,24,7
6697,1,home,0,8,8
6697,2,work,8,15,7
6697,3,shop,15,16,1
6697,4,home,16,24,8
6698,1,home,0,6,6
6698,2,work,6,13,7
6698,3,shop,13,14,1
6698,4,home,14,24,10
6699,1,home,0,8,8
6699,2,work,8,16,8
6699,3,home,16,21,5
6699,4,work,21,22,1
6699,5,home,22,24,2
6700,1,home,0,8,8
6700,2,work,8,15,7
6700,3,home,15,22,7
6700,4,work,22,23,1
6700,5,home,23,24,1
6701,1,home,0,7,7
6701,2,work,7,14,7
6701,3,home,14,24,10
6702,1,home,0,7,7
6702,2,work,7,14,7
6702,3,home,14,22,8
6702,4,work,22,23,1
6702,5,home,23,24,1
6703,1,home,0,8,8
6703,2,work,8,15,7
6703,3,home,15,24,9
6704,1,home,0,6,6
6704,2,work,6,13,7
6704,3,home,13,18,5
6704,4,shop,18,19,1
6704,5,home,19,24,5
6705,1,home,0,7,7
6705,2,work,7,14,7
6705,3,home,14,18,4
6705,4,work,18,20,2
6705,5,home,20,24,4
6706,1,home,0,6,6
6706,2,shop,6,7,1
6706,3,home,7,10,3
6706,4,education,10,13,3
6706,5,home,13,20,7
6706,6,shop,20,21,1
6706,7,home,21,24,3
6707,1,home,0,8,8
6707,2,education,8,11,3
6707,3,home,11,18,7
6707,4,shop,18,19,1
6707,5,home,19,24,5
6708,1,home,0,6,6
6708,2,shop,6,7,1
6708,3,work,7,15,8
6708,4,home,15,24,9
6709,1,home,0,7,7
6709,2,education,7,11,4
6709,3,home,11,15,4
6709,4,shop,15,17,2
6709,5,home,17,24,7
6710,1,home,0,7,7
6710,2,work,7,13,6
6710,3,home,13,17,4
6710,4,work,17,20,3
6710,5,home,20,24,4
6711,1,home,0,7,7
6711,2,education,7,12,5
6711,3,home,12,18,6
6711,4,shop,18,20,2
6711,5,home,20,24,4
6712,1,home,0,7,7
6712,2,work,7,15,8
6712,3,shop,15,16,1
6712,4,home,16,24,8
6713,1,home,0,8,8
6713,2,work,8,15,7
6713,3,home,15,24,9
6714,1,home,0,6,6
6714,2,work,6,13,7
6714,3,home,13,24,11
6715,1,home,0,7,7
6715,2,work,7,14,7
6715,3,home,14,18,4
6715,4,shop,18,19,1
6715,5,home,19,24,5
6716,1,home,0,7,7
6716,2,work,7,13,6
6716,3,home,13,24,11
6717,1,home,0,8,8
6717,2,work,8,14,6
6717,3,shop,14,15,1
6717,4,home,15,24,9
6718,1,home,0,7,7
6718,2,work,7,13,6
6718,3,home,13,18,5
6718,4,shop,18,19,1
6718,5,home,19,24,5
6719,1,home,0,9,9
6719,2,work,9,17,8
6719,3,home,17,24,7
6720,1,home,0,7,7
6720,2,work,7,14,7
6720,3,shop,14,15,1
6720,4,work,15,16,1
6720,5,home,16,24,8
6721,1,home,0,6,6
6721,2,work,6,7,1
6721,3,home,7,9,2
6721,4,work,9,10,1
6721,5,home,10,13,3
6721,6,work,13,15,2
6721,7,home,15,21,6
6721,8,work,21,22,1
6721,9,home,22,24,2
6722,1,home,0,7,7
6722,2,work,7,13,6
6722,3,shop,13,14,1
6722,4,home,14,16,2
6722,5,work,16,20,4
6722,6,home,20,24,4
6723,1,home,0,8,8
6723,2,work,8,15,7
6723,3,home,15,21,6
6723,4,work,21,22,1
6723,5,home,22,24,2
6724,1,home,0,7,7
6724,2,shop,7,8,1
6724,3,education,8,11,3
6724,4,home,11,14,3
6724,5,education,14,16,2
6724,6,home,16,24,8
6725,1,home,0,6,6
6725,2,work,6,13,7
6725,3,shop,13,14,1
6725,4,work,14,19,5
6725,5,home,19,24,5
6726,1,home,0,6,6
6726,2,work,6,13,7
6726,3,home,13,21,8
6726,4,work,21,22,1
6726,5,home,22,24,2
6727,1,home,0,7,7
6727,2,work,7,14,7
6727,3,home,14,22,8
6727,4,work,22,23,1
6727,5,home,23,24,1
6728,1,home,0,6,6
6728,2,shop,6,7,1
6728,3,home,7,10,3
6728,4,education,10,13,3
6728,5,shop,13,15,2
6728,6,home,15,24,9
6729,1,home,0,7,7
6729,2,work,7,13,6
6729,3,home,13,17,4
6729,4,work,17,20,3
6729,5,home,20,24,4
6730,1,home,0,7,7
6730,2,work,7,13,6
6730,3,shop,13,14,1
6730,4,work,14,19,5
6730,5,home,19,24,5
6731,1,home,0,7,7
6731,2,shop,7,8,1
6731,3,work,8,15,7
6731,4,home,15,24,9
6732,1,home,0,7,7
6732,2,education,7,12,5
6732,3,home,12,19,7
6732,4,shop,19,20,1
6732,5,home,20,24,4
6733,1,home,0,9,9
6733,2,shop,9,10,1
6733,3,home,10,16,6
6733,4,work,16,20,4
6733,5,home,20,24,4
6734,1,home,0,6,6
6734,2,work,6,13,7
6734,3,home,13,21,8
6734,4,shop,21,22,1
6734,5,home,22,24,2
6735,1,home,0,7,7
6735,2,education,7,11,4
6735,3,home,11,14,3
6735,4,education,14,16,2
6735,5,home,16,24,8
6736,1,home,0,7,7
6736,2,work,7,14,7
6736,3,home,14,24,10
6737,1,home,0,7,7
6737,2,education,7,12,5
6737,3,home,12,18,6
6737,4,shop,18,19,1
6737,5,home,19,24,5
6738,1,home,0,7,7
6738,2,education,7,12,5
6738,3,shop,12,14,2
6738,4,home,14,24,10
6739,1,home,0,7,7
6739,2,shop,7,8,1
6739,3,education,8,11,3
6739,4,home,11,16,5
6739,5,shop,16,18,2
6739,6,home,18,24,6
6740,1,home,0,7,7
6740,2,work,7,13,6
6740,3,home,13,23,10
6740,4,work,23,24,1
6741,1,home,0,6,6
6741,2,shop,6,7,1
6741,3,home,7,10,3
6741,4,education,10,12,2
6741,5,shop,12,14,2
6741,6,education,14,16,2
6741,7,home,16,24,8
6742,1,home,0,8,8
6742,2,work,8,15,7
6742,3,home,15,24,9
6743,1,home,0,7,7
6743,2,work,7,15,8
6743,3,home,15,23,8
6743,4,work,23,24,1
6744,1,home,0,8,8
6744,2,work,8,16,8
6744,3,shop,16,17,1
6744,4,work,17,20,3
6744,5,home,20,24,4
6745,1,home,0,6,6
6745,2,work,6,13,7
6745,3,shop,13,15,2
6745,4,work,15,20,5
6745,5,home,20,24,4
6746,1,home,0,6,6
6746,2,work,6,14,8
6746,3,home,14,24,10
6747,1,home,0,6,6
6747,2,work,6,13,7
6747,3,home,13,24,11
6748,1,home,0,8,8
6748,2,shop,8,9,1
6748,3,home,9,16,7
6748,4,work,16,20,4
6748,5,home,20,24,4
6749,1,home,0,7,7
6749,2,shop,7,8,1
6749,3,home,8,12,4
6749,4,work,12,19,7
6749,5,home,19,24,5
6750,1,home,0,7,7
6750,2,shop,7,8,1
6750,3,education,8,12,4
6750,4,home,12,18,6
6750,5,shop,18,19,1
6750,6,home,19,24,5
6751,1,home,0,6,6
6751,2,shop,6,8,2
6751,3,home,8,13,5
6751,4,education,13,16,3
6751,5,home,16,21,5
6751,6,work,21,22,1
6751,7,home,22,24,2
6752,1,home,0,8,8
6752,2,work,8,15,7
6752,3,shop,15,16,1
6752,4,home,16,24,8
6753,1,home,0,8,8
6753,2,work,8,15,7
6753,3,home,15,16,1
6753,4,work,16,20,4
6753,5,home,20,24,4
6754,1,home,0,9,9
6754,2,shop,9,10,1
6754,3,work,10,17,7
6754,4,home,17,24,7
6755,1,home,0,6,6
6755,2,work,6,13,7
6755,3,home,13,18,5
6755,4,work,18,20,2
6755,5,home,20,24,4
6756,1,home,0,9,9
6756,2,work,9,16,7
6756,3,home,16,21,5
6756,4,shop,21,22,1
6756,5,home,22,24,2
6757,1,home,0,9,9
6757,2,education,9,14,5
6757,3,home,14,24,10
6758,1,home,0,6,6
6758,2,shop,6,7,1
6758,3,work,7,13,6
6758,4,home,13,21,8
6758,5,work,21,22,1
6758,6,home,22,24,2
6759,1,home,0,8,8
6759,2,work,8,14,6
6759,3,home,14,24,10
6760,1,home,0,7,7
6760,2,work,7,13,6
6760,3,home,13,17,4
6760,4,work,17,20,3
6760,5,home,20,24,4
6761,1,home,0,7,7
6761,2,education,7,11,4
6761,3,home,11,18,7
6761,4,shop,18,20,2
6761,5,home,20,24,4
6762,1,work,0,1,1
6762,2,home,1,8,7
6762,3,education,8,11,3
6762,4,home,11,18,7
6762,5,shop,18,19,1
6762,6,home,19,24,5
6763,1,home,0,7,7
6763,2,work,7,9,2
6763,3,home,9,15,6
6763,4,work,15,17,2
6763,5,home,17,23,6
6763,6,work,23,24,1
6764,1,home,0,6,6
6764,2,work,6,13,7
6764,3,home,13,22,9
6764,4,work,22,23,1
6764,5,home,23,24,1
6765,1,home,0,7,7
6765,2,shop,7,8,1
6765,3,education,8,11,3
6765,4,home,11,17,6
6765,5,shop,17,19,2
6765,6,home,19,24,5
6766,1,home,0,7,7
6766,2,education,7,12,5
6766,3,shop,12,14,2
6766,4,home,14,24,10
6767,1,home,0,7,7
6767,2,work,7,14,7
6767,3,shop,14,15,1
6767,4,work,15,20,5
6767,5,home,20,24,4
6768,1,home,0,8,8
6768,2,work,8,14,6
6768,3,home,14,24,10
6769,1,home,0,6,6
6769,2,shop,6,7,1
6769,3,home,7,10,3
6769,4,education,10,12,2
6769,5,home,12,17,5
6769,6,shop,17,19,2
6769,7,home,19,24,5
6770,1,home,0,7,7
6770,2,shop,7,9,2
6770,3,education,9,12,3
6770,4,home,12,19,7
6770,5,shop,19,20,1
6770,6,home,20,24,4
6771,1,home,0,7,7
6771,2,work,7,13,6
6771,3,home,13,21,8
6771,4,work,21,22,1
6771,5,home,22,24,2
6772,1,work,0,7,7
6772,2,shop,7,8,1
6772,3,work,8,13,5
6772,4,shop,13,14,1
6772,5,education,14,17,3
6772,6,home,17,24,7
6773,1,home,0,7,7
6773,2,shop,7,8,1
6773,3,education,8,11,3
6773,4,home,11,19,8
6773,5,shop,19,21,2
6773,6,home,21,24,3
6774,1,home,0,7,7
6774,2,education,7,11,4
6774,3,home,11,18,7
6774,4,shop,18,19,1
6774,5,home,19,24,5
6775,1,home,0,6,6
6775,2,work,6,7,1
6775,3,home,7,11,4
6775,4,work,11,13,2
6775,5,home,13,22,9
6775,6,work,22,23,1
6775,7,home,23,24,1
6776,1,home,0,6,6
6776,2,work,6,13,7
6776,3,shop,13,14,1
6776,4,work,14,20,6
6776,5,home,20,24,4
6777,1,home,0,6,6
6777,2,work,6,13,7
6777,3,home,13,16,3
6777,4,work,16,20,4
6777,5,home,20,24,4
6778,1,home,0,7,7
6778,2,work,7,11,4
6778,3,home,11,17,6
6778,4,work,17,19,2
6778,5,home,19,24,5
6779,1,home,0,6,6
6779,2,work,6,13,7
6779,3,home,13,21,8
6779,4,work,21,22,1
6779,5,home,22,24,2
6780,1,home,0,6,6
6780,2,work,6,8,2
6780,3,home,8,14,6
6780,4,work,14,16,2
6780,5,home,16,23,7
6780,6,work,23,24,1
6781,1,home,0,8,8
6781,2,work,8,10,2
6781,3,home,10,13,3
6781,4,work,13,14,1
6781,5,home,14,21,7
6781,6,work,21,22,1
6781,7,home,22,24,2
6782,1,home,0,7,7
6782,2,shop,7,8,1
6782,3,education,8,12,4
6782,4,home,12,13,1
6782,5,education,13,16,3
6782,6,home,16,24,8
6783,1,home,0,8,8
6783,2,work,8,15,7
6783,3,home,15,24,9
6784,1,home,0,8,8
6784,2,education,8,12,4
6784,3,home,12,24,12
6785,1,home,0,8,8
6785,2,work,8,15,7
6785,3,home,15,20,5
6785,4,shop,20,21,1
6785,5,home,21,24,3
6786,1,home,0,7,7
6786,2,work,7,13,6
6786,3,shop,13,14,1
6786,4,work,14,20,6
6786,5,home,20,24,4
6787,1,home,0,8,8
6787,2,work,8,15,7
6787,3,home,15,24,9
6788,1,home,0,6,6
6788,2,shop,6,7,1
6788,3,work,7,14,7
6788,4,home,14,24,10
6789,1,home,0,6,6
6789,2,work,6,8,2
6789,3,home,8,15,7
6789,4,work,15,17,2
6789,5,home,17,24,7
6790,1,home,0,6,6
6790,2,work,6,12,6
6790,3,shop,12,13,1
6790,4,work,13,19,6
6790,5,education,19,20,1
6790,6,home,20,24,4
6791,1,home,0,7,7
6791,2,work,7,14,7
6791,3,shop,14,15,1
6791,4,home,15,24,9
6792,1,home,0,6,6
6792,2,shop,6,7,1
6792,3,home,7,9,2
6792,4,education,9,12,3
6792,5,home,12,19,7
6792,6,shop,19,20,1
6792,7,home,20,24,4
6793,1,home,0,7,7
6793,2,work,7,13,6
6793,3,shop,13,14,1
6793,4,work,14,19,5
6793,5,home,19,24,5
6794,1,home,0,6,6
6794,2,shop,6,7,1
6794,3,home,7,11,4
6794,4,work,11,17,6
6794,5,home,17,24,7
6795,1,home,0,6,6
6795,2,shop,6,8,2
6795,3,home,8,9,1
6795,4,education,9,12,3
6795,5,home,12,17,5
6795,6,work,17,20,3
6795,7,home,20,24,4
6796,1,home,0,7,7
6796,2,work,7,13,6
6796,3,shop,13,14,1
6796,4,work,14,19,5
6796,5,home,19,24,5
6797,1,home,0,8,8
6797,2,work,8,14,6
6797,3,shop,14,15,1
6797,4,home,15,23,8
6797,5,work,23,24,1
6798,1,home,0,8,8
6798,2,shop,8,9,1
6798,3,home,9,12,3
6798,4,education,12,16,4
6798,5,home,16,24,8
6799,1,home,0,7,7
6799,2,work,7,14,7
6799,3,home,14,24,10
6800,1,home,0,6,6
6800,2,work,6,13,7
6800,3,home,13,24,11
6801,1,home,0,7,7
6801,2,work,7,13,6
6801,3,shop,13,14,1
6801,4,home,14,22,8
6801,5,work,22,23,1
6801,6,home,23,24,1
6802,1,home,0,6,6
6802,2,work,6,13,7
6802,3,home,13,24,11
6803,1,home,0,7,7
6803,2,work,7,13,6
6803,3,home,13,17,4
6803,4,work,17,20,3
6803,5,home,20,24,4
6804,1,home,0,8,8
6804,2,work,8,15,7
6804,3,home,15,19,4
6804,4,shop,19,20,1
6804,5,home,20,24,4
6805,1,home,0,6,6
6805,2,shop,6,7,1
6805,3,work,7,13,6
6805,4,home,13,17,4
6805,5,work,17,20,3
6805,6,home,20,24,4
6806,1,home,0,7,7
6806,2,education,7,12,5
6806,3,home,12,19,7
6806,4,shop,19,20,1
6806,5,home,20,24,4
6807,1,home,0,7,7
6807,2,work,7,12,5
6807,3,shop,12,13,1
6807,4,education,13,16,3
6807,5,shop,16,17,1
6807,6,work,17,20,3
6807,7,home,20,24,4
6808,1,home,0,8,8
6808,2,work,8,16,8
6808,3,home,16,24,8
6809,1,home,0,8,8
6809,2,work,8,15,7
6809,3,home,15,21,6
6809,4,work,21,22,1
6809,5,home,22,24,2
6810,1,home,0,8,8
6810,2,work,8,15,7
6810,3,home,15,24,9
6811,1,home,0,6,6
6811,2,work,6,8,2
6811,3,home,8,14,6
6811,4,work,14,16,2
6811,5,home,16,21,5
6811,6,work,21,22,1
6811,7,home,22,24,2
6812,1,home,0,7,7
6812,2,shop,7,8,1
6812,3,work,8,14,6
6812,4,home,14,24,10
6813,1,home,0,6,6
6813,2,shop,6,7,1
6813,3,work,7,14,7
6813,4,home,14,17,3
6813,5,work,17,20,3
6813,6,home,20,24,4
6814,1,home,0,6,6
6814,2,shop,6,7,1
6814,3,home,7,13,6
6814,4,education,13,16,3
6814,5,home,16,24,8
6815,1,home,0,7,7
6815,2,shop,7,8,1
6815,3,home,8,22,14
6815,4,work,22,23,1
6815,5,home,23,24,1
6816,1,home,0,7,7
6816,2,shop,7,8,1
6816,3,education,8,11,3
6816,4,home,11,13,2
6816,5,education,13,16,3
6816,6,home,16,24,8
6817,1,home,0,6,6
6817,2,work,6,12,6
6817,3,shop,12,13,1
6817,4,work,13,19,6
6817,5,education,19,20,1
6817,6,home,20,24,4
6818,1,home,0,6,6
6818,2,work,6,14,8
6818,3,home,14,24,10
6819,1,home,0,7,7
6819,2,work,7,13,6
6819,3,home,13,17,4
6819,4,shop,17,18,1
6819,5,home,18,24,6
6820,1,home,0,6,6
6820,2,shop,6,7,1
6820,3,home,7,10,3
6820,4,education,10,13,3
6820,5,shop,13,15,2
6820,6,home,15,24,9
6821,1,home,0,8,8
6821,2,education,8,11,3
6821,3,home,11,16,5
6821,4,shop,16,17,1
6821,5,home,17,24,7
6822,1,home,0,8,8
6822,2,work,8,14,6
6822,3,shop,14,15,1
6822,4,home,15,24,9
6823,1,home,0,7,7
6823,2,education,7,11,4
6823,3,home,11,18,7
6823,4,shop,18,19,1
6823,5,home,19,24,5
6824,1,home,0,6,6
6824,2,work,6,13,7
6824,3,home,13,18,5
6824,4,shop,18,19,1
6824,5,home,19,24,5
6825,1,home,0,8,8
6825,2,work,8,15,7
6825,3,home,15,22,7
6825,4,work,22,23,1
6825,5,home,23,24,1
6826,1,home,0,7,7
6826,2,education,7,12,5
6826,3,shop,12,13,1
6826,4,home,13,21,8
6826,5,shop,21,22,1
6826,6,home,22,24,2
6827,1,home,0,7,7
6827,2,work,7,14,7
6827,3,home,14,21,7
6827,4,work,21,22,1
6827,5,home,22,24,2
6828,1,home,0,6,6
6828,2,work,6,13,7
6828,3,home,13,20,7
6828,4,shop,20,21,1
6828,5,home,21,24,3
6829,1,home,0,8,8
6829,2,work,8,15,7
6829,3,home,15,22,7
6829,4,work,22,23,1
6829,5,home,23,24,1
6830,1,home,0,7,7
6830,2,work,7,14,7
6830,3,home,14,24,10
6831,1,home,0,6,6
6831,2,shop,6,7,1
6831,3,home,7,9,2
6831,4,education,9,12,3
6831,5,shop,12,14,2
6831,6,education,14,16,2
6831,7,home,16,24,8
6832,1,home,0,8,8
6832,2,shop,8,9,1
6832,3,work,9,17,8
6832,4,home,17,22,5
6832,5,work,22,23,1
6832,6,home,23,24,1
6833,1,home,0,6,6
6833,2,shop,6,7,1
6833,3,work,7,13,6
6833,4,home,13,24,11
6834,1,home,0,7,7
6834,2,shop,7,8,1
6834,3,education,8,11,3
6834,4,home,11,13,2
6834,5,education,13,15,2
6834,6,shop,15,16,1
6834,7,home,16,24,8
6835,1,home,0,7,7
6835,2,work,7,14,7
6835,3,home,14,24,10
6836,1,home,0,7,7
6836,2,education,7,11,4
6836,3,home,11,17,6
6836,4,shop,17,18,1
6836,5,home,18,24,6
6837,1,home,0,7,7
6837,2,education,7,12,5
6837,3,shop,12,14,2
6837,4,education,14,16,2
6837,5,home,16,24,8
6838,1,home,0,6,6
6838,2,work,6,13,7
6838,3,shop,13,14,1
6838,4,work,14,20,6
6838,5,home,20,24,4
6839,1,home,0,6,6
6839,2,shop,6,7,1
6839,3,work,7,13,6
6839,4,home,13,17,4
6839,5,work,17,20,3
6839,6,home,20,24,4
6840,1,home,0,9,9
6840,2,work,9,16,7
6840,3,home,16,24,8
6841,1,home,0,6,6
6841,2,work,6,8,2
6841,3,home,8,9,1
6841,4,work,9,12,3
6841,5,home,12,21,9
6841,6,work,21,22,1
6841,7,home,22,24,2
6842,1,home,0,7,7
6842,2,work,7,9,2
6842,3,home,9,15,6
6842,4,work,15,17,2
6842,5,home,17,22,5
6842,6,work,22,23,1
6842,7,home,23,24,1
6843,1,home,0,7,7
6843,2,work,7,13,6
6843,3,home,13,24,11
6844,1,home,0,8,8
6844,2,work,8,15,7
6844,3,home,15,22,7
6844,4,work,22,23,1
6844,5,home,23,24,1
6845,1,home,0,8,8
6845,2,work,8,15,7
6845,3,shop,15,16,1
6845,4,work,16,20,4
6845,5,home,20,24,4
6846,1,home,0,6,6
6846,2,work,6,13,7
6846,3,home,13,17,4
6846,4,work,17,20,3
6846,5,home,20,24,4
6847,1,home,0,8,8
6847,2,education,8,11,3
6847,3,shop,11,12,1
6847,4,work,12,19,7
6847,5,home,19,22,3
6847,6,work,22,23,1
6847,7,home,23,24,1
6848,1,home,0,7,7
6848,2,work,7,13,6
6848,3,shop,13,14,1
6848,4,home,14,24,10
6849,1,home,0,8,8
6849,2,work,8,15,7
6849,3,home,15,24,9
6850,1,home,0,5,5
6850,2,work,5,13,8
6850,3,home,13,18,5
6850,4,work,18,20,2
6850,5,home,20,24,4
6851,1,home,0,6,6
6851,2,shop,6,7,1
6851,3,work,7,14,7
6851,4,home,14,22,8
6851,5,work,22,23,1
6851,6,home,23,24,1
6852,1,home,0,7,7
6852,2,work,7,14,7
6852,3,home,14,18,4
6852,4,work,18,20,2
6852,5,home,20,24,4
6853,1,home,0,7,7
6853,2,education,7,11,4
6853,3,home,11,14,3
6853,4,education,14,16,2
6853,5,home,16,20,4
6853,6,shop,20,21,1
6853,7,home,21,24,3
6854,1,home,0,7,7
6854,2,work,7,14,7
6854,3,home,14,18,4
6854,4,work,18,20,2
6854,5,home,20,24,4
6855,1,home,0,7,7
6855,2,work,7,14,7
6855,3,home,14,24,10
6856,1,home,0,7,7
6856,2,work,7,13,6
6856,3,home,13,24,11
6857,1,home,0,7,7
6857,2,shop,7,9,2
6857,3,education,9,12,3
6857,4,home,12,18,6
6857,5,shop,18,20,2
6857,6,home,20,24,4
6858,1,home,0,7,7
6858,2,work,7,15,8
6858,3,shop,15,16,1
6858,4,work,16,20,4
6858,5,home,20,24,4
6859,1,home,0,6,6
6859,2,work,6,13,7
6859,3,shop,13,14,1
6859,4,home,14,24,10
6860,1,home,0,6,6
6860,2,work,6,14,8
6860,3,shop,14,15,1
6860,4,home,15,24,9
6861,1,home,0,7,7
6861,2,work,7,13,6
6861,3,shop,13,15,2
6861,4,work,15,20,5
6861,5,home,20,24,4
6862,1,home,0,7,7
6862,2,work,7,13,6
6862,3,shop,13,14,1
6862,4,home,14,24,10
6863,1,home,0,6,6
6863,2,work,6,13,7
6863,3,home,13,17,4
6863,4,shop,17,18,1
6863,5,home,18,24,6
6864,1,home,0,6,6
6864,2,work,6,8,2
6864,3,home,8,14,6
6864,4,work,14,17,3
6864,5,home,17,23,6
6864,6,work,23,24,1
6865,1,home,0,7,7
6865,2,work,7,14,7
6865,3,shop,14,15,1
6865,4,work,15,20,5
6865,5,home,20,24,4
6866,1,home,0,7,7
6866,2,work,7,13,6
6866,3,home,13,18,5
6866,4,shop,18,20,2
6866,5,home,20,24,4
6867,1,home,0,8,8
6867,2,work,8,15,7
6867,3,shop,15,16,1
6867,4,home,16,24,8
6868,1,home,0,7,7
6868,2,work,7,13,6
6868,3,shop,13,14,1
6868,4,home,14,21,7
6868,5,work,21,22,1
6868,6,home,22,24,2
6869,1,home,0,8,8
6869,2,work,8,14,6
6869,3,home,14,24,10
6870,1,home,0,7,7
6870,2,work,7,13,6
6870,3,home,13,19,6
6870,4,shop,19,20,1
6870,5,home,20,24,4
6871,1,home,0,6,6
6871,2,shop,6,7,1
6871,3,home,7,9,2
6871,4,education,9,13,4
6871,5,work,13,19,6
6871,6,home,19,24,5
6872,1,home,0,7,7
6872,2,work,7,13,6
6872,3,home,13,17,4
6872,4,work,17,20,3
6872,5,home,20,24,4
6873,1,home,0,8,8
6873,2,work,8,15,7
6873,3,home,15,24,9
6874,1,home,0,8,8
6874,2,work,8,15,7
6874,3,shop,15,16,1
6874,4,work,16,20,4
6874,5,home,20,24,4
6875,1,home,0,7,7
6875,2,education,7,12,5
6875,3,shop,12,14,2
6875,4,home,14,18,4
6875,5,shop,18,19,1
6875,6,home,19,24,5
6876,1,home,0,6,6
6876,2,work,6,13,7
6876,3,shop,13,14,1
6876,4,work,14,19,5
6876,5,home,19,24,5
6877,1,home,0,7,7
6877,2,education,7,12,5
6877,3,home,12,20,8
6877,4,shop,20,21,1
6877,5,home,21,24,3
6878,1,home,0,8,8
6878,2,work,8,15,7
6878,3,home,15,21,6
6878,4,shop,21,22,1
6878,5,home,22,24,2
6879,1,home,0,9,9
6879,2,work,9,16,7
6879,3,home,16,24,8
6880,1,home,0,8,8
6880,2,work,8,15,7
6880,3,home,15,24,9
6881,1,home,0,6,6
6881,2,work,6,13,7
6881,3,shop,13,14,1
6881,4,work,14,19,5
6881,5,home,19,24,5
6882,1,home,0,8,8
6882,2,work,8,15,7
6882,3,home,15,23,8
6882,4,work,23,24,1
6883,1,home,0,8,8
6883,2,work,8,13,5
6883,3,home,13,23,10
6883,4,work,23,24,1
6884,1,home,0,7,7
6884,2,work,7,14,7
6884,3,home,14,18,4
6884,4,shop,18,19,1
6884,5,home,19,24,5
6885,1,home,0,7,7
6885,2,work,7,13,6
6885,3,home,13,16,3
6885,4,work,16,20,4
6885,5,home,20,24,4
6886,1,home,0,6,6
6886,2,work,6,13,7
6886,3,shop,13,14,1
6886,4,work,14,19,5
6886,5,home,19,24,5
6887,1,home,0,6,6
6887,2,work,6,13,7
6887,3,home,13,20,7
6887,4,shop,20,21,1
6887,5,home,21,24,3
6888,1,home,0,7,7
6888,2,education,7,12,5
6888,3,home,12,20,8
6888,4,shop,20,21,1
6888,5,home,21,24,3
6889,1,home,0,7,7
6889,2,work,7,9,2
6889,3,home,9,14,5
6889,4,work,14,17,3
6889,5,home,17,23,6
6889,6,work,23,24,1
6890,1,home,0,7,7
6890,2,work,7,13,6
6890,3,home,13,24,11
6891,1,home,0,7,7
6891,2,education,7,10,3
6891,3,home,10,14,4
6891,4,education,14,16,2
6891,5,home,16,24,8
6892,1,home,0,6,6
6892,2,work,6,13,7
6892,3,home,13,18,5
6892,4,work,18,20,2
6892,5,home,20,24,4
6893,1,home,0,7,7
6893,2,shop,7,8,1
6893,3,work,8,14,6
6893,4,home,14,23,9
6893,5,work,23,24,1
6894,1,home,0,7,7
6894,2,education,7,12,5
6894,3,home,12,16,4
6894,4,shop,16,17,1
6894,5,home,17,24,7
6895,1,home,0,7,7
6895,2,education,7,11,4
6895,3,home,11,19,8
6895,4,shop,19,21,2
6895,5,home,21,24,3
6896,1,home,0,7,7
6896,2,work,7,13,6
6896,3,home,13,17,4
6896,4,work,17,20,3
6896,5,home,20,24,4
6897,1,home,0,7,7
6897,2,work,7,13,6
6897,3,shop,13,14,1
6897,4,home,14,22,8
6897,5,work,22,23,1
6897,6,home,23,24,1
6898,1,home,0,7,7
6898,2,work,7,15,8
6898,3,home,15,24,9
6899,1,home,0,7,7
6899,2,work,7,14,7
6899,3,shop,14,15,1
6899,4,home,15,24,9
6900,1,home,0,7,7
6900,2,work,7,13,6
6900,3,shop,13,14,1
6900,4,work,14,19,5
6900,5,home,19,24,5
6901,1,home,0,8,8
6901,2,work,8,16,8
6901,3,home,16,19,3
6901,4,shop,19,20,1
6901,5,home,20,24,4
6902,1,home,0,6,6
6902,2,work,6,8,2
6902,3,home,8,12,4
6902,4,work,12,14,2
6902,5,home,14,22,8
6902,6,work,22,23,1
6902,7,home,23,24,1
6903,1,home,0,6,6
6903,2,work,6,13,7
6903,3,home,13,24,11
6904,1,home,0,7,7
6904,2,work,7,13,6
6904,3,home,13,24,11
6905,1,home,0,8,8
6905,2,work,8,12,4
6905,3,shop,12,13,1
6905,4,work,13,19,6
6905,5,home,19,24,5
6906,1,home,0,7,7
6906,2,work,7,13,6
6906,3,home,13,21,8
6906,4,work,21,22,1
6906,5,home,22,24,2
6907,1,home,0,7,7
6907,2,work,7,13,6
6907,3,home,13,18,5
6907,4,shop,18,19,1
6907,5,home,19,24,5
6908,1,home,0,7,7
6908,2,work,7,13,6
6908,3,home,13,20,7
6908,4,shop,20,21,1
6908,5,home,21,24,3
6909,1,home,0,6,6
6909,2,work,6,8,2
6909,3,home,8,14,6
6909,4,work,14,17,3
6909,5,home,17,21,4
6909,6,work,21,22,1
6909,7,home,22,24,2
6910,1,home,0,6,6
6910,2,shop,6,7,1
6910,3,work,7,14,7
6910,4,home,14,23,9
6910,5,work,23,24,1
6911,1,home,0,7,7
6911,2,work,7,13,6
6911,3,home,13,17,4
6911,4,work,17,20,3
6911,5,home,20,24,4
6912,1,home,0,8,8
6912,2,work,8,14,6
6912,3,shop,14,15,1
6912,4,work,15,20,5
6912,5,home,20,24,4
6913,1,home,0,8,8
6913,2,work,8,15,7
6913,3,home,15,22,7
6913,4,work,22,23,1
6913,5,home,23,24,1
6914,1,home,0,6,6
6914,2,work,6,8,2
6914,3,home,8,14,6
6914,4,work,14,17,3
6914,5,home,17,24,7
6915,1,home,0,8,8
6915,2,work,8,14,6
6915,3,home,14,18,4
6915,4,work,18,20,2
6915,5,home,20,24,4
6916,1,home,0,6,6
6916,2,shop,6,7,1
6916,3,home,7,10,3
6916,4,education,10,13,3
6916,5,home,13,24,11
6917,1,home,0,8,8
6917,2,work,8,15,7
6917,3,home,15,21,6
6917,4,shop,21,22,1
6917,5,home,22,24,2
6918,1,home,0,7,7
6918,2,work,7,14,7
6918,3,shop,14,16,2
6918,4,work,16,19,3
6918,5,home,19,24,5
6919,1,home,0,7,7
6919,2,work,7,13,6
6919,3,shop,13,14,1
6919,4,home,14,23,9
6919,5,work,23,24,1
6920,1,home,0,6,6
6920,2,work,6,13,7
6920,3,home,13,24,11
6921,1,home,0,6,6
6921,2,work,6,13,7
6921,3,home,13,17,4
6921,4,shop,17,18,1
6921,5,home,18,23,5
6921,6,work,23,24,1
6922,1,home,0,7,7
6922,2,work,7,13,6
6922,3,shop,13,14,1
6922,4,home,14,21,7
6922,5,work,21,22,1
6922,6,home,22,24,2
6923,1,home,0,6,6
6923,2,shop,6,7,1
6923,3,home,7,13,6
6923,4,education,13,16,3
6923,5,home,16,24,8
6924,1,home,0,7,7
6924,2,shop,7,9,2
6924,3,education,9,11,2
6924,4,home,11,20,9
6924,5,shop,20,21,1
6924,6,home,21,24,3
6925,1,home,0,7,7
6925,2,shop,7,8,1
6925,3,education,8,11,3
6925,4,home,11,14,3
6925,5,education,14,16,2
6925,6,home,16,21,5
6925,7,shop,21,22,1
6925,8,home,22,24,2
6926,1,home,0,7,7
6926,2,work,7,14,7
6926,3,home,14,17,3
6926,4,work,17,20,3
6926,5,home,20,24,4
6927,1,home,0,8,8
6927,2,shop,8,9,1
6927,3,work,9,15,6
6927,4,home,15,24,9
6928,1,home,0,8,8
6928,2,work,8,13,5
6928,3,shop,13,15,2
6928,4,home,15,24,9
6929,1,home,0,7,7
6929,2,work,7,13,6
6929,3,home,13,16,3
6929,4,work,16,20,4
6929,5,home,20,24,4
6930,1,home,0,6,6
6930,2,work,6,13,7
6930,3,shop,13,14,1
6930,4,work,14,18,4
6930,5,home,18,24,6
6931,1,home,0,8,8
6931,2,work,8,15,7
6931,3,shop,15,16,1
6931,4,home,16,24,8
6932,1,home,0,9,9
6932,2,shop,9,10,1
6932,3,home,10,16,6
6932,4,work,16,20,4
6932,5,home,20,24,4
6933,1,home,0,6,6
6933,2,shop,6,7,1
6933,3,home,7,10,3
6933,4,education,10,13,3
6933,5,home,13,14,1
6933,6,education,14,17,3
6933,7,shop,17,18,1
6933,8,home,18,24,6
6934,1,home,0,6,6
6934,2,work,6,13,7
6934,3,home,13,19,6
6934,4,shop,19,20,1
6934,5,home,20,24,4
6935,1,home,0,7,7
6935,2,education,7,11,4
6935,3,home,11,19,8
6935,4,shop,19,20,1
6935,5,home,20,24,4
6936,1,home,0,6,6
6936,2,work,6,12,6
6936,3,shop,12,13,1
6936,4,work,13,19,6
6936,5,home,19,24,5
6937,1,home,0,7,7
6937,2,work,7,14,7
6937,3,home,14,18,4
6937,4,shop,18,19,1
6937,5,home,19,24,5
6938,1,home,0,7,7
6938,2,work,7,14,7
6938,3,home,14,16,2
6938,4,work,16,20,4
6938,5,home,20,24,4
6939,1,home,0,7,7
6939,2,shop,7,9,2
6939,3,education,9,12,3
6939,4,home,12,13,1
6939,5,education,13,16,3
6939,6,shop,16,17,1
6939,7,home,17,24,7
6940,1,home,0,7,7
6940,2,work,7,14,7
6940,3,home,14,23,9
6940,4,work,23,24,1
6941,1,home,0,7,7
6941,2,work,7,15,8
6941,3,home,15,21,6
6941,4,shop,21,22,1
6941,5,home,22,24,2
6942,1,home,0,7,7
6942,2,work,7,14,7
6942,3,shop,14,15,1
6942,4,home,15,22,7
6942,5,work,22,23,1
6942,6,home,23,24,1
6943,1,home,0,6,6
6943,2,work,6,8,2
6943,3,home,8,12,4
6943,4,work,12,14,2
6943,5,home,14,17,3
6943,6,shop,17,18,1
6943,7,home,18,23,5
6943,8,work,23,24,1
6944,1,home,0,8,8
6944,2,work,8,14,6
6944,3,home,14,24,10
6945,1,home,0,7,7
6945,2,education,7,11,4
6945,3,home,11,18,7
6945,4,shop,18,20,2
6945,5,home,20,24,4
6946,1,home,0,6,6
6946,2,work,6,13,7
6946,3,home,13,17,4
6946,4,work,17,20,3
6946,5,home,20,24,4
6947,1,home,0,6,6
6947,2,work,6,8,2
6947,3,home,8,9,1
6947,4,work,9,11,2
6947,5,home,11,16,5
6947,6,work,16,18,2
6947,7,home,18,23,5
6947,8,work,23,24,1
6948,1,home,0,6,6
6948,2,work,6,8,2
6948,3,home,8,12,4
6948,4,work,12,14,2
6948,5,home,14,20,6
6948,6,shop,20,21,1
6948,7,home,21,24,3
6949,1,home,0,9,9
6949,2,work,9,16,7
6949,3,home,16,24,8
6950,1,home,0,7,7
6950,2,work,7,14,7
6950,3,home,14,18,4
6950,4,work,18,20,2
6950,5,home,20,24,4
6951,1,home,0,8,8
6951,2,work,8,14,6
6951,3,home,14,24,10
6952,1,home,0,8,8
6952,2,work,8,15,7
6952,3,shop,15,16,1
6952,4,home,16,24,8
6953,1,home,0,7,7
6953,2,work,7,13,6
6953,3,home,13,21,8
6953,4,work,21,22,1
6953,5,home,22,24,2
6954,1,home,0,6,6
6954,2,work,6,13,7
6954,3,shop,13,15,2
6954,4,work,15,19,4
6954,5,home,19,24,5
6955,1,home,0,6,6
6955,2,work,6,13,7
6955,3,shop,13,14,1
6955,4,home,14,18,4
6955,5,shop,18,19,1
6955,6,home,19,24,5
6956,1,home,0,8,8
6956,2,work,8,13,5
6956,3,shop,13,14,1
6956,4,home,14,24,10
6957,1,home,0,7,7
6957,2,education,7,11,4
6957,3,home,11,13,2
6957,4,education,13,16,3
6957,5,home,16,20,4
6957,6,shop,20,21,1
6957,7,home,21,24,3
6958,1,home,0,7,7
6958,2,work,7,13,6
6958,3,shop,13,14,1
6958,4,home,14,24,10
6959,1,home,0,7,7
6959,2,work,7,14,7
6959,3,home,14,19,5
6959,4,shop,19,20,1
6959,5,home,20,24,4
6960,1,home,0,6,6
6960,2,shop,6,7,1
6960,3,home,7,10,3
6960,4,education,10,13,3
6960,5,home,13,19,6
6960,6,shop,19,20,1
6960,7,home,20,24,4
6961,1,home,0,7,7
6961,2,work,7,9,2
6961,3,home,9,13,4
6961,4,work,13,15,2
6961,5,home,15,19,4
6961,6,shop,19,20,1
6961,7,home,20,24,4
6962,1,home,0,7,7
6962,2,shop,7,8,1
6962,3,education,8,11,3
6962,4,home,11,17,6
6962,5,shop,17,18,1
6962,6,home,18,24,6
6963,1,home,0,8,8
6963,2,education,8,12,4
6963,3,shop,12,13,1
6963,4,work,13,19,6
6963,5,home,19,24,5
6964,1,home,0,8,8
6964,2,work,8,15,7
6964,3,shop,15,16,1
6964,4,work,16,19,3
6964,5,home,19,24,5
6965,1,home,0,7,7
6965,2,education,7,11,4
6965,3,home,11,17,6
6965,4,shop,17,18,1
6965,5,home,18,24,6
6966,1,home,0,6,6
6966,2,work,6,13,7
6966,3,home,13,24,11
6967,1,home,0,6,6
6967,2,shop,6,7,1
6967,3,home,7,13,6
6967,4,education,13,16,3
6967,5,home,16,24,8
6968,1,home,0,7,7
6968,2,work,7,14,7
6968,3,home,14,22,8
6968,4,work,22,23,1
6968,5,home,23,24,1
6969,1,home,0,8,8
6969,2,work,8,13,5
6969,3,home,13,21,8
6969,4,shop,21,22,1
6969,5,home,22,24,2
6970,1,home,0,6,6
6970,2,shop,6,7,1
6970,3,work,7,13,6
6970,4,home,13,24,11
6971,1,home,0,7,7
6971,2,work,7,13,6
6971,3,home,13,21,8
6971,4,shop,21,22,1
6971,5,home,22,24,2
6972,1,home,0,7,7
6972,2,shop,7,8,1
6972,3,home,8,15,7
6972,4,work,15,20,5
6972,5,home,20,24,4
6973,1,home,0,6,6
6973,2,work,6,13,7
6973,3,shop,13,14,1
6973,4,work,14,19,5
6973,5,home,19,24,5
6974,1,home,0,8,8
6974,2,work,8,14,6
6974,3,shop,14,15,1
6974,4,home,15,24,9
6975,1,home,0,7,7
6975,2,education,7,12,5
6975,3,shop,12,13,1
6975,4,education,13,15,2
6975,5,shop,15,17,2
6975,6,home,17,24,7
6976,1,home,0,8,8
6976,2,work,8,15,7
6976,3,home,15,24,9
6977,1,home,0,6,6
6977,2,work,6,13,7
6977,3,home,13,24,11
6978,1,home,0,7,7
6978,2,work,7,14,7
6978,3,shop,14,15,1
6978,4,home,15,20,5
6978,5,shop,20,21,1
6978,6,home,21,24,3
6979,1,home,0,7,7
6979,2,work,7,14,7
6979,3,home,14,18,4
6979,4,work,18,20,2
6979,5,home,20,24,4
6980,1,home,0,8,8
6980,2,shop,8,10,2
6980,3,work,10,17,7
6980,4,home,17,24,7
6981,1,home,0,7,7
6981,2,education,7,11,4
6981,3,home,11,18,7
6981,4,shop,18,19,1
6981,5,home,19,24,5
6982,1,home,0,7,7
6982,2,work,7,13,6
6982,3,shop,13,15,2
6982,4,home,15,24,9
6983,1,home,0,8,8
6983,2,work,8,14,6
6983,3,home,14,24,10
6984,1,home,0,6,6
6984,2,shop,6,7,1
6984,3,home,7,9,2
6984,4,education,9,12,3
6984,5,home,12,14,2
6984,6,education,14,17,3
6984,7,home,17,24,7
6985,1,home,0,7,7
6985,2,work,7,16,9
6985,3,home,16,21,5
6985,4,work,21,22,1
6985,5,home,22,24,2
6986,1,home,0,7,7
6986,2,education,7,11,4
6986,3,home,11,19,8
6986,4,shop,19,20,1
6986,5,home,20,24,4
6987,1,home,0,7,7
6987,2,shop,7,9,2
6987,3,education,9,11,2
6987,4,home,11,20,9
6987,5,shop,20,21,1
6987,6,home,21,24,3
6988,1,home,0,6,6
6988,2,shop,6,7,1
6988,3,work,7,8,1
6988,4,home,8,12,4
6988,5,work,12,14,2
6988,6,home,14,21,7
6988,7,work,21,22,1
6988,8,home,22,24,2
6989,1,home,0,6,6
6989,2,work,6,14,8
6989,3,home,14,24,10
6990,1,home,0,6,6
6990,2,shop,6,7,1
6990,3,home,7,9,2
6990,4,education,9,12,3
6990,5,work,12,19,7
6990,6,home,19,24,5
6991,1,home,0,6,6
6991,2,shop,6,7,1
6991,3,home,7,13,6
6991,4,education,13,16,3
6991,5,shop,16,18,2
6991,6,home,18,24,6
6992,1,home,0,7,7
6992,2,work,7,13,6
6992,3,shop,13,14,1
6992,4,home,14,18,4
6992,5,work,18,20,2
6992,6,home,20,24,4
6993,1,home,0,7,7
6993,2,work,7,13,6
6993,3,home,13,22,9
6993,4,work,22,23,1
6993,5,home,23,24,1
6994,1,home,0,8,8
6994,2,work,8,15,7
6994,3,shop,15,16,1
6994,4,work,16,20,4
6994,5,home,20,24,4
6995,1,home,0,7,7
6995,2,shop,7,8,1
6995,3,education,8,11,3
6995,4,home,11,16,5
6995,5,shop,16,17,1
6995,6,home,17,24,7
6996,1,home,0,6,6
6996,2,work,6,8,2
6996,3,home,8,12,4
6996,4,work,12,14,2
6996,5,home,14,20,6
6996,6,shop,20,21,1
6996,7,home,21,24,3
6997,1,home,0,7,7
6997,2,work,7,13,6
6997,3,shop,13,14,1
6997,4,home,14,18,4
6997,5,shop,18,19,1
6997,6,home,19,24,5
6998,1,home,0,6,6
6998,2,work,6,13,7
6998,3,shop,13,14,1
6998,4,home,14,24,10
6999,1,home,0,8,8
6999,2,work,8,15,7
6999,3,home,15,21,6
6999,4,work,21,22,1
6999,5,home,22,24,2
7000,1,home,0,7,7
7000,2,work,7,13,6
7000,3,shop,13,14,1
7000,4,home,14,24,10
7001,1,home,0,6,6
7001,2,work,6,13,7
7001,3,shop,13,14,1
7001,4,home,14,23,9
7001,5,work,23,24,1
7002,1,home,0,8,8
7002,2,work,8,16,8
7002,3,home,16,24,8
7003,1,home,0,6,6
7003,2,work,6,7,1
7003,3,home,7,11,4
7003,4,work,11,13,2
7003,5,shop,13,14,1
7003,6,home,14,21,7
7003,7,work,21,22,1
7003,8,home,22,24,2
7004,1,home,0,6,6
7004,2,work,6,13,7
7004,3,shop,13,14,1
7004,4,home,14,24,10
7005,1,home,0,7,7
7005,2,work,7,13,6
7005,3,shop,13,14,1
7005,4,work,14,20,6
7005,5,home,20,24,4
7006,1,home,0,7,7
7006,2,work,7,13,6
7006,3,home,13,24,11
7007,1,home,0,7,7
7007,2,shop,7,9,2
7007,3,education,9,16,7
7007,4,shop,16,17,1
7007,5,home,17,24,7
7008,1,home,0,7,7
7008,2,work,7,13,6
7008,3,shop,13,14,1
7008,4,home,14,24,10
7009,1,home,0,8,8
7009,2,work,8,14,6
7009,3,shop,14,15,1
7009,4,home,15,21,6
7009,5,work,21,22,1
7009,6,home,22,24,2
7010,1,home,0,7,7
7010,2,shop,7,8,1
7010,3,home,8,15,7
7010,4,work,15,20,5
7010,5,home,20,24,4
7011,1,home,0,8,8
7011,2,education,8,11,3
7011,3,home,11,15,4
7011,4,work,15,20,5
7011,5,home,20,24,4
7012,1,home,0,9,9
7012,2,work,9,16,7
7012,3,shop,16,17,1
7012,4,home,17,24,7
7013,1,home,0,6,6
7013,2,work,6,12,6
7013,3,shop,12,13,1
7013,4,work,13,19,6
7013,5,home,19,24,5
7014,1,home,0,7,7
7014,2,education,7,11,4
7014,3,home,11,17,6
7014,4,shop,17,18,1
7014,5,home,18,24,6
7015,1,home,0,7,7
7015,2,work,7,14,7
7015,3,shop,14,15,1
7015,4,work,15,20,5
7015,5,home,20,24,4
7016,1,home,0,6,6
7016,2,work,6,13,7
7016,3,home,13,24,11
7017,1,home,0,6,6
7017,2,work,6,13,7
7017,3,home,13,18,5
7017,4,work,18,20,2
7017,5,home,20,24,4
7018,1,home,0,7,7
7018,2,work,7,13,6
7018,3,home,13,17,4
7018,4,work,17,19,2
7018,5,home,19,24,5
7019,1,home,0,8,8
7019,2,work,8,14,6
7019,3,shop,14,15,1
7019,4,work,15,20,5
7019,5,home,20,24,4
7020,1,home,0,6,6
7020,2,shop,6,7,1
7020,3,home,7,12,5
7020,4,work,12,19,7
7020,5,home,19,23,4
7020,6,work,23,24,1
7021,1,home,0,6,6
7021,2,shop,6,7,1
7021,3,home,7,10,3
7021,4,education,10,12,2
7021,5,shop,12,14,2
7021,6,home,14,21,7
7021,7,shop,21,22,1
7021,8,home,22,24,2
7022,1,home,0,6,6
7022,2,work,6,13,7
7022,3,shop,13,14,1
7022,4,work,14,19,5
7022,5,home,19,24,5
7023,1,home,0,7,7
7023,2,work,7,13,6
7023,3,shop,13,14,1
7023,4,education,14,17,3
7023,5,home,17,24,7
7024,1,home,0,7,7
7024,2,education,7,11,4
7024,3,home,11,16,5
7024,4,shop,16,17,1
7024,5,home,17,24,7
7025,1,home,0,9,9
7025,2,work,9,13,4
7025,3,shop,13,14,1
7025,4,home,14,24,10
7026,1,home,0,6,6
7026,2,work,6,13,7
7026,3,home,13,21,8
7026,4,work,21,22,1
7026,5,home,22,24,2
7027,1,home,0,7,7
7027,2,work,7,14,7
7027,3,shop,14,15,1
7027,4,home,15,24,9
7028,1,home,0,8,8
7028,2,work,8,15,7
7028,3,shop,15,16,1
7028,4,work,16,20,4
7028,5,home,20,24,4
7029,1,home,0,6,6
7029,2,work,6,13,7
7029,3,shop,13,14,1
7029,4,home,14,24,10
7030,1,home,0,6,6
7030,2,shop,6,7,1
7030,3,work,7,13,6
7030,4,home,13,21,8
7030,5,work,21,22,1
7030,6,home,22,24,2
7031,1,home,0,7,7
7031,2,work,7,13,6
7031,3,shop,13,14,1
7031,4,work,14,19,5
7031,5,home,19,24,5
7032,1,home,0,6,6
7032,2,shop,6,7,1
7032,3,home,7,9,2
7032,4,education,9,12,3
7032,5,shop,12,14,2
7032,6,education,14,16,2
7032,7,home,16,24,8
7033,1,home,0,7,7
7033,2,work,7,13,6
7033,3,home,13,24,11
7034,1,home,0,7,7
7034,2,work,7,13,6
7034,3,shop,13,14,1
7034,4,education,14,17,3
7034,5,home,17,22,5
7034,6,work,22,23,1
7034,7,home,23,24,1
7035,1,home,0,6,6
7035,2,shop,6,7,1
7035,3,home,7,10,3
7035,4,education,10,13,3
7035,5,shop,13,15,2
7035,6,home,15,24,9
7036,1,home,0,8,8
7036,2,work,8,16,8
7036,3,home,16,21,5
7036,4,work,21,22,1
7036,5,home,22,24,2
7037,1,home,0,6,6
7037,2,work,6,13,7
7037,3,home,13,23,10
7037,4,work,23,24,1
7038,1,home,0,8,8
7038,2,work,8,15,7
7038,3,home,15,24,9
7039,1,home,0,7,7
7039,2,work,7,13,6
7039,3,home,13,17,4
7039,4,work,17,20,3
7039,5,home,20,24,4
7040,1,home,0,7,7
7040,2,work,7,13,6
7040,3,home,13,15,2
7040,4,work,15,20,5
7040,5,home,20,24,4
7041,1,home,0,6,6
7041,2,work,6,13,7
7041,3,shop,13,14,1
7041,4,home,14,24,10
7042,1,home,0,7,7
7042,2,work,7,13,6
7042,3,home,13,24,11
7043,1,home,0,7,7
7043,2,shop,7,8,1
7043,3,work,8,15,7
7043,4,home,15,24,9
7044,1,home,0,7,7
7044,2,work,7,9,2
7044,3,home,9,13,4
7044,4,work,13,16,3
7044,5,home,16,23,7
7044,6,work,23,24,1
7045,1,home,0,9,9
7045,2,work,9,16,7
7045,3,shop,16,17,1
7045,4,work,17,20,3
7045,5,home,20,24,4
7046,1,home,0,7,7
7046,2,work,7,13,6
7046,3,home,13,18,5
7046,4,work,18,20,2
7046,5,home,20,24,4
7047,1,home,0,7,7
7047,2,work,7,14,7
7047,3,shop,14,15,1
7047,4,home,15,22,7
7047,5,work,22,23,1
7047,6,home,23,24,1
7048,1,home,0,6,6
7048,2,work,6,8,2
7048,3,home,8,14,6
7048,4,work,14,17,3
7048,5,home,17,24,7
7049,1,home,0,7,7
7049,2,education,7,11,4
7049,3,home,11,19,8
7049,4,shop,19,21,2
7049,5,home,21,24,3
7050,1,home,0,7,7
7050,2,education,7,11,4
7050,3,home,11,19,8
7050,4,shop,19,20,1
7050,5,home,20,24,4
7051,1,home,0,6,6
7051,2,work,6,7,1
7051,3,home,7,9,2
7051,4,work,9,11,2
7051,5,home,11,16,5
7051,6,work,16,18,2
7051,7,home,18,22,4
7051,8,work,22,23,1
7051,9,home,23,24,1
7052,1,home,0,6,6
7052,2,work,6,13,7
7052,3,home,13,17,4
7052,4,work,17,20,3
7052,5,home,20,24,4
7053,1,home,0,8,8
7053,2,work,8,14,6
7053,3,home,14,24,10
7054,1,home,0,7,7
7054,2,work,7,14,7
7054,3,home,14,19,5
7054,4,shop,19,20,1
7054,5,home,20,24,4
7055,1,home,0,7,7
7055,2,work,7,13,6
7055,3,shop,13,15,2
7055,4,home,15,24,9
7056,1,home,0,7,7
7056,2,shop,7,8,1
7056,3,education,8,12,4
7056,4,home,12,18,6
7056,5,shop,18,20,2
7056,6,home,20,24,4
7057,1,home,0,8,8
7057,2,work,8,15,7
7057,3,home,15,24,9
7058,1,home,0,7,7
7058,2,education,7,12,5
7058,3,home,12,20,8
7058,4,shop,20,21,1
7058,5,home,21,24,3
7059,1,home,0,8,8
7059,2,work,8,15,7
7059,3,home,15,24,9
7060,1,home,0,7,7
7060,2,work,7,14,7
7060,3,home,14,18,4
7060,4,work,18,20,2
7060,5,home,20,24,4
7061,1,home,0,7,7
7061,2,work,7,13,6
7061,3,shop,13,14,1
7061,4,work,14,19,5
7061,5,home,19,24,5
7062,1,home,0,7,7
7062,2,work,7,14,7
7062,3,home,14,24,10
7063,1,home,0,6,6
7063,2,work,6,13,7
7063,3,home,13,24,11
7064,1,home,0,6,6
7064,2,work,6,13,7
7064,3,home,13,21,8
7064,4,work,21,22,1
7064,5,home,22,24,2
7065,1,home,0,7,7
7065,2,work,7,13,6
7065,3,home,13,21,8
7065,4,shop,21,22,1
7065,5,home,22,24,2
7066,1,home,0,6,6
7066,2,shop,6,7,1
7066,3,home,7,9,2
7066,4,education,9,12,3
7066,5,shop,12,15,3
7066,6,home,15,19,4
7066,7,shop,19,20,1
7066,8,home,20,24,4
7067,1,home,0,7,7
7067,2,shop,7,8,1
7067,3,home,8,15,7
7067,4,work,15,20,5
7067,5,home,20,24,4
7068,1,home,0,8,8
7068,2,work,8,14,6
7068,3,shop,14,15,1
7068,4,work,15,19,4
7068,5,home,19,24,5
7069,1,home,0,8,8
7069,2,work,8,15,7
7069,3,home,15,24,9
7070,1,home,0,7,7
7070,2,work,7,14,7
7070,3,home,14,18,4
7070,4,work,18,19,1
7070,5,home,19,24,5
7071,1,home,0,6,6
7071,2,work,6,13,7
7071,3,shop,13,14,1
7071,4,work,14,20,6
7071,5,home,20,24,4
7072,1,home,0,7,7
7072,2,shop,7,9,2
7072,3,education,9,12,3
7072,4,home,12,20,8
7072,5,shop,20,21,1
7072,6,home,21,24,3
7073,1,home,0,7,7
7073,2,shop,7,8,1
7073,3,work,8,16,8
7073,4,home,16,24,8
7074,1,home,0,7,7
7074,2,work,7,8,1
7074,3,home,8,13,5
7074,4,work,13,16,3
7074,5,home,16,22,6
7074,6,work,22,23,1
7074,7,home,23,24,1
7075,1,home,0,8,8
7075,2,work,8,15,7
7075,3,home,15,20,5
7075,4,shop,20,21,1
7075,5,home,21,24,3
7076,1,home,0,6,6
7076,2,shop,6,8,2
7076,3,work,8,15,7
7076,4,home,15,23,8
7076,5,work,23,24,1
7077,1,home,0,6,6
7077,2,work,6,12,6
7077,3,shop,12,13,1
7077,4,work,13,19,6
7077,5,home,19,24,5
7078,1,home,0,6,6
7078,2,shop,6,7,1
7078,3,home,7,10,3
7078,4,education,10,12,2
7078,5,home,12,18,6
7078,6,shop,18,20,2
7078,7,home,20,24,4
7079,1,home,0,6,6
7079,2,work,6,13,7
7079,3,home,13,17,4
7079,4,shop,17,18,1
7079,5,home,18,24,6
7080,1,home,0,6,6
7080,2,work,6,8,2
7080,3,home,8,12,4
7080,4,work,12,13,1
7080,5,home,13,21,8
7080,6,work,21,22,1
7080,7,home,22,24,2
7081,1,home,0,7,7
7081,2,work,7,14,7
7081,3,shop,14,15,1
7081,4,home,15,18,3
7081,5,work,18,20,2
7081,6,home,20,24,4
7082,1,home,0,7,7
7082,2,work,7,13,6
7082,3,shop,13,14,1
7082,4,work,14,20,6
7082,5,home,20,24,4
7083,1,home,0,6,6
7083,2,work,6,13,7
7083,3,home,13,23,10
7083,4,work,23,24,1
7084,1,home,0,7,7
7084,2,work,7,14,7
7084,3,home,14,22,8
7084,4,work,22,23,1
7084,5,home,23,24,1
7085,1,home,0,8,8
7085,2,work,8,14,6
7085,3,shop,14,15,1
7085,4,home,15,24,9
7086,1,home,0,7,7
7086,2,work,7,9,2
7086,3,home,9,13,4
7086,4,education,13,15,2
7086,5,home,15,21,6
7086,6,work,21,22,1
7086,7,home,22,24,2
7087,1,home,0,7,7
7087,2,education,7,10,3
7087,3,home,10,13,3
7087,4,education,13,16,3
7087,5,home,16,24,8
7088,1,home,0,6,6
7088,2,work,6,12,6
7088,3,shop,12,14,2
7088,4,home,14,18,4
7088,5,work,18,20,2
7088,6,home,20,24,4
7089,1,home,0,6,6
7089,2,shop,6,7,1
7089,3,home,7,13,6
7089,4,education,13,16,3
7089,5,home,16,24,8
7090,1,home,0,8,8
7090,2,work,8,15,7
7090,3,shop,15,16,1
7090,4,home,16,24,8
7091,1,home,0,6,6
7091,2,shop,6,7,1
7091,3,home,7,10,3
7091,4,education,10,15,5
7091,5,work,15,20,5
7091,6,home,20,24,4
7092,1,home,0,6,6
7092,2,work,6,13,7
7092,3,home,13,16,3
7092,4,work,16,20,4
7092,5,home,20,24,4
7093,1,home,0,11,11
7093,2,education,11,15,4
7093,3,work,15,19,4
7093,4,home,19,24,5
7094,1,home,0,7,7
7094,2,education,7,11,4
7094,3,home,11,21,10
7094,4,shop,21,22,1
7094,5,home,22,24,2
7095,1,home,0,6,6
7095,2,shop,6,7,1
7095,3,work,7,13,6
7095,4,home,13,24,11
7096,1,home,0,8,8
7096,2,work,8,14,6
7096,3,home,14,21,7
7096,4,work,21,22,1
7096,5,home,22,24,2
7097,1,home,0,8,8
7097,2,work,8,11,3
7097,3,shop,11,12,1
7097,4,work,12,18,6
7097,5,home,18,24,6
7098,1,home,0,8,8
7098,2,work,8,16,8
7098,3,home,16,24,8
7099,1,home,0,7,7
7099,2,work,7,13,6
7099,3,home,13,24,11
7100,1,home,0,7,7
7100,2,education,7,11,4
7100,3,home,11,17,6
7100,4,shop,17,18,1
7100,5,home,18,24,6
7101,1,home,0,7,7
7101,2,work,7,14,7
7101,3,home,14,24,10
7102,1,home,0,7,7
7102,2,work,7,14,7
7102,3,shop,14,15,1
7102,4,home,15,24,9
7103,1,home,0,6,6
7103,2,work,6,13,7
7103,3,shop,13,14,1
7103,4,work,14,20,6
7103,5,home,20,24,4
7104,1,home,0,7,7
7104,2,work,7,14,7
7104,3,home,14,21,7
7104,4,work,21,22,1
7104,5,home,22,24,2
7105,1,home,0,6,6
7105,2,work,6,8,2
7105,3,home,8,9,1
7105,4,work,9,11,2
7105,5,home,11,16,5
7105,6,work,16,18,2
7105,7,home,18,24,6
7106,1,home,0,8,8
7106,2,work,8,15,7
7106,3,home,15,24,9
7107,1,home,0,8,8
7107,2,education,8,11,3
7107,3,home,11,18,7
7107,4,shop,18,20,2
7107,5,home,20,24,4
7108,1,home,0,8,8
7108,2,education,8,11,3
7108,3,home,11,23,12
7108,4,work,23,24,1
7109,1,home,0,7,7
7109,2,shop,7,8,1
7109,3,home,8,13,5
7109,4,education,13,16,3
7109,5,shop,16,17,1
7109,6,home,17,24,7
7110,1,home,0,7,7
7110,2,work,7,14,7
7110,3,shop,14,15,1
7110,4,home,15,24,9
7111,1,home,0,7,7
7111,2,work,7,14,7
7111,3,shop,14,15,1
7111,4,home,15,21,6
7111,5,shop,21,22,1
7111,6,home,22,24,2
7112,1,home,0,6,6
7112,2,work,6,13,7
7112,3,shop,13,15,2
7112,4,work,15,20,5
7112,5,home,20,24,4
7113,1,home,0,8,8
7113,2,work,8,14,6
7113,3,shop,14,15,1
7113,4,work,15,20,5
7113,5,home,20,24,4
7114,1,home,0,7,7
7114,2,work,7,13,6
7114,3,shop,13,15,2
7114,4,work,15,20,5
7114,5,home,20,24,4
7115,1,home,0,6,6
7115,2,work,6,13,7
7115,3,home,13,21,8
7115,4,shop,21,22,1
7115,5,home,22,24,2
7116,1,home,0,7,7
7116,2,education,7,12,5
7116,3,home,12,19,7
7116,4,shop,19,20,1
7116,5,home,20,24,4
7117,1,home,0,8,8
7117,2,work,8,14,6
7117,3,home,14,24,10
7118,1,home,0,6,6
7118,2,shop,6,7,1
7118,3,work,7,14,7
7118,4,home,14,21,7
7118,5,work,21,22,1
7118,6,home,22,24,2
7119,1,home,0,8,8
7119,2,work,8,14,6
7119,3,shop,14,16,2
7119,4,home,16,24,8
7120,1,home,0,6,6
7120,2,work,6,13,7
7120,3,home,13,24,11
7121,1,home,0,6,6
7121,2,work,6,14,8
7121,3,home,14,24,10
7122,1,home,0,7,7
7122,2,work,7,14,7
7122,3,home,14,24,10
7123,1,home,0,7,7
7123,2,work,7,14,7
7123,3,home,14,21,7
7123,4,shop,21,22,1
7123,5,home,22,24,2
7124,1,home,0,6,6
7124,2,work,6,13,7
7124,3,home,13,19,6
7124,4,shop,19,20,1
7124,5,home,20,24,4
7125,1,home,0,7,7
7125,2,shop,7,8,1
7125,3,education,8,12,4
7125,4,home,12,20,8
7125,5,shop,20,21,1
7125,6,home,21,24,3
7126,1,home,0,7,7
7126,2,work,7,12,5
7126,3,shop,12,13,1
7126,4,work,13,19,6
7126,5,home,19,24,5
7127,1,home,0,7,7
7127,2,work,7,13,6
7127,3,shop,13,14,1
7127,4,home,14,24,10
7128,1,home,0,8,8
7128,2,shop,8,9,1
7128,3,work,9,15,6
7128,4,home,15,24,9
7129,1,home,0,9,9
7129,2,education,9,12,3
7129,3,home,12,18,6
7129,4,work,18,20,2
7129,5,home,20,24,4
7130,1,home,0,7,7
7130,2,work,7,14,7
7130,3,home,14,24,10
7131,1,home,0,7,7
7131,2,education,7,11,4
7131,3,home,11,20,9
7131,4,shop,20,21,1
7131,5,home,21,24,3
7132,1,home,0,9,9
7132,2,education,9,13,4
7132,3,shop,13,14,1
7132,4,home,14,18,4
7132,5,work,18,20,2
7132,6,home,20,24,4
7133,1,home,0,8,8
7133,2,work,8,15,7
7133,3,home,15,21,6
7133,4,work,21,22,1
7133,5,home,22,24,2
7134,1,home,0,6,6
7134,2,work,6,13,7
7134,3,home,13,18,5
7134,4,shop,18,19,1
7134,5,home,19,24,5
7135,1,home,0,6,6
7135,2,shop,6,7,1
7135,3,home,7,11,4
7135,4,education,11,12,1
7135,5,home,12,20,8
7135,6,shop,20,21,1
7135,7,home,21,24,3
7136,1,home,0,7,7
7136,2,work,7,14,7
7136,3,home,14,24,10
7137,1,home,0,7,7
7137,2,work,7,13,6
7137,3,home,13,24,11
7138,1,home,0,9,9
7138,2,work,9,16,7
7138,3,shop,16,17,1
7138,4,home,17,24,7
7139,1,home,0,6,6
7139,2,shop,6,7,1
7139,3,home,7,10,3
7139,4,education,10,12,2
7139,5,shop,12,14,2
7139,6,education,14,16,2
7139,7,shop,16,17,1
7139,8,home,17,24,7
7140,1,home,0,6,6
7140,2,work,6,7,1
7140,3,home,7,11,4
7140,4,work,11,13,2
7140,5,home,13,21,8
7140,6,work,21,22,1
7140,7,home,22,24,2
7141,1,home,0,7,7
7141,2,shop,7,8,1
7141,3,education,8,12,4
7141,4,shop,12,14,2
7141,5,home,14,21,7
7141,6,shop,21,22,1
7141,7,home,22,24,2
7142,1,home,0,7,7
7142,2,work,7,14,7
7142,3,home,14,24,10
7143,1,home,0,6,6
7143,2,work,6,8,2
7143,3,home,8,14,6
7143,4,shop,14,15,1
7143,5,home,15,22,7
7143,6,work,22,23,1
7143,7,home,23,24,1
7144,1,home,0,7,7
7144,2,work,7,15,8
7144,3,home,15,23,8
7144,4,work,23,24,1
7145,1,home,0,6,6
7145,2,work,6,13,7
7145,3,home,13,24,11
7146,1,home,0,6,6
7146,2,work,6,8,2
7146,3,home,8,14,6
7146,4,work,14,17,3
7146,5,home,17,22,5
7146,6,work,22,23,1
7146,7,home,23,24,1
7147,1,home,0,6,6
7147,2,work,6,8,2
7147,3,home,8,12,4
7147,4,work,12,14,2
7147,5,home,14,19,5
7147,6,shop,19,20,1
7147,7,home,20,24,4
7148,1,home,0,7,7
7148,2,work,7,13,6
7148,3,shop,13,14,1
7148,4,home,14,24,10
7149,1,home,0,8,8
7149,2,work,8,15,7
7149,3,home,15,19,4
7149,4,shop,19,20,1
7149,5,home,20,24,4
7150,1,home,0,7,7
7150,2,work,7,13,6
7150,3,shop,13,14,1
7150,4,home,14,17,3
7150,5,work,17,20,3
7150,6,home,20,24,4
7151,1,home,0,7,7
7151,2,work,7,13,6
7151,3,home,13,16,3
7151,4,work,16,17,1
7151,5,home,17,24,7
7152,1,home,0,7,7
7152,2,shop,7,8,1
7152,3,home,8,11,3
7152,4,education,11,16,5
7152,5,home,16,24,8
7153,1,home,0,7,7
7153,2,work,7,14,7
7153,3,home,14,18,4
7153,4,shop,18,19,1
7153,5,home,19,24,5
7154,1,home,0,6,6
7154,2,work,6,8,2
7154,3,home,8,9,1
7154,4,work,9,11,2
7154,5,home,11,14,3
7154,6,work,14,18,4
7154,7,home,18,23,5
7154,8,work,23,24,1
7155,1,home,0,7,7
7155,2,work,7,13,6
7155,3,home,13,24,11
7156,1,home,0,8,8
7156,2,work,8,15,7
7156,3,home,15,24,9
7157,1,home,0,6,6
7157,2,work,6,8,2
7157,3,home,8,13,5
7157,4,work,13,15,2
7157,5,shop,15,16,1
7157,6,work,16,18,2
7157,7,home,18,24,6
7158,1,home,0,6,6
7158,2,work,6,8,2
7158,3,home,8,9,1
7158,4,work,9,11,2
7158,5,home,11,17,6
7158,6,work,17,19,2
7158,7,home,19,23,4
7158,8,work,23,24,1
7159,1,home,0,6,6
7159,2,work,6,10,4
7159,3,home,10,15,5
7159,4,work,15,17,2
7159,5,home,17,24,7
7160,1,home,0,8,8
7160,2,work,8,15,7
7160,3,home,15,18,3
7160,4,work,18,20,2
7160,5,home,20,24,4
7161,1,home,0,7,7
7161,2,work,7,13,6
7161,3,home,13,17,4
7161,4,work,17,20,3
7161,5,home,20,24,4
7162,1,home,0,7,7
7162,2,work,7,13,6
7162,3,shop,13,14,1
7162,4,work,14,19,5
7162,5,home,19,24,5
7163,1,home,0,6,6
7163,2,shop,6,7,1
7163,3,work,7,15,8
7163,4,home,15,21,6
7163,5,work,21,22,1
7163,6,home,22,24,2
7164,1,home,0,6,6
7164,2,work,6,13,7
7164,3,shop,13,14,1
7164,4,education,14,16,2
7164,5,home,16,24,8
7165,1,home,0,8,8
7165,2,education,8,11,3
7165,3,home,11,17,6
7165,4,shop,17,18,1
7165,5,home,18,24,6
7166,1,home,0,8,8
7166,2,work,8,16,8
7166,3,shop,16,17,1
7166,4,home,17,22,5
7166,5,work,22,23,1
7166,6,home,23,24,1
7167,1,home,0,7,7
7167,2,work,7,8,1
7167,3,home,8,9,1
7167,4,work,9,10,1
7167,5,shop,10,11,1
7167,6,work,11,13,2
7167,7,home,13,16,3
7167,8,work,16,18,2
7167,9,home,18,24,6
7168,1,home,0,8,8
7168,2,work,8,16,8
7168,3,home,16,24,8
7169,1,home,0,6,6
7169,2,shop,6,7,1
7169,3,home,7,13,6
7169,4,education,13,16,3
7169,5,home,16,24,8
7170,1,home,0,6,6
7170,2,shop,6,7,1
7170,3,work,7,14,7
7170,4,home,14,21,7
7170,5,work,21,22,1
7170,6,home,22,24,2
7171,1,home,0,8,8
7171,2,shop,8,9,1
7171,3,home,9,17,8
7171,4,work,17,20,3
7171,5,home,20,24,4
7172,1,home,0,8,8
7172,2,work,8,14,6
7172,3,shop,14,15,1
7172,4,home,15,24,9
7173,1,home,0,7,7
7173,2,education,7,11,4
7173,3,home,11,19,8
7173,4,shop,19,21,2
7173,5,home,21,24,3
7174,1,home,0,8,8
7174,2,education,8,11,3
7174,3,home,11,18,7
7174,4,shop,18,19,1
7174,5,home,19,24,5
7175,1,home,0,7,7
7175,2,work,7,13,6
7175,3,home,13,18,5
7175,4,shop,18,19,1
7175,5,home,19,24,5
7176,1,home,0,7,7
7176,2,education,7,12,5
7176,3,shop,12,14,2
7176,4,education,14,16,2
7176,5,home,16,24,8
7177,1,home,0,6,6
7177,2,work,6,8,2
7177,3,home,8,12,4
7177,4,work,12,13,1
7177,5,home,13,15,2
7177,6,work,15,17,2
7177,7,home,17,24,7
7178,1,home,0,6,6
7178,2,work,6,7,1
7178,3,home,7,9,2
7178,4,work,9,12,3
7178,5,home,12,18,6
7178,6,work,18,20,2
7178,7,home,20,24,4
7179,1,home,0,7,7
7179,2,work,7,13,6
7179,3,home,13,17,4
7179,4,work,17,20,3
7179,5,home,20,24,4
7180,1,home,0,9,9
7180,2,work,9,16,7
7180,3,home,16,24,8
7181,1,home,0,9,9
7181,2,work,9,17,8
7181,3,home,17,24,7
7182,1,home,0,6,6
7182,2,shop,6,7,1
7182,3,home,7,10,3
7182,4,education,10,13,3
7182,5,shop,13,15,2
7182,6,home,15,19,4
7182,7,shop,19,20,1
7182,8,home,20,24,4
7183,1,home,0,7,7
7183,2,work,7,13,6
7183,3,shop,13,14,1
7183,4,work,14,18,4
7183,5,education,18,20,2
7183,6,home,20,24,4
7184,1,home,0,7,7
7184,2,education,7,13,6
7184,3,home,13,20,7
7184,4,shop,20,21,1
7184,5,home,21,24,3
7185,1,home,0,6,6
7185,2,work,6,13,7
7185,3,home,13,24,11
7186,1,home,0,7,7
7186,2,work,7,13,6
7186,3,home,13,24,11
7187,1,home,0,7,7
7187,2,education,7,11,4
7187,3,home,11,19,8
7187,4,shop,19,20,1
7187,5,home,20,24,4
7188,1,home,0,7,7
7188,2,work,7,13,6
7188,3,shop,13,14,1
7188,4,work,14,19,5
7188,5,home,19,24,5
7189,1,home,0,7,7
7189,2,work,7,9,2
7189,3,home,9,15,6
7189,4,work,15,17,2
7189,5,home,17,24,7
7190,1,home,0,6,6
7190,2,work,6,13,7
7190,3,shop,13,14,1
7190,4,work,14,19,5
7190,5,home,19,24,5
7191,1,home,0,9,9
7191,2,work,9,16,7
7191,3,home,16,23,7
7191,4,work,23,24,1
7192,1,home,0,7,7
7192,2,work,7,14,7
7192,3,home,14,16,2
7192,4,work,16,19,3
7192,5,home,19,24,5
7193,1,home,0,7,7
7193,2,work,7,14,7
7193,3,home,14,16,2
7193,4,work,16,20,4
7193,5,home,20,24,4
7194,1,home,0,7,7
7194,2,education,7,13,6
7194,3,shop,13,14,1
7194,4,home,14,21,7
7194,5,shop,21,22,1
7194,6,home,22,24,2
7195,1,home,0,7,7
7195,2,work,7,13,6
7195,3,shop,13,14,1
7195,4,education,14,18,4
7195,5,work,18,20,2
7195,6,home,20,24,4
7196,1,home,0,6,6
7196,2,shop,6,7,1
7196,3,home,7,13,6
7196,4,education,13,16,3
7196,5,shop,16,17,1
7196,6,home,17,24,7
7197,1,home,0,6,6
7197,2,shop,6,7,1
7197,3,home,7,10,3
7197,4,education,10,12,2
7197,5,shop,12,14,2
7197,6,education,14,16,2
7197,7,home,16,24,8
7198,1,home,0,7,7
7198,2,work,7,13,6
7198,3,shop,13,14,1
7198,4,home,14,24,10
7199,1,home,0,7,7
7199,2,work,7,13,6
7199,3,shop,13,14,1
7199,4,work,14,19,5
7199,5,home,19,24,5
7200,1,home,0,7,7
7200,2,work,7,13,6
7200,3,shop,13,14,1
7200,4,work,14,19,5
7200,5,home,19,24,5
7201,1,home,0,6,6
7201,2,shop,6,7,1
7201,3,home,7,13,6
7201,4,education,13,16,3
7201,5,home,16,24,8
7202,1,home,0,7,7
7202,2,work,7,13,6
7202,3,home,13,18,5
7202,4,work,18,20,2
7202,5,home,20,24,4
7203,1,home,0,7,7
7203,2,education,7,12,5
7203,3,home,12,19,7
7203,4,shop,19,21,2
7203,5,home,21,24,3
7204,1,home,0,7,7
7204,2,work,7,9,2
7204,3,home,9,13,4
7204,4,work,13,15,2
7204,5,home,15,22,7
7204,6,work,22,23,1
7204,7,home,23,24,1
7205,1,home,0,8,8
7205,2,education,8,12,4
7205,3,shop,12,13,1
7205,4,education,13,14,1
7205,5,shop,14,16,2
7205,6,home,16,24,8
7206,1,home,0,8,8
7206,2,work,8,15,7
7206,3,shop,15,16,1
7206,4,work,16,19,3
7206,5,home,19,24,5
7207,1,home,0,7,7
7207,2,work,7,13,6
7207,3,home,13,24,11
7208,1,home,0,6,6
7208,2,shop,6,7,1
7208,3,home,7,11,4
7208,4,education,11,14,3
7208,5,shop,14,15,1
7208,6,home,15,24,9
7209,1,home,0,6,6
7209,2,work,6,13,7
7209,3,home,13,18,5
7209,4,work,18,20,2
7209,5,home,20,24,4
7210,1,home,0,8,8
7210,2,work,8,15,7
7210,3,home,15,24,9
7211,1,home,0,6,6
7211,2,shop,6,7,1
7211,3,home,7,13,6
7211,4,education,13,16,3
7211,5,home,16,24,8
7212,1,home,0,6,6
7212,2,work,6,13,7
7212,3,shop,13,14,1
7212,4,home,14,24,10
7213,1,home,0,8,8
7213,2,education,8,11,3
7213,3,home,11,17,6
7213,4,shop,17,18,1
7213,5,home,18,24,6
7214,1,home,0,6,6
7214,2,work,6,8,2
7214,3,home,8,14,6
7214,4,work,14,16,2
7214,5,home,16,23,7
7214,6,work,23,24,1
7215,1,home,0,6,6
7215,2,work,6,13,7
7215,3,home,13,24,11
7216,1,home,0,7,7
7216,2,work,7,15,8
7216,3,shop,15,16,1
7216,4,home,16,22,6
7216,5,work,22,23,1
7216,6,home,23,24,1
7217,1,home,0,6,6
7217,2,work,6,9,3
7217,3,home,9,15,6
7217,4,work,15,17,2
7217,5,home,17,23,6
7217,6,work,23,24,1
7218,1,home,0,6,6
7218,2,work,6,8,2
7218,3,home,8,13,5
7218,4,work,13,17,4
7218,5,home,17,23,6
7218,6,work,23,24,1
7219,1,home,0,6,6
7219,2,shop,6,7,1
7219,3,work,7,9,2
7219,4,home,9,13,4
7219,5,work,13,15,2
7219,6,home,15,23,8
7219,7,work,23,24,1
7220,1,home,0,6,6
7220,2,work,6,13,7
7220,3,shop,13,14,1
7220,4,work,14,19,5
7220,5,home,19,24,5
7221,1,home,0,7,7
7221,2,shop,7,8,1
7221,3,work,8,15,7
7221,4,home,15,24,9
7222,1,home,0,6,6
7222,2,shop,6,7,1
7222,3,home,7,15,8
7222,4,work,15,20,5
7222,5,home,20,24,4
7223,1,home,0,6,6
7223,2,shop,6,7,1
7223,3,home,7,11,4
7223,4,work,11,18,7
7223,5,home,18,24,6
7224,1,home,0,7,7
7224,2,work,7,13,6
7224,3,home,13,19,6
7224,4,shop,19,20,1
7224,5,home,20,24,4
7225,1,home,0,9,9
7225,2,work,9,16,7
7225,3,home,16,24,8
7226,1,home,0,6,6
7226,2,shop,6,7,1
7226,3,work,7,15,8
7226,4,shop,15,16,1
7226,5,home,16,24,8
7227,1,home,0,6,6
7227,2,work,6,13,7
7227,3,home,13,24,11
7228,1,home,0,7,7
7228,2,work,7,13,6
7228,3,home,13,17,4
7228,4,work,17,20,3
7228,5,home,20,24,4
7229,1,home,0,7,7
7229,2,work,7,14,7
7229,3,shop,14,15,1
7229,4,work,15,19,4
7229,5,education,19,20,1
7229,6,home,20,24,4
7230,1,home,0,7,7
7230,2,work,7,13,6
7230,3,shop,13,14,1
7230,4,work,14,19,5
7230,5,home,19,24,5
7231,1,home,0,6,6
7231,2,shop,6,7,1
7231,3,home,7,14,7
7231,4,work,14,20,6
7231,5,home,20,24,4
7232,1,home,0,7,7
7232,2,education,7,11,4
7232,3,home,11,18,7
7232,4,shop,18,19,1
7232,5,home,19,24,5
7233,1,home,0,6,6
7233,2,work,6,13,7
7233,3,home,13,21,8
7233,4,work,21,22,1
7233,5,home,22,24,2
7234,1,home,0,7,7
7234,2,work,7,13,6
7234,3,home,13,17,4
7234,4,work,17,20,3
7234,5,home,20,24,4
7235,1,home,0,6,6
7235,2,work,6,8,2
7235,3,home,8,9,1
7235,4,work,9,11,2
7235,5,home,11,17,6
7235,6,work,17,19,2
7235,7,home,19,24,5
7236,1,home,0,8,8
7236,2,work,8,15,7
7236,3,home,15,22,7
7236,4,work,22,23,1
7236,5,home,23,24,1
7237,1,home,0,7,7
7237,2,work,7,13,6
7237,3,home,13,18,5
7237,4,shop,18,19,1
7237,5,home,19,24,5
7238,1,home,0,7,7
7238,2,shop,7,8,1
7238,3,education,8,11,3
7238,4,home,11,13,2
7238,5,education,13,16,3
7238,6,home,16,24,8
7239,1,home,0,8,8
7239,2,work,8,14,6
7239,3,shop,14,15,1
7239,4,work,15,20,5
7239,5,home,20,24,4
7240,1,home,0,6,6
7240,2,work,6,13,7
7240,3,home,13,23,10
7240,4,work,23,24,1
7241,1,home,0,6,6
7241,2,shop,6,7,1
7241,3,home,7,13,6
7241,4,education,13,18,5
7241,5,home,18,24,6
7242,1,home,0,8,8
7242,2,education,8,12,4
7242,3,shop,12,13,1
7242,4,work,13,20,7
7242,5,home,20,24,4
7243,1,home,0,7,7
7243,2,work,7,13,6
7243,3,home,13,16,3
7243,4,work,16,19,3
7243,5,education,19,20,1
7243,6,home,20,24,4
7244,1,home,0,7,7
7244,2,shop,7,8,1
7244,3,education,8,12,4
7244,4,shop,12,14,2
7244,5,home,14,24,10
7245,1,home,0,7,7
7245,2,work,7,13,6
7245,3,shop,13,14,1
7245,4,home,14,21,7
7245,5,work,21,22,1
7245,6,home,22,24,2
7246,1,home,0,7,7
7246,2,work,7,14,7
7246,3,home,14,17,3
7246,4,work,17,20,3
7246,5,home,20,24,4
7247,1,home,0,9,9
7247,2,work,9,15,6
7247,3,home,15,24,9
7248,1,home,0,7,7
7248,2,education,7,11,4
7248,3,home,11,13,2
7248,4,education,13,16,3
7248,5,shop,16,18,2
7248,6,home,18,24,6
7249,1,home,0,6,6
7249,2,work,6,12,6
7249,3,shop,12,13,1
7249,4,education,13,17,4
7249,5,home,17,24,7
7250,1,home,0,6,6
7250,2,work,6,7,1
7250,3,home,7,11,4
7250,4,work,11,13,2
7250,5,home,13,21,8
7250,6,work,21,22,1
7250,7,home,22,24,2
7251,1,home,0,6,6
7251,2,shop,6,7,1
7251,3,home,7,13,6
7251,4,education,13,16,3
7251,5,shop,16,17,1
7251,6,home,17,24,7
7252,1,home,0,7,7
7252,2,work,7,14,7
7252,3,home,14,17,3
7252,4,work,17,20,3
7252,5,home,20,24,4
7253,1,home,0,7,7
7253,2,work,7,14,7
7253,3,home,14,24,10
7254,1,home,0,6,6
7254,2,work,6,13,7
7254,3,shop,13,14,1
7254,4,work,14,20,6
7254,5,home,20,24,4
7255,1,home,0,7,7
7255,2,work,7,13,6
7255,3,home,13,24,11
7256,1,home,0,6,6
7256,2,work,6,8,2
7256,3,home,8,11,3
7256,4,work,11,13,2
7256,5,home,13,18,5
7256,6,work,18,20,2
7256,7,home,20,24,4
7257,1,home,0,8,8
7257,2,shop,8,9,1
7257,3,education,9,11,2
7257,4,home,11,15,4
7257,5,shop,15,16,1
7257,6,home,16,24,8
7258,1,home,0,8,8
7258,2,education,8,11,3
7258,3,home,11,24,13
7259,1,home,0,7,7
7259,2,work,7,13,6
7259,3,home,13,24,11
7260,1,home,0,6,6
7260,2,work,6,13,7
7260,3,home,13,22,9
7260,4,work,22,23,1
7260,5,home,23,24,1
7261,1,home,0,8,8
7261,2,work,8,15,7
7261,3,home,15,23,8
7261,4,work,23,24,1
7262,1,home,0,7,7
7262,2,work,7,14,7
7262,3,home,14,24,10
7263,1,home,0,7,7
7263,2,work,7,13,6
7263,3,home,13,16,3
7263,4,work,16,20,4
7263,5,home,20,24,4
7264,1,home,0,6,6
7264,2,work,6,13,7
7264,3,shop,13,14,1
7264,4,work,14,19,5
7264,5,home,19,24,5
7265,1,home,0,7,7
7265,2,work,7,14,7
7265,3,shop,14,15,1
7265,4,home,15,21,6
7265,5,work,21,22,1
7265,6,home,22,24,2
7266,1,home,0,7,7
7266,2,work,7,13,6
7266,3,shop,13,14,1
7266,4,home,14,23,9
7266,5,work,23,24,1
7267,1,home,0,7,7
7267,2,work,7,13,6
7267,3,home,13,24,11
7268,1,home,0,7,7
7268,2,education,7,11,4
7268,3,home,11,17,6
7268,4,shop,17,18,1
7268,5,home,18,24,6
7269,1,home,0,8,8
7269,2,work,8,14,6
7269,3,shop,14,15,1
7269,4,home,15,19,4
7269,5,shop,19,20,1
7269,6,home,20,24,4
7270,1,home,0,8,8
7270,2,work,8,15,7
7270,3,home,15,24,9
7271,1,home,0,6,6
7271,2,work,6,13,7
7271,3,shop,13,14,1
7271,4,home,14,23,9
7271,5,work,23,24,1
7272,1,home,0,6,6
7272,2,work,6,13,7
7272,3,home,13,15,2
7272,4,work,15,20,5
7272,5,home,20,24,4
7273,1,home,0,6,6
7273,2,work,6,13,7
7273,3,home,13,24,11
7274,1,home,0,7,7
7274,2,work,7,14,7
7274,3,shop,14,15,1
7274,4,home,15,24,9
7275,1,home,0,7,7
7275,2,work,7,10,3
7275,3,home,10,17,7
7275,4,work,17,19,2
7275,5,home,19,24,5
7276,1,home,0,7,7
7276,2,education,7,12,5
7276,3,home,12,16,4
7276,4,shop,16,17,1
7276,5,home,17,24,7
7277,1,home,0,6,6
7277,2,work,6,13,7
7277,3,home,13,18,5
7277,4,shop,18,19,1
7277,5,home,19,23,4
7277,6,work,23,24,1
7278,1,home,0,7,7
7278,2,work,7,13,6
7278,3,home,13,14,1
7278,4,work,14,19,5
7278,5,home,19,24,5
7279,1,home,0,7,7
7279,2,education,7,11,4
7279,3,home,11,19,8
7279,4,shop,19,20,1
7279,5,home,20,24,4
7280,1,home,0,8,8
7280,2,work,8,14,6
7280,3,shop,14,15,1
7280,4,work,15,19,4
7280,5,home,19,24,5
7281,1,home,0,7,7
7281,2,shop,7,8,1
7281,3,education,8,11,3
7281,4,home,11,16,5
7281,5,shop,16,18,2
7281,6,home,18,24,6
7282,1,home,0,7,7
7282,2,work,7,13,6
7282,3,shop,13,14,1
7282,4,home,14,24,10
7283,1,home,0,6,6
7283,2,shop,6,7,1
7283,3,home,7,13,6
7283,4,education,13,16,3
7283,5,shop,16,17,1
7283,6,home,17,24,7
7284,1,home,0,8,8
7284,2,work,8,15,7
7284,3,home,15,23,8
7284,4,work,23,24,1
7285,1,home,0,7,7
7285,2,shop,7,8,1
7285,3,home,8,10,2
7285,4,work,10,18,8
7285,5,home,18,24,6
7286,1,home,0,6,6
7286,2,shop,6,7,1
7286,3,home,7,13,6
7286,4,education,13,16,3
7286,5,home,16,24,8
7287,1,home,0,8,8
7287,2,work,8,15,7
7287,3,home,15,22,7
7287,4,work,22,23,1
7287,5,home,23,24,1
7288,1,home,0,7,7
7288,2,work,7,13,6
7288,3,home,13,17,4
7288,4,work,17,20,3
7288,5,home,20,24,4
7289,1,home,0,6,6
7289,2,shop,6,7,1
7289,3,home,7,10,3
7289,4,education,10,12,2
7289,5,home,12,17,5
7289,6,shop,17,18,1
7289,7,home,18,24,6
7290,1,home,0,6,6
7290,2,work,6,13,7
7290,3,home,13,21,8
7290,4,work,21,22,1
7290,5,home,22,24,2
7291,1,home,0,8,8
7291,2,work,8,15,7
7291,3,home,15,22,7
7291,4,work,22,23,1
7291,5,home,23,24,1
7292,1,home,0,7,7
7292,2,work,7,14,7
7292,3,home,14,19,5
7292,4,shop,19,20,1
7292,5,home,20,24,4
7293,1,home,0,8,8
7293,2,work,8,14,6
7293,3,shop,14,15,1
7293,4,home,15,23,8
7293,5,work,23,24,1
7294,1,home,0,6,6
7294,2,work,6,13,7
7294,3,home,13,17,4
7294,4,shop,17,18,1
7294,5,home,18,24,6
7295,1,home,0,6,6
7295,2,work,6,13,7
7295,3,shop,13,14,1
7295,4,home,14,24,10
7296,1,home,0,7,7
7296,2,work,7,8,1
7296,3,home,8,9,1
7296,4,work,9,11,2
7296,5,home,11,15,4
7296,6,work,15,17,2
7296,7,home,17,22,5
7296,8,work,22,23,1
7296,9,home,23,24,1
7297,1,home,0,7,7
7297,2,shop,7,8,1
7297,3,work,8,14,6
7297,4,shop,14,15,1
7297,5,home,15,24,9
7298,1,home,0,7,7
7298,2,work,7,14,7
7298,3,home,14,18,4
7298,4,work,18,20,2
7298,5,home,20,24,4
7299,1,home,0,7,7
7299,2,education,7,11,4
7299,3,home,11,17,6
7299,4,shop,17,19,2
7299,5,home,19,24,5
7300,1,home,0,8,8
7300,2,shop,8,9,1
7300,3,work,9,14,5
7300,4,home,14,24,10
7301,1,home,0,6,6
7301,2,shop,6,7,1
7301,3,work,7,13,6
7301,4,home,13,21,8
7301,5,work,21,22,1
7301,6,home,22,24,2
7302,1,home,0,7,7
7302,2,work,7,14,7
7302,3,shop,14,15,1
7302,4,work,15,20,5
7302,5,home,20,24,4
7303,1,home,0,6,6
7303,2,shop,6,7,1
7303,3,home,7,8,1
7303,4,work,8,9,1
7303,5,home,9,13,4
7303,6,work,13,15,2
7303,7,home,15,22,7
7303,8,work,22,23,1
7303,9,home,23,24,1
7304,1,home,0,6,6
7304,2,shop,6,7,1
7304,3,home,7,10,3
7304,4,education,10,16,6
7304,5,home,16,24,8
7305,1,home,0,7,7
7305,2,work,7,14,7
7305,3,shop,14,15,1
7305,4,home,15,24,9
7306,1,home,0,7,7
7306,2,education,7,12,5
7306,3,shop,12,14,2
7306,4,education,14,16,2
7306,5,shop,16,17,1
7306,6,home,17,24,7
7307,1,home,0,7,7
7307,2,work,7,9,2
7307,3,shop,9,10,1
7307,4,work,10,16,6
7307,5,home,16,24,8
7308,1,home,0,6,6
7308,2,shop,6,7,1
7308,3,home,7,9,2
7308,4,education,9,12,3
7308,5,home,12,14,2
7308,6,education,14,16,2
7308,7,shop,16,18,2
7308,8,home,18,24,6
7309,1,home,0,8,8
7309,2,work,8,15,7
7309,3,home,15,24,9
7310,1,home,0,7,7
7310,2,education,7,11,4
7310,3,home,11,18,7
7310,4,shop,18,20,2
7310,5,home,20,24,4
7311,1,work,0,7,7
7311,2,shop,7,8,1
7311,3,work,8,15,7
7311,4,home,15,20,5
7311,5,shop,20,21,1
7311,6,home,21,24,3
7312,1,home,0,9,9
7312,2,work,9,13,4
7312,3,home,13,22,9
7312,4,work,22,23,1
7312,5,home,23,24,1
7313,1,home,0,6,6
7313,2,work,6,13,7
7313,3,home,13,21,8
7313,4,work,21,22,1
7313,5,home,22,24,2
7314,1,home,0,7,7
7314,2,work,7,14,7
7314,3,home,14,18,4
7314,4,shop,18,19,1
7314,5,home,19,24,5
7315,1,home,0,7,7
7315,2,work,7,14,7
7315,3,home,14,24,10
7316,1,home,0,7,7
7316,2,education,7,12,5
7316,3,home,12,20,8
7316,4,shop,20,21,1
7316,5,home,21,24,3
7317,1,home,0,7,7
7317,2,work,7,13,6
7317,3,home,13,24,11
7318,1,home,0,7,7
7318,2,work,7,14,7
7318,3,home,14,21,7
7318,4,work,21,22,1
7318,5,home,22,24,2
7319,1,home,0,6,6
7319,2,work,6,12,6
7319,3,shop,12,13,1
7319,4,work,13,19,6
7319,5,home,19,24,5
7320,1,home,0,7,7
7320,2,work,7,14,7
7320,3,home,14,24,10
7321,1,home,0,8,8
7321,2,work,8,15,7
7321,3,home,15,21,6
7321,4,work,21,22,1
7321,5,home,22,24,2
7322,1,home,0,8,8
7322,2,work,8,15,7
7322,3,home,15,22,7
7322,4,work,22,23,1
7322,5,home,23,24,1
7323,1,home,0,7,7
7323,2,work,7,14,7
7323,3,shop,14,15,1
7323,4,home,15,24,9
7324,1,home,0,6,6
7324,2,work,6,8,2
7324,3,home,8,14,6
7324,4,work,14,16,2
7324,5,home,16,22,6
7324,6,work,22,23,1
7324,7,home,23,24,1
7325,1,home,0,6,6
7325,2,work,6,13,7
7325,3,shop,13,14,1
7325,4,home,14,22,8
7325,5,work,22,23,1
7325,6,home,23,24,1
7326,1,home,0,8,8
7326,2,education,8,12,4
7326,3,shop,12,14,2
7326,4,education,14,16,2
7326,5,home,16,24,8
7327,1,home,0,6,6
7327,2,work,6,13,7
7327,3,shop,13,14,1
7327,4,education,14,16,2
7327,5,home,16,24,8
7328,1,home,0,7,7
7328,2,work,7,14,7
7328,3,shop,14,15,1
7328,4,work,15,19,4
7328,5,home,19,24,5
7329,1,home,0,6,6
7329,2,work,6,13,7
7329,3,home,13,18,5
7329,4,shop,18,19,1
7329,5,home,19,24,5
7330,1,home,0,8,8
7330,2,work,8,14,6
7330,3,shop,14,15,1
7330,4,work,15,20,5
7330,5,home,20,24,4
7331,1,home,0,6,6
7331,2,work,6,13,7
7331,3,home,13,17,4
7331,4,work,17,20,3
7331,5,home,20,24,4
7332,1,home,0,7,7
7332,2,shop,7,8,1
7332,3,work,8,15,7
7332,4,home,15,20,5
7332,5,shop,20,21,1
7332,6,home,21,24,3
7333,1,home,0,7,7
7333,2,work,7,14,7
7333,3,shop,14,16,2
7333,4,work,16,19,3
7333,5,home,19,24,5
7334,1,home,0,7,7
7334,2,work,7,13,6
7334,3,home,13,18,5
7334,4,work,18,20,2
7334,5,home,20,24,4
7335,1,home,0,7,7
7335,2,work,7,14,7
7335,3,shop,14,16,2
7335,4,home,16,21,5
7335,5,work,21,22,1
7335,6,home,22,24,2
7336,1,home,0,8,8
7336,2,shop,8,9,1
7336,3,work,9,16,7
7336,4,home,16,24,8
7337,1,home,0,7,7
7337,2,work,7,10,3
7337,3,home,10,14,4
7337,4,work,14,17,3
7337,5,home,17,23,6
7337,6,work,23,24,1
7338,1,home,0,7,7
7338,2,education,7,11,4
7338,3,home,11,16,5
7338,4,shop,16,18,2
7338,5,home,18,24,6
7339,1,home,0,8,8
7339,2,work,8,15,7
7339,3,shop,15,16,1
7339,4,work,16,20,4
7339,5,home,20,24,4
7340,1,home,0,7,7
7340,2,work,7,13,6
7340,3,shop,13,14,1
7340,4,work,14,19,5
7340,5,home,19,24,5
7341,1,home,0,7,7
7341,2,education,7,13,6
7341,3,home,13,21,8
7341,4,shop,21,22,1
7341,5,home,22,24,2
7342,1,home,0,8,8
7342,2,work,8,15,7
7342,3,home,15,24,9
7343,1,home,0,6,6
7343,2,work,6,7,1
7343,3,home,7,9,2
7343,4,work,9,10,1
7343,5,home,10,14,4
7343,6,work,14,16,2
7343,7,shop,16,17,1
7343,8,home,17,23,6
7343,9,work,23,24,1
7344,1,home,0,7,7
7344,2,work,7,13,6
7344,3,shop,13,14,1
7344,4,home,14,23,9
7344,5,work,23,24,1
7345,1,home,0,7,7
7345,2,work,7,14,7
7345,3,home,14,23,9
7345,4,work,23,24,1
7346,1,home,0,7,7
7346,2,work,7,14,7
7346,3,shop,14,15,1
7346,4,home,15,24,9
7347,1,home,0,7,7
7347,2,education,7,12,5
7347,3,home,12,21,9
7347,4,shop,21,22,1
7347,5,home,22,24,2
7348,1,home,0,8,8
7348,2,work,8,15,7
7348,3,home,15,24,9
7349,1,home,0,8,8
7349,2,work,8,14,6
7349,3,shop,14,15,1
7349,4,work,15,19,4
7349,5,home,19,24,5
7350,1,home,0,8,8
7350,2,work,8,15,7
7350,3,shop,15,16,1
7350,4,home,16,19,3
7350,5,shop,19,20,1
7350,6,home,20,24,4
7351,1,home,0,6,6
7351,2,work,6,8,2
7351,3,home,8,12,4
7351,4,work,12,14,2
7351,5,home,14,22,8
7351,6,work,22,23,1
7351,7,home,23,24,1
7352,1,home,0,8,8
7352,2,work,8,14,6
7352,3,home,14,24,10
7353,1,home,0,6,6
7353,2,work,6,13,7
7353,3,shop,13,14,1
7353,4,home,14,24,10
7354,1,home,0,6,6
7354,2,work,6,13,7
7354,3,home,13,24,11
7355,1,home,0,8,8
7355,2,work,8,14,6
7355,3,home,14,22,8
7355,4,work,22,23,1
7355,5,home,23,24,1
7356,1,home,0,7,7
7356,2,work,7,14,7
7356,3,shop,14,15,1
7356,4,home,15,24,9
7357,1,home,0,6,6
7357,2,work,6,13,7
7357,3,home,13,24,11
7358,1,home,0,7,7
7358,2,education,7,12,5
7358,3,home,12,20,8
7358,4,shop,20,21,1
7358,5,home,21,24,3
7359,1,home,0,6,6
7359,2,work,6,13,7
7359,3,shop,13,14,1
7359,4,work,14,19,5
7359,5,home,19,24,5
7360,1,home,0,8,8
7360,2,work,8,14,6
7360,3,home,14,23,9
7360,4,work,23,24,1
7361,1,home,0,6,6
7361,2,shop,6,7,1
7361,3,home,7,9,2
7361,4,education,9,12,3
7361,5,shop,12,14,2
7361,6,education,14,16,2
7361,7,shop,16,17,1
7361,8,home,17,24,7
7362,1,home,0,8,8
7362,2,work,8,13,5
7362,3,home,13,17,4
7362,4,work,17,20,3
7362,5,home,20,24,4
7363,1,home,0,7,7
7363,2,work,7,13,6
7363,3,home,13,24,11
7364,1,home,0,8,8
7364,2,shop,8,9,1
7364,3,work,9,16,7
7364,4,home,16,24,8
7365,1,home,0,6,6
7365,2,shop,6,7,1
7365,3,home,7,13,6
7365,4,education,13,16,3
7365,5,home,16,24,8
7366,1,home,0,6,6
7366,2,shop,6,7,1
7366,3,work,7,14,7
7366,4,home,14,24,10
7367,1,home,0,7,7
7367,2,work,7,13,6
7367,3,home,13,21,8
7367,4,work,21,22,1
7367,5,home,22,24,2
7368,1,home,0,8,8
7368,2,work,8,15,7
7368,3,shop,15,16,1
7368,4,home,16,21,5
7368,5,shop,21,22,1
7368,6,home,22,24,2
7369,1,home,0,8,8
7369,2,work,8,15,7
7369,3,shop,15,16,1
7369,4,work,16,20,4
7369,5,home,20,24,4
7370,1,home,0,8,8
7370,2,education,8,14,6
7370,3,work,14,19,5
7370,4,home,19,24,5
7371,1,home,0,6,6
7371,2,work,6,13,7
7371,3,home,13,16,3
7371,4,work,16,20,4
7371,5,home,20,24,4
7372,1,home,0,7,7
7372,2,work,7,13,6
7372,3,shop,13,14,1
7372,4,education,14,16,2
7372,5,home,16,24,8
7373,1,home,0,7,7
7373,2,work,7,9,2
7373,3,home,9,16,7
7373,4,work,16,18,2
7373,5,home,18,24,6
7374,1,home,0,7,7
7374,2,shop,7,8,1
7374,3,education,8,11,3
7374,4,home,11,14,3
7374,5,education,14,15,1
7374,6,shop,15,17,2
7374,7,home,17,24,7
7375,1,home,0,7,7
7375,2,work,7,14,7
7375,3,shop,14,15,1
7375,4,work,15,20,5
7375,5,home,20,24,4
7376,1,home,0,7,7
7376,2,education,7,11,4
7376,3,home,11,14,3
7376,4,education,14,16,2
7376,5,shop,16,17,1
7376,6,home,17,24,7
7377,1,home,0,8,8
7377,2,work,8,13,5
7377,3,home,13,24,11
7378,1,home,0,6,6
7378,2,work,6,13,7
7378,3,home,13,24,11
7379,1,home,0,6,6
7379,2,shop,6,7,1
7379,3,work,7,14,7
7379,4,home,14,21,7
7379,5,work,21,22,1
7379,6,home,22,24,2
7380,1,home,0,7,7
7380,2,education,7,13,6
7380,3,home,13,19,6
7380,4,shop,19,20,1
7380,5,home,20,24,4
7381,1,home,0,8,8
7381,2,work,8,15,7
7381,3,home,15,24,9
7382,1,home,0,7,7
7382,2,work,7,9,2
7382,3,home,9,14,5
7382,4,work,14,16,2
7382,5,home,16,22,6
7382,6,work,22,23,1
7382,7,home,23,24,1
7383,1,home,0,8,8
7383,2,work,8,16,8
7383,3,shop,16,17,1
7383,4,home,17,24,7
7384,1,home,0,8,8
7384,2,work,8,14,6
7384,3,home,14,24,10
7385,1,home,0,8,8
7385,2,shop,8,9,1
7385,3,home,9,14,5
7385,4,work,14,20,6
7385,5,home,20,24,4
7386,1,home,0,8,8
7386,2,work,8,15,7
7386,3,home,15,21,6
7386,4,work,21,22,1
7386,5,home,22,24,2
7387,1,home,0,7,7
7387,2,work,7,13,6
7387,3,home,13,24,11
7388,1,home,0,8,8
7388,2,work,8,14,6
7388,3,home,14,24,10
7389,1,home,0,6,6
7389,2,shop,6,7,1
7389,3,home,7,13,6
7389,4,education,13,16,3
7389,5,home,16,24,8
7390,1,home,0,8,8
7390,2,work,8,15,7
7390,3,home,15,24,9
7391,1,home,0,6,6
7391,2,work,6,13,7
7391,3,shop,13,14,1
7391,4,work,14,20,6
7391,5,home,20,24,4
7392,1,home,0,7,7
7392,2,work,7,13,6
7392,3,home,13,17,4
7392,4,work,17,20,3
7392,5,home,20,24,4
7393,1,home,0,8,8
7393,2,work,8,14,6
7393,3,shop,14,15,1
7393,4,work,15,19,4
7393,5,home,19,24,5
7394,1,home,0,8,8
7394,2,work,8,15,7
7394,3,home,15,24,9
7395,1,home,0,7,7
7395,2,education,7,11,4
7395,3,home,11,18,7
7395,4,shop,18,19,1
7395,5,home,19,24,5
7396,1,home,0,6,6
7396,2,work,6,13,7
7396,3,home,13,21,8
7396,4,work,21,22,1
7396,5,home,22,24,2
7397,1,home,0,7,7
7397,2,work,7,14,7
7397,3,shop,14,15,1
7397,4,home,15,23,8
7397,5,work,23,24,1
7398,1,home,0,8,8
7398,2,work,8,14,6
7398,3,shop,14,15,1
7398,4,work,15,19,4
7398,5,home,19,24,5
7399,1,work,0,7,7
7399,2,shop,7,8,1
7399,3,work,8,14,6
7399,4,home,14,24,10
7400,1,home,0,6,6
7400,2,shop,6,7,1
7400,3,home,7,10,3
7400,4,education,10,12,2
7400,5,home,12,18,6
7400,6,shop,18,19,1
7400,7,home,19,24,5
7401,1,home,0,7,7
7401,2,education,7,10,3
7401,3,home,10,16,6
7401,4,shop,16,17,1
7401,5,home,17,24,7
7402,1,home,0,7,7
7402,2,work,7,15,8
7402,3,home,15,24,9
7403,1,home,0,8,8
7403,2,work,8,16,8
7403,3,home,16,24,8
7404,1,home,0,6,6
7404,2,work,6,13,7
7404,3,shop,13,14,1
7404,4,work,14,20,6
7404,5,home,20,24,4
7405,1,home,0,6,6
7405,2,work,6,8,2
7405,3,home,8,13,5
7405,4,work,13,15,2
7405,5,home,15,21,6
7405,6,work,21,22,1
7405,7,home,22,24,2
7406,1,home,0,7,7
7406,2,work,7,14,7
7406,3,shop,14,15,1
7406,4,home,15,16,1
7406,5,work,16,19,3
7406,6,home,19,24,5
7407,1,home,0,7,7
7407,2,work,7,13,6
7407,3,home,13,18,5
7407,4,work,18,20,2
7407,5,home,20,24,4
7408,1,home,0,8,8
7408,2,education,8,11,3
7408,3,home,11,16,5
7408,4,work,16,20,4
7408,5,home,20,24,4
7409,1,home,0,7,7
7409,2,education,7,11,4
7409,3,home,11,14,3
7409,4,education,14,16,2
7409,5,shop,16,18,2
7409,6,home,18,24,6
7410,1,home,0,8,8
7410,2,education,8,11,3
7410,3,home,11,15,4
7410,4,shop,15,17,2
7410,5,home,17,24,7
7411,1,home,0,6,6
7411,2,shop,6,7,1
7411,3,work,7,14,7
7411,4,home,14,24,10
7412,1,home,0,8,8
7412,2,work,8,14,6
7412,3,home,14,24,10
7413,1,home,0,6,6
7413,2,shop,6,7,1
7413,3,home,7,13,6
7413,4,education,13,16,3
7413,5,home,16,24,8
7414,1,home,0,8,8
7414,2,work,8,13,5
7414,3,shop,13,15,2
7414,4,work,15,20,5
7414,5,home,20,24,4
7415,1,home,0,6,6
7415,2,shop,6,7,1
7415,3,home,7,10,3
7415,4,education,10,12,2
7415,5,shop,12,14,2
7415,6,home,14,20,6
7415,7,shop,20,21,1
7415,8,home,21,24,3
7416,1,home,0,7,7
7416,2,work,7,14,7
7416,3,home,14,23,9
7416,4,work,23,24,1
7417,1,home,0,8,8
7417,2,work,8,13,5
7417,3,shop,13,14,1
7417,4,home,14,24,10
7418,1,home,0,7,7
7418,2,work,7,14,7
7418,3,shop,14,15,1
7418,4,home,15,24,9
7419,1,home,0,7,7
7419,2,work,7,14,7
7419,3,home,14,24,10
7420,1,home,0,9,9
7420,2,work,9,15,6
7420,3,home,15,24,9
7421,1,home,0,7,7
7421,2,work,7,14,7
7421,3,shop,14,15,1
7421,4,home,15,24,9
7422,1,home,0,6,6
7422,2,shop,6,7,1
7422,3,home,7,10,3
7422,4,education,10,13,3
7422,5,shop,13,14,1
7422,6,education,14,16,2
7422,7,shop,16,17,1
7422,8,home,17,21,4
7422,9,shop,21,22,1
7422,10,home,22,24,2
7423,1,home,0,6,6
7423,2,shop,6,7,1
7423,3,work,7,13,6
7423,4,home,13,14,1
7423,5,work,14,19,5
7423,6,home,19,24,5
7424,1,home,0,6,6
7424,2,work,6,13,7
7424,3,home,13,24,11
7425,1,home,0,7,7
7425,2,work,7,13,6
7425,3,shop,13,14,1
7425,4,work,14,20,6
7425,5,home,20,24,4
7426,1,home,0,7,7
7426,2,work,7,13,6
7426,3,home,13,23,10
7426,4,work,23,24,1
7427,1,home,0,7,7
7427,2,work,7,8,1
7427,3,home,8,14,6
7427,4,work,14,17,3
7427,5,home,17,24,7
7428,1,home,0,7,7
7428,2,work,7,9,2
7428,3,home,9,12,3
7428,4,work,12,13,1
7428,5,home,13,21,8
7428,6,work,21,22,1
7428,7,home,22,24,2
7429,1,home,0,6,6
7429,2,work,6,13,7
7429,3,shop,13,14,1
7429,4,work,14,19,5
7429,5,home,19,24,5
7430,1,home,0,8,8
7430,2,work,8,16,8
7430,3,home,16,23,7
7430,4,work,23,24,1
7431,1,home,0,7,7
7431,2,work,7,14,7
7431,3,shop,14,15,1
7431,4,home,15,21,6
7431,5,shop,21,22,1
7431,6,home,22,24,2
7432,1,home,0,7,7
7432,2,shop,7,8,1
7432,3,work,8,15,7
7432,4,home,15,22,7
7432,5,work,22,23,1
7432,6,home,23,24,1
7433,1,home,0,7,7
7433,2,work,7,8,1
7433,3,home,8,11,3
7433,4,work,11,13,2
7433,5,home,13,17,4
7433,6,work,17,18,1
7433,7,home,18,24,6
7434,1,home,0,6,6
7434,2,work,6,12,6
7434,3,shop,12,13,1
7434,4,work,13,20,7
7434,5,home,20,24,4
7435,1,home,0,6,6
7435,2,shop,6,7,1
7435,3,home,7,9,2
7435,4,education,9,13,4
7435,5,shop,13,15,2
7435,6,home,15,24,9
7436,1,home,0,7,7
7436,2,work,7,9,2
7436,3,home,9,15,6
7436,4,work,15,17,2
7436,5,home,17,24,7
7437,1,home,0,8,8
7437,2,work,8,14,6
7437,3,home,14,23,9
7437,4,work,23,24,1
7438,1,home,0,7,7
7438,2,education,7,11,4
7438,3,home,11,14,3
7438,4,education,14,16,2
7438,5,home,16,24,8
7439,1,home,0,7,7
7439,2,work,7,13,6
7439,3,shop,13,14,1
7439,4,home,14,24,10
7440,1,home,0,7,7
7440,2,work,7,14,7
7440,3,home,14,18,4
7440,4,work,18,20,2
7440,5,home,20,24,4
7441,1,home,0,6,6
7441,2,work,6,13,7
7441,3,home,13,17,4
7441,4,work,17,18,1
7441,5,home,18,24,6
7442,1,home,0,7,7
7442,2,education,7,11,4
7442,3,home,11,17,6
7442,4,shop,17,18,1
7442,5,home,18,24,6
7443,1,home,0,7,7
7443,2,work,7,13,6
7443,3,home,13,17,4
7443,4,work,17,20,3
7443,5,home,20,24,4
7444,1,home,0,8,8
7444,2,work,8,14,6
7444,3,shop,14,15,1
7444,4,home,15,24,9
7445,1,home,0,6,6
7445,2,work,6,8,2
7445,3,home,8,13,5
7445,4,shop,13,14,1
7445,5,home,14,21,7
7445,6,work,21,22,1
7445,7,home,22,24,2
7446,1,home,0,6,6
7446,2,work,6,7,1
7446,3,home,7,13,6
7446,4,work,13,15,2
7446,5,home,15,21,6
7446,6,work,21,22,1
7446,7,home,22,24,2
7447,1,home,0,7,7
7447,2,work,7,14,7
7447,3,shop,14,15,1
7447,4,work,15,19,4
7447,5,home,19,24,5
7448,1,home,0,7,7
7448,2,work,7,13,6
7448,3,home,13,24,11
7449,1,home,0,7,7
7449,2,education,7,12,5
7449,3,shop,12,14,2
7449,4,education,14,16,2
7449,5,shop,16,18,2
7449,6,home,18,24,6
7450,1,home,0,8,8
7450,2,work,8,14,6
7450,3,shop,14,15,1
7450,4,work,15,19,4
7450,5,home,19,24,5
7451,1,home,0,7,7
7451,2,work,7,13,6
7451,3,home,13,24,11
7452,1,home,0,8,8
7452,2,education,8,13,5
7452,3,work,13,20,7
7452,4,home,20,24,4
7453,1,home,0,9,9
7453,2,education,9,12,3
7453,3,home,12,19,7
7453,4,shop,19,20,1
7453,5,home,20,24,4
7454,1,home,0,6,6
7454,2,work,6,13,7
7454,3,shop,13,14,1
7454,4,work,14,20,6
7454,5,home,20,24,4
7455,1,home,0,7,7
7455,2,work,7,14,7
7455,3,home,14,23,9
7455,4,work,23,24,1
7456,1,home,0,6,6
7456,2,shop,6,7,1
7456,3,work,7,14,7
7456,4,home,14,24,10
7457,1,home,0,7,7
7457,2,education,7,12,5
7457,3,shop,12,14,2
7457,4,education,14,16,2
7457,5,home,16,24,8
7458,1,home,0,8,8
7458,2,work,8,14,6
7458,3,shop,14,15,1
7458,4,work,15,19,4
7458,5,home,19,24,5
7459,1,home,0,6,6
7459,2,shop,6,7,1
7459,3,home,7,9,2
7459,4,education,9,12,3
7459,5,home,12,18,6
7459,6,shop,18,19,1
7459,7,home,19,24,5
7460,1,home,0,7,7
7460,2,education,7,12,5
7460,3,home,12,21,9
7460,4,shop,21,22,1
7460,5,home,22,24,2
7461,1,home,0,8,8
7461,2,education,8,12,4
7461,3,home,12,20,8
7461,4,shop,20,21,1
7461,5,home,21,24,3
7462,1,home,0,7,7
7462,2,work,7,13,6
7462,3,home,13,24,11
7463,1,home,0,8,8
7463,2,education,8,11,3
7463,3,home,11,15,4
7463,4,shop,15,16,1
7463,5,home,16,24,8
7464,1,home,0,8,8
7464,2,work,8,14,6
7464,3,home,14,24,10
7465,1,home,0,7,7
7465,2,work,7,14,7
7465,3,shop,14,15,1
7465,4,work,15,20,5
7465,5,home,20,24,4
7466,1,home,0,7,7
7466,2,education,7,11,4
7466,3,home,11,18,7
7466,4,shop,18,19,1
7466,5,home,19,24,5
7467,1,home,0,8,8
7467,2,shop,8,9,1
7467,3,work,9,16,7
7467,4,home,16,24,8
7468,1,home,0,9,9
7468,2,work,9,13,4
7468,3,shop,13,14,1
7468,4,work,14,20,6
7468,5,home,20,24,4
7469,1,home,0,6,6
7469,2,work,6,13,7
7469,3,home,13,18,5
7469,4,work,18,20,2
7469,5,home,20,24,4
7470,1,home,0,9,9
7470,2,work,9,16,7
7470,3,home,16,21,5
7470,4,work,21,22,1
7470,5,home,22,24,2
7471,1,home,0,7,7
7471,2,work,7,13,6
7471,3,shop,13,14,1
7471,4,education,14,16,2
7471,5,home,16,24,8
7472,1,home,0,8,8
7472,2,work,8,14,6
7472,3,home,14,19,5
7472,4,shop,19,20,1
7472,5,home,20,24,4
7473,1,home,0,7,7
7473,2,shop,7,8,1
7473,3,work,8,16,8
7473,4,home,16,21,5
7473,5,shop,21,22,1
7473,6,home,22,24,2
7474,1,home,0,9,9
7474,2,work,9,16,7
7474,3,home,16,24,8
7475,1,home,0,7,7
7475,2,shop,7,8,1
7475,3,education,8,11,3
7475,4,home,11,18,7
7475,5,shop,18,20,2
7475,6,home,20,24,4
7476,1,home,0,8,8
7476,2,work,8,14,6
7476,3,shop,14,15,1
7476,4,home,15,23,8
7476,5,work,23,24,1
7477,1,home,0,8,8
7477,2,work,8,15,7
7477,3,shop,15,16,1
7477,4,home,16,24,8
7478,1,home,0,8,8
7478,2,work,8,14,6
7478,3,shop,14,15,1
7478,4,work,15,20,5
7478,5,home,20,24,4
7479,1,home,0,7,7
7479,2,work,7,13,6
7479,3,home,13,17,4
7479,4,work,17,20,3
7479,5,home,20,24,4
7480,1,home,0,6,6
7480,2,work,6,14,8
7480,3,home,14,21,7
7480,4,work,21,22,1
7480,5,home,22,24,2
7481,1,home,0,9,9
7481,2,work,9,17,8
7481,3,home,17,24,7
7482,1,home,0,7,7
7482,2,shop,7,9,2
7482,3,education,9,11,2
7482,4,home,11,19,8
7482,5,shop,19,20,1
7482,6,home,20,24,4
7483,1,home,0,6,6
7483,2,shop,6,7,1
7483,3,home,7,10,3
7483,4,education,10,12,2
7483,5,home,12,14,2
7483,6,education,14,16,2
7483,7,home,16,21,5
7483,8,shop,21,22,1
7483,9,home,22,24,2
7484,1,home,0,7,7
7484,2,shop,7,8,1
7484,3,education,8,11,3
7484,4,home,11,17,6
7484,5,shop,17,18,1
7484,6,home,18,24,6
7485,1,home,0,8,8
7485,2,work,8,15,7
7485,3,home,15,24,9
7486,1,home,0,7,7
7486,2,work,7,13,6
7486,3,shop,13,14,1
7486,4,work,14,19,5
7486,5,home,19,24,5
7487,1,home,0,7,7
7487,2,work,7,14,7
7487,3,home,14,21,7
7487,4,work,21,22,1
7487,5,home,22,24,2
7488,1,home,0,7,7
7488,2,work,7,9,2
7488,3,home,9,15,6
7488,4,work,15,17,2
7488,5,home,17,24,7
7489,1,home,0,6,6
7489,2,work,6,7,1
7489,3,home,7,12,5
7489,4,work,12,13,1
7489,5,home,13,17,4
7489,6,work,17,18,1
7489,7,home,18,24,6
7490,1,home,0,6,6
7490,2,work,6,13,7
7490,3,shop,13,14,1
7490,4,home,14,24,10
7491,1,home,0,7,7
7491,2,work,7,13,6
7491,3,shop,13,14,1
7491,4,education,14,16,2
7491,5,home,16,21,5
7491,6,work,21,22,1
7491,7,home,22,24,2
7492,1,home,0,7,7
7492,2,education,7,13,6
7492,3,shop,13,15,2
7492,4,home,15,24,9
7493,1,home,0,7,7
7493,2,shop,7,8,1
7493,3,home,8,13,5
7493,4,work,13,19,6
7493,5,home,19,24,5
7494,1,home,0,7,7
7494,2,shop,7,9,2
7494,3,education,9,12,3
7494,4,home,12,18,6
7494,5,shop,18,19,1
7494,6,home,19,24,5
7495,1,home,0,7,7
7495,2,shop,7,8,1
7495,3,education,8,11,3
7495,4,home,11,17,6
7495,5,shop,17,19,2
7495,6,home,19,24,5
7496,1,work,0,9,9
7496,2,shop,9,10,1
7496,3,home,10,16,6
7496,4,work,16,20,4
7496,5,home,20,24,4
7497,1,home,0,7,7
7497,2,shop,7,8,1
7497,3,home,8,13,5
7497,4,education,13,16,3
7497,5,shop,16,18,2
7497,6,home,18,24,6
7498,1,home,0,6,6
7498,2,work,6,13,7
7498,3,shop,13,14,1
7498,4,work,14,19,5
7498,5,home,19,24,5
7499,1,home,0,8,8
7499,2,education,8,11,3
7499,3,home,11,18,7
7499,4,shop,18,19,1
7499,5,home,19,24,5
7500,1,home,0,8,8
7500,2,education,8,14,6
7500,3,home,14,22,8
7500,4,work,22,23,1
7500,5,home,23,24,1
7501,1,home,0,6,6
7501,2,shop,6,7,1
7501,3,home,7,10,3
7501,4,education,10,12,2
7501,5,home,12,19,7
7501,6,shop,19,20,1
7501,7,home,20,24,4
7502,1,home,0,6,6
7502,2,work,6,13,7
7502,3,home,13,17,4
7502,4,shop,17,18,1
7502,5,home,18,24,6
7503,1,home,0,6,6
7503,2,work,6,8,2
7503,3,home,8,12,4
7503,4,work,12,14,2
7503,5,home,14,21,7
7503,6,work,21,22,1
7503,7,home,22,24,2
7504,1,home,0,7,7
7504,2,work,7,13,6
7504,3,shop,13,14,1
7504,4,education,14,17,3
7504,5,home,17,24,7
7505,1,home,0,7,7
7505,2,work,7,14,7
7505,3,home,14,20,6
7505,4,shop,20,21,1
7505,5,home,21,24,3
7506,1,home,0,7,7
7506,2,work,7,13,6
7506,3,shop,13,14,1
7506,4,home,14,24,10
7507,1,home,0,6,6
7507,2,work,6,13,7
7507,3,home,13,18,5
7507,4,work,18,20,2
7507,5,home,20,24,4
7508,1,home,0,9,9
7508,2,work,9,16,7
7508,3,home,16,21,5
7508,4,shop,21,22,1
7508,5,home,22,24,2
7509,1,home,0,7,7
7509,2,work,7,13,6
7509,3,home,13,17,4
7509,4,work,17,20,3
7509,5,home,20,24,4
7510,1,home,0,7,7
7510,2,shop,7,8,1
7510,3,work,8,15,7
7510,4,home,15,24,9
7511,1,home,0,7,7
7511,2,work,7,9,2
7511,3,home,9,13,4
7511,4,work,13,15,2
7511,5,home,15,22,7
7511,6,work,22,23,1
7511,7,home,23,24,1
7512,1,home,0,7,7
7512,2,work,7,13,6
7512,3,shop,13,14,1
7512,4,home,14,24,10
7513,1,home,0,6,6
7513,2,work,6,8,2
7513,3,home,8,14,6
7513,4,education,14,15,1
7513,5,work,15,17,2
7513,6,home,17,24,7
7514,1,home,0,7,7
7514,2,shop,7,8,1
7514,3,work,8,15,7
7514,4,home,15,24,9
7515,1,home,0,7,7
7515,2,shop,7,8,1
7515,3,work,8,15,7
7515,4,shop,15,16,1
7515,5,home,16,24,8
7516,1,home,0,8,8
7516,2,work,8,14,6
7516,3,home,14,20,6
7516,4,shop,20,21,1
7516,5,home,21,24,3
7517,1,home,0,7,7
7517,2,work,7,13,6
7517,3,home,13,22,9
7517,4,work,22,23,1
7517,5,home,23,24,1
7518,1,home,0,7,7
7518,2,work,7,13,6
7518,3,home,13,17,4
7518,4,work,17,20,3
7518,5,home,20,24,4
7519,1,home,0,6,6
7519,2,work,6,12,6
7519,3,shop,12,13,1
7519,4,work,13,19,6
7519,5,home,19,23,4
7519,6,work,23,24,1
7520,1,home,0,8,8
7520,2,work,8,15,7
7520,3,shop,15,16,1
7520,4,home,16,21,5
7520,5,work,21,22,1
7520,6,home,22,24,2
7521,1,home,0,6,6
7521,2,work,6,13,7
7521,3,home,13,17,4
7521,4,work,17,20,3
7521,5,home,20,24,4
7522,1,home,0,7,7
7522,2,education,7,12,5
7522,3,shop,12,14,2
7522,4,education,14,16,2
7522,5,home,16,24,8
7523,1,home,0,7,7
7523,2,work,7,14,7
7523,3,shop,14,15,1
7523,4,home,15,24,9
7524,1,home,0,7,7
7524,2,work,7,15,8
7524,3,home,15,24,9
7525,1,home,0,7,7
7525,2,work,7,13,6
7525,3,shop,13,14,1
7525,4,home,14,18,4
7525,5,work,18,20,2
7525,6,home,20,24,4
7526,1,home,0,6,6
7526,2,work,6,13,7
7526,3,home,13,17,4
7526,4,work,17,20,3
7526,5,home,20,24,4
7527,1,home,0,8,8
7527,2,work,8,16,8
7527,3,home,16,20,4
7527,4,shop,20,21,1
7527,5,home,21,24,3
7528,1,home,0,7,7
7528,2,work,7,13,6
7528,3,shop,13,14,1
7528,4,home,14,18,4
7528,5,work,18,20,2
7528,6,home,20,24,4
7529,1,home,0,8,8
7529,2,shop,8,9,1
7529,3,work,9,16,7
7529,4,shop,16,17,1
7529,5,home,17,24,7
7530,1,home,0,8,8
7530,2,work,8,14,6
7530,3,shop,14,15,1
7530,4,home,15,22,7
7530,5,work,22,23,1
7530,6,home,23,24,1
7531,1,home,0,8,8
7531,2,work,8,13,5
7531,3,home,13,24,11
7532,1,home,0,8,8
7532,2,work,8,15,7
7532,3,home,15,21,6
7532,4,shop,21,22,1
7532,5,home,22,24,2
7533,1,home,0,7,7
7533,2,education,7,11,4
7533,3,home,11,19,8
7533,4,shop,19,21,2
7533,5,home,21,24,3
7534,1,home,0,7,7
7534,2,work,7,14,7
7534,3,shop,14,15,1
7534,4,home,15,24,9
7535,1,home,0,8,8
7535,2,work,8,16,8
7535,3,shop,16,17,1
7535,4,home,17,24,7
7536,1,home,0,8,8
7536,2,work,8,15,7
7536,3,home,15,24,9
7537,1,home,0,7,7
7537,2,work,7,14,7
7537,3,home,14,24,10
7538,1,home,0,8,8
7538,2,work,8,15,7
7538,3,home,15,20,5
7538,4,shop,20,21,1
7538,5,home,21,24,3
7539,1,home,0,7,7
7539,2,shop,7,9,2
7539,3,education,9,12,3
7539,4,home,12,15,3
7539,5,shop,15,16,1
7539,6,home,16,24,8
7540,1,home,0,6,6
7540,2,shop,6,7,1
7540,3,home,7,10,3
7540,4,education,10,13,3
7540,5,home,13,21,8
7540,6,shop,21,22,1
7540,7,home,22,24,2
7541,1,home,0,7,7
7541,2,work,7,14,7
7541,3,home,14,21,7
7541,4,work,21,22,1
7541,5,home,22,24,2
7542,1,home,0,7,7
7542,2,work,7,15,8
7542,3,home,15,22,7
7542,4,work,22,23,1
7542,5,home,23,24,1
7543,1,home,0,8,8
7543,2,work,8,15,7
7543,3,home,15,24,9
7544,1,home,0,7,7
7544,2,work,7,13,6
7544,3,shop,13,14,1
7544,4,home,14,24,10
7545,1,home,0,7,7
7545,2,work,7,15,8
7545,3,home,15,24,9
7546,1,home,0,6,6
7546,2,shop,6,7,1
7546,3,home,7,18,11
7546,4,work,18,20,2
7546,5,home,20,24,4
7547,1,home,0,7,7
7547,2,work,7,13,6
7547,3,home,13,24,11
7548,1,home,0,7,7
7548,2,work,7,13,6
7548,3,home,13,17,4
7548,4,work,17,20,3
7548,5,home,20,24,4
7549,1,home,0,6,6
7549,2,work,6,8,2
7549,3,home,8,15,7
7549,4,work,15,17,2
7549,5,home,17,23,6
7549,6,work,23,24,1
7550,1,home,0,6,6
7550,2,work,6,13,7
7550,3,home,13,24,11
7551,1,home,0,6,6
7551,2,work,6,14,8
7551,3,home,14,24,10
7552,1,home,0,6,6
7552,2,work,6,13,7
7552,3,home,13,18,5
7552,4,work,18,20,2
7552,5,home,20,24,4
7553,1,home,0,7,7
7553,2,work,7,13,6
7553,3,home,13,18,5
7553,4,work,18,20,2
7553,5,home,20,24,4
7554,1,home,0,8,8
7554,2,work,8,13,5
7554,3,home,13,17,4
7554,4,work,17,20,3
7554,5,home,20,24,4
7555,1,home,0,8,8
7555,2,work,8,14,6
7555,3,home,14,21,7
7555,4,work,21,22,1
7555,5,home,22,24,2
7556,1,home,0,7,7
7556,2,work,7,9,2
7556,3,home,9,14,5
7556,4,work,14,16,2
7556,5,shop,16,17,1
7556,6,home,17,23,6
7556,7,work,23,24,1
7557,1,home,0,6,6
7557,2,shop,6,7,1
7557,3,home,7,10,3
7557,4,education,10,15,5
7557,5,shop,15,17,2
7557,6,home,17,24,7
7558,1,home,0,6,6
7558,2,work,6,13,7
7558,3,home,13,18,5
7558,4,shop,18,19,1
7558,5,home,19,24,5
7559,1,home,0,7,7
7559,2,education,7,13,6
7559,3,home,13,20,7
7559,4,shop,20,21,1
7559,5,home,21,24,3
7560,1,home,0,7,7
7560,2,shop,7,8,1
7560,3,home,8,9,1
7560,4,work,9,13,4
7560,5,home,13,17,4
7560,6,work,17,20,3
7560,7,home,20,24,4
7561,1,home,0,8,8
7561,2,education,8,10,2
7561,3,home,10,14,4
7561,4,education,14,16,2
7561,5,home,16,24,8
7562,1,home,0,7,7
7562,2,work,7,9,2
7562,3,home,9,15,6
7562,4,work,15,17,2
7562,5,home,17,24,7
7563,1,home,0,8,8
7563,2,work,8,15,7
7563,3,shop,15,16,1
7563,4,home,16,24,8
7564,1,home,0,6,6
7564,2,work,6,13,7
7564,3,home,13,24,11
7565,1,home,0,6,6
7565,2,shop,6,7,1
7565,3,home,7,13,6
7565,4,education,13,16,3
7565,5,shop,16,17,1
7565,6,home,17,24,7
7566,1,home,0,9,9
7566,2,work,9,17,8
7566,3,home,17,23,6
7566,4,work,23,24,1
7567,1,home,0,6,6
7567,2,shop,6,7,1
7567,3,home,7,10,3
7567,4,education,10,14,4
7567,5,shop,14,16,2
7567,6,home,16,24,8
7568,1,home,0,6,6
7568,2,work,6,13,7
7568,3,shop,13,14,1
7568,4,work,14,19,5
7568,5,home,19,24,5
7569,1,home,0,8,8
7569,2,work,8,15,7
7569,3,home,15,24,9
7570,1,home,0,7,7
7570,2,work,7,13,6
7570,3,home,13,24,11
7571,1,home,0,6,6
7571,2,work,6,13,7
7571,3,home,13,24,11
7572,1,home,0,6,6
7572,2,work,6,13,7
7572,3,shop,13,14,1
7572,4,work,14,19,5
7572,5,home,19,24,5
7573,1,home,0,6,6
7573,2,work,6,8,2
7573,3,home,8,9,1
7573,4,work,9,11,2
7573,5,home,11,17,6
7573,6,work,17,19,2
7573,7,home,19,24,5
7574,1,home,0,7,7
7574,2,work,7,15,8
7574,3,home,15,22,7
7574,4,work,22,23,1
7574,5,home,23,24,1
7575,1,home,0,7,7
7575,2,work,7,13,6
7575,3,home,13,24,11
7576,1,home,0,6,6
7576,2,work,6,13,7
7576,3,shop,13,14,1
7576,4,home,14,18,4
7576,5,work,18,20,2
7576,6,home,20,24,4
7577,1,home,0,7,7
7577,2,work,7,9,2
7577,3,home,9,16,7
7577,4,work,16,18,2
7577,5,home,18,24,6
7578,1,home,0,7,7
7578,2,education,7,10,3
7578,3,home,10,14,4
7578,4,education,14,16,2
7578,5,home,16,24,8
7579,1,home,0,7,7
7579,2,education,7,13,6
7579,3,shop,13,15,2
7579,4,home,15,24,9
7580,1,home,0,8,8
7580,2,work,8,15,7
7580,3,home,15,24,9
7581,1,home,0,7,7
7581,2,education,7,11,4
7581,3,home,11,14,3
7581,4,education,14,16,2
7581,5,home,16,20,4
7581,6,shop,20,21,1
7581,7,home,21,24,3
7582,1,home,0,7,7
7582,2,work,7,14,7
7582,3,home,14,19,5
7582,4,shop,19,20,1
7582,5,home,20,24,4
7583,1,home,0,7,7
7583,2,work,7,13,6
7583,3,shop,13,14,1
7583,4,work,14,19,5
7583,5,home,19,24,5
7584,1,home,0,8,8
7584,2,work,8,15,7
7584,3,home,15,24,9
7585,1,home,0,7,7
7585,2,education,7,12,5
7585,3,home,12,19,7
7585,4,shop,19,20,1
7585,5,home,20,24,4
7586,1,home,0,7,7
7586,2,shop,7,8,1
7586,3,home,8,9,1
7586,4,work,9,17,8
7586,5,home,17,24,7
7587,1,home,0,6,6
7587,2,work,6,13,7
7587,3,home,13,24,11
7588,1,home,0,7,7
7588,2,work,7,14,7
7588,3,shop,14,15,1
7588,4,home,15,24,9
7589,1,home,0,6,6
7589,2,work,6,13,7
7589,3,home,13,21,8
7589,4,work,21,22,1
7589,5,home,22,24,2
7590,1,home,0,7,7
7590,2,education,7,11,4
7590,3,home,11,17,6
7590,4,shop,17,19,2
7590,5,home,19,24,5
7591,1,home,0,6,6
7591,2,shop,6,7,1
7591,3,home,7,10,3
7591,4,education,10,13,3
7591,5,shop,13,15,2
7591,6,home,15,24,9
7592,1,home,0,7,7
7592,2,education,7,11,4
7592,3,home,11,17,6
7592,4,shop,17,19,2
7592,5,home,19,24,5
7593,1,home,0,6,6
7593,2,work,6,8,2
7593,3,home,8,11,3
7593,4,work,11,13,2
7593,5,home,13,20,7
7593,6,shop,20,21,1
7593,7,home,21,24,3
7594,1,home,0,6,6
7594,2,work,6,7,1
7594,3,home,7,9,2
7594,4,work,9,11,2
7594,5,home,11,16,5
7594,6,work,16,18,2
7594,7,home,18,24,6
7595,1,home,0,6,6
7595,2,work,6,8,2
7595,3,home,8,12,4
7595,4,work,12,14,2
7595,5,home,14,21,7
7595,6,work,21,22,1
7595,7,home,22,24,2
7596,1,home,0,6,6
7596,2,work,6,8,2
7596,3,home,8,14,6
7596,4,work,14,17,3
7596,5,home,17,23,6
7596,6,work,23,24,1
7597,1,home,0,7,7
7597,2,work,7,14,7
7597,3,shop,14,15,1
7597,4,home,15,23,8
7597,5,work,23,24,1
7598,1,home,0,6,6
7598,2,work,6,7,1
7598,3,home,7,13,6
7598,4,work,13,15,2
7598,5,home,15,22,7
7598,6,work,22,23,1
7598,7,home,23,24,1
7599,1,home,0,6,6
7599,2,work,6,13,7
7599,3,home,13,19,6
7599,4,shop,19,20,1
7599,5,home,20,24,4
7600,1,home,0,7,7
7600,2,work,7,13,6
7600,3,shop,13,14,1
7600,4,home,14,24,10
7601,1,home,0,8,8
7601,2,education,8,11,3
7601,3,shop,11,12,1
7601,4,home,12,16,4
7601,5,work,16,20,4
7601,6,home,20,24,4
7602,1,home,0,6,6
7602,2,shop,6,7,1
7602,3,home,7,10,3
7602,4,education,10,16,6
7602,5,home,16,24,8
7603,1,home,0,8,8
7603,2,work,8,14,6
7603,3,shop,14,15,1
7603,4,work,15,20,5
7603,5,home,20,24,4
7604,1,home,0,8,8
7604,2,work,8,14,6
7604,3,home,14,20,6
7604,4,shop,20,21,1
7604,5,home,21,24,3
7605,1,home,0,6,6
7605,2,work,6,7,1
7605,3,home,7,12,5
7605,4,work,12,14,2
7605,5,home,14,21,7
7605,6,work,21,22,1
7605,7,home,22,24,2
7606,1,home,0,7,7
7606,2,shop,7,8,1
7606,3,education,8,12,4
7606,4,home,12,18,6
7606,5,shop,18,19,1
7606,6,home,19,24,5
7607,1,home,0,6,6
7607,2,shop,6,7,1
7607,3,home,7,13,6
7607,4,education,13,16,3
7607,5,home,16,24,8
7608,1,home,0,8,8
7608,2,work,8,15,7
7608,3,home,15,20,5
7608,4,shop,20,21,1
7608,5,home,21,24,3
7609,1,home,0,9,9
7609,2,work,9,16,7
7609,3,home,16,24,8
7610,1,home,0,7,7
7610,2,education,7,11,4
7610,3,home,11,17,6
7610,4,shop,17,18,1
7610,5,home,18,24,6
7611,1,home,0,8,8
7611,2,work,8,15,7
7611,3,home,15,24,9
7612,1,home,0,6,6
7612,2,work,6,13,7
7612,3,home,13,17,4
7612,4,work,17,20,3
7612,5,home,20,24,4
7613,1,home,0,7,7
7613,2,work,7,13,6
7613,3,home,13,24,11
7614,1,home,0,7,7
7614,2,work,7,13,6
7614,3,home,13,17,4
7614,4,shop,17,18,1
7614,5,home,18,24,6
7615,1,home,0,7,7
7615,2,work,7,14,7
7615,3,home,14,24,10
7616,1,home,0,7,7
7616,2,education,7,12,5
7616,3,home,12,19,7
7616,4,shop,19,20,1
7616,5,home,20,24,4
7617,1,home,0,6,6
7617,2,shop,6,7,1
7617,3,home,7,10,3
7617,4,education,10,12,2
7617,5,shop,12,14,2
7617,6,education,14,16,2
7617,7,shop,16,17,1
7617,8,home,17,24,7
7618,1,home,0,8,8
7618,2,work,8,14,6
7618,3,home,14,23,9
7618,4,work,23,24,1
7619,1,home,0,8,8
7619,2,work,8,15,7
7619,3,home,15,22,7
7619,4,work,22,23,1
7619,5,home,23,24,1
7620,1,home,0,6,6
7620,2,work,6,13,7
7620,3,shop,13,14,1
7620,4,home,14,24,10
7621,1,home,0,6,6
7621,2,shop,6,7,1
7621,3,home,7,13,6
7621,4,education,13,15,2
7621,5,shop,15,16,1
7621,6,home,16,24,8
7622,1,home,0,7,7
7622,2,education,7,12,5
7622,3,shop,12,14,2
7622,4,home,14,21,7
7622,5,shop,21,22,1
7622,6,home,22,24,2
7623,1,home,0,9,9
7623,2,education,9,11,2
7623,3,home,11,17,6
7623,4,shop,17,18,1
7623,5,home,18,24,6
7624,1,home,0,6,6
7624,2,work,6,13,7
7624,3,shop,13,14,1
7624,4,home,14,24,10
7625,1,home,0,7,7
7625,2,work,7,14,7
7625,3,home,14,24,10
7626,1,home,0,6,6
7626,2,work,6,13,7
7626,3,shop,13,14,1
7626,4,work,14,19,5
7626,5,home,19,24,5
7627,1,home,0,7,7
7627,2,work,7,14,7
7627,3,home,14,24,10
7628,1,home,0,6,6
7628,2,work,6,13,7
7628,3,shop,13,14,1
7628,4,work,14,19,5
7628,5,home,19,24,5
7629,1,home,0,6,6
7629,2,shop,6,8,2
7629,3,home,8,11,3
7629,4,education,11,15,4
7629,5,home,15,21,6
7629,6,work,21,22,1
7629,7,home,22,24,2
7630,1,home,0,7,7
7630,2,work,7,14,7
7630,3,shop,14,15,1
7630,4,home,15,24,9
7631,1,home,0,8,8
7631,2,work,8,16,8
7631,3,home,16,21,5
7631,4,shop,21,22,1
7631,5,home,22,24,2
7632,1,home,0,7,7
7632,2,education,7,12,5
7632,3,home,12,19,7
7632,4,shop,19,21,2
7632,5,home,21,24,3
7633,1,home,0,8,8
7633,2,work,8,13,5
7633,3,home,13,17,4
7633,4,shop,17,18,1
7633,5,home,18,24,6
7634,1,home,0,6,6
7634,2,work,6,13,7
7634,3,home,13,24,11
7635,1,home,0,8,8
7635,2,work,8,14,6
7635,3,shop,14,15,1
7635,4,work,15,19,4
7635,5,home,19,24,5
7636,1,home,0,7,7
7636,2,shop,7,8,1
7636,3,education,8,11,3
7636,4,home,11,17,6
7636,5,shop,17,18,1
7636,6,home,18,24,6
7637,1,home,0,8,8
7637,2,work,8,15,7
7637,3,home,15,23,8
7637,4,work,23,24,1
7638,1,home,0,8,8
7638,2,work,8,16,8
7638,3,shop,16,17,1
7638,4,work,17,19,2
7638,5,home,19,24,5
7639,1,home,0,6,6
7639,2,shop,6,7,1
7639,3,home,7,12,5
7639,4,work,12,18,6
7639,5,home,18,22,4
7639,6,work,22,23,1
7639,7,home,23,24,1
7640,1,home,0,7,7
7640,2,education,7,13,6
7640,3,home,13,19,6
7640,4,shop,19,20,1
7640,5,home,20,24,4
7641,1,home,0,7,7
7641,2,work,7,14,7
7641,3,home,14,24,10
7642,1,home,0,7,7
7642,2,work,7,13,6
7642,3,shop,13,14,1
7642,4,home,14,24,10
7643,1,home,0,8,8
7643,2,work,8,15,7
7643,3,shop,15,16,1
7643,4,home,16,22,6
7643,5,work,22,23,1
7643,6,home,23,24,1
7644,1,home,0,6,6
7644,2,work,6,13,7
7644,3,home,13,24,11
7645,1,home,0,8,8
7645,2,work,8,14,6
7645,3,home,14,18,4
7645,4,work,18,20,2
7645,5,home,20,24,4
7646,1,home,0,6,6
7646,2,shop,6,7,1
7646,3,home,7,13,6
7646,4,education,13,16,3
7646,5,shop,16,18,2
7646,6,home,18,24,6
7647,1,work,0,8,8
7647,2,shop,8,9,1
7647,3,home,9,13,4
7647,4,work,13,19,6
7647,5,home,19,24,5
7648,1,home,0,6,6
7648,2,work,6,13,7
7648,3,home,13,22,9
7648,4,work,22,23,1
7648,5,home,23,24,1
7649,1,home,0,8,8
7649,2,work,8,15,7
7649,3,shop,15,16,1
7649,4,home,16,24,8
7650,1,home,0,8,8
7650,2,shop,8,9,1
7650,3,home,9,14,5
7650,4,work,14,20,6
7650,5,home,20,24,4
7651,1,home,0,6,6
7651,2,shop,6,7,1
7651,3,home,7,10,3
7651,4,education,10,13,3
7651,5,home,13,20,7
7651,6,shop,20,21,1
7651,7,home,21,24,3
7652,1,home,0,7,7
7652,2,education,7,11,4
7652,3,home,11,18,7
7652,4,shop,18,19,1
7652,5,home,19,24,5
7653,1,home,0,6,6
7653,2,shop,6,7,1
7653,3,work,7,13,6
7653,4,home,13,17,4
7653,5,work,17,20,3
7653,6,home,20,24,4
7654,1,home,0,7,7
7654,2,education,7,11,4
7654,3,home,11,17,6
7654,4,shop,17,18,1
7654,5,home,18,24,6
7655,1,home,0,7,7
7655,2,work,7,14,7
7655,3,home,14,20,6
7655,4,shop,20,21,1
7655,5,home,21,24,3
7656,1,home,0,8,8
7656,2,education,8,11,3
7656,3,home,11,14,3
7656,4,shop,14,15,1
7656,5,home,15,24,9
7657,1,home,0,7,7
7657,2,shop,7,8,1
7657,3,education,8,12,4
7657,4,home,12,19,7
7657,5,shop,19,20,1
7657,6,home,20,24,4
7658,1,home,0,8,8
7658,2,shop,8,9,1
7658,3,work,9,18,9
7658,4,home,18,24,6
7659,1,home,0,7,7
7659,2,education,7,12,5
7659,3,home,12,19,7
7659,4,shop,19,20,1
7659,5,home,20,24,4
7660,1,home,0,7,7
7660,2,work,7,9,2
7660,3,home,9,13,4
7660,4,work,13,15,2
7660,5,home,15,23,8
7660,6,work,23,24,1
7661,1,home,0,7,7
7661,2,work,7,13,6
7661,3,home,13,17,4
7661,4,shop,17,18,1
7661,5,work,18,20,2
7661,6,home,20,24,4
7662,1,home,0,7,7
7662,2,work,7,14,7
7662,3,home,14,24,10
7663,1,home,0,7,7
7663,2,education,7,11,4
7663,3,home,11,20,9
7663,4,shop,20,21,1
7663,5,home,21,24,3
7664,1,home,0,7,7
7664,2,education,7,11,4
7664,3,home,11,18,7
7664,4,shop,18,19,1
7664,5,home,19,24,5
7665,1,home,0,7,7
7665,2,education,7,12,5
7665,3,shop,12,14,2
7665,4,education,14,16,2
7665,5,shop,16,17,1
7665,6,home,17,24,7
7666,1,home,0,7,7
7666,2,work,7,13,6
7666,3,home,13,22,9
7666,4,work,22,23,1
7666,5,home,23,24,1
7667,1,home,0,8,8
7667,2,shop,8,9,1
7667,3,work,9,15,6
7667,4,home,15,24,9
7668,1,home,0,7,7
7668,2,work,7,14,7
7668,3,home,14,18,4
7668,4,work,18,20,2
7668,5,home,20,24,4
7669,1,home,0,8,8
7669,2,work,8,14,6
7669,3,shop,14,15,1
7669,4,home,15,21,6
7669,5,work,21,22,1
7669,6,home,22,24,2
7670,1,home,0,6,6
7670,2,work,6,12,6
7670,3,shop,12,13,1
7670,4,work,13,19,6
7670,5,home,19,24,5
7671,1,home,0,7,7
7671,2,education,7,11,4
7671,3,home,11,17,6
7671,4,shop,17,18,1
7671,5,home,18,24,6
7672,1,home,0,6,6
7672,2,work,6,13,7
7672,3,home,13,17,4
7672,4,work,17,20,3
7672,5,home,20,24,4
7673,1,home,0,8,8
7673,2,work,8,15,7
7673,3,shop,15,16,1
7673,4,work,16,20,4
7673,5,home,20,24,4
7674,1,home,0,8,8
7674,2,work,8,15,7
7674,3,shop,15,16,1
7674,4,home,16,24,8
7675,1,home,0,7,7
7675,2,shop,7,8,1
7675,3,education,8,11,3
7675,4,home,11,14,3
7675,5,education,14,17,3
7675,6,home,17,24,7
7676,1,home,0,8,8
7676,2,work,8,13,5
7676,3,home,13,24,11
7677,1,home,0,7,7
7677,2,work,7,13,6
7677,3,home,13,17,4
7677,4,shop,17,18,1
7677,5,home,18,24,6
7678,1,home,0,6,6
7678,2,work,6,13,7
7678,3,shop,13,14,1
7678,4,home,14,18,4
7678,5,work,18,20,2
7678,6,home,20,24,4
7679,1,home,0,6,6
7679,2,work,6,13,7
7679,3,shop,13,14,1
7679,4,home,14,22,8
7679,5,work,22,23,1
7679,6,home,23,24,1
7680,1,home,0,8,8
7680,2,work,8,15,7
7680,3,home,15,24,9
7681,1,home,0,7,7
7681,2,education,7,12,5
7681,3,home,12,20,8
7681,4,shop,20,21,1
7681,5,home,21,24,3
7682,1,home,0,8,8
7682,2,work,8,15,7
7682,3,shop,15,16,1
7682,4,home,16,24,8
7683,1,home,0,6,6
7683,2,shop,6,7,1
7683,3,home,7,14,7
7683,4,work,14,20,6
7683,5,home,20,24,4
7684,1,home,0,8,8
7684,2,work,8,15,7
7684,3,home,15,22,7
7684,4,work,22,23,1
7684,5,home,23,24,1
7685,1,home,0,6,6
7685,2,shop,6,7,1
7685,3,home,7,12,5
7685,4,education,12,16,4
7685,5,home,16,24,8
7686,1,home,0,8,8
7686,2,work,8,14,6
7686,3,shop,14,15,1
7686,4,work,15,19,4
7686,5,home,19,24,5
7687,1,home,0,7,7
7687,2,work,7,13,6
7687,3,shop,13,14,1
7687,4,home,14,24,10
7688,1,home,0,7,7
7688,2,education,7,11,4
7688,3,home,11,19,8
7688,4,shop,19,20,1
7688,5,home,20,24,4
7689,1,home,0,6,6
7689,2,work,6,13,7
7689,3,home,13,24,11
7690,1,home,0,6,6
7690,2,work,6,13,7
7690,3,home,13,17,4
7690,4,shop,17,18,1
7690,5,home,18,24,6
7691,1,home,0,7,7
7691,2,work,7,13,6
7691,3,shop,13,14,1
7691,4,home,14,24,10
7692,1,home,0,7,7
7692,2,shop,7,8,1
7692,3,education,8,12,4
7692,4,shop,12,14,2
7692,5,education,14,17,3
7692,6,shop,17,19,2
7692,7,home,19,24,5
7693,1,home,0,6,6
7693,2,work,6,13,7
7693,3,shop,13,14,1
7693,4,home,14,21,7
7693,5,work,21,22,1
7693,6,home,22,24,2
7694,1,home,0,9,9
7694,2,work,9,15,6
7694,3,home,15,24,9
7695,1,home,0,8,8
7695,2,work,8,15,7
7695,3,home,15,24,9
7696,1,home,0,6,6
7696,2,shop,6,7,1
7696,3,home,7,10,3
7696,4,education,10,13,3
7696,5,shop,13,15,2
7696,6,home,15,21,6
7696,7,shop,21,22,1
7696,8,home,22,24,2
7697,1,home,0,7,7
7697,2,work,7,13,6
7697,3,home,13,24,11
7698,1,home,0,7,7
7698,2,work,7,9,2
7698,3,home,9,13,4
7698,4,work,13,15,2
7698,5,home,15,23,8
7698,6,work,23,24,1
7699,1,home,0,7,7
7699,2,work,7,9,2
7699,3,home,9,11,2
7699,4,work,11,13,2
7699,5,home,13,21,8
7699,6,work,21,22,1
7699,7,home,22,24,2
7700,1,home,0,7,7
7700,2,education,7,11,4
7700,3,home,11,18,7
7700,4,shop,18,19,1
7700,5,home,19,24,5
7701,1,home,0,8,8
7701,2,education,8,11,3
7701,3,home,11,18,7
7701,4,shop,18,19,1
7701,5,home,19,24,5
7702,1,home,0,6,6
7702,2,work,6,8,2
7702,3,home,8,10,2
7702,4,work,10,11,1
7702,5,home,11,16,5
7702,6,work,16,18,2
7702,7,home,18,24,6
7703,1,home,0,7,7
7703,2,work,7,9,2
7703,3,home,9,14,5
7703,4,work,14,16,2
7703,5,home,16,23,7
7703,6,work,23,24,1
7704,1,home,0,6,6
7704,2,work,6,13,7
7704,3,home,13,22,9
7704,4,work,22,23,1
7704,5,home,23,24,1
7705,1,home,0,6,6
7705,2,work,6,12,6
7705,3,shop,12,13,1
7705,4,work,13,19,6
7705,5,home,19,24,5
7706,1,home,0,7,7
7706,2,work,7,13,6
7706,3,home,13,22,9
7706,4,work,22,23,1
7706,5,home,23,24,1
7707,1,home,0,8,8
7707,2,shop,8,9,1
7707,3,work,9,15,6
7707,4,home,15,24,9
7708,1,home,0,6,6
7708,2,shop,6,7,1
7708,3,home,7,12,5
7708,4,education,12,15,3
7708,5,shop,15,16,1
7708,6,home,16,24,8
7709,1,home,0,7,7
7709,2,work,7,14,7
7709,3,home,14,24,10
7710,1,home,0,6,6
7710,2,work,6,13,7
7710,3,home,13,17,4
7710,4,work,17,20,3
7710,5,home,20,24,4
7711,1,home,0,6,6
7711,2,work,6,9,3
7711,3,home,9,14,5
7711,4,shop,14,15,1
7711,5,work,15,17,2
7711,6,home,17,23,6
7711,7,work,23,24,1
7712,1,home,0,8,8
7712,2,work,8,15,7
7712,3,home,15,19,4
7712,4,shop,19,20,1
7712,5,home,20,24,4
7713,1,home,0,8,8
7713,2,work,8,15,7
7713,3,shop,15,16,1
7713,4,home,16,24,8
7714,1,home,0,7,7
7714,2,shop,7,9,2
7714,3,education,9,15,6
7714,4,shop,15,17,2
7714,5,home,17,24,7
7715,1,home,0,6,6
7715,2,work,6,8,2
7715,3,home,8,13,5
7715,4,work,13,15,2
7715,5,home,15,22,7
7715,6,work,22,23,1
7715,7,home,23,24,1
7716,1,work,0,1,1
7716,2,home,1,7,6
7716,3,education,7,10,3
7716,4,home,10,14,4
7716,5,education,14,16,2
7716,6,shop,16,17,1
7716,7,home,17,24,7
7717,1,home,0,9,9
7717,2,work,9,16,7
7717,3,home,16,24,8
7718,1,home,0,7,7
7718,2,work,7,14,7
7718,3,shop,14,15,1
7718,4,work,15,19,4
7718,5,home,19,24,5
7719,1,home,0,7,7
7719,2,shop,7,8,1
7719,3,education,8,11,3
7719,4,home,11,18,7
7719,5,shop,18,19,1
7719,6,home,19,24,5
7720,1,home,0,6,6
7720,2,shop,6,7,1
7720,3,home,7,10,3
7720,4,education,10,13,3
7720,5,home,13,21,8
7720,6,shop,21,22,1
7720,7,home,22,24,2
7721,1,home,0,6,6
7721,2,shop,6,7,1
7721,3,work,7,14,7
7721,4,home,14,24,10
7722,1,home,0,8,8
7722,2,shop,8,9,1
7722,3,work,9,17,8
7722,4,home,17,24,7
7723,1,home,0,8,8
7723,2,work,8,13,5
7723,3,shop,13,14,1
7723,4,work,14,19,5
7723,5,home,19,24,5
7724,1,home,0,7,7
7724,2,work,7,15,8
7724,3,shop,15,16,1
7724,4,home,16,21,5
7724,5,work,21,22,1
7724,6,home,22,24,2
7725,1,home,0,8,8
7725,2,work,8,15,7
7725,3,shop,15,16,1
7725,4,home,16,24,8
7726,1,home,0,6,6
7726,2,work,6,13,7
7726,3,shop,13,14,1
7726,4,home,14,24,10
7727,1,home,0,8,8
7727,2,work,8,10,2
7727,3,home,10,16,6
7727,4,work,16,18,2
7727,5,home,18,24,6
7728,1,home,0,8,8
7728,2,work,8,15,7
7728,3,home,15,24,9
7729,1,home,0,8,8
7729,2,shop,8,10,2
7729,3,education,10,14,4
7729,4,shop,14,15,1
7729,5,home,15,21,6
7729,6,shop,21,22,1
7729,7,home,22,24,2
7730,1,home,0,6,6
7730,2,work,6,13,7
7730,3,shop,13,14,1
7730,4,home,14,24,10
7731,1,home,0,7,7
7731,2,shop,7,8,1
7731,3,education,8,12,4
7731,4,shop,12,13,1
7731,5,education,13,16,3
7731,6,home,16,24,8
7732,1,home,0,6,6
7732,2,work,6,12,6
7732,3,shop,12,13,1
7732,4,work,13,19,6
7732,5,home,19,24,5
7733,1,home,0,7,7
7733,2,work,7,13,6
7733,3,shop,13,14,1
7733,4,home,14,23,9
7733,5,work,23,24,1
7734,1,home,0,6,6
7734,2,work,6,13,7
7734,3,shop,13,14,1
7734,4,work,14,19,5
7734,5,home,19,24,5
7735,1,home,0,6,6
7735,2,work,6,8,2
7735,3,home,8,12,4
7735,4,work,12,14,2
7735,5,home,14,21,7
7735,6,work,21,22,1
7735,7,home,22,24,2
7736,1,home,0,7,7
7736,2,work,7,14,7
7736,3,shop,14,15,1
7736,4,work,15,19,4
7736,5,home,19,24,5
7737,1,home,0,7,7
7737,2,work,7,14,7
7737,3,home,14,24,10
7738,1,home,0,7,7
7738,2,work,7,13,6
7738,3,shop,13,14,1
7738,4,home,14,23,9
7738,5,work,23,24,1
7739,1,home,0,6,6
7739,2,shop,6,7,1
7739,3,home,7,10,3
7739,4,education,10,13,3
7739,5,shop,13,15,2
7739,6,home,15,24,9
7740,1,home,0,8,8
7740,2,work,8,14,6
7740,3,home,14,22,8
7740,4,work,22,23,1
7740,5,home,23,24,1
7741,1,home,0,7,7
7741,2,education,7,11,4
7741,3,home,11,18,7
7741,4,shop,18,20,2
7741,5,home,20,24,4
7742,1,home,0,7,7
7742,2,work,7,13,6
7742,3,home,13,17,4
7742,4,work,17,20,3
7742,5,home,20,24,4
7743,1,home,0,7,7
7743,2,work,7,13,6
7743,3,shop,13,14,1
7743,4,home,14,24,10
7744,1,home,0,6,6
7744,2,work,6,13,7
7744,3,home,13,17,4
7744,4,work,17,20,3
7744,5,home,20,24,4
7745,1,home,0,7,7
7745,2,work,7,13,6
7745,3,shop,13,14,1
7745,4,home,14,24,10
7746,1,home,0,7,7
7746,2,work,7,14,7
7746,3,shop,14,15,1
7746,4,work,15,20,5
7746,5,home,20,24,4
7747,1,home,0,7,7
7747,2,shop,7,9,2
7747,3,education,9,11,2
7747,4,home,11,18,7
7747,5,shop,18,20,2
7747,6,home,20,24,4
7748,1,home,0,7,7
7748,2,work,7,13,6
7748,3,home,13,18,5
7748,4,shop,18,19,1
7748,5,home,19,24,5
7749,1,home,0,6,6
7749,2,work,6,13,7
7749,3,shop,13,14,1
7749,4,home,14,21,7
7749,5,work,21,22,1
7749,6,home,22,24,2
7750,1,home,0,8,8
7750,2,work,8,15,7
7750,3,home,15,24,9
7751,1,home,0,7,7
7751,2,work,7,14,7
7751,3,home,14,24,10
7752,1,home,0,6,6
7752,2,work,6,13,7
7752,3,shop,13,14,1
7752,4,home,14,24,10
7753,1,home,0,6,6
7753,2,work,6,8,2
7753,3,home,8,9,1
7753,4,work,9,11,2
7753,5,home,11,17,6
7753,6,work,17,19,2
7753,7,home,19,24,5
7754,1,home,0,7,7
7754,2,work,7,14,7
7754,3,shop,14,15,1
7754,4,work,15,20,5
7754,5,home,20,24,4
7755,1,home,0,6,6
7755,2,work,6,8,2
7755,3,home,8,13,5
7755,4,work,13,14,1
7755,5,home,14,21,7
7755,6,work,21,22,1
7755,7,home,22,24,2
7756,1,home,0,6,6
7756,2,work,6,8,2
7756,3,home,8,14,6
7756,4,work,14,15,1
7756,5,home,15,21,6
7756,6,work,21,22,1
7756,7,home,22,24,2
7757,1,home,0,6,6
7757,2,shop,6,7,1
7757,3,home,7,13,6
7757,4,education,13,15,2
7757,5,shop,15,16,1
7757,6,home,16,24,8
7758,1,home,0,6,6
7758,2,work,6,13,7
7758,3,home,13,16,3
7758,4,work,16,20,4
7758,5,home,20,24,4
7759,1,home,0,7,7
7759,2,work,7,15,8
7759,3,home,15,24,9
7760,1,home,0,6,6
7760,2,shop,6,7,1
7760,3,home,7,10,3
7760,4,education,10,16,6
7760,5,home,16,24,8
7761,1,home,0,7,7
7761,2,work,7,9,2
7761,3,home,9,13,4
7761,4,work,13,15,2
7761,5,home,15,22,7
7761,6,work,22,23,1
7761,7,home,23,24,1
7762,1,home,0,6,6
7762,2,shop,6,7,1
7762,3,home,7,9,2
7762,4,work,9,16,7
7762,5,home,16,21,5
7762,6,work,21,22,1
7762,7,home,22,24,2
7763,1,home,0,7,7
7763,2,shop,7,9,2
7763,3,education,9,11,2
7763,4,home,11,16,5
7763,5,shop,16,17,1
7763,6,home,17,24,7
7764,1,home,0,8,8
7764,2,education,8,14,6
7764,3,home,14,21,7
7764,4,work,21,22,1
7764,5,home,22,24,2
7765,1,home,0,6,6
7765,2,work,6,13,7
7765,3,home,13,18,5
7765,4,shop,18,19,1
7765,5,home,19,24,5
7766,1,home,0,7,7
7766,2,work,7,14,7
7766,3,shop,14,15,1
7766,4,home,15,24,9
7767,1,home,0,9,9
7767,2,education,9,15,6
7767,3,work,15,20,5
7767,4,home,20,24,4
7768,1,home,0,8,8
7768,2,work,8,15,7
7768,3,home,15,24,9
7769,1,home,0,8,8
7769,2,shop,8,9,1
7769,3,education,9,12,3
7769,4,shop,12,15,3
7769,5,home,15,24,9
7770,1,home,0,8,8
7770,2,work,8,17,9
7770,3,home,17,24,7
7771,1,home,0,7,7
7771,2,work,7,13,6
7771,3,home,13,20,7
7771,4,shop,20,21,1
7771,5,home,21,24,3
7772,1,home,0,8,8
7772,2,work,8,15,7
7772,3,shop,15,16,1
7772,4,home,16,21,5
7772,5,work,21,22,1
7772,6,home,22,24,2
7773,1,home,0,8,8
7773,2,education,8,14,6
7773,3,shop,14,15,1
7773,4,home,15,21,6
7773,5,work,21,22,1
7773,6,home,22,24,2
7774,1,home,0,8,8
7774,2,education,8,13,5
7774,3,shop,13,14,1
7774,4,home,14,24,10
7775,1,home,0,8,8
7775,2,education,8,11,3
7775,3,home,11,15,4
7775,4,shop,15,16,1
7775,5,work,16,20,4
7775,6,home,20,24,4
7776,1,home,0,7,7
7776,2,work,7,13,6
7776,3,shop,13,14,1
7776,4,work,14,19,5
7776,5,home,19,24,5
7777,1,home,0,7,7
7777,2,work,7,13,6
7777,3,shop,13,14,1
7777,4,home,14,17,3
7777,5,work,17,20,3
7777,6,home,20,24,4
7778,1,home,0,8,8
7778,2,education,8,11,3
7778,3,home,11,17,6
7778,4,shop,17,18,1
7778,5,home,18,24,6
7779,1,home,0,7,7
7779,2,work,7,13,6
7779,3,home,13,24,11
7780,1,home,0,7,7
7780,2,work,7,13,6
7780,3,home,13,18,5
7780,4,shop,18,19,1
7780,5,home,19,24,5
7781,1,home,0,6,6
7781,2,shop,6,7,1
7781,3,home,7,10,3
7781,4,education,10,13,3
7781,5,shop,13,15,2
7781,6,home,15,21,6
7781,7,shop,21,22,1
7781,8,home,22,24,2
7782,1,home,0,7,7
7782,2,work,7,13,6
7782,3,home,13,23,10
7782,4,work,23,24,1
7783,1,home,0,7,7
7783,2,work,7,9,2
7783,3,home,9,17,8
7783,4,work,17,19,2
7783,5,home,19,24,5
7784,1,home,0,6,6
7784,2,work,6,8,2
7784,3,home,8,9,1
7784,4,work,9,11,2
7784,5,home,11,14,3
7784,6,work,14,16,2
7784,7,home,16,23,7
7784,8,work,23,24,1
7785,1,home,0,6,6
7785,2,shop,6,7,1
7785,3,home,7,13,6
7785,4,education,13,16,3
7785,5,home,16,24,8
7786,1,home,0,8,8
7786,2,work,8,14,6
7786,3,home,14,21,7
7786,4,work,21,22,1
7786,5,home,22,24,2
7787,1,home,0,7,7
7787,2,work,7,13,6
7787,3,home,13,17,4
7787,4,work,17,20,3
7787,5,home,20,24,4
7788,1,home,0,6,6
7788,2,work,6,13,7
7788,3,shop,13,14,1
7788,4,work,14,19,5
7788,5,home,19,24,5
7789,1,home,0,8,8
7789,2,work,8,15,7
7789,3,home,15,20,5
7789,4,shop,20,21,1
7789,5,home,21,24,3
7790,1,home,0,6,6
7790,2,work,6,8,2
7790,3,home,8,14,6
7790,4,work,14,16,2
7790,5,home,16,22,6
7790,6,work,22,23,1
7790,7,home,23,24,1
7791,1,home,0,6,6
7791,2,work,6,13,7
7791,3,home,13,17,4
7791,4,work,17,20,3
7791,5,home,20,24,4
7792,1,home,0,6,6
7792,2,work,6,13,7
7792,3,home,13,24,11
7793,1,home,0,6,6
7793,2,work,6,13,7
7793,3,shop,13,14,1
7793,4,education,14,17,3
7793,5,home,17,21,4
7793,6,work,21,22,1
7793,7,home,22,24,2
7794,1,home,0,8,8
7794,2,work,8,15,7
7794,3,home,15,24,9
7795,1,home,0,9,9
7795,2,work,9,16,7
7795,3,shop,16,17,1
7795,4,home,17,24,7
7796,1,home,0,7,7
7796,2,work,7,14,7
7796,3,shop,14,15,1
7796,4,home,15,24,9
7797,1,home,0,6,6
7797,2,shop,6,7,1
7797,3,home,7,13,6
7797,4,education,13,16,3
7797,5,home,16,24,8
7798,1,home,0,7,7
7798,2,education,7,12,5
7798,3,shop,12,14,2
7798,4,education,14,15,1
7798,5,shop,15,17,2
7798,6,home,17,24,7
7799,1,home,0,7,7
7799,2,work,7,13,6
7799,3,shop,13,14,1
7799,4,home,14,24,10
7800,1,home,0,8,8
7800,2,work,8,15,7
7800,3,shop,15,17,2
7800,4,home,17,23,6
7800,5,work,23,24,1
7801,1,home,0,6,6
7801,2,work,6,13,7
7801,3,shop,13,14,1
7801,4,home,14,24,10
7802,1,home,0,6,6
7802,2,shop,6,7,1
7802,3,home,7,9,2
7802,4,education,9,12,3
7802,5,home,12,20,8
7802,6,shop,20,21,1
7802,7,home,21,24,3
7803,1,home,0,7,7
7803,2,work,7,15,8
7803,3,home,15,24,9
7804,1,home,0,6,6
7804,2,work,6,13,7
7804,3,shop,13,14,1
7804,4,education,14,17,3
7804,5,home,17,24,7
7805,1,home,0,6,6
7805,2,work,6,13,7
7805,3,home,13,24,11
7806,1,home,0,9,9
7806,2,work,9,15,6
7806,3,home,15,20,5
7806,4,shop,20,21,1
7806,5,home,21,24,3
7807,1,home,0,6,6
7807,2,work,6,8,2
7807,3,home,8,12,4
7807,4,work,12,14,2
7807,5,home,14,18,4
7807,6,work,18,19,1
7807,7,home,19,24,5
7808,1,home,0,8,8
7808,2,work,8,14,6
7808,3,shop,14,15,1
7808,4,home,15,24,9
7809,1,home,0,6,6
7809,2,work,6,7,1
7809,3,home,7,9,2
7809,4,work,9,11,2
7809,5,home,11,15,4
7809,6,work,15,18,3
7809,7,home,18,23,5
7809,8,work,23,24,1
7810,1,home,0,9,9
7810,2,work,9,15,6
7810,3,home,15,24,9
7811,1,home,0,7,7
7811,2,work,7,13,6
7811,3,home,13,18,5
7811,4,work,18,20,2
7811,5,home,20,24,4
7812,1,home,0,8,8
7812,2,work,8,15,7
7812,3,home,15,24,9
7813,1,home,0,8,8
7813,2,work,8,14,6
7813,3,shop,14,15,1
7813,4,home,15,24,9
7814,1,home,0,7,7
7814,2,work,7,13,6
7814,3,home,13,18,5
7814,4,shop,18,19,1
7814,5,home,19,24,5
7815,1,home,0,7,7
7815,2,work,7,13,6
7815,3,home,13,17,4
7815,4,work,17,20,3
7815,5,home,20,24,4
7816,1,home,0,6,6
7816,2,shop,6,7,1
7816,3,home,7,10,3
7816,4,education,10,13,3
7816,5,home,13,20,7
7816,6,shop,20,21,1
7816,7,home,21,24,3
7817,1,home,0,6,6
7817,2,work,6,13,7
7817,3,home,13,21,8
7817,4,work,21,22,1
7817,5,home,22,24,2
7818,1,home,0,6,6
7818,2,shop,6,7,1
7818,3,home,7,13,6
7818,4,education,13,16,3
7818,5,home,16,24,8
7819,1,home,0,8,8
7819,2,work,8,15,7
7819,3,shop,15,16,1
7819,4,work,16,20,4
7819,5,home,20,24,4
7820,1,home,0,8,8
7820,2,work,8,15,7
7820,3,home,15,23,8
7820,4,work,23,24,1
7821,1,home,0,7,7
7821,2,education,7,11,4
7821,3,home,11,15,4
7821,4,shop,15,16,1
7821,5,home,16,24,8
7822,1,home,0,7,7
7822,2,education,7,11,4
7822,3,home,11,17,6
7822,4,shop,17,18,1
7822,5,home,18,24,6
7823,1,home,0,7,7
7823,2,work,7,9,2
7823,3,home,9,15,6
7823,4,work,15,17,2
7823,5,home,17,24,7
7824,1,home,0,7,7
7824,2,work,7,13,6
7824,3,home,13,18,5
7824,4,shop,18,19,1
7824,5,home,19,23,4
7824,6,work,23,24,1
7825,1,home,0,7,7
7825,2,work,7,13,6
7825,3,shop,13,14,1
7825,4,work,14,19,5
7825,5,home,19,24,5
7826,1,home,0,6,6
7826,2,shop,6,7,1
7826,3,home,7,9,2
7826,4,education,9,12,3
7826,5,home,12,15,3
7826,6,work,15,20,5
7826,7,home,20,24,4
7827,1,home,0,6,6
7827,2,shop,6,7,1
7827,3,home,7,8,1
7827,4,work,8,15,7
7827,5,home,15,21,6
7827,6,shop,21,22,1
7827,7,home,22,24,2
7828,1,home,0,9,9
7828,2,work,9,16,7
7828,3,home,16,24,8
7829,1,home,0,8,8
7829,2,work,8,15,7
7829,3,home,15,24,9
7830,1,home,0,8,8
7830,2,work,8,15,7
7830,3,home,15,19,4
7830,4,shop,19,21,2
7830,5,home,21,24,3
7831,1,home,0,7,7
7831,2,education,7,11,4
7831,3,home,11,15,4
7831,4,shop,15,16,1
7831,5,home,16,24,8
7832,1,home,0,6,6
7832,2,work,6,13,7
7832,3,shop,13,14,1
7832,4,home,14,22,8
7832,5,work,22,23,1
7832,6,home,23,24,1
7833,1,home,0,6,6
7833,2,work,6,13,7
7833,3,home,13,16,3
7833,4,work,16,20,4
7833,5,home,20,24,4
7834,1,home,0,8,8
7834,2,work,8,15,7
7834,3,home,15,24,9
7835,1,home,0,7,7
7835,2,work,7,8,1
7835,3,home,8,13,5
7835,4,work,13,15,2
7835,5,home,15,21,6
7835,6,work,21,22,1
7835,7,home,22,24,2
7836,1,home,0,6,6
7836,2,shop,6,7,1
7836,3,home,7,10,3
7836,4,education,10,12,2
7836,5,home,12,18,6
7836,6,shop,18,19,1
7836,7,home,19,24,5
7837,1,home,0,6,6
7837,2,work,6,13,7
7837,3,home,13,20,7
7837,4,shop,20,21,1
7837,5,home,21,24,3
7838,1,home,0,7,7
7838,2,work,7,14,7
7838,3,shop,14,15,1
7838,4,home,15,21,6
7838,5,work,21,22,1
7838,6,home,22,24,2
7839,1,home,0,6,6
7839,2,work,6,13,7
7839,3,home,13,17,4
7839,4,work,17,20,3
7839,5,home,20,24,4
7840,1,home,0,7,7
7840,2,work,7,13,6
7840,3,home,13,18,5
7840,4,work,18,20,2
7840,5,home,20,24,4
7841,1,home,0,7,7
7841,2,work,7,13,6
7841,3,shop,13,14,1
7841,4,home,14,24,10
7842,1,home,0,8,8
7842,2,work,8,15,7
7842,3,home,15,21,6
7842,4,work,21,22,1
7842,5,home,22,24,2
7843,1,home,0,7,7
7843,2,work,7,14,7
7843,3,shop,14,15,1
7843,4,home,15,21,6
7843,5,work,21,22,1
7843,6,home,22,24,2
7844,1,home,0,8,8
7844,2,work,8,14,6
7844,3,home,14,24,10
7845,1,home,0,8,8
7845,2,work,8,15,7
7845,3,shop,15,16,1
7845,4,work,16,20,4
7845,5,home,20,24,4
7846,1,home,0,6,6
7846,2,shop,6,7,1
7846,3,home,7,13,6
7846,4,education,13,16,3
7846,5,home,16,24,8
7847,1,home,0,8,8
7847,2,work,8,15,7
7847,3,home,15,24,9
7848,1,home,0,8,8
7848,2,education,8,12,4
7848,3,home,12,24,12
7849,1,home,0,7,7
7849,2,education,7,11,4
7849,3,home,11,17,6
7849,4,shop,17,19,2
7849,5,home,19,24,5
7850,1,home,0,7,7
7850,2,work,7,13,6
7850,3,home,13,24,11
7851,1,home,0,6,6
7851,2,work,6,13,7
7851,3,shop,13,14,1
7851,4,home,14,24,10
7852,1,home,0,7,7
7852,2,shop,7,8,1
7852,3,home,8,11,3
7852,4,work,11,18,7
7852,5,home,18,22,4
7852,6,work,22,23,1
7852,7,home,23,24,1
7853,1,home,0,7,7
7853,2,shop,7,8,1
7853,3,work,8,14,6
7853,4,home,14,21,7
7853,5,shop,21,22,1
7853,6,home,22,24,2
7854,1,home,0,6,6
7854,2,work,6,13,7
7854,3,shop,13,14,1
7854,4,education,14,16,2
7854,5,shop,16,17,1
7854,6,work,17,20,3
7854,7,home,20,24,4
7855,1,home,0,6,6
7855,2,work,6,8,2
7855,3,home,8,14,6
7855,4,work,14,15,1
7855,5,home,15,22,7
7855,6,work,22,23,1
7855,7,home,23,24,1
7856,1,home,0,6,6
7856,2,work,6,13,7
7856,3,home,13,16,3
7856,4,work,16,19,3
7856,5,home,19,24,5
7857,1,home,0,7,7
7857,2,work,7,9,2
7857,3,home,9,14,5
7857,4,work,14,15,1
7857,5,home,15,21,6
7857,6,work,21,22,1
7857,7,home,22,24,2
7858,1,home,0,6,6
7858,2,work,6,13,7
7858,3,shop,13,14,1
7858,4,home,14,21,7
7858,5,work,21,22,1
7858,6,home,22,24,2
7859,1,home,0,7,7
7859,2,education,7,12,5
7859,3,shop,12,13,1
7859,4,education,13,16,3
7859,5,home,16,24,8
7860,1,home,0,7,7
7860,2,work,7,13,6
7860,3,shop,13,14,1
7860,4,work,14,19,5
7860,5,home,19,24,5
7861,1,home,0,6,6
7861,2,shop,6,7,1
7861,3,home,7,9,2
7861,4,work,9,17,8
7861,5,home,17,24,7
7862,1,home,0,7,7
7862,2,work,7,13,6
7862,3,home,13,16,3
7862,4,work,16,20,4
7862,5,home,20,24,4
7863,1,home,0,6,6
7863,2,work,6,13,7
7863,3,home,13,23,10
7863,4,work,23,24,1
7864,1,home,0,7,7
7864,2,work,7,14,7
7864,3,shop,14,15,1
7864,4,home,15,24,9
7865,1,home,0,7,7
7865,2,work,7,13,6
7865,3,shop,13,14,1
7865,4,work,14,19,5
7865,5,home,19,24,5
7866,1,home,0,6,6
7866,2,shop,6,7,1
7866,3,home,7,8,1
7866,4,work,8,15,7
7866,5,home,15,18,3
7866,6,work,18,20,2
7866,7,home,20,24,4
7867,1,home,0,8,8
7867,2,work,8,14,6
7867,3,shop,14,15,1
7867,4,home,15,22,7
7867,5,work,22,23,1
7867,6,home,23,24,1
7868,1,home,0,7,7
7868,2,work,7,13,6
7868,3,shop,13,14,1
7868,4,work,14,20,6
7868,5,home,20,24,4
7869,1,home,0,8,8
7869,2,education,8,11,3
7869,3,home,11,18,7
7869,4,shop,18,21,3
7869,5,home,21,24,3
7870,1,home,0,8,8
7870,2,work,8,15,7
7870,3,home,15,21,6
7870,4,work,21,22,1
7870,5,home,22,24,2
7871,1,home,0,7,7
7871,2,shop,7,8,1
7871,3,work,8,14,6
7871,4,home,14,24,10
7872,1,home,0,7,7
7872,2,shop,7,9,2
7872,3,education,9,11,2
7872,4,home,11,17,6
7872,5,shop,17,18,1
7872,6,home,18,24,6
7873,1,home,0,7,7
7873,2,work,7,14,7
7873,3,home,14,24,10
7874,1,home,0,8,8
7874,2,work,8,14,6
7874,3,home,14,16,2
7874,4,work,16,19,3
7874,5,home,19,23,4
7874,6,work,23,24,1
7875,1,home,0,6,6
7875,2,shop,6,7,1
7875,3,work,7,14,7
7875,4,home,14,24,10
7876,1,home,0,8,8
7876,2,education,8,11,3
7876,3,home,11,17,6
7876,4,work,17,20,3
7876,5,home,20,24,4
7877,1,home,0,7,7
7877,2,work,7,14,7
7877,3,home,14,24,10
7878,1,home,0,7,7
7878,2,education,7,11,4
7878,3,home,11,14,3
7878,4,education,14,16,2
7878,5,shop,16,17,1
7878,6,home,17,24,7
7879,1,home,0,7,7
7879,2,shop,7,8,1
7879,3,education,8,11,3
7879,4,home,11,18,7
7879,5,shop,18,19,1
7879,6,home,19,24,5
7880,1,home,0,7,7
7880,2,work,7,14,7
7880,3,shop,14,15,1
7880,4,work,15,20,5
7880,5,home,20,24,4
7881,1,home,0,6,6
7881,2,work,6,13,7
7881,3,home,13,19,6
7881,4,shop,19,20,1
7881,5,home,20,24,4
7882,1,home,0,8,8
7882,2,education,8,12,4
7882,3,shop,12,14,2
7882,4,education,14,16,2
7882,5,home,16,24,8
7883,1,home,0,7,7
7883,2,work,7,13,6
7883,3,home,13,16,3
7883,4,shop,16,17,1
7883,5,home,17,23,6
7883,6,work,23,24,1
7884,1,home,0,7,7
7884,2,work,7,13,6
7884,3,home,13,19,6
7884,4,shop,19,20,1
7884,5,home,20,24,4
7885,1,home,0,6,6
7885,2,work,6,8,2
7885,3,home,8,13,5
7885,4,work,13,15,2
7885,5,home,15,22,7
7885,6,work,22,23,1
7885,7,home,23,24,1
7886,1,home,0,6,6
7886,2,work,6,8,2
7886,3,home,8,13,5
7886,4,work,13,15,2
7886,5,home,15,22,7
7886,6,work,22,23,1
7886,7,home,23,24,1
7887,1,home,0,6,6
7887,2,shop,6,7,1
7887,3,home,7,9,2
7887,4,education,9,12,3
7887,5,shop,12,13,1
7887,6,education,13,15,2
7887,7,shop,15,16,1
7887,8,home,16,24,8
7888,1,home,0,7,7
7888,2,shop,7,8,1
7888,3,work,8,15,7
7888,4,home,15,24,9
7889,1,home,0,8,8
7889,2,work,8,15,7
7889,3,shop,15,16,1
7889,4,home,16,23,7
7889,5,work,23,24,1
7890,1,home,0,7,7
7890,2,work,7,14,7
7890,3,shop,14,15,1
7890,4,work,15,20,5
7890,5,home,20,24,4
7891,1,home,0,7,7
7891,2,work,7,14,7
7891,3,home,14,21,7
7891,4,work,21,22,1
7891,5,home,22,24,2
7892,1,home,0,8,8
7892,2,work,8,14,6
7892,3,home,14,18,4
7892,4,work,18,20,2
7892,5,home,20,24,4
7893,1,home,0,7,7
7893,2,work,7,14,7
7893,3,home,14,18,4
7893,4,work,18,20,2
7893,5,home,20,24,4
7894,1,home,0,6,6
7894,2,shop,6,7,1
7894,3,home,7,13,6
7894,4,education,13,16,3
7894,5,home,16,21,5
7894,6,shop,21,22,1
7894,7,home,22,24,2
7895,1,home,0,7,7
7895,2,shop,7,8,1
7895,3,education,8,12,4
7895,4,shop,12,14,2
7895,5,home,14,21,7
7895,6,shop,21,22,1
7895,7,home,22,24,2
7896,1,home,0,8,8
7896,2,work,8,14,6
7896,3,shop,14,15,1
7896,4,home,15,24,9
7897,1,home,0,6,6
7897,2,work,6,8,2
7897,3,home,8,11,3
7897,4,work,11,12,1
7897,5,home,12,16,4
7897,6,work,16,19,3
7897,7,home,19,24,5
7898,1,home,0,7,7
7898,2,shop,7,9,2
7898,3,work,9,15,6
7898,4,home,15,24,9
7899,1,home,0,8,8
7899,2,work,8,15,7
7899,3,shop,15,16,1
7899,4,home,16,23,7
7899,5,work,23,24,1
7900,1,home,0,9,9
7900,2,education,9,13,4
7900,3,shop,13,14,1
7900,4,home,14,24,10
7901,1,home,0,6,6
7901,2,shop,6,7,1
7901,3,home,7,9,2
7901,4,work,9,15,6
7901,5,home,15,24,9
7902,1,home,0,7,7
7902,2,work,7,13,6
7902,3,shop,13,14,1
7902,4,home,14,23,9
7902,5,work,23,24,1
7903,1,home,0,7,7
7903,2,work,7,14,7
7903,3,shop,14,15,1
7903,4,work,15,19,4
7903,5,home,19,23,4
7903,6,work,23,24,1
7904,1,home,0,6,6
7904,2,shop,6,7,1
7904,3,home,7,9,2
7904,4,work,9,16,7
7904,5,home,16,24,8
7905,1,home,0,7,7
7905,2,work,7,13,6
7905,3,shop,13,14,1
7905,4,home,14,21,7
7905,5,work,21,22,1
7905,6,home,22,24,2
7906,1,home,0,8,8
7906,2,work,8,14,6
7906,3,home,14,23,9
7906,4,work,23,24,1
7907,1,home,0,8,8
7907,2,work,8,15,7
7907,3,home,15,22,7
7907,4,work,22,23,1
7907,5,home,23,24,1
7908,1,home,0,7,7
7908,2,work,7,13,6
7908,3,shop,13,14,1
7908,4,home,14,24,10
7909,1,home,0,7,7
7909,2,education,7,11,4
7909,3,home,11,17,6
7909,4,shop,17,18,1
7909,5,home,18,24,6
7910,1,home,0,7,7
7910,2,education,7,11,4
7910,3,home,11,18,7
7910,4,shop,18,19,1
7910,5,home,19,24,5
7911,1,home,0,7,7
7911,2,work,7,14,7
7911,3,home,14,24,10
7912,1,home,0,7,7
7912,2,shop,7,9,2
7912,3,education,9,11,2
7912,4,home,11,17,6
7912,5,shop,17,18,1
7912,6,home,18,24,6
7913,1,home,0,6,6
7913,2,work,6,7,1
7913,3,home,7,9,2
7913,4,work,9,10,1
7913,5,home,10,14,4
7913,6,work,14,18,4
7913,7,home,18,21,3
7913,8,work,21,22,1
7913,9,home,22,24,2
7914,1,home,0,7,7
7914,2,education,7,11,4
7914,3,home,11,16,5
7914,4,shop,16,17,1
7914,5,home,17,24,7
7915,1,home,0,6,6
7915,2,work,6,13,7
7915,3,shop,13,14,1
7915,4,home,14,24,10
7916,1,home,0,7,7
7916,2,work,7,9,2
7916,3,home,9,14,5
7916,4,work,14,16,2
7916,5,home,16,22,6
7916,6,work,22,23,1
7916,7,home,23,24,1
7917,1,home,0,8,8
7917,2,education,8,10,2
7917,3,home,10,17,7
7917,4,shop,17,18,1
7917,5,home,18,24,6
7918,1,home,0,8,8
7918,2,education,8,12,4
7918,3,shop,12,13,1
7918,4,education,13,16,3
7918,5,home,16,24,8
7919,1,home,0,7,7
7919,2,work,7,14,7
7919,3,home,14,24,10
7920,1,home,0,6,6
7920,2,work,6,14,8
7920,3,home,14,24,10
7921,1,home,0,7,7
7921,2,work,7,13,6
7921,3,home,13,18,5
7921,4,work,18,20,2
7921,5,home,20,24,4
7922,1,home,0,7,7
7922,2,shop,7,8,1
7922,3,education,8,12,4
7922,4,home,12,19,7
7922,5,shop,19,20,1
7922,6,home,20,24,4
7923,1,home,0,6,6
7923,2,shop,6,7,1
7923,3,work,7,9,2
7923,4,home,9,14,5
7923,5,work,14,16,2
7923,6,home,16,22,6
7923,7,work,22,23,1
7923,8,home,23,24,1
7924,1,home,0,6,6
7924,2,work,6,13,7
7924,3,home,13,23,10
7924,4,work,23,24,1
7925,1,home,0,6,6
7925,2,shop,6,7,1
7925,3,home,7,9,2
7925,4,education,9,12,3
7925,5,home,12,18,6
7925,6,shop,18,19,1
7925,7,home,19,24,5
7926,1,home,0,7,7
7926,2,work,7,13,6
7926,3,home,13,18,5
7926,4,work,18,20,2
7926,5,home,20,24,4
7927,1,home,0,6,6
7927,2,work,6,8,2
7927,3,home,8,13,5
7927,4,work,13,15,2
7927,5,home,15,21,6
7927,6,work,21,22,1
7927,7,home,22,24,2
7928,1,home,0,6,6
7928,2,shop,6,7,1
7928,3,home,7,9,2
7928,4,education,9,12,3
7928,5,shop,12,15,3
7928,6,home,15,21,6
7928,7,shop,21,22,1
7928,8,home,22,24,2
7929,1,home,0,6,6
7929,2,work,6,13,7
7929,3,home,13,19,6
7929,4,shop,19,20,1
7929,5,home,20,24,4
7930,1,home,0,6,6
7930,2,work,6,8,2
7930,3,home,8,11,3
7930,4,work,11,13,2
7930,5,home,13,17,4
7930,6,work,17,19,2
7930,7,home,19,24,5
7931,1,home,0,6,6
7931,2,work,6,13,7
7931,3,shop,13,14,1
7931,4,home,14,18,4
7931,5,work,18,20,2
7931,6,home,20,24,4
7932,1,home,0,7,7
7932,2,education,7,11,4
7932,3,home,11,14,3
7932,4,education,14,16,2
7932,5,home,16,24,8
7933,1,home,0,6,6
7933,2,shop,6,7,1
7933,3,work,7,14,7
7933,4,home,14,24,10
7934,1,home,0,6,6
7934,2,work,6,13,7
7934,3,home,13,16,3
7934,4,work,16,19,3
7934,5,home,19,23,4
7934,6,work,23,24,1
7935,1,home,0,6,6
7935,2,shop,6,7,1
7935,3,home,7,10,3
7935,4,education,10,12,2
7935,5,shop,12,13,1
7935,6,home,13,20,7
7935,7,shop,20,21,1
7935,8,home,21,24,3
7936,1,home,0,6,6
7936,2,work,6,13,7
7936,3,home,13,24,11
7937,1,home,0,7,7
7937,2,work,7,13,6
7937,3,shop,13,14,1
7937,4,education,14,17,3
7937,5,home,17,24,7
7938,1,home,0,7,7
7938,2,work,7,9,2
7938,3,home,9,14,5
7938,4,work,14,16,2
7938,5,home,16,23,7
7938,6,work,23,24,1
7939,1,home,0,6,6
7939,2,work,6,8,2
7939,3,home,8,12,4
7939,4,work,12,14,2
7939,5,home,14,20,6
7939,6,shop,20,21,1
7939,7,home,21,24,3
7940,1,home,0,7,7
7940,2,work,7,13,6
7940,3,shop,13,14,1
7940,4,home,14,18,4
7940,5,shop,18,19,1
7940,6,home,19,23,4
7940,7,work,23,24,1
7941,1,home,0,6,6
7941,2,shop,6,7,1
7941,3,home,7,13,6
7941,4,education,13,16,3
7941,5,shop,16,17,1
7941,6,home,17,24,7
7942,1,home,0,6,6
7942,2,work,6,8,2
7942,3,home,8,9,1
7942,4,work,9,11,2
7942,5,home,11,15,4
7942,6,shop,15,16,1
7942,7,work,16,19,3
7942,8,home,19,24,5
7943,1,home,0,7,7
7943,2,work,7,13,6
7943,3,shop,13,14,1
7943,4,work,14,19,5
7943,5,home,19,24,5
7944,1,home,0,6,6
7944,2,shop,6,7,1
7944,3,home,7,12,5
7944,4,education,12,13,1
7944,5,work,13,19,6
7944,6,home,19,24,5
7945,1,home,0,7,7
7945,2,work,7,13,6
7945,3,home,13,24,11
7946,1,home,0,7,7
7946,2,work,7,13,6
7946,3,shop,13,14,1
7946,4,work,14,19,5
7946,5,home,19,24,5
7947,1,home,0,7,7
7947,2,work,7,14,7
7947,3,shop,14,15,1
7947,4,home,15,24,9
7948,1,home,0,7,7
7948,2,work,7,14,7
7948,3,home,14,21,7
7948,4,shop,21,22,1
7948,5,home,22,24,2
7949,1,home,0,8,8
7949,2,work,8,13,5
7949,3,home,13,21,8
7949,4,work,21,22,1
7949,5,home,22,24,2
7950,1,home,0,6,6
7950,2,shop,6,7,1
7950,3,home,7,9,2
7950,4,education,9,12,3
7950,5,home,12,18,6
7950,6,shop,18,19,1
7950,7,home,19,24,5
7951,1,home,0,7,7
7951,2,work,7,14,7
7951,3,home,14,23,9
7951,4,work,23,24,1
7952,1,home,0,7,7
7952,2,work,7,14,7
7952,3,home,14,21,7
7952,4,shop,21,22,1
7952,5,home,22,24,2
7953,1,home,0,6,6
7953,2,shop,6,7,1
7953,3,home,7,10,3
7953,4,education,10,13,3
7953,5,shop,13,15,2
7953,6,home,15,24,9
7954,1,home,0,6,6
7954,2,work,6,12,6
7954,3,shop,12,13,1
7954,4,work,13,19,6
7954,5,home,19,24,5
7955,1,home,0,6,6
7955,2,work,6,13,7
7955,3,home,13,23,10
7955,4,work,23,24,1
7956,1,home,0,7,7
7956,2,work,7,14,7
7956,3,home,14,24,10
7957,1,home,0,6,6
7957,2,shop,6,7,1
7957,3,home,7,13,6
7957,4,education,13,16,3
7957,5,shop,16,17,1
7957,6,home,17,24,7
7958,1,home,0,6,6
7958,2,work,6,13,7
7958,3,home,13,18,5
7958,4,shop,18,19,1
7958,5,home,19,24,5
7959,1,home,0,6,6
7959,2,work,6,8,2
7959,3,home,8,14,6
7959,4,work,14,16,2
7959,5,home,16,22,6
7959,6,work,22,23,1
7959,7,home,23,24,1
7960,1,home,0,7,7
7960,2,work,7,13,6
7960,3,home,13,24,11
7961,1,home,0,6,6
7961,2,shop,6,7,1
7961,3,home,7,13,6
7961,4,education,13,16,3
7961,5,home,16,24,8
7962,1,home,0,8,8
7962,2,work,8,14,6
7962,3,shop,14,15,1
7962,4,home,15,24,9
7963,1,home,0,6,6
7963,2,work,6,13,7
7963,3,home,13,16,3
7963,4,work,16,20,4
7963,5,home,20,24,4
7964,1,home,0,6,6
7964,2,shop,6,7,1
7964,3,home,7,13,6
7964,4,education,13,16,3
7964,5,shop,16,17,1
7964,6,home,17,24,7
7965,1,home,0,6,6
7965,2,shop,6,7,1
7965,3,home,7,13,6
7965,4,education,13,16,3
7965,5,home,16,24,8
7966,1,home,0,7,7
7966,2,shop,7,9,2
7966,3,home,9,13,4
7966,4,education,13,16,3
7966,5,home,16,24,8
7967,1,home,0,6,6
7967,2,work,6,13,7
7967,3,home,13,24,11
7968,1,home,0,8,8
7968,2,work,8,14,6
7968,3,shop,14,15,1
7968,4,home,15,23,8
7968,5,work,23,24,1
7969,1,home,0,8,8
7969,2,work,8,15,7
7969,3,home,15,23,8
7969,4,work,23,24,1
7970,1,home,0,6,6
7970,2,work,6,8,2
7970,3,home,8,11,3
7970,4,work,11,13,2
7970,5,home,13,17,4
7970,6,work,17,19,2
7970,7,home,19,24,5
7971,1,home,0,6,6
7971,2,work,6,13,7
7971,3,home,13,14,1
7971,4,work,14,19,5
7971,5,home,19,24,5
7972,1,home,0,8,8
7972,2,work,8,14,6
7972,3,shop,14,15,1
7972,4,work,15,19,4
7972,5,home,19,24,5
7973,1,home,0,6,6
7973,2,work,6,14,8
7973,3,home,14,24,10
7974,1,home,0,6,6
7974,2,work,6,8,2
7974,3,home,8,9,1
7974,4,work,9,11,2
7974,5,home,11,15,4
7974,6,work,15,18,3
7974,7,home,18,24,6
7975,1,home,0,8,8
7975,2,work,8,14,6
7975,3,home,14,19,5
7975,4,shop,19,21,2
7975,5,home,21,24,3
7976,1,home,0,7,7
7976,2,work,7,14,7
7976,3,home,14,23,9
7976,4,work,23,24,1
7977,1,home,0,7,7
7977,2,shop,7,9,2
7977,3,education,9,11,2
7977,4,home,11,17,6
7977,5,shop,17,18,1
7977,6,home,18,24,6
7978,1,home,0,8,8
7978,2,work,8,15,7
7978,3,home,15,24,9
7979,1,home,0,6,6
7979,2,work,6,7,1
7979,3,home,7,13,6
7979,4,work,13,15,2
7979,5,home,15,22,7
7979,6,work,22,23,1
7979,7,home,23,24,1
7980,1,home,0,7,7
7980,2,work,7,14,7
7980,3,shop,14,15,1
7980,4,home,15,24,9
7981,1,home,0,7,7
7981,2,work,7,14,7
7981,3,home,14,24,10
7982,1,home,0,6,6
7982,2,work,6,13,7
7982,3,home,13,16,3
7982,4,work,16,20,4
7982,5,home,20,24,4
7983,1,home,0,8,8
7983,2,work,8,15,7
7983,3,shop,15,16,1
7983,4,home,16,24,8
7984,1,work,0,8,8
7984,2,shop,8,9,1
7984,3,home,9,16,7
7984,4,work,16,20,4
7984,5,home,20,24,4
7985,1,home,0,9,9
7985,2,work,9,16,7
7985,3,home,16,24,8
7986,1,home,0,8,8
7986,2,education,8,12,4
7986,3,shop,12,13,1
7986,4,work,13,20,7
7986,5,home,20,24,4
7987,1,home,0,8,8
7987,2,education,8,11,3
7987,3,home,11,16,5
7987,4,shop,16,18,2
7987,5,home,18,24,6
7988,1,home,0,7,7
7988,2,work,7,13,6
7988,3,home,13,15,2
7988,4,work,15,19,4
7988,5,home,19,24,5
7989,1,home,0,8,8
7989,2,work,8,13,5
7989,3,shop,13,14,1
7989,4,work,14,20,6
7989,5,home,20,24,4
7990,1,home,0,6,6
7990,2,work,6,7,1
7990,3,home,7,11,4
7990,4,work,11,13,2
7990,5,shop,13,14,1
7990,6,work,14,17,3
7990,7,home,17,23,6
7990,8,work,23,24,1
7991,1,home,0,6,6
7991,2,shop,6,7,1
7991,3,home,7,13,6
7991,4,education,13,16,3
7991,5,shop,16,17,1
7991,6,home,17,24,7
7992,1,home,0,6,6
7992,2,shop,6,7,1
7992,3,home,7,10,3
7992,4,education,10,13,3
7992,5,home,13,19,6
7992,6,shop,19,20,1
7992,7,home,20,24,4
7993,1,home,0,6,6
7993,2,work,6,13,7
7993,3,home,13,18,5
7993,4,work,18,20,2
7993,5,home,20,24,4
7994,1,home,0,8,8
7994,2,education,8,13,5
7994,3,work,13,19,6
7994,4,home,19,24,5
7995,1,home,0,7,7
7995,2,work,7,13,6
7995,3,shop,13,14,1
7995,4,education,14,16,2
7995,5,home,16,24,8
7996,1,home,0,8,8
7996,2,work,8,16,8
7996,3,home,16,21,5
7996,4,shop,21,22,1
7996,5,home,22,24,2
7997,1,home,0,7,7
7997,2,work,7,15,8
7997,3,shop,15,16,1
7997,4,home,16,23,7
7997,5,work,23,24,1
7998,1,home,0,9,9
7998,2,work,9,18,9
7998,3,home,18,24,6
7999,1,home,0,7,7
7999,2,shop,7,8,1
7999,3,education,8,11,3
7999,4,home,11,14,3
7999,5,education,14,16,2
7999,6,home,16,24,8
8000,1,home,0,6,6
8000,2,shop,6,7,1
8000,3,work,7,13,6
8000,4,home,13,16,3
8000,5,work,16,19,3
8000,6,home,19,24,5
8001,1,home,0,6,6
8001,2,work,6,13,7
8001,3,shop,13,14,1
8001,4,education,14,16,2
8001,5,home,16,24,8
8002,1,home,0,8,8
8002,2,work,8,15,7
8002,3,home,15,24,9
8003,1,home,0,7,7
8003,2,work,7,13,6
8003,3,shop,13,14,1
8003,4,home,14,24,10
8004,1,home,0,6,6
8004,2,shop,6,7,1
8004,3,home,7,9,2
8004,4,education,9,12,3
8004,5,shop,12,14,2
8004,6,home,14,20,6
8004,7,shop,20,21,1
8004,8,home,21,24,3
8005,1,home,0,7,7
8005,2,work,7,14,7
8005,3,home,14,24,10
8006,1,home,0,7,7
8006,2,work,7,14,7
8006,3,home,14,21,7
8006,4,work,21,22,1
8006,5,home,22,24,2
8007,1,home,0,6,6
8007,2,shop,6,7,1
8007,3,home,7,9,2
8007,4,education,9,12,3
8007,5,home,12,16,4
8007,6,shop,16,17,1
8007,7,home,17,24,7
8008,1,home,0,6,6
8008,2,shop,6,7,1
8008,3,work,7,14,7
8008,4,home,14,23,9
8008,5,work,23,24,1
8009,1,home,0,7,7
8009,2,work,7,9,2
8009,3,home,9,16,7
8009,4,work,16,18,2
8009,5,home,18,24,6
8010,1,home,0,6,6
8010,2,work,6,14,8
8010,3,home,14,17,3
8010,4,work,17,20,3
8010,5,home,20,24,4
8011,1,home,0,6,6
8011,2,shop,6,7,1
8011,3,home,7,10,3
8011,4,education,10,13,3
8011,5,home,13,19,6
8011,6,shop,19,21,2
8011,7,home,21,24,3
8012,1,home,0,8,8
8012,2,work,8,13,5
8012,3,shop,13,14,1
8012,4,work,14,20,6
8012,5,home,20,24,4
8013,1,home,0,8,8
8013,2,work,8,14,6
8013,3,shop,14,15,1
8013,4,home,15,19,4
8013,5,shop,19,20,1
8013,6,home,20,24,4
8014,1,home,0,7,7
8014,2,education,7,11,4
8014,3,home,11,17,6
8014,4,shop,17,18,1
8014,5,home,18,24,6
8015,1,home,0,7,7
8015,2,work,7,13,6
8015,3,home,13,17,4
8015,4,work,17,20,3
8015,5,home,20,24,4
8016,1,home,0,7,7
8016,2,work,7,9,2
8016,3,home,9,13,4
8016,4,work,13,15,2
8016,5,home,15,22,7
8016,6,work,22,23,1
8016,7,home,23,24,1
8017,1,home,0,8,8
8017,2,education,8,12,4
8017,3,work,12,18,6
8017,4,home,18,24,6
8018,1,home,0,7,7
8018,2,work,7,14,7
8018,3,home,14,24,10
8019,1,home,0,7,7
8019,2,work,7,13,6
8019,3,shop,13,14,1
8019,4,home,14,21,7
8019,5,work,21,22,1
8019,6,home,22,24,2
8020,1,home,0,6,6
8020,2,shop,6,7,1
8020,3,home,7,11,4
8020,4,work,11,18,7
8020,5,home,18,24,6
8021,1,home,0,6,6
8021,2,work,6,13,7
8021,3,shop,13,14,1
8021,4,home,14,24,10
8022,1,home,0,8,8
8022,2,work,8,17,9
8022,3,home,17,21,4
8022,4,work,21,22,1
8022,5,home,22,24,2
8023,1,home,0,7,7
8023,2,education,7,11,4
8023,3,home,11,17,6
8023,4,shop,17,18,1
8023,5,home,18,24,6
8024,1,home,0,8,8
8024,2,work,8,16,8
8024,3,home,16,24,8
8025,1,home,0,6,6
8025,2,work,6,13,7
8025,3,shop,13,14,1
8025,4,work,14,20,6
8025,5,home,20,24,4
8026,1,home,0,6,6
8026,2,work,6,13,7
8026,3,home,13,20,7
8026,4,shop,20,21,1
8026,5,home,21,24,3
8027,1,home,0,7,7
8027,2,work,7,13,6
8027,3,shop,13,14,1
8027,4,work,14,19,5
8027,5,home,19,24,5
8028,1,home,0,8,8
8028,2,education,8,11,3
8028,3,shop,11,12,1
8028,4,home,12,18,6
8028,5,work,18,20,2
8028,6,home,20,24,4
8029,1,home,0,7,7
8029,2,work,7,13,6
8029,3,shop,13,14,1
8029,4,home,14,24,10
8030,1,home,0,6,6
8030,2,work,6,13,7
8030,3,shop,13,14,1
8030,4,home,14,24,10
8031,1,home,0,8,8
8031,2,education,8,12,4
8031,3,shop,12,13,1
8031,4,education,13,16,3
8031,5,shop,16,17,1
8031,6,home,17,24,7
8032,1,home,0,6,6
8032,2,work,6,12,6
8032,3,shop,12,13,1
8032,4,work,13,19,6
8032,5,home,19,24,5
8033,1,home,0,8,8
8033,2,work,8,16,8
8033,3,home,16,23,7
8033,4,work,23,24,1
8034,1,home,0,7,7
8034,2,shop,7,8,1
8034,3,education,8,12,4
8034,4,home,12,19,7
8034,5,shop,19,21,2
8034,6,home,21,24,3
8035,1,home,0,8,8
8035,2,work,8,14,6
8035,3,shop,14,15,1
8035,4,work,15,18,3
8035,5,education,18,19,1
8035,6,work,19,20,1
8035,7,home,20,24,4
8036,1,home,0,8,8
8036,2,education,8,12,4
8036,3,home,12,16,4
8036,4,shop,16,17,1
8036,5,home,17,24,7
8037,1,home,0,7,7
8037,2,work,7,13,6
8037,3,home,13,17,4
8037,4,work,17,20,3
8037,5,home,20,24,4
8038,1,home,0,6,6
8038,2,work,6,13,7
8038,3,shop,13,14,1
8038,4,work,14,20,6
8038,5,home,20,24,4
8039,1,home,0,6,6
8039,2,work,6,13,7
8039,3,home,13,17,4
8039,4,shop,17,18,1
8039,5,home,18,24,6
8040,1,home,0,6,6
8040,2,work,6,13,7
8040,3,home,13,17,4
8040,4,work,17,20,3
8040,5,home,20,24,4
8041,1,home,0,8,8
8041,2,work,8,15,7
8041,3,home,15,24,9
8042,1,home,0,8,8
8042,2,work,8,16,8
8042,3,shop,16,17,1
8042,4,work,17,20,3
8042,5,home,20,24,4
8043,1,home,0,7,7
8043,2,education,7,11,4
8043,3,home,11,18,7
8043,4,shop,18,20,2
8043,5,home,20,24,4
8044,1,home,0,6,6
8044,2,shop,6,7,1
8044,3,work,7,14,7
8044,4,home,14,16,2
8044,5,work,16,20,4
8044,6,home,20,24,4
8045,1,home,0,7,7
8045,2,work,7,13,6
8045,3,shop,13,14,1
8045,4,work,14,19,5
8045,5,home,19,24,5
8046,1,home,0,8,8
8046,2,work,8,15,7
8046,3,home,15,24,9
8047,1,home,0,6,6
8047,2,work,6,8,2
8047,3,home,8,11,3
8047,4,work,11,13,2
8047,5,home,13,21,8
8047,6,work,21,22,1
8047,7,home,22,24,2
8048,1,home,0,6,6
8048,2,work,6,8,2
8048,3,home,8,13,5
8048,4,work,13,15,2
8048,5,home,15,22,7
8048,6,work,22,23,1
8048,7,home,23,24,1
8049,1,home,0,6,6
8049,2,work,6,13,7
8049,3,home,13,15,2
8049,4,work,15,20,5
8049,5,home,20,24,4
8050,1,home,0,7,7
8050,2,work,7,10,3
8050,3,home,10,16,6
8050,4,work,16,19,3
8050,5,home,19,24,5
8051,1,home,0,6,6
8051,2,work,6,7,1
8051,3,home,7,13,6
8051,4,work,13,15,2
8051,5,home,15,22,7
8051,6,work,22,23,1
8051,7,home,23,24,1
8052,1,home,0,6,6
8052,2,shop,6,7,1
8052,3,home,7,13,6
8052,4,education,13,16,3
8052,5,shop,16,17,1
8052,6,home,17,24,7
8053,1,home,0,8,8
8053,2,work,8,14,6
8053,3,shop,14,15,1
8053,4,work,15,19,4
8053,5,home,19,24,5
8054,1,home,0,6,6
8054,2,shop,6,7,1
8054,3,home,7,10,3
8054,4,education,10,15,5
8054,5,shop,15,17,2
8054,6,home,17,24,7
8055,1,home,0,7,7
8055,2,work,7,14,7
8055,3,shop,14,15,1
8055,4,work,15,19,4
8055,5,home,19,23,4
8055,6,work,23,24,1
8056,1,home,0,7,7
8056,2,work,7,13,6
8056,3,home,13,24,11
8057,1,home,0,7,7
8057,2,shop,7,8,1
8057,3,education,8,12,4
8057,4,home,12,20,8
8057,5,shop,20,21,1
8057,6,home,21,24,3
8058,1,home,0,6,6
8058,2,work,6,8,2
8058,3,home,8,13,5
8058,4,work,13,15,2
8058,5,home,15,22,7
8058,6,work,22,23,1
8058,7,home,23,24,1
8059,1,home,0,8,8
8059,2,work,8,14,6
8059,3,home,14,21,7
8059,4,shop,21,22,1
8059,5,home,22,24,2
8060,1,home,0,6,6
8060,2,shop,6,7,1
8060,3,home,7,13,6
8060,4,education,13,14,1
8060,5,shop,14,15,1
8060,6,home,15,24,9
8061,1,home,0,9,9
8061,2,work,9,16,7
8061,3,home,16,24,8
8062,1,home,0,7,7
8062,2,work,7,14,7
8062,3,shop,14,15,1
8062,4,home,15,24,9
8063,1,home,0,8,8
8063,2,work,8,16,8
8063,3,home,16,24,8
8064,1,home,0,6,6
8064,2,shop,6,7,1
8064,3,home,7,9,2
8064,4,education,9,13,4
8064,5,shop,13,14,1
8064,6,home,14,20,6
8064,7,shop,20,21,1
8064,8,home,21,24,3
8065,1,home,0,6,6
8065,2,shop,6,7,1
8065,3,home,7,9,2
8065,4,education,9,12,3
8065,5,shop,12,14,2
8065,6,home,14,24,10
8066,1,home,0,7,7
8066,2,work,7,13,6
8066,3,home,13,24,11
8067,1,home,0,6,6
8067,2,shop,6,7,1
8067,3,home,7,9,2
8067,4,work,9,15,6
8067,5,home,15,23,8
8067,6,work,23,24,1
8068,1,home,0,6,6
8068,2,work,6,13,7
8068,3,home,13,22,9
8068,4,work,22,23,1
8068,5,home,23,24,1
8069,1,home,0,8,8
8069,2,education,8,14,6
8069,3,shop,14,15,1
8069,4,work,15,20,5
8069,5,home,20,24,4
8070,1,home,0,7,7
8070,2,work,7,13,6
8070,3,home,13,17,4
8070,4,work,17,20,3
8070,5,home,20,24,4
8071,1,home,0,6,6
8071,2,shop,6,7,1
8071,3,home,7,9,2
8071,4,education,9,12,3
8071,5,home,12,20,8
8071,6,shop,20,21,1
8071,7,home,21,24,3
8072,1,home,0,7,7
8072,2,shop,7,9,2
8072,3,education,9,11,2
8072,4,home,11,18,7
8072,5,shop,18,20,2
8072,6,home,20,24,4
8073,1,home,0,7,7
8073,2,work,7,14,7
8073,3,home,14,21,7
8073,4,work,21,22,1
8073,5,home,22,24,2
8074,1,home,0,7,7
8074,2,work,7,14,7
8074,3,home,14,24,10
8075,1,home,0,8,8
8075,2,work,8,15,7
8075,3,home,15,19,4
8075,4,shop,19,20,1
8075,5,home,20,24,4
8076,1,home,0,7,7
8076,2,education,7,11,4
8076,3,home,11,18,7
8076,4,shop,18,19,1
8076,5,home,19,24,5
8077,1,home,0,8,8
8077,2,work,8,15,7
8077,3,home,15,21,6
8077,4,work,21,22,1
8077,5,home,22,24,2
8078,1,home,0,7,7
8078,2,shop,7,9,2
8078,3,education,9,11,2
8078,4,home,11,18,7
8078,5,shop,18,19,1
8078,6,home,19,24,5
8079,1,home,0,7,7
8079,2,work,7,14,7
8079,3,home,14,24,10
8080,1,home,0,7,7
8080,2,work,7,14,7
8080,3,home,14,17,3
8080,4,work,17,20,3
8080,5,home,20,24,4
8081,1,home,0,7,7
8081,2,work,7,14,7
8081,3,shop,14,15,1
8081,4,home,15,22,7
8081,5,work,22,23,1
8081,6,home,23,24,1
8082,1,home,0,7,7
8082,2,education,7,11,4
8082,3,home,11,15,4
8082,4,shop,15,16,1
8082,5,home,16,24,8
8083,1,home,0,9,9
8083,2,work,9,16,7
8083,3,home,16,22,6
8083,4,work,22,23,1
8083,5,home,23,24,1
8084,1,home,0,6,6
8084,2,work,6,13,7
8084,3,shop,13,14,1
8084,4,home,14,23,9
8084,5,work,23,24,1
8085,1,home,0,7,7
8085,2,shop,7,8,1
8085,3,education,8,12,4
8085,4,shop,12,14,2
8085,5,education,14,16,2
8085,6,home,16,19,3
8085,7,shop,19,20,1
8085,8,home,20,24,4
8086,1,home,0,8,8
8086,2,work,8,16,8
8086,3,home,16,24,8
8087,1,home,0,8,8
8087,2,education,8,12,4
8087,3,home,12,17,5
8087,4,work,17,20,3
8087,5,home,20,24,4
8088,1,home,0,7,7
8088,2,work,7,13,6
8088,3,shop,13,15,2
8088,4,work,15,20,5
8088,5,home,20,24,4
8089,1,home,0,7,7
8089,2,work,7,14,7
8089,3,home,14,19,5
8089,4,shop,19,20,1
8089,5,home,20,24,4
8090,1,home,0,6,6
8090,2,work,6,13,7
8090,3,shop,13,14,1
8090,4,work,14,20,6
8090,5,home,20,24,4
8091,1,home,0,6,6
8091,2,work,6,9,3
8091,3,home,9,15,6
8091,4,work,15,17,2
8091,5,home,17,23,6
8091,6,work,23,24,1
8092,1,home,0,8,8
8092,2,work,8,15,7
8092,3,shop,15,17,2
8092,4,work,17,19,2
8092,5,home,19,24,5
8093,1,home,0,7,7
8093,2,work,7,9,2
8093,3,home,9,13,4
8093,4,work,13,15,2
8093,5,home,15,21,6
8093,6,work,21,22,1
8093,7,home,22,24,2
8094,1,home,0,6,6
8094,2,work,6,13,7
8094,3,home,13,17,4
8094,4,work,17,20,3
8094,5,home,20,24,4
8095,1,home,0,7,7
8095,2,work,7,14,7
8095,3,home,14,17,3
8095,4,work,17,20,3
8095,5,home,20,24,4
8096,1,home,0,6,6
8096,2,work,6,7,1
8096,3,home,7,11,4
8096,4,work,11,12,1
8096,5,home,12,19,7
8096,6,shop,19,20,1
8096,7,home,20,24,4
8097,1,home,0,6,6
8097,2,work,6,13,7
8097,3,shop,13,15,2
8097,4,home,15,17,2
8097,5,work,17,20,3
8097,6,home,20,24,4
8098,1,home,0,7,7
8098,2,shop,7,9,2
8098,3,education,9,12,3
8098,4,shop,12,14,2
8098,5,home,14,20,6
8098,6,shop,20,21,1
8098,7,home,21,24,3
8099,1,home,0,7,7
8099,2,education,7,11,4
8099,3,home,11,18,7
8099,4,shop,18,19,1
8099,5,home,19,24,5
8100,1,home,0,6,6
8100,2,work,6,13,7
8100,3,home,13,24,11
8101,1,home,0,7,7
8101,2,work,7,13,6
8101,3,home,13,24,11
8102,1,home,0,9,9
8102,2,work,9,16,7
8102,3,home,16,23,7
8102,4,work,23,24,1
8103,1,home,0,6,6
8103,2,work,6,13,7
8103,3,shop,13,14,1
8103,4,work,14,20,6
8103,5,home,20,24,4
8104,1,home,0,7,7
8104,2,work,7,14,7
8104,3,shop,14,16,2
8104,4,work,16,20,4
8104,5,home,20,24,4
8105,1,home,0,7,7
8105,2,work,7,14,7
8105,3,home,14,23,9
8105,4,work,23,24,1
8106,1,home,0,6,6
8106,2,work,6,13,7
8106,3,home,13,24,11
8107,1,home,0,6,6
8107,2,work,6,13,7
8107,3,shop,13,14,1
8107,4,work,14,19,5
8107,5,home,19,24,5
8108,1,home,0,7,7
8108,2,work,7,14,7
8108,3,home,14,19,5
8108,4,shop,19,20,1
8108,5,home,20,24,4
8109,1,home,0,8,8
8109,2,work,8,15,7
8109,3,home,15,24,9
8110,1,home,0,8,8
8110,2,work,8,14,6
8110,3,home,14,24,10
8111,1,home,0,6,6
8111,2,work,6,8,2
8111,3,home,8,14,6
8111,4,work,14,16,2
8111,5,home,16,21,5
8111,6,work,21,22,1
8111,7,home,22,24,2
8112,1,home,0,7,7
8112,2,work,7,14,7
8112,3,home,14,22,8
8112,4,work,22,23,1
8112,5,home,23,24,1
8113,1,home,0,7,7
8113,2,work,7,13,6
8113,3,home,13,24,11
8114,1,home,0,7,7
8114,2,work,7,9,2
8114,3,home,9,14,5
8114,4,work,14,17,3
8114,5,home,17,22,5
8114,6,work,22,23,1
8114,7,home,23,24,1
8115,1,home,0,7,7
8115,2,work,7,13,6
8115,3,home,13,18,5
8115,4,shop,18,19,1
8115,5,home,19,24,5
8116,1,home,0,6,6
8116,2,work,6,7,1
8116,3,home,7,8,1
8116,4,work,8,10,2
8116,5,home,10,14,4
8116,6,work,14,15,1
8116,7,home,15,16,1
8116,8,work,16,18,2
8116,9,education,18,19,1
8116,10,home,19,24,5
8117,1,home,0,7,7
8117,2,work,7,14,7
8117,3,home,14,19,5
8117,4,shop,19,20,1
8117,5,home,20,24,4
8118,1,home,0,7,7
8118,2,shop,7,8,1
8118,3,education,8,12,4
8118,4,home,12,18,6
8118,5,shop,18,19,1
8118,6,home,19,24,5
8119,1,home,0,7,7
8119,2,work,7,13,6
8119,3,shop,13,14,1
8119,4,work,14,18,4
8119,5,home,18,24,6
8120,1,home,0,7,7
8120,2,education,7,11,4
8120,3,home,11,17,6
8120,4,shop,17,18,1
8120,5,home,18,24,6
8121,1,home,0,7,7
8121,2,work,7,13,6
8121,3,home,13,24,11
8122,1,home,0,6,6
8122,2,shop,6,7,1
8122,3,home,7,10,3
8122,4,education,10,13,3
8122,5,shop,13,15,2
8122,6,home,15,24,9
8123,1,home,0,7,7
8123,2,work,7,14,7
8123,3,shop,14,15,1
8123,4,home,15,24,9
8124,1,home,0,7,7
8124,2,work,7,13,6
8124,3,shop,13,14,1
8124,4,home,14,24,10
8125,1,home,0,8,8
8125,2,shop,8,9,1
8125,3,work,9,16,7
8125,4,shop,16,18,2
8125,5,home,18,24,6
8126,1,home,0,6,6
8126,2,work,6,8,2
8126,3,home,8,13,5
8126,4,shop,13,14,1
8126,5,work,14,16,2
8126,6,home,16,21,5
8126,7,work,21,22,1
8126,8,home,22,24,2
8127,1,home,0,6,6
8127,2,work,6,13,7
8127,3,home,13,17,4
8127,4,work,17,20,3
8127,5,home,20,24,4
8128,1,home,0,7,7
8128,2,work,7,13,6
8128,3,home,13,24,11
8129,1,home,0,6,6
8129,2,work,6,13,7
8129,3,home,13,23,10
8129,4,work,23,24,1
8130,1,home,0,7,7
8130,2,work,7,13,6
8130,3,home,13,24,11
8131,1,home,0,8,8
8131,2,work,8,15,7
8131,3,home,15,24,9
8132,1,home,0,6,6
8132,2,work,6,13,7
8132,3,home,13,17,4
8132,4,work,17,20,3
8132,5,home,20,24,4
8133,1,home,0,6,6
8133,2,work,6,13,7
8133,3,home,13,21,8
8133,4,shop,21,22,1
8133,5,home,22,24,2
8134,1,home,0,7,7
8134,2,work,7,14,7
8134,3,shop,14,15,1
8134,4,home,15,24,9
8135,1,home,0,6,6
8135,2,shop,6,7,1
8135,3,home,7,13,6
8135,4,education,13,15,2
8135,5,shop,15,16,1
8135,6,home,16,24,8
8136,1,home,0,7,7
8136,2,shop,7,8,1
8136,3,work,8,15,7
8136,4,home,15,21,6
8136,5,work,21,22,1
8136,6,home,22,24,2
8137,1,home,0,7,7
8137,2,shop,7,8,1
8137,3,education,8,12,4
8137,4,home,12,16,4
8137,5,shop,16,18,2
8137,6,home,18,24,6
8138,1,home,0,7,7
8138,2,education,7,11,4
8138,3,home,11,17,6
8138,4,shop,17,18,1
8138,5,home,18,24,6
8139,1,home,0,7,7
8139,2,shop,7,8,1
8139,3,work,8,16,8
8139,4,home,16,24,8
8140,1,home,0,6,6
8140,2,work,6,8,2
8140,3,home,8,13,5
8140,4,work,13,16,3
8140,5,home,16,22,6
8140,6,work,22,23,1
8140,7,home,23,24,1
8141,1,home,0,8,8
8141,2,education,8,11,3
8141,3,home,11,16,5
8141,4,work,16,20,4
8141,5,home,20,24,4
8142,1,home,0,6,6
8142,2,work,6,13,7
8142,3,shop,13,14,1
8142,4,home,14,23,9
8142,5,work,23,24,1
8143,1,home,0,7,7
8143,2,education,7,11,4
8143,3,home,11,17,6
8143,4,shop,17,18,1
8143,5,home,18,24,6
8144,1,home,0,8,8
8144,2,work,8,13,5
8144,3,shop,13,14,1
8144,4,work,14,19,5
8144,5,home,19,24,5
8145,1,home,0,8,8
8145,2,work,8,15,7
8145,3,home,15,24,9
8146,1,home,0,8,8
8146,2,work,8,15,7
8146,3,home,15,24,9
8147,1,home,0,8,8
8147,2,work,8,15,7
8147,3,home,15,24,9
8148,1,home,0,8,8
8148,2,work,8,15,7
8148,3,home,15,21,6
8148,4,work,21,22,1
8148,5,home,22,24,2
8149,1,home,0,7,7
8149,2,work,7,16,9
8149,3,shop,16,17,1
8149,4,home,17,22,5
8149,5,work,22,23,1
8149,6,home,23,24,1
8150,1,home,0,6,6
8150,2,work,6,8,2
8150,3,home,8,14,6
8150,4,work,14,17,3
8150,5,home,17,23,6
8150,6,work,23,24,1
8151,1,home,0,6,6
8151,2,work,6,13,7
8151,3,home,13,21,8
8151,4,work,21,22,1
8151,5,home,22,24,2
8152,1,home,0,8,8
8152,2,education,8,11,3
8152,3,home,11,14,3
8152,4,work,14,19,5
8152,5,home,19,24,5
8153,1,home,0,7,7
8153,2,work,7,13,6
8153,3,shop,13,14,1
8153,4,home,14,24,10
8154,1,home,0,7,7
8154,2,work,7,14,7
8154,3,home,14,24,10
8155,1,home,0,6,6
8155,2,work,6,13,7
8155,3,shop,13,14,1
8155,4,work,14,19,5
8155,5,home,19,24,5
8156,1,home,0,6,6
8156,2,work,6,13,7
8156,3,shop,13,14,1
8156,4,home,14,21,7
8156,5,work,21,22,1
8156,6,home,22,24,2
8157,1,home,0,6,6
8157,2,work,6,13,7
8157,3,shop,13,14,1
8157,4,home,14,24,10
8158,1,home,0,7,7
8158,2,work,7,14,7
8158,3,home,14,22,8
8158,4,work,22,23,1
8158,5,home,23,24,1
8159,1,home,0,6,6
8159,2,shop,6,7,1
8159,3,home,7,10,3
8159,4,education,10,12,2
8159,5,home,12,21,9
8159,6,shop,21,22,1
8159,7,home,22,24,2
8160,1,home,0,9,9
8160,2,work,9,15,6
8160,3,home,15,18,3
8160,4,work,18,19,1
8160,5,home,19,24,5
8161,1,home,0,8,8
8161,2,education,8,11,3
8161,3,home,11,24,13
8162,1,home,0,6,6
8162,2,work,6,12,6
8162,3,shop,12,13,1
8162,4,work,13,20,7
8162,5,home,20,24,4
8163,1,home,0,6,6
8163,2,work,6,13,7
8163,3,home,13,17,4
8163,4,work,17,20,3
8163,5,home,20,24,4
8164,1,home,0,7,7
8164,2,work,7,13,6
8164,3,shop,13,14,1
8164,4,home,14,22,8
8164,5,work,22,23,1
8164,6,home,23,24,1
8165,1,home,0,7,7
8165,2,work,7,13,6
8165,3,shop,13,14,1
8165,4,work,14,18,4
8165,5,home,18,24,6
8166,1,home,0,6,6
8166,2,work,6,13,7
8166,3,home,13,17,4
8166,4,work,17,20,3
8166,5,home,20,24,4
8167,1,home,0,7,7
8167,2,work,7,9,2
8167,3,home,9,12,3
8167,4,work,12,14,2
8167,5,home,14,21,7
8167,6,work,21,22,1
8167,7,home,22,24,2
8168,1,home,0,6,6
8168,2,work,6,12,6
8168,3,shop,12,13,1
8168,4,work,13,19,6
8168,5,home,19,24,5
8169,1,home,0,8,8
8169,2,work,8,14,6
8169,3,home,14,24,10
8170,1,home,0,9,9
8170,2,work,9,16,7
8170,3,shop,16,17,1
8170,4,home,17,21,4
8170,5,work,21,22,1
8170,6,home,22,24,2
8171,1,home,0,7,7
8171,2,shop,7,8,1
8171,3,work,8,15,7
8171,4,home,15,24,9
8172,1,home,0,7,7
8172,2,work,7,13,6
8172,3,shop,13,15,2
8172,4,home,15,24,9
8173,1,home,0,6,6
8173,2,work,6,13,7
8173,3,shop,13,14,1
8173,4,work,14,20,6
8173,5,home,20,24,4
8174,1,home,0,6,6
8174,2,work,6,8,2
8174,3,home,8,14,6
8174,4,work,14,17,3
8174,5,home,17,21,4
8174,6,work,21,22,1
8174,7,home,22,24,2
8175,1,home,0,8,8
8175,2,work,8,17,9
8175,3,home,17,24,7
8176,1,home,0,6,6
8176,2,work,6,13,7
8176,3,home,13,23,10
8176,4,work,23,24,1
8177,1,home,0,7,7
8177,2,education,7,11,4
8177,3,home,11,18,7
8177,4,shop,18,19,1
8177,5,home,19,24,5
8178,1,home,0,7,7
8178,2,shop,7,8,1
8178,3,education,8,11,3
8178,4,home,11,17,6
8178,5,shop,17,19,2
8178,6,home,19,24,5
8179,1,home,0,6,6
8179,2,shop,6,7,1
8179,3,work,7,14,7
8179,4,shop,14,16,2
8179,5,home,16,24,8
8180,1,home,0,7,7
8180,2,shop,7,8,1
8180,3,education,8,12,4
8180,4,shop,12,14,2
8180,5,home,14,20,6
8180,6,shop,20,21,1
8180,7,home,21,24,3
8181,1,home,0,6,6
8181,2,work,6,8,2
8181,3,home,8,13,5
8181,4,work,13,14,1
8181,5,home,14,21,7
8181,6,work,21,22,1
8181,7,home,22,24,2
8182,1,home,0,8,8
8182,2,work,8,14,6
8182,3,home,14,24,10
8183,1,home,0,6,6
8183,2,work,6,13,7
8183,3,shop,13,14,1
8183,4,work,14,20,6
8183,5,home,20,24,4
8184,1,home,0,6,6
8184,2,shop,6,7,1
8184,3,home,7,9,2
8184,4,education,9,11,2
8184,5,home,11,18,7
8184,6,shop,18,19,1
8184,7,home,19,24,5
8185,1,home,0,6,6
8185,2,work,6,13,7
8185,3,home,13,24,11
8186,1,home,0,6,6
8186,2,shop,6,7,1
8186,3,home,7,10,3
8186,4,education,10,12,2
8186,5,home,12,18,6
8186,6,shop,18,19,1
8186,7,home,19,24,5
8187,1,home,0,7,7
8187,2,work,7,13,6
8187,3,home,13,20,7
8187,4,shop,20,21,1
8187,5,home,21,24,3
8188,1,home,0,7,7
8188,2,work,7,13,6
8188,3,home,13,24,11
8189,1,home,0,6,6
8189,2,work,6,13,7
8189,3,home,13,17,4
8189,4,work,17,20,3
8189,5,home,20,24,4
8190,1,home,0,7,7
8190,2,work,7,13,6
8190,3,shop,13,14,1
8190,4,work,14,20,6
8190,5,home,20,24,4
8191,1,home,0,7,7
8191,2,education,7,11,4
8191,3,home,11,20,9
8191,4,shop,20,21,1
8191,5,home,21,24,3
8192,1,home,0,7,7
8192,2,work,7,13,6
8192,3,home,13,17,4
8192,4,shop,17,18,1
8192,5,home,18,24,6
8193,1,home,0,8,8
8193,2,work,8,15,7
8193,3,home,15,24,9
8194,1,home,0,7,7
8194,2,work,7,14,7
8194,3,home,14,21,7
8194,4,shop,21,22,1
8194,5,home,22,24,2
8195,1,home,0,6,6
8195,2,work,6,13,7
8195,3,home,13,17,4
8195,4,work,17,19,2
8195,5,home,19,24,5
8196,1,home,0,7,7
8196,2,shop,7,8,1
8196,3,work,8,15,7
8196,4,home,15,24,9
8197,1,home,0,8,8
8197,2,work,8,15,7
8197,3,home,15,24,9
8198,1,home,0,7,7
8198,2,work,7,15,8
8198,3,shop,15,16,1
8198,4,work,16,20,4
8198,5,home,20,24,4
8199,1,home,0,7,7
8199,2,work,7,14,7
8199,3,shop,14,15,1
8199,4,work,15,19,4
8199,5,home,19,24,5
8200,1,home,0,7,7
8200,2,shop,7,8,1
8200,3,work,8,15,7
8200,4,home,15,19,4
8200,5,shop,19,20,1
8200,6,home,20,24,4
8201,1,home,0,6,6
8201,2,work,6,7,1
8201,3,home,7,9,2
8201,4,work,9,10,1
8201,5,home,10,16,6
8201,6,work,16,18,2
8201,7,home,18,24,6
8202,1,home,0,8,8
8202,2,education,8,12,4
8202,3,shop,12,14,2
8202,4,home,14,21,7
8202,5,shop,21,22,1
8202,6,home,22,24,2
8203,1,home,0,7,7
8203,2,work,7,14,7
8203,3,shop,14,15,1
8203,4,home,15,24,9
8204,1,home,0,7,7
8204,2,work,7,13,6
8204,3,home,13,24,11
8205,1,home,0,6,6
8205,2,work,6,8,2
8205,3,home,8,14,6
8205,4,work,14,17,3
8205,5,home,17,24,7
8206,1,home,0,7,7
8206,2,work,7,13,6
8206,3,home,13,15,2
8206,4,work,15,19,4
8206,5,home,19,24,5
8207,1,home,0,7,7
8207,2,work,7,9,2
8207,3,home,9,15,6
8207,4,work,15,17,2
8207,5,home,17,23,6
8207,6,work,23,24,1
8208,1,home,0,7,7
8208,2,work,7,13,6
8208,3,shop,13,14,1
8208,4,work,14,19,5
8208,5,home,19,24,5
8209,1,home,0,8,8
8209,2,work,8,15,7
8209,3,shop,15,16,1
8209,4,home,16,24,8
8210,1,home,0,6,6
8210,2,work,6,13,7
8210,3,shop,13,14,1
8210,4,work,14,19,5
8210,5,home,19,24,5
8211,1,home,0,7,7
8211,2,work,7,14,7
8211,3,home,14,24,10
8212,1,home,0,7,7
8212,2,work,7,9,2
8212,3,home,9,12,3
8212,4,work,12,14,2
8212,5,home,14,18,4
8212,6,work,18,20,2
8212,7,home,20,24,4
8213,1,home,0,9,9
8213,2,work,9,16,7
8213,3,home,16,24,8
8214,1,home,0,7,7
8214,2,education,7,11,4
8214,3,home,11,17,6
8214,4,shop,17,19,2
8214,5,home,19,24,5
8215,1,home,0,8,8
8215,2,work,8,15,7
8215,3,home,15,24,9
8216,1,home,0,6,6
8216,2,work,6,13,7
8216,3,shop,13,14,1
8216,4,work,14,20,6
8216,5,home,20,24,4
8217,1,home,0,8,8
8217,2,work,8,15,7
8217,3,home,15,24,9
8218,1,home,0,8,8
8218,2,work,8,15,7
8218,3,shop,15,16,1
8218,4,home,16,24,8
8219,1,home,0,6,6
8219,2,shop,6,7,1
8219,3,home,7,9,2
8219,4,education,9,12,3
8219,5,shop,12,14,2
8219,6,education,14,16,2
8219,7,shop,16,17,1
8219,8,home,17,24,7
8220,1,home,0,7,7
8220,2,education,7,11,4
8220,3,home,11,14,3
8220,4,education,14,17,3
8220,5,home,17,24,7
8221,1,home,0,7,7
8221,2,shop,7,8,1
8221,3,education,8,11,3
8221,4,home,11,17,6
8221,5,shop,17,18,1
8221,6,home,18,24,6
8222,1,home,0,7,7
8222,2,education,7,11,4
8222,3,home,11,18,7
8222,4,shop,18,19,1
8222,5,home,19,24,5
8223,1,home,0,8,8
8223,2,shop,8,9,1
8223,3,work,9,16,7
8223,4,home,16,23,7
8223,5,work,23,24,1
8224,1,home,0,7,7
8224,2,work,7,14,7
8224,3,home,14,18,4
8224,4,shop,18,19,1
8224,5,home,19,24,5
8225,1,home,0,8,8
8225,2,work,8,13,5
8225,3,shop,13,14,1
8225,4,home,14,24,10
8226,1,home,0,7,7
8226,2,work,7,14,7
8226,3,shop,14,15,1
8226,4,home,15,24,9
8227,1,home,0,6,6
8227,2,work,6,8,2
8227,3,home,8,13,5
8227,4,work,13,15,2
8227,5,home,15,22,7
8227,6,work,22,23,1
8227,7,home,23,24,1
8228,1,home,0,6,6
8228,2,work,6,8,2
8228,3,home,8,13,5
8228,4,work,13,15,2
8228,5,home,15,22,7
8228,6,work,22,23,1
8228,7,home,23,24,1
8229,1,home,0,8,8
8229,2,work,8,15,7
8229,3,home,15,24,9
8230,1,home,0,8,8
8230,2,work,8,15,7
8230,3,home,15,21,6
8230,4,work,21,22,1
8230,5,home,22,24,2
8231,1,home,0,6,6
8231,2,shop,6,7,1
8231,3,work,7,14,7
8231,4,home,14,24,10
8232,1,home,0,7,7
8232,2,work,7,13,6
8232,3,home,13,24,11
8233,1,home,0,6,6
8233,2,work,6,7,1
8233,3,home,7,13,6
8233,4,work,13,15,2
8233,5,home,15,22,7
8233,6,work,22,23,1
8233,7,home,23,24,1
8234,1,home,0,8,8
8234,2,work,8,14,6
8234,3,shop,14,15,1
8234,4,work,15,19,4
8234,5,home,19,24,5
8235,1,home,0,6,6
8235,2,work,6,13,7
8235,3,home,13,24,11
8236,1,home,0,7,7
8236,2,work,7,14,7
8236,3,shop,14,15,1
8236,4,home,15,24,9
8237,1,home,0,7,7
8237,2,shop,7,8,1
8237,3,home,8,13,5
8237,4,education,13,16,3
8237,5,home,16,21,5
8237,6,shop,21,22,1
8237,7,home,22,24,2
8238,1,home,0,8,8
8238,2,education,8,11,3
8238,3,home,11,17,6
8238,4,shop,17,18,1
8238,5,home,18,24,6
8239,1,home,0,8,8
8239,2,work,8,15,7
8239,3,home,15,16,1
8239,4,work,16,20,4
8239,5,home,20,24,4
8240,1,home,0,7,7
8240,2,shop,7,9,2
8240,3,education,9,12,3
8240,4,shop,12,13,1
8240,5,home,13,19,6
8240,6,shop,19,20,1
8240,7,home,20,24,4
8241,1,home,0,6,6
8241,2,shop,6,7,1
8241,3,home,7,13,6
8241,4,work,13,19,6
8241,5,home,19,24,5
8242,1,home,0,8,8
8242,2,work,8,15,7
8242,3,home,15,24,9
8243,1,home,0,8,8
8243,2,work,8,15,7
8243,3,home,15,24,9
8244,1,home,0,7,7
8244,2,work,7,14,7
8244,3,home,14,24,10
8245,1,home,0,8,8
8245,2,work,8,16,8
8245,3,home,16,24,8
8246,1,home,0,6,6
8246,2,shop,6,7,1
8246,3,home,7,10,3
8246,4,education,10,12,2
8246,5,shop,12,13,1
8246,6,home,13,20,7
8246,7,shop,20,21,1
8246,8,home,21,24,3
8247,1,home,0,7,7
8247,2,education,7,11,4
8247,3,home,11,19,8
8247,4,shop,19,21,2
8247,5,home,21,24,3
8248,1,home,0,7,7
8248,2,work,7,13,6
8248,3,shop,13,14,1
8248,4,work,14,20,6
8248,5,home,20,24,4
8249,1,home,0,8,8
8249,2,work,8,15,7
8249,3,home,15,24,9
8250,1,home,0,6,6
8250,2,work,6,13,7
8250,3,shop,13,14,1
8250,4,education,14,16,2
8250,5,shop,16,17,1
8250,6,work,17,20,3
8250,7,home,20,24,4
8251,1,home,0,7,7
8251,2,education,7,11,4
8251,3,home,11,19,8
8251,4,shop,19,20,1
8251,5,home,20,24,4
8252,1,home,0,6,6
8252,2,work,6,13,7
8252,3,home,13,21,8
8252,4,work,21,22,1
8252,5,home,22,24,2
8253,1,home,0,6,6
8253,2,work,6,8,2
8253,3,home,8,14,6
8253,4,work,14,16,2
8253,5,home,16,22,6
8253,6,work,22,23,1
8253,7,home,23,24,1
8254,1,home,0,7,7
8254,2,work,7,15,8
8254,3,home,15,24,9
8255,1,home,0,7,7
8255,2,work,7,13,6
8255,3,home,13,24,11
8256,1,home,0,6,6
8256,2,shop,6,7,1
8256,3,home,7,13,6
8256,4,education,13,16,3
8256,5,home,16,24,8
8257,1,home,0,8,8
8257,2,work,8,15,7
8257,3,home,15,24,9
8258,1,home,0,7,7
8258,2,work,7,14,7
8258,3,home,14,24,10
8259,1,home,0,7,7
8259,2,work,7,14,7
8259,3,home,14,24,10
8260,1,home,0,7,7
8260,2,work,7,13,6
8260,3,home,13,19,6
8260,4,shop,19,20,1
8260,5,home,20,24,4
8261,1,home,0,8,8
8261,2,work,8,16,8
8261,3,home,16,21,5
8261,4,shop,21,22,1
8261,5,home,22,24,2
8262,1,home,0,8,8
8262,2,work,8,14,6
8262,3,home,14,24,10
8263,1,home,0,7,7
8263,2,shop,7,8,1
8263,3,home,8,11,3
8263,4,work,11,18,7
8263,5,home,18,24,6
8264,1,home,0,6,6
8264,2,work,6,8,2
8264,3,home,8,9,1
8264,4,work,9,10,1
8264,5,home,10,14,4
8264,6,work,14,16,2
8264,7,home,16,22,6
8264,8,work,22,23,1
8264,9,home,23,24,1
8265,1,home,0,7,7
8265,2,work,7,14,7
8265,3,home,14,21,7
8265,4,shop,21,22,1
8265,5,home,22,24,2
8266,1,home,0,7,7
8266,2,education,7,12,5
8266,3,shop,12,13,1
8266,4,education,13,16,3
8266,5,shop,16,18,2
8266,6,home,18,24,6
8267,1,home,0,7,7
8267,2,shop,7,8,1
8267,3,work,8,13,5
8267,4,home,13,18,5
8267,5,shop,18,19,1
8267,6,home,19,24,5
8268,1,home,0,7,7
8268,2,work,7,9,2
8268,3,home,9,11,2
8268,4,work,11,13,2
8268,5,home,13,21,8
8268,6,work,21,22,1
8268,7,home,22,24,2
8269,1,home,0,7,7
8269,2,education,7,11,4
8269,3,home,11,20,9
8269,4,shop,20,21,1
8269,5,home,21,24,3
8270,1,home,0,6,6
8270,2,work,6,7,1
8270,3,home,7,8,1
8270,4,work,8,10,2
8270,5,home,10,16,6
8270,6,work,16,18,2
8270,7,home,18,23,5
8270,8,work,23,24,1
8271,1,home,0,7,7
8271,2,work,7,14,7
8271,3,home,14,18,4
8271,4,work,18,20,2
8271,5,home,20,24,4
8272,1,home,0,7,7
8272,2,work,7,13,6
8272,3,shop,13,14,1
8272,4,home,14,23,9
8272,5,work,23,24,1
8273,1,home,0,7,7
8273,2,work,7,13,6
8273,3,shop,13,14,1
8273,4,work,14,19,5
8273,5,home,19,24,5
8274,1,home,0,7,7
8274,2,education,7,11,4
8274,3,home,11,17,6
8274,4,shop,17,18,1
8274,5,home,18,24,6
8275,1,home,0,8,8
8275,2,education,8,11,3
8275,3,home,11,18,7
8275,4,shop,18,19,1
8275,5,home,19,24,5
8276,1,home,0,7,7
8276,2,work,7,13,6
8276,3,shop,13,14,1
8276,4,home,14,24,10
8277,1,home,0,7,7
8277,2,work,7,14,7
8277,3,shop,14,15,1
8277,4,home,15,24,9
8278,1,home,0,7,7
8278,2,work,7,8,1
8278,3,home,8,12,4
8278,4,work,12,14,2
8278,5,home,14,21,7
8278,6,work,21,22,1
8278,7,home,22,24,2
8279,1,home,0,7,7
8279,2,education,7,12,5
8279,3,shop,12,13,1
8279,4,education,13,16,3
8279,5,shop,16,17,1
8279,6,home,17,24,7
8280,1,home,0,6,6
8280,2,shop,6,7,1
8280,3,home,7,9,2
8280,4,education,9,12,3
8280,5,home,12,19,7
8280,6,shop,19,21,2
8280,7,home,21,24,3
8281,1,home,0,8,8
8281,2,education,8,11,3
8281,3,home,11,16,5
8281,4,work,16,20,4
8281,5,home,20,24,4
8282,1,home,0,7,7
8282,2,work,7,13,6
8282,3,home,13,24,11
8283,1,home,0,7,7
8283,2,work,7,12,5
8283,3,shop,12,13,1
8283,4,work,13,19,6
8283,5,home,19,24,5
8284,1,home,0,7,7
8284,2,work,7,13,6
8284,3,shop,13,14,1
8284,4,work,14,19,5
8284,5,home,19,24,5
8285,1,home,0,7,7
8285,2,work,7,13,6
8285,3,home,13,24,11
8286,1,home,0,8,8
8286,2,work,8,12,4
8286,3,shop,12,13,1
8286,4,work,13,19,6
8286,5,home,19,24,5
8287,1,home,0,8,8
8287,2,work,8,15,7
8287,3,home,15,22,7
8287,4,work,22,23,1
8287,5,home,23,24,1
8288,1,home,0,6,6
8288,2,work,6,13,7
8288,3,home,13,22,9
8288,4,work,22,23,1
8288,5,home,23,24,1
8289,1,home,0,6,6
8289,2,work,6,13,7
8289,3,shop,13,14,1
8289,4,work,14,18,4
8289,5,home,18,24,6
8290,1,home,0,6,6
8290,2,shop,6,7,1
8290,3,home,7,13,6
8290,4,education,13,16,3
8290,5,home,16,24,8
8291,1,home,0,9,9
8291,2,work,9,15,6
8291,3,home,15,24,9
8292,1,home,0,7,7
8292,2,education,7,10,3
8292,3,home,10,14,4
8292,4,education,14,16,2
8292,5,shop,16,17,1
8292,6,home,17,24,7
8293,1,home,0,7,7
8293,2,work,7,14,7
8293,3,home,14,24,10
8294,1,home,0,7,7
8294,2,shop,7,8,1
8294,3,education,8,11,3
8294,4,home,11,18,7
8294,5,shop,18,19,1
8294,6,home,19,24,5
8295,1,home,0,7,7
8295,2,education,7,11,4
8295,3,home,11,13,2
8295,4,education,13,15,2
8295,5,shop,15,16,1
8295,6,home,16,24,8
8296,1,home,0,6,6
8296,2,work,6,7,1
8296,3,home,7,9,2
8296,4,work,9,10,1
8296,5,home,10,16,6
8296,6,work,16,18,2
8296,7,home,18,24,6
8297,1,home,0,6,6
8297,2,shop,6,7,1
8297,3,home,7,13,6
8297,4,education,13,16,3
8297,5,home,16,24,8
8298,1,home,0,9,9
8298,2,work,9,16,7
8298,3,shop,16,17,1
8298,4,home,17,24,7
8299,1,home,0,8,8
8299,2,work,8,14,6
8299,3,home,14,21,7
8299,4,work,21,22,1
8299,5,home,22,24,2
8300,1,home,0,6,6
8300,2,work,6,13,7
8300,3,home,13,18,5
8300,4,work,18,19,1
8300,5,home,19,24,5
8301,1,home,0,7,7
8301,2,work,7,13,6
8301,3,home,13,21,8
8301,4,work,21,22,1
8301,5,home,22,24,2
8302,1,home,0,6,6
8302,2,shop,6,7,1
8302,3,work,7,8,1
8302,4,home,8,13,5
8302,5,work,13,14,1
8302,6,home,14,21,7
8302,7,work,21,22,1
8302,8,home,22,24,2
8303,1,home,0,8,8
8303,2,shop,8,9,1
8303,3,home,9,13,4
8303,4,work,13,20,7
8303,5,home,20,24,4
8304,1,home,0,7,7
8304,2,work,7,13,6
8304,3,home,13,24,11
8305,1,home,0,8,8
8305,2,work,8,15,7
8305,3,shop,15,16,1
8305,4,work,16,20,4
8305,5,home,20,24,4
8306,1,home,0,8,8
8306,2,work,8,13,5
8306,3,shop,13,14,1
8306,4,home,14,24,10
8307,1,home,0,6,6
8307,2,shop,6,7,1
8307,3,work,7,15,8
8307,4,home,15,24,9
8308,1,home,0,7,7
8308,2,shop,7,8,1
8308,3,education,8,11,3
8308,4,home,11,18,7
8308,5,shop,18,20,2
8308,6,home,20,24,4
8309,1,home,0,7,7
8309,2,shop,7,8,1
8309,3,work,8,15,7
8309,4,home,15,24,9
8310,1,home,0,7,7
8310,2,shop,7,8,1
8310,3,education,8,12,4
8310,4,shop,12,13,1
8310,5,education,13,16,3
8310,6,home,16,24,8
8311,1,home,0,8,8
8311,2,work,8,14,6
8311,3,shop,14,15,1
8311,4,home,15,24,9
8312,1,home,0,8,8
8312,2,work,8,14,6
8312,3,home,14,24,10
8313,1,home,0,6,6
8313,2,work,6,8,2
8313,3,home,8,9,1
8313,4,work,9,11,2
8313,5,home,11,14,3
8313,6,work,14,16,2
8313,7,home,16,22,6
8313,8,work,22,23,1
8313,9,home,23,24,1
8314,1,home,0,7,7
8314,2,work,7,13,6
8314,3,home,13,17,4
8314,4,work,17,20,3
8314,5,home,20,24,4
8315,1,home,0,7,7
8315,2,shop,7,9,2
8315,3,home,9,13,4
8315,4,education,13,16,3
8315,5,shop,16,17,1
8315,6,home,17,24,7
8316,1,home,0,8,8
8316,2,work,8,15,7
8316,3,home,15,24,9
8317,1,home,0,7,7
8317,2,work,7,9,2
8317,3,home,9,15,6
8317,4,work,15,17,2
8317,5,home,17,24,7
8318,1,home,0,6,6
8318,2,shop,6,7,1
8318,3,home,7,11,4
8318,4,work,11,18,7
8318,5,education,18,19,1
8318,6,home,19,24,5
8319,1,home,0,7,7
8319,2,work,7,14,7
8319,3,home,14,19,5
8319,4,shop,19,20,1
8319,5,home,20,24,4
8320,1,home,0,8,8
8320,2,work,8,15,7
8320,3,home,15,17,2
8320,4,shop,17,18,1
8320,5,home,18,24,6
8321,1,home,0,7,7
8321,2,work,7,13,6
8321,3,shop,13,15,2
8321,4,work,15,20,5
8321,5,home,20,24,4
8322,1,home,0,6,6
8322,2,work,6,13,7
8322,3,home,13,15,2
8322,4,work,15,20,5
8322,5,home,20,24,4
8323,1,home,0,7,7
8323,2,work,7,13,6
8323,3,home,13,17,4
8323,4,work,17,20,3
8323,5,home,20,24,4
8324,1,home,0,8,8
8324,2,shop,8,9,1
8324,3,home,9,14,5
8324,4,work,14,20,6
8324,5,home,20,24,4
8325,1,home,0,7,7
8325,2,work,7,14,7
8325,3,home,14,24,10
8326,1,home,0,9,9
8326,2,work,9,16,7
8326,3,shop,16,17,1
8326,4,home,17,24,7
8327,1,home,0,7,7
8327,2,work,7,14,7
8327,3,shop,14,15,1
8327,4,home,15,20,5
8327,5,shop,20,21,1
8327,6,home,21,24,3
8328,1,home,0,8,8
8328,2,work,8,14,6
8328,3,home,14,24,10
8329,1,home,0,9,9
8329,2,work,9,15,6
8329,3,home,15,21,6
8329,4,shop,21,22,1
8329,5,home,22,24,2
8330,1,home,0,7,7
8330,2,education,7,12,5
8330,3,home,12,20,8
8330,4,shop,20,21,1
8330,5,home,21,24,3
8331,1,home,0,8,8
8331,2,education,8,12,4
8331,3,home,12,16,4
8331,4,shop,16,17,1
8331,5,home,17,21,4
8331,6,work,21,22,1
8331,7,home,22,24,2
8332,1,home,0,7,7
8332,2,work,7,9,2
8332,3,home,9,13,4
8332,4,work,13,15,2
8332,5,home,15,21,6
8332,6,work,21,22,1
8332,7,home,22,24,2
8333,1,home,0,6,6
8333,2,shop,6,7,1
8333,3,work,7,13,6
8333,4,home,13,24,11
8334,1,home,0,8,8
8334,2,shop,8,9,1
8334,3,home,9,12,3
8334,4,work,12,18,6
8334,5,home,18,24,6
8335,1,home,0,7,7
8335,2,work,7,13,6
8335,3,home,13,24,11
8336,1,home,0,8,8
8336,2,shop,8,9,1
8336,3,work,9,16,7
8336,4,home,16,21,5
8336,5,work,21,22,1
8336,6,home,22,24,2
8337,1,home,0,6,6
8337,2,work,6,13,7
8337,3,shop,13,14,1
8337,4,work,14,19,5
8337,5,home,19,24,5
8338,1,home,0,6,6
8338,2,work,6,7,1
8338,3,home,7,9,2
8338,4,work,9,11,2
8338,5,home,11,16,5
8338,6,work,16,19,3
8338,7,home,19,24,5
8339,1,home,0,7,7
8339,2,work,7,14,7
8339,3,home,14,24,10
8340,1,home,0,8,8
8340,2,work,8,15,7
8340,3,home,15,18,3
8340,4,work,18,20,2
8340,5,home,20,24,4
8341,1,home,0,7,7
8341,2,education,7,12,5
8341,3,home,12,18,6
8341,4,shop,18,19,1
8341,5,home,19,24,5
8342,1,home,0,7,7
8342,2,work,7,14,7
8342,3,home,14,24,10
8343,1,home,0,7,7
8343,2,work,7,13,6
8343,3,shop,13,14,1
8343,4,home,14,22,8
8343,5,work,22,23,1
8343,6,home,23,24,1
8344,1,home,0,7,7
8344,2,education,7,11,4
8344,3,home,11,19,8
8344,4,shop,19,20,1
8344,5,home,20,24,4
8345,1,home,0,8,8
8345,2,shop,8,9,1
8345,3,work,9,16,7
8345,4,home,16,21,5
8345,5,work,21,22,1
8345,6,home,22,24,2
8346,1,home,0,6,6
8346,2,work,6,12,6
8346,3,shop,12,13,1
8346,4,education,13,16,3
8346,5,home,16,24,8
8347,1,home,0,7,7
8347,2,work,7,14,7
8347,3,home,14,24,10
8348,1,home,0,8,8
8348,2,work,8,13,5
8348,3,home,13,20,7
8348,4,shop,20,21,1
8348,5,home,21,24,3
8349,1,home,0,6,6
8349,2,work,6,13,7
8349,3,home,13,21,8
8349,4,work,21,22,1
8349,5,home,22,24,2
8350,1,home,0,6,6
8350,2,work,6,13,7
8350,3,home,13,21,8
8350,4,shop,21,22,1
8350,5,home,22,24,2
8351,1,home,0,6,6
8351,2,work,6,13,7
8351,3,shop,13,14,1
8351,4,home,14,24,10
8352,1,home,0,8,8
8352,2,work,8,15,7
8352,3,home,15,24,9
8353,1,home,0,7,7
8353,2,education,7,11,4
8353,3,home,11,14,3
8353,4,education,14,16,2
8353,5,home,16,21,5
8353,6,shop,21,22,1
8353,7,home,22,24,2
8354,1,work,0,2,2
8354,2,home,2,6,4
8354,3,work,6,8,2
8354,4,home,8,13,5
8354,5,work,13,15,2
8354,6,home,15,21,6
8354,7,work,21,22,1
8354,8,home,22,24,2
8355,1,home,0,7,7
8355,2,work,7,14,7
8355,3,shop,14,15,1
8355,4,work,15,20,5
8355,5,home,20,24,4
8356,1,home,0,8,8
8356,2,work,8,15,7
8356,3,home,15,24,9
8357,1,home,0,7,7
8357,2,work,7,13,6
8357,3,home,13,24,11
8358,1,home,0,6,6
8358,2,shop,6,7,1
8358,3,home,7,9,2
8358,4,work,9,16,7
8358,5,home,16,21,5
8358,6,work,21,22,1
8358,7,home,22,24,2
8359,1,home,0,7,7
8359,2,shop,7,8,1
8359,3,education,8,11,3
8359,4,home,11,17,6
8359,5,shop,17,18,1
8359,6,home,18,24,6
8360,1,home,0,7,7
8360,2,shop,7,8,1
8360,3,education,8,11,3
8360,4,home,11,14,3
8360,5,education,14,16,2
8360,6,home,16,21,5
8360,7,shop,21,22,1
8360,8,home,22,24,2
8361,1,home,0,7,7
8361,2,education,7,11,4
8361,3,home,11,17,6
8361,4,shop,17,18,1
8361,5,home,18,24,6
8362,1,home,0,7,7
8362,2,shop,7,8,1
8362,3,work,8,14,6
8362,4,home,14,24,10
8363,1,home,0,7,7
8363,2,work,7,14,7
8363,3,home,14,22,8
8363,4,work,22,23,1
8363,5,home,23,24,1
8364,1,home,0,6,6
8364,2,work,6,13,7
8364,3,home,13,19,6
8364,4,shop,19,20,1
8364,5,home,20,24,4
8365,1,home,0,7,7
8365,2,education,7,12,5
8365,3,shop,12,15,3
8365,4,home,15,24,9
8366,1,home,0,7,7
8366,2,work,7,13,6
8366,3,shop,13,14,1
8366,4,home,14,18,4
8366,5,work,18,20,2
8366,6,home,20,24,4
8367,1,home,0,7,7
8367,2,work,7,13,6
8367,3,home,13,24,11
8368,1,home,0,6,6
8368,2,work,6,13,7
8368,3,home,13,18,5
8368,4,shop,18,19,1
8368,5,home,19,24,5
8369,1,home,0,7,7
8369,2,work,7,13,6
8369,3,shop,13,15,2
8369,4,home,15,24,9
8370,1,home,0,7,7
8370,2,shop,7,8,1
8370,3,education,8,11,3
8370,4,home,11,17,6
8370,5,shop,17,19,2
8370,6,home,19,24,5
8371,1,home,0,7,7
8371,2,shop,7,8,1
8371,3,work,8,14,6
8371,4,home,14,24,10
8372,1,home,0,7,7
8372,2,education,7,11,4
8372,3,home,11,18,7
8372,4,shop,18,19,1
8372,5,home,19,24,5
8373,1,home,0,6,6
8373,2,work,6,13,7
8373,3,home,13,24,11
8374,1,home,0,7,7
8374,2,education,7,11,4
8374,3,home,11,18,7
8374,4,shop,18,20,2
8374,5,home,20,24,4
8375,1,home,0,6,6
8375,2,shop,6,7,1
8375,3,home,7,13,6
8375,4,education,13,16,3
8375,5,home,16,24,8
8376,1,home,0,6,6
8376,2,work,6,7,1
8376,3,home,7,11,4
8376,4,work,11,13,2
8376,5,home,13,17,4
8376,6,work,17,19,2
8376,7,home,19,22,3
8376,8,work,22,23,1
8376,9,home,23,24,1
8377,1,home,0,6,6
8377,2,shop,6,7,1
8377,3,work,7,14,7
8377,4,home,14,24,10
8378,1,home,0,6,6
8378,2,shop,6,7,1
8378,3,home,7,9,2
8378,4,education,9,15,6
8378,5,shop,15,17,2
8378,6,home,17,24,7
8379,1,home,0,8,8
8379,2,work,8,14,6
8379,3,home,14,24,10
8380,1,home,0,7,7
8380,2,work,7,13,6
8380,3,home,13,24,11
8381,1,home,0,6,6
8381,2,shop,6,7,1
8381,3,home,7,13,6
8381,4,education,13,16,3
8381,5,shop,16,17,1
8381,6,home,17,24,7
8382,1,home,0,7,7
8382,2,education,7,12,5
8382,3,shop,12,13,1
8382,4,home,13,20,7
8382,5,shop,20,21,1
8382,6,home,21,24,3
8383,1,home,0,7,7
8383,2,shop,7,8,1
8383,3,education,8,11,3
8383,4,home,11,18,7
8383,5,shop,18,20,2
8383,6,home,20,24,4
8384,1,home,0,6,6
8384,2,work,6,8,2
8384,3,shop,8,9,1
8384,4,work,9,11,2
8384,5,home,11,15,4
8384,6,work,15,17,2
8384,7,home,17,21,4
8384,8,work,21,22,1
8384,9,home,22,24,2
8385,1,home,0,6,6
8385,2,shop,6,7,1
8385,3,home,7,9,2
8385,4,education,9,13,4
8385,5,shop,13,15,2
8385,6,home,15,21,6
8385,7,shop,21,22,1
8385,8,home,22,24,2
8386,1,home,0,7,7
8386,2,work,7,14,7
8386,3,home,14,18,4
8386,4,work,18,20,2
8386,5,home,20,24,4
8387,1,home,0,6,6
8387,2,work,6,13,7
8387,3,home,13,22,9
8387,4,work,22,23,1
8387,5,home,23,24,1
8388,1,home,0,7,7
8388,2,education,7,11,4
8388,3,home,11,17,6
8388,4,shop,17,19,2
8388,5,home,19,24,5
8389,1,home,0,6,6
8389,2,work,6,13,7
8389,3,shop,13,15,2
8389,4,work,15,19,4
8389,5,home,19,24,5
8390,1,home,0,6,6
8390,2,work,6,13,7
8390,3,shop,13,14,1
8390,4,work,14,19,5
8390,5,home,19,24,5
8391,1,home,0,6,6
8391,2,work,6,13,7
8391,3,shop,13,14,1
8391,4,work,14,19,5
8391,5,home,19,24,5
8392,1,home,0,7,7
8392,2,education,7,11,4
8392,3,home,11,17,6
8392,4,shop,17,18,1
8392,5,home,18,24,6
8393,1,home,0,8,8
8393,2,work,8,14,6
8393,3,home,14,20,6
8393,4,shop,20,21,1
8393,5,home,21,24,3
8394,1,home,0,8,8
8394,2,work,8,14,6
8394,3,shop,14,15,1
8394,4,home,15,22,7
8394,5,work,22,23,1
8394,6,home,23,24,1
8395,1,home,0,6,6
8395,2,shop,6,7,1
8395,3,home,7,13,6
8395,4,education,13,16,3
8395,5,home,16,24,8
8396,1,home,0,7,7
8396,2,work,7,9,2
8396,3,home,9,15,6
8396,4,work,15,18,3
8396,5,home,18,24,6
8397,1,home,0,7,7
8397,2,work,7,13,6
8397,3,home,13,17,4
8397,4,work,17,20,3
8397,5,home,20,24,4
8398,1,home,0,7,7
8398,2,work,7,13,6
8398,3,home,13,17,4
8398,4,work,17,20,3
8398,5,home,20,24,4
8399,1,home,0,8,8
8399,2,work,8,13,5
8399,3,home,13,24,11
8400,1,home,0,6,6
8400,2,shop,6,7,1
8400,3,home,7,13,6
8400,4,education,13,16,3
8400,5,home,16,24,8
8401,1,home,0,6,6
8401,2,shop,6,7,1
8401,3,work,7,14,7
8401,4,home,14,23,9
8401,5,work,23,24,1
8402,1,home,0,8,8
8402,2,work,8,15,7
8402,3,home,15,21,6
8402,4,work,21,22,1
8402,5,home,22,24,2
8403,1,home,0,7,7
8403,2,education,7,12,5
8403,3,shop,12,13,1
8403,4,home,13,19,6
8403,5,shop,19,20,1
8403,6,home,20,24,4
8404,1,home,0,6,6
8404,2,work,6,13,7
8404,3,home,13,17,4
8404,4,work,17,20,3
8404,5,home,20,24,4
8405,1,home,0,7,7
8405,2,work,7,13,6
8405,3,shop,13,14,1
8405,4,education,14,16,2
8405,5,home,16,24,8
8406,1,home,0,7,7
8406,2,education,7,11,4
8406,3,home,11,18,7
8406,4,shop,18,19,1
8406,5,home,19,24,5
8407,1,home,0,8,8
8407,2,work,8,14,6
8407,3,shop,14,15,1
8407,4,home,15,24,9
8408,1,home,0,6,6
8408,2,work,6,13,7
8408,3,home,13,24,11
8409,1,home,0,7,7
8409,2,work,7,14,7
8409,3,home,14,24,10
8410,1,home,0,6,6
8410,2,work,6,8,2
8410,3,home,8,14,6
8410,4,work,14,16,2
8410,5,home,16,22,6
8410,6,work,22,23,1
8410,7,home,23,24,1
8411,1,home,0,9,9
8411,2,work,9,17,8
8411,3,home,17,24,7
8412,1,home,0,7,7
8412,2,work,7,13,6
8412,3,home,13,16,3
8412,4,work,16,19,3
8412,5,home,19,24,5
8413,1,home,0,7,7
8413,2,shop,7,8,1
8413,3,work,8,15,7
8413,4,home,15,22,7
8413,5,work,22,23,1
8413,6,home,23,24,1
8414,1,home,0,7,7
8414,2,work,7,14,7
8414,3,home,14,24,10
8415,1,home,0,6,6
8415,2,shop,6,7,1
8415,3,work,7,13,6
8415,4,home,13,21,8
8415,5,shop,21,22,1
8415,6,home,22,24,2
8416,1,home,0,7,7
8416,2,education,7,11,4
8416,3,home,11,18,7
8416,4,shop,18,20,2
8416,5,home,20,24,4
8417,1,home,0,8,8
8417,2,work,8,15,7
8417,3,home,15,24,9
8418,1,home,0,7,7
8418,2,work,7,14,7
8418,3,home,14,22,8
8418,4,work,22,23,1
8418,5,home,23,24,1
8419,1,home,0,8,8
8419,2,education,8,11,3
8419,3,home,11,17,6
8419,4,shop,17,18,1
8419,5,home,18,24,6
8420,1,home,0,8,8
8420,2,work,8,15,7
8420,3,shop,15,16,1
8420,4,home,16,24,8
8421,1,home,0,7,7
8421,2,education,7,11,4
8421,3,home,11,19,8
8421,4,shop,19,20,1
8421,5,home,20,24,4
8422,1,home,0,3,3
8422,2,work,3,12,9
8422,3,shop,12,13,1
8422,4,work,13,19,6
8422,5,home,19,24,5
8423,1,home,0,8,8
8423,2,work,8,14,6
8423,3,shop,14,15,1
8423,4,home,15,24,9
8424,1,home,0,6,6
8424,2,work,6,12,6
8424,3,shop,12,13,1
8424,4,work,13,19,6
8424,5,home,19,24,5
8425,1,home,0,6,6
8425,2,shop,6,7,1
8425,3,work,7,14,7
8425,4,home,14,24,10
8426,1,home,0,7,7
8426,2,work,7,13,6
8426,3,home,13,24,11
8427,1,home,0,6,6
8427,2,work,6,13,7
8427,3,home,13,16,3
8427,4,work,16,20,4
8427,5,home,20,24,4
8428,1,home,0,8,8
8428,2,work,8,15,7
8428,3,shop,15,16,1
8428,4,work,16,20,4
8428,5,home,20,24,4
8429,1,home,0,6,6
8429,2,work,6,13,7
8429,3,home,13,17,4
8429,4,work,17,19,2
8429,5,home,19,24,5
8430,1,home,0,8,8
8430,2,shop,8,9,1
8430,3,work,9,15,6
8430,4,home,15,24,9
8431,1,home,0,7,7
8431,2,shop,7,8,1
8431,3,work,8,15,7
8431,4,home,15,24,9
8432,1,home,0,6,6
8432,2,work,6,13,7
8432,3,home,13,17,4
8432,4,shop,17,18,1
8432,5,home,18,24,6
8433,1,home,0,6,6
8433,2,shop,6,7,1
8433,3,home,7,13,6
8433,4,education,13,16,3
8433,5,shop,16,18,2
8433,6,home,18,24,6
8434,1,home,0,6,6
8434,2,shop,6,8,2
8434,3,home,8,13,5
8434,4,work,13,19,6
8434,5,education,19,20,1
8434,6,home,20,24,4
8435,1,home,0,6,6
8435,2,work,6,8,2
8435,3,home,8,12,4
8435,4,work,12,14,2
8435,5,home,14,22,8
8435,6,work,22,23,1
8435,7,home,23,24,1
8436,1,home,0,7,7
8436,2,work,7,14,7
8436,3,home,14,22,8
8436,4,work,22,23,1
8436,5,home,23,24,1
8437,1,home,0,7,7
8437,2,work,7,8,1
8437,3,home,8,15,7
8437,4,work,15,18,3
8437,5,home,18,24,6
8438,1,home,0,7,7
8438,2,work,7,14,7
8438,3,home,14,15,1
8438,4,work,15,19,4
8438,5,home,19,24,5
8439,1,home,0,8,8
8439,2,education,8,11,3
8439,3,home,11,20,9
8439,4,shop,20,21,1
8439,5,home,21,24,3
8440,1,home,0,8,8
8440,2,work,8,15,7
8440,3,home,15,20,5
8440,4,shop,20,21,1
8440,5,home,21,24,3
8441,1,home,0,8,8
8441,2,work,8,14,6
8441,3,home,14,24,10
8442,1,home,0,6,6
8442,2,work,6,13,7
8442,3,shop,13,14,1
8442,4,work,14,19,5
8442,5,home,19,24,5
8443,1,home,0,7,7
8443,2,education,7,11,4
8443,3,home,11,15,4
8443,4,shop,15,16,1
8443,5,home,16,21,5
8443,6,shop,21,22,1
8443,7,home,22,24,2
8444,1,home,0,7,7
8444,2,work,7,13,6
8444,3,shop,13,14,1
8444,4,education,14,17,3
8444,5,home,17,24,7
8445,1,home,0,8,8
8445,2,work,8,15,7
8445,3,home,15,24,9
8446,1,home,0,6,6
8446,2,work,6,8,2
8446,3,home,8,12,4
8446,4,work,12,14,2
8446,5,home,14,18,4
8446,6,work,18,19,1
8446,7,home,19,24,5
8447,1,home,0,7,7
8447,2,work,7,14,7
8447,3,home,14,24,10
8448,1,home,0,6,6
8448,2,work,6,13,7
8448,3,shop,13,14,1
8448,4,home,14,24,10
8449,1,home,0,6,6
8449,2,work,6,13,7
8449,3,shop,13,14,1
8449,4,education,14,16,2
8449,5,home,16,24,8
8450,1,home,0,8,8
8450,2,work,8,15,7
8450,3,home,15,24,9
8451,1,home,0,7,7
8451,2,shop,7,9,2
8451,3,education,9,11,2
8451,4,home,11,17,6
8451,5,shop,17,18,1
8451,6,home,18,24,6
8452,1,home,0,9,9
8452,2,work,9,16,7
8452,3,shop,16,17,1
8452,4,work,17,20,3
8452,5,home,20,24,4
8453,1,home,0,7,7
8453,2,work,7,14,7
8453,3,home,14,23,9
8453,4,work,23,24,1
8454,1,home,0,7,7
8454,2,work,7,14,7
8454,3,home,14,24,10
8455,1,home,0,6,6
8455,2,work,6,12,6
8455,3,shop,12,13,1
8455,4,work,13,19,6
8455,5,home,19,24,5
8456,1,home,0,6,6
8456,2,work,6,8,2
8456,3,home,8,13,5
8456,4,work,13,15,2
8456,5,home,15,21,6
8456,6,work,21,22,1
8456,7,home,22,24,2
8457,1,home,0,7,7
8457,2,work,7,9,2
8457,3,home,9,13,4
8457,4,work,13,16,3
8457,5,home,16,22,6
8457,6,work,22,23,1
8457,7,home,23,24,1
8458,1,home,0,7,7
8458,2,education,7,11,4
8458,3,home,11,18,7
8458,4,shop,18,19,1
8458,5,home,19,24,5
8459,1,home,0,8,8
8459,2,education,8,11,3
8459,3,home,11,15,4
8459,4,shop,15,16,1
8459,5,work,16,20,4
8459,6,home,20,24,4
8460,1,home,0,6,6
8460,2,work,6,8,2
8460,3,home,8,12,4
8460,4,work,12,14,2
8460,5,home,14,21,7
8460,6,work,21,22,1
8460,7,home,22,24,2
8461,1,home,0,8,8
8461,2,work,8,14,6
8461,3,shop,14,15,1
8461,4,home,15,24,9
8462,1,home,0,6,6
8462,2,work,6,13,7
8462,3,home,13,19,6
8462,4,shop,19,20,1
8462,5,home,20,24,4
8463,1,home,0,6,6
8463,2,work,6,13,7
8463,3,shop,13,14,1
8463,4,work,14,19,5
8463,5,home,19,24,5
8464,1,home,0,7,7
8464,2,work,7,14,7
8464,3,home,14,24,10
8465,1,home,0,8,8
8465,2,education,8,12,4
8465,3,home,12,16,4
8465,4,shop,16,17,1
8465,5,home,17,24,7
8466,1,home,0,6,6
8466,2,work,6,13,7
8466,3,shop,13,14,1
8466,4,work,14,18,4
8466,5,home,18,24,6
8467,1,home,0,8,8
8467,2,work,8,13,5
8467,3,shop,13,14,1
8467,4,work,14,20,6
8467,5,home,20,24,4
8468,1,home,0,7,7
8468,2,work,7,13,6
8468,3,home,13,24,11
8469,1,home,0,8,8
8469,2,education,8,12,4
8469,3,work,12,19,7
8469,4,home,19,24,5
8470,1,home,0,8,8
8470,2,education,8,11,3
8470,3,home,11,18,7
8470,4,shop,18,19,1
8470,5,home,19,24,5
8471,1,home,0,7,7
8471,2,work,7,13,6
8471,3,shop,13,14,1
8471,4,work,14,20,6
8471,5,home,20,24,4
8472,1,home,0,7,7
8472,2,work,7,14,7
8472,3,home,14,24,10
8473,1,home,0,7,7
8473,2,work,7,13,6
8473,3,home,13,17,4
8473,4,work,17,20,3
8473,5,home,20,24,4
8474,1,home,0,6,6
8474,2,work,6,13,7
8474,3,home,13,21,8
8474,4,work,21,22,1
8474,5,home,22,24,2
8475,1,home,0,6,6
8475,2,work,6,13,7
8475,3,home,13,22,9
8475,4,work,22,23,1
8475,5,home,23,24,1
8476,1,home,0,7,7
8476,2,work,7,9,2
8476,3,home,9,15,6
8476,4,work,15,17,2
8476,5,home,17,21,4
8476,6,work,21,22,1
8476,7,home,22,24,2
8477,1,home,0,7,7
8477,2,work,7,13,6
8477,3,shop,13,14,1
8477,4,work,14,20,6
8477,5,home,20,24,4
8478,1,home,0,6,6
8478,2,shop,6,7,1
8478,3,work,7,14,7
8478,4,home,14,24,10
8479,1,home,0,8,8
8479,2,work,8,16,8
8479,3,home,16,22,6
8479,4,work,22,23,1
8479,5,home,23,24,1
8480,1,home,0,6,6
8480,2,shop,6,8,2
8480,3,home,8,9,1
8480,4,work,9,16,7
8480,5,shop,16,17,1
8480,6,home,17,24,7
8481,1,home,0,6,6
8481,2,shop,6,7,1
8481,3,home,7,9,2
8481,4,work,9,15,6
8481,5,home,15,24,9
8482,1,home,0,8,8
8482,2,education,8,12,4
8482,3,home,12,24,12
8483,1,home,0,9,9
8483,2,work,9,16,7
8483,3,shop,16,17,1
8483,4,work,17,20,3
8483,5,home,20,24,4
8484,1,home,0,6,6
8484,2,work,6,13,7
8484,3,home,13,24,11
8485,1,home,0,7,7
8485,2,work,7,13,6
8485,3,home,13,24,11
8486,1,home,0,7,7
8486,2,work,7,13,6
8486,3,home,13,18,5
8486,4,work,18,20,2
8486,5,home,20,24,4
8487,1,home,0,8,8
8487,2,work,8,14,6
8487,3,home,14,19,5
8487,4,shop,19,20,1
8487,5,home,20,24,4
8488,1,home,0,8,8
8488,2,work,8,15,7
8488,3,home,15,24,9
8489,1,home,0,7,7
8489,2,work,7,13,6
8489,3,home,13,16,3
8489,4,work,16,20,4
8489,5,home,20,24,4
8490,1,home,0,6,6
8490,2,work,6,13,7
8490,3,shop,13,14,1
8490,4,home,14,16,2
8490,5,work,16,20,4
8490,6,home,20,24,4
8491,1,home,0,8,8
8491,2,work,8,15,7
8491,3,home,15,24,9
8492,1,home,0,6,6
8492,2,shop,6,7,1
8492,3,home,7,13,6
8492,4,education,13,16,3
8492,5,home,16,24,8
8493,1,home,0,8,8
8493,2,work,8,15,7
8493,3,home,15,22,7
8493,4,work,22,23,1
8493,5,home,23,24,1
8494,1,home,0,6,6
8494,2,work,6,13,7
8494,3,home,13,16,3
8494,4,work,16,20,4
8494,5,home,20,24,4
8495,1,home,0,8,8
8495,2,work,8,13,5
8495,3,shop,13,14,1
8495,4,work,14,19,5
8495,5,education,19,20,1
8495,6,home,20,24,4
8496,1,home,0,8,8
8496,2,work,8,15,7
8496,3,shop,15,16,1
8496,4,work,16,19,3
8496,5,education,19,20,1
8496,6,home,20,24,4
8497,1,home,0,7,7
8497,2,work,7,13,6
8497,3,home,13,24,11
8498,1,home,0,8,8
8498,2,work,8,14,6
8498,3,home,14,23,9
8498,4,work,23,24,1
8499,1,home,0,6,6
8499,2,work,6,8,2
8499,3,home,8,14,6
8499,4,work,14,17,3
8499,5,home,17,24,7
8500,1,home,0,8,8
8500,2,work,8,15,7
8500,3,home,15,24,9
8501,1,home,0,8,8
8501,2,work,8,14,6
8501,3,home,14,19,5
8501,4,shop,19,20,1
8501,5,home,20,24,4
8502,1,home,0,7,7
8502,2,shop,7,9,2
8502,3,education,9,12,3
8502,4,shop,12,13,1
8502,5,education,13,16,3
8502,6,home,16,24,8
8503,1,home,0,7,7
8503,2,work,7,13,6
8503,3,home,13,24,11
8504,1,home,0,7,7
8504,2,education,7,12,5
8504,3,shop,12,14,2
8504,4,education,14,16,2
8504,5,home,16,24,8
8505,1,home,0,6,6
8505,2,work,6,8,2
8505,3,home,8,12,4
8505,4,work,12,14,2
8505,5,home,14,19,5
8505,6,shop,19,21,2
8505,7,home,21,24,3
8506,1,home,0,6,6
8506,2,work,6,13,7
8506,3,home,13,17,4
8506,4,shop,17,18,1
8506,5,work,18,20,2
8506,6,home,20,24,4
8507,1,home,0,9,9
8507,2,work,9,16,7
8507,3,home,16,21,5
8507,4,shop,21,22,1
8507,5,home,22,24,2
8508,1,home,0,7,7
8508,2,work,7,13,6
8508,3,home,13,17,4
8508,4,work,17,20,3
8508,5,home,20,24,4
8509,1,home,0,8,8
8509,2,work,8,14,6
8509,3,shop,14,15,1
8509,4,work,15,20,5
8509,5,home,20,24,4
8510,1,home,0,7,7
8510,2,work,7,13,6
8510,3,home,13,21,8
8510,4,work,21,22,1
8510,5,home,22,24,2
8511,1,home,0,8,8
8511,2,work,8,15,7
8511,3,shop,15,16,1
8511,4,home,16,24,8
8512,1,home,0,6,6
8512,2,work,6,13,7
8512,3,shop,13,14,1
8512,4,education,14,17,3
8512,5,home,17,24,7
8513,1,home,0,8,8
8513,2,work,8,15,7
8513,3,home,15,24,9
8514,1,home,0,7,7
8514,2,education,7,11,4
8514,3,home,11,14,3
8514,4,education,14,15,1
8514,5,shop,15,16,1
8514,6,home,16,24,8
8515,1,home,0,6,6
8515,2,shop,6,7,1
8515,3,home,7,9,2
8515,4,shop,9,10,1
8515,5,work,10,15,5
8515,6,home,15,24,9
8516,1,home,0,8,8
8516,2,education,8,12,4
8516,3,home,12,16,4
8516,4,work,16,20,4
8516,5,home,20,24,4
8517,1,home,0,6,6
8517,2,work,6,13,7
8517,3,home,13,24,11
8518,1,home,0,8,8
8518,2,education,8,12,4
8518,3,shop,12,13,1
8518,4,work,13,20,7
8518,5,home,20,24,4
8519,1,home,0,8,8
8519,2,work,8,14,6
8519,3,home,14,24,10
8520,1,home,0,6,6
8520,2,work,6,13,7
8520,3,shop,13,14,1
8520,4,home,14,24,10
8521,1,home,0,6,6
8521,2,work,6,13,7
8521,3,shop,13,14,1
8521,4,home,14,23,9
8521,5,work,23,24,1
8522,1,home,0,8,8
8522,2,work,8,16,8
8522,3,shop,16,17,1
8522,4,home,17,24,7
8523,1,home,0,7,7
8523,2,work,7,15,8
8523,3,home,15,21,6
8523,4,shop,21,22,1
8523,5,home,22,24,2
8524,1,home,0,7,7
8524,2,shop,7,8,1
8524,3,education,8,11,3
8524,4,home,11,18,7
8524,5,shop,18,19,1
8524,6,home,19,24,5
8525,1,home,0,7,7
8525,2,work,7,14,7
8525,3,home,14,24,10
8526,1,home,0,7,7
8526,2,work,7,14,7
8526,3,home,14,24,10
8527,1,home,0,7,7
8527,2,work,7,13,6
8527,3,home,13,17,4
8527,4,work,17,20,3
8527,5,home,20,24,4
8528,1,home,0,7,7
8528,2,work,7,14,7
8528,3,shop,14,15,1
8528,4,work,15,20,5
8528,5,home,20,24,4
8529,1,home,0,8,8
8529,2,work,8,12,4
8529,3,shop,12,13,1
8529,4,work,13,19,6
8529,5,home,19,24,5
8530,1,home,0,7,7
8530,2,work,7,13,6
8530,3,home,13,23,10
8530,4,work,23,24,1
8531,1,home,0,7,7
8531,2,work,7,8,1
8531,3,home,8,14,6
8531,4,work,14,17,3
8531,5,home,17,24,7
8532,1,home,0,6,6
8532,2,work,6,13,7
8532,3,home,13,16,3
8532,4,work,16,19,3
8532,5,home,19,24,5
8533,1,home,0,7,7
8533,2,shop,7,8,1
8533,3,work,8,15,7
8533,4,home,15,24,9
8534,1,home,0,6,6
8534,2,work,6,13,7
8534,3,shop,13,14,1
8534,4,home,14,24,10
8535,1,home,0,7,7
8535,2,work,7,14,7
8535,3,shop,14,15,1
8535,4,work,15,19,4
8535,5,home,19,24,5
8536,1,home,0,7,7
8536,2,work,7,13,6
8536,3,shop,13,14,1
8536,4,home,14,18,4
8536,5,work,18,20,2
8536,6,home,20,24,4
8537,1,home,0,9,9
8537,2,work,9,16,7
8537,3,home,16,21,5
8537,4,work,21,22,1
8537,5,home,22,24,2
8538,1,home,0,6,6
8538,2,work,6,8,2
8538,3,home,8,14,6
8538,4,work,14,17,3
8538,5,home,17,23,6
8538,6,work,23,24,1
8539,1,home,0,7,7
8539,2,work,7,13,6
8539,3,shop,13,14,1
8539,4,work,14,19,5
8539,5,home,19,24,5
8540,1,home,0,7,7
8540,2,shop,7,8,1
8540,3,education,8,11,3
8540,4,home,11,14,3
8540,5,education,14,16,2
8540,6,home,16,24,8
8541,1,home,0,7,7
8541,2,work,7,13,6
8541,3,home,13,24,11
8542,1,home,0,7,7
8542,2,shop,7,9,2
8542,3,work,9,16,7
8542,4,home,16,24,8
8543,1,home,0,7,7
8543,2,work,7,14,7
8543,3,shop,14,15,1
8543,4,work,15,19,4
8543,5,home,19,24,5
8544,1,home,0,7,7
8544,2,work,7,14,7
8544,3,home,14,20,6
8544,4,shop,20,21,1
8544,5,home,21,24,3
8545,1,home,0,9,9
8545,2,work,9,16,7
8545,3,shop,16,17,1
8545,4,home,17,22,5
8545,5,work,22,23,1
8545,6,home,23,24,1
8546,1,home,0,7,7
8546,2,education,7,11,4
8546,3,home,11,17,6
8546,4,shop,17,18,1
8546,5,home,18,24,6
8547,1,home,0,7,7
8547,2,work,7,14,7
8547,3,home,14,24,10
8548,1,home,0,8,8
8548,2,work,8,15,7
8548,3,home,15,20,5
8548,4,shop,20,21,1
8548,5,home,21,24,3
8549,1,home,0,6,6
8549,2,shop,6,7,1
8549,3,work,7,14,7
8549,4,shop,14,15,1
8549,5,home,15,24,9
8550,1,home,0,6,6
8550,2,shop,6,7,1
8550,3,work,7,14,7
8550,4,home,14,18,4
8550,5,work,18,20,2
8550,6,home,20,24,4
8551,1,home,0,6,6
8551,2,work,6,8,2
8551,3,home,8,12,4
8551,4,work,12,13,1
8551,5,home,13,22,9
8551,6,work,22,23,1
8551,7,home,23,24,1
8552,1,home,0,7,7
8552,2,work,7,13,6
8552,3,home,13,24,11
8553,1,home,0,7,7
8553,2,work,7,14,7
8553,3,shop,14,16,2
8553,4,home,16,24,8
8554,1,home,0,6,6
8554,2,work,6,13,7
8554,3,shop,13,14,1
8554,4,home,14,24,10
8555,1,home,0,8,8
8555,2,work,8,12,4
8555,3,shop,12,13,1
8555,4,work,13,20,7
8555,5,home,20,24,4
8556,1,home,0,7,7
8556,2,education,7,10,3
8556,3,home,10,14,4
8556,4,education,14,16,2
8556,5,home,16,24,8
8557,1,home,0,6,6
8557,2,shop,6,7,1
8557,3,home,7,11,4
8557,4,work,11,18,7
8557,5,home,18,23,5
8557,6,work,23,24,1
8558,1,home,0,8,8
8558,2,education,8,11,3
8558,3,home,11,18,7
8558,4,shop,18,20,2
8558,5,home,20,24,4
8559,1,home,0,8,8
8559,2,work,8,15,7
8559,3,home,15,24,9
8560,1,home,0,6,6
8560,2,shop,6,7,1
8560,3,home,7,11,4
8560,4,work,11,18,7
8560,5,home,18,23,5
8560,6,work,23,24,1
8561,1,home,0,8,8
8561,2,work,8,15,7
8561,3,shop,15,16,1
8561,4,home,16,21,5
8561,5,work,21,22,1
8561,6,home,22,24,2
8562,1,home,0,6,6
8562,2,work,6,13,7
8562,3,home,13,18,5
8562,4,work,18,20,2
8562,5,home,20,24,4
8563,1,home,0,6,6
8563,2,shop,6,7,1
8563,3,home,7,13,6
8563,4,education,13,16,3
8563,5,home,16,24,8
8564,1,home,0,7,7
8564,2,education,7,12,5
8564,3,shop,12,14,2
8564,4,education,14,16,2
8564,5,home,16,24,8
8565,1,home,0,7,7
8565,2,work,7,14,7
8565,3,shop,14,15,1
8565,4,home,15,24,9
8566,1,work,0,1,1
8566,2,shop,1,2,1
8566,3,home,2,8,6
8566,4,education,8,11,3
8566,5,home,11,17,6
8566,6,shop,17,18,1
8566,7,home,18,24,6
8567,1,home,0,6,6
8567,2,work,6,13,7
8567,3,home,13,24,11
8568,1,home,0,7,7
8568,2,work,7,13,6
8568,3,home,13,24,11
8569,1,home,0,8,8
8569,2,education,8,12,4
8569,3,work,12,18,6
8569,4,home,18,24,6
8570,1,home,0,8,8
8570,2,education,8,12,4
8570,3,work,12,19,7
8570,4,home,19,23,4
8570,5,work,23,24,1
8571,1,home,0,8,8
8571,2,education,8,11,3
8571,3,home,11,19,8
8571,4,shop,19,21,2
8571,5,home,21,24,3
8572,1,home,0,7,7
8572,2,education,7,13,6
8572,3,shop,13,15,2
8572,4,home,15,24,9
8573,1,home,0,6,6
8573,2,work,6,13,7
8573,3,home,13,18,5
8573,4,work,18,20,2
8573,5,home,20,24,4
8574,1,home,0,8,8
8574,2,work,8,15,7
8574,3,shop,15,16,1
8574,4,home,16,24,8
8575,1,home,0,6,6
8575,2,work,6,13,7
8575,3,home,13,18,5
8575,4,shop,18,19,1
8575,5,home,19,24,5
8576,1,home,0,7,7
8576,2,work,7,8,1
8576,3,home,8,14,6
8576,4,work,14,17,3
8576,5,home,17,22,5
8576,6,work,22,23,1
8576,7,home,23,24,1
8577,1,home,0,7,7
8577,2,work,7,13,6
8577,3,shop,13,14,1
8577,4,home,14,24,10
8578,1,home,0,6,6
8578,2,work,6,12,6
8578,3,shop,12,13,1
8578,4,work,13,19,6
8578,5,home,19,24,5
8579,1,home,0,7,7
8579,2,education,7,12,5
8579,3,home,12,19,7
8579,4,shop,19,20,1
8579,5,home,20,24,4
8580,1,home,0,8,8
8580,2,education,8,11,3
8580,3,home,11,14,3
8580,4,work,14,20,6
8580,5,home,20,24,4
8581,1,home,0,8,8
8581,2,work,8,15,7
8581,3,home,15,24,9
8582,1,home,0,8,8
8582,2,work,8,15,7
8582,3,home,15,22,7
8582,4,work,22,23,1
8582,5,home,23,24,1
8583,1,home,0,6,6
8583,2,work,6,13,7
8583,3,home,13,24,11
8584,1,home,0,7,7
8584,2,work,7,13,6
8584,3,home,13,24,11
8585,1,home,0,7,7
8585,2,education,7,11,4
8585,3,home,11,18,7
8585,4,shop,18,19,1
8585,5,home,19,24,5
8586,1,home,0,7,7
8586,2,work,7,13,6
8586,3,shop,13,14,1
8586,4,home,14,22,8
8586,5,work,22,23,1
8586,6,home,23,24,1
8587,1,home,0,7,7
8587,2,work,7,13,6
8587,3,shop,13,14,1
8587,4,work,14,20,6
8587,5,home,20,24,4
8588,1,home,0,7,7
8588,2,education,7,11,4
8588,3,home,11,12,1
8588,4,education,12,16,4
8588,5,home,16,20,4
8588,6,shop,20,21,1
8588,7,home,21,24,3
8589,1,home,0,7,7
8589,2,work,7,9,2
8589,3,home,9,15,6
8589,4,work,15,17,2
8589,5,home,17,22,5
8589,6,work,22,23,1
8589,7,home,23,24,1
8590,1,home,0,8,8
8590,2,work,8,13,5
8590,3,home,13,22,9
8590,4,work,22,23,1
8590,5,home,23,24,1
8591,1,home,0,8,8
8591,2,work,8,16,8
8591,3,home,16,21,5
8591,4,shop,21,22,1
8591,5,home,22,24,2
8592,1,home,0,8,8
8592,2,education,8,11,3
8592,3,home,11,15,4
8592,4,work,15,20,5
8592,5,home,20,24,4
8593,1,home,0,6,6
8593,2,work,6,8,2
8593,3,home,8,14,6
8593,4,work,14,16,2
8593,5,home,16,23,7
8593,6,work,23,24,1
8594,1,home,0,7,7
8594,2,education,7,11,4
8594,3,home,11,19,8
8594,4,shop,19,21,2
8594,5,home,21,24,3
8595,1,home,0,8,8
8595,2,work,8,16,8
8595,3,home,16,21,5
8595,4,shop,21,22,1
8595,5,home,22,24,2
8596,1,home,0,7,7
8596,2,work,7,13,6
8596,3,shop,13,14,1
8596,4,home,14,24,10
8597,1,home,0,7,7
8597,2,work,7,9,2
8597,3,home,9,16,7
8597,4,work,16,18,2
8597,5,home,18,22,4
8597,6,work,22,23,1
8597,7,home,23,24,1
8598,1,home,0,6,6
8598,2,work,6,13,7
8598,3,home,13,17,4
8598,4,work,17,20,3
8598,5,home,20,24,4
8599,1,home,0,6,6
8599,2,work,6,13,7
8599,3,home,13,24,11
8600,1,home,0,8,8
8600,2,work,8,15,7
8600,3,home,15,21,6
8600,4,shop,21,22,1
8600,5,home,22,24,2
8601,1,home,0,7,7
8601,2,education,7,12,5
8601,3,home,12,19,7
8601,4,shop,19,21,2
8601,5,home,21,24,3
8602,1,home,0,6,6
8602,2,work,6,13,7
8602,3,home,13,17,4
8602,4,work,17,20,3
8602,5,home,20,24,4
8603,1,home,0,7,7
8603,2,work,7,15,8
8603,3,home,15,24,9
8604,1,home,0,8,8
8604,2,work,8,15,7
8604,3,shop,15,16,1
8604,4,home,16,24,8
8605,1,home,0,6,6
8605,2,work,6,12,6
8605,3,shop,12,13,1
8605,4,education,13,16,3
8605,5,home,16,24,8
8606,1,home,0,6,6
8606,2,shop,6,7,1
8606,3,home,7,10,3
8606,4,education,10,12,2
8606,5,home,12,21,9
8606,6,shop,21,22,1
8606,7,home,22,24,2
8607,1,home,0,7,7
8607,2,work,7,14,7
8607,3,home,14,18,4
8607,4,shop,18,19,1
8607,5,home,19,24,5
8608,1,home,0,8,8
8608,2,shop,8,9,1
8608,3,work,9,15,6
8608,4,home,15,24,9
8609,1,home,0,8,8
8609,2,work,8,14,6
8609,3,shop,14,15,1
8609,4,work,15,20,5
8609,5,home,20,24,4
8610,1,home,0,8,8
8610,2,work,8,15,7
8610,3,home,15,24,9
8611,1,home,0,9,9
8611,2,work,9,16,7
8611,3,home,16,20,4
8611,4,shop,20,21,1
8611,5,home,21,24,3
8612,1,home,0,9,9
8612,2,work,9,16,7
8612,3,home,16,24,8
8613,1,home,0,8,8
8613,2,shop,8,9,1
8613,3,work,9,16,7
8613,4,home,16,24,8
8614,1,home,0,6,6
8614,2,shop,6,7,1
8614,3,work,7,14,7
8614,4,home,14,24,10
8615,1,home,0,7,7
8615,2,work,7,13,6
8615,3,shop,13,14,1
8615,4,home,14,24,10
8616,1,home,0,7,7
8616,2,shop,7,8,1
8616,3,education,8,11,3
8616,4,home,11,18,7
8616,5,shop,18,20,2
8616,6,home,20,24,4
8617,1,home,0,6,6
8617,2,work,6,13,7
8617,3,shop,13,14,1
8617,4,home,14,24,10
8618,1,home,0,6,6
8618,2,work,6,8,2
8618,3,home,8,9,1
8618,4,work,9,11,2
8618,5,home,11,17,6
8618,6,work,17,19,2
8618,7,home,19,23,4
8618,8,work,23,24,1
8619,1,home,0,6,6
8619,2,work,6,13,7
8619,3,home,13,24,11
8620,1,home,0,6,6
8620,2,shop,6,7,1
8620,3,home,7,10,3
8620,4,education,10,13,3
8620,5,shop,13,15,2
8620,6,home,15,19,4
8620,7,shop,19,20,1
8620,8,home,20,24,4
8621,1,home,0,6,6
8621,2,work,6,8,2
8621,3,home,8,13,5
8621,4,work,13,15,2
8621,5,home,15,21,6
8621,6,work,21,22,1
8621,7,home,22,24,2
8622,1,home,0,7,7
8622,2,shop,7,8,1
8622,3,home,8,12,4
8622,4,work,12,18,6
8622,5,home,18,24,6
8623,1,home,0,8,8
8623,2,education,8,11,3
8623,3,home,11,15,4
8623,4,work,15,20,5
8623,5,home,20,24,4
8624,1,home,0,6,6
8624,2,shop,6,7,1
8624,3,work,7,13,6
8624,4,home,13,17,4
8624,5,work,17,20,3
8624,6,home,20,24,4
8625,1,work,0,7,7
8625,2,shop,7,8,1
8625,3,home,8,14,6
8625,4,work,14,19,5
8625,5,home,19,24,5
8626,1,home,0,8,8
8626,2,work,8,14,6
8626,3,home,14,21,7
8626,4,work,21,22,1
8626,5,home,22,24,2
8627,1,home,0,8,8
8627,2,work,8,15,7
8627,3,home,15,24,9
8628,1,home,0,7,7
8628,2,work,7,13,6
8628,3,home,13,21,8
8628,4,work,21,22,1
8628,5,home,22,24,2
8629,1,home,0,9,9
8629,2,work,9,16,7
8629,3,shop,16,17,1
8629,4,home,17,22,5
8629,5,work,22,23,1
8629,6,home,23,24,1
8630,1,home,0,6,6
8630,2,shop,6,7,1
8630,3,home,7,10,3
8630,4,education,10,13,3
8630,5,shop,13,14,1
8630,6,home,14,21,7
8630,7,shop,21,22,1
8630,8,home,22,24,2
8631,1,home,0,6,6
8631,2,shop,6,7,1
8631,3,home,7,13,6
8631,4,work,13,19,6
8631,5,home,19,24,5
8632,1,home,0,8,8
8632,2,work,8,14,6
8632,3,home,14,24,10
8633,1,home,0,7,7
8633,2,work,7,14,7
8633,3,shop,14,15,1
8633,4,home,15,24,9
8634,1,home,0,6,6
8634,2,shop,6,7,1
8634,3,home,7,10,3
8634,4,work,10,17,7
8634,5,home,17,24,7
8635,1,home,0,6,6
8635,2,work,6,8,2
8635,3,home,8,9,1
8635,4,work,9,11,2
8635,5,home,11,16,5
8635,6,work,16,18,2
8635,7,home,18,24,6
8636,1,home,0,6,6
8636,2,work,6,7,1
8636,3,home,7,9,2
8636,4,work,9,11,2
8636,5,home,11,16,5
8636,6,work,16,18,2
8636,7,home,18,24,6
8637,1,home,0,6,6
8637,2,work,6,13,7
8637,3,shop,13,14,1
8637,4,work,14,19,5
8637,5,home,19,24,5
8638,1,home,0,6,6
8638,2,work,6,7,1
8638,3,home,7,13,6
8638,4,work,13,14,1
8638,5,home,14,22,8
8638,6,work,22,23,1
8638,7,home,23,24,1
8639,1,home,0,7,7
8639,2,education,7,11,4
8639,3,home,11,17,6
8639,4,shop,17,18,1
8639,5,home,18,24,6
8640,1,home,0,8,8
8640,2,work,8,15,7
8640,3,shop,15,16,1
8640,4,home,16,22,6
8640,5,work,22,23,1
8640,6,home,23,24,1
8641,1,home,0,8,8
8641,2,work,8,14,6
8641,3,shop,14,15,1
8641,4,home,15,24,9
8642,1,home,0,8,8
8642,2,education,8,11,3
8642,3,home,11,18,7
8642,4,shop,18,20,2
8642,5,home,20,24,4
8643,1,home,0,8,8
8643,2,work,8,14,6
8643,3,shop,14,15,1
8643,4,home,15,19,4
8643,5,shop,19,20,1
8643,6,home,20,24,4
8644,1,home,0,7,7
8644,2,work,7,14,7
8644,3,shop,14,15,1
8644,4,work,15,20,5
8644,5,home,20,24,4
8645,1,home,0,6,6
8645,2,work,6,13,7
8645,3,home,13,24,11
8646,1,home,0,8,8
8646,2,education,8,11,3
8646,3,home,11,18,7
8646,4,shop,18,19,1
8646,5,home,19,24,5
8647,1,home,0,7,7
8647,2,work,7,13,6
8647,3,shop,13,14,1
8647,4,work,14,20,6
8647,5,home,20,24,4
8648,1,home,0,6,6
8648,2,work,6,13,7
8648,3,shop,13,14,1
8648,4,home,14,21,7
8648,5,work,21,22,1
8648,6,home,22,24,2
8649,1,home,0,8,8
8649,2,work,8,16,8
8649,3,home,16,21,5
8649,4,work,21,22,1
8649,5,home,22,24,2
8650,1,home,0,8,8
8650,2,education,8,11,3
8650,3,home,11,14,3
8650,4,education,14,16,2
8650,5,home,16,24,8
8651,1,home,0,6,6
8651,2,work,6,8,2
8651,3,home,8,15,7
8651,4,work,15,17,2
8651,5,home,17,24,7
8652,1,home,0,6,6
8652,2,work,6,8,2
8652,3,home,8,9,1
8652,4,work,9,11,2
8652,5,home,11,15,4
8652,6,work,15,18,3
8652,7,home,18,21,3
8652,8,work,21,22,1
8652,9,home,22,24,2
8653,1,home,0,7,7
8653,2,education,7,11,4
8653,3,home,11,19,8
8653,4,shop,19,20,1
8653,5,home,20,24,4
8654,1,home,0,6,6
8654,2,work,6,12,6
8654,3,shop,12,13,1
8654,4,work,13,19,6
8654,5,education,19,20,1
8654,6,home,20,24,4
8655,1,home,0,7,7
8655,2,education,7,11,4
8655,3,home,11,17,6
8655,4,shop,17,19,2
8655,5,home,19,24,5
8656,1,home,0,7,7
8656,2,work,7,14,7
8656,3,home,14,24,10
8657,1,home,0,6,6
8657,2,work,6,8,2
8657,3,home,8,12,4
8657,4,work,12,14,2
8657,5,home,14,21,7
8657,6,work,21,22,1
8657,7,home,22,24,2
8658,1,home,0,7,7
8658,2,shop,7,8,1
8658,3,work,8,14,6
8658,4,home,14,21,7
8658,5,work,21,22,1
8658,6,home,22,24,2
8659,1,home,0,8,8
8659,2,education,8,13,5
8659,3,work,13,18,5
8659,4,home,18,24,6
8660,1,home,0,6,6
8660,2,work,6,13,7
8660,3,home,13,21,8
8660,4,work,21,22,1
8660,5,home,22,24,2
8661,1,home,0,6,6
8661,2,shop,6,7,1
8661,3,home,7,10,3
8661,4,education,10,13,3
8661,5,shop,13,15,2
8661,6,home,15,20,5
8661,7,shop,20,21,1
8661,8,home,21,24,3
8662,1,home,0,6,6
8662,2,work,6,8,2
8662,3,home,8,13,5
8662,4,work,13,15,2
8662,5,home,15,23,8
8662,6,work,23,24,1
8663,1,home,0,6,6
8663,2,work,6,13,7
8663,3,home,13,24,11
8664,1,home,0,7,7
8664,2,work,7,9,2
8664,3,home,9,13,4
8664,4,work,13,15,2
8664,5,home,15,21,6
8664,6,work,21,22,1
8664,7,home,22,24,2
8665,1,home,0,7,7
8665,2,work,7,13,6
8665,3,shop,13,14,1
8665,4,home,14,24,10
8666,1,home,0,7,7
8666,2,work,7,13,6
8666,3,home,13,16,3
8666,4,work,16,19,3
8666,5,home,19,24,5
8667,1,home,0,7,7
8667,2,work,7,13,6
8667,3,home,13,17,4
8667,4,shop,17,18,1
8667,5,home,18,24,6
8668,1,home,0,7,7
8668,2,education,7,11,4
8668,3,home,11,17,6
8668,4,shop,17,18,1
8668,5,home,18,24,6
8669,1,home,0,6,6
8669,2,work,6,8,2
8669,3,home,8,14,6
8669,4,work,14,17,3
8669,5,home,17,23,6
8669,6,work,23,24,1
8670,1,home,0,6,6
8670,2,work,6,13,7
8670,3,home,13,23,10
8670,4,work,23,24,1
8671,1,home,0,7,7
8671,2,education,7,11,4
8671,3,home,11,18,7
8671,4,shop,18,19,1
8671,5,home,19,24,5
8672,1,home,0,6,6
8672,2,work,6,8,2
8672,3,home,8,11,3
8672,4,work,11,13,2
8672,5,home,13,20,7
8672,6,shop,20,21,1
8672,7,home,21,24,3
8673,1,home,0,7,7
8673,2,work,7,14,7
8673,3,home,14,21,7
8673,4,work,21,22,1
8673,5,home,22,24,2
8674,1,home,0,7,7
8674,2,work,7,13,6
8674,3,shop,13,14,1
8674,4,home,14,19,5
8674,5,shop,19,20,1
8674,6,home,20,24,4
8675,1,home,0,7,7
8675,2,work,7,15,8
8675,3,shop,15,16,1
8675,4,home,16,23,7
8675,5,work,23,24,1
8676,1,home,0,6,6
8676,2,work,6,13,7
8676,3,shop,13,14,1
8676,4,work,14,19,5
8676,5,home,19,24,5
8677,1,home,0,6,6
8677,2,work,6,13,7
8677,3,home,13,16,3
8677,4,work,16,20,4
8677,5,home,20,24,4
8678,1,home,0,7,7
8678,2,work,7,13,6
8678,3,home,13,24,11
8679,1,home,0,7,7
8679,2,education,7,12,5
8679,3,shop,12,13,1
8679,4,education,13,16,3
8679,5,home,16,24,8
8680,1,home,0,7,7
8680,2,work,7,9,2
8680,3,home,9,12,3
8680,4,work,12,15,3
8680,5,shop,15,16,1
8680,6,home,16,21,5
8680,7,work,21,22,1
8680,8,home,22,24,2
8681,1,home,0,8,8
8681,2,work,8,15,7
8681,3,home,15,18,3
8681,4,work,18,20,2
8681,5,home,20,24,4
8682,1,home,0,8,8
8682,2,education,8,11,3
8682,3,home,11,17,6
8682,4,shop,17,18,1
8682,5,home,18,24,6
8683,1,home,0,7,7
8683,2,work,7,14,7
8683,3,home,14,23,9
8683,4,work,23,24,1
8684,1,home,0,6,6
8684,2,shop,6,7,1
8684,3,home,7,11,4
8684,4,work,11,19,8
8684,5,home,19,24,5
8685,1,home,0,6,6
8685,2,work,6,8,2
8685,3,home,8,9,1
8685,4,work,9,11,2
8685,5,home,11,15,4
8685,6,work,15,17,2
8685,7,home,17,23,6
8685,8,work,23,24,1
8686,1,home,0,8,8
8686,2,work,8,15,7
8686,3,home,15,21,6
8686,4,work,21,22,1
8686,5,home,22,24,2
8687,1,home,0,7,7
8687,2,work,7,14,7
8687,3,home,14,24,10
8688,1,home,0,7,7
8688,2,work,7,14,7
8688,3,shop,14,15,1
8688,4,home,15,20,5
8688,5,shop,20,21,1
8688,6,home,21,24,3
8689,1,home,0,7,7
8689,2,shop,7,8,1
8689,3,education,8,12,4
8689,4,shop,12,13,1
8689,5,education,13,16,3
8689,6,home,16,24,8
8690,1,home,0,6,6
8690,2,work,6,8,2
8690,3,home,8,14,6
8690,4,work,14,18,4
8690,5,home,18,24,6
8691,1,home,0,7,7
8691,2,work,7,8,1
8691,3,home,8,12,4
8691,4,work,12,15,3
8691,5,home,15,22,7
8691,6,work,22,23,1
8691,7,home,23,24,1
8692,1,home,0,6,6
8692,2,shop,6,7,1
8692,3,home,7,11,4
8692,4,education,11,16,5
8692,5,home,16,24,8
8693,1,home,0,8,8
8693,2,work,8,15,7
8693,3,shop,15,16,1
8693,4,home,16,21,5
8693,5,work,21,22,1
8693,6,home,22,24,2
8694,1,home,0,7,7
8694,2,work,7,14,7
8694,3,home,14,24,10
8695,1,home,0,6,6
8695,2,work,6,13,7
8695,3,shop,13,14,1
8695,4,work,14,20,6
8695,5,home,20,24,4
8696,1,home,0,8,8
8696,2,work,8,15,7
8696,3,home,15,24,9
8697,1,home,0,8,8
8697,2,work,8,15,7
8697,3,home,15,18,3
8697,4,shop,18,19,1
8697,5,home,19,24,5
8698,1,home,0,7,7
8698,2,education,7,11,4
8698,3,home,11,13,2
8698,4,education,13,15,2
8698,5,shop,15,17,2
8698,6,home,17,24,7
8699,1,home,0,6,6
8699,2,work,6,8,2
8699,3,home,8,9,1
8699,4,work,9,11,2
8699,5,home,11,15,4
8699,6,work,15,17,2
8699,7,home,17,24,7
8700,1,home,0,7,7
8700,2,work,7,13,6
8700,3,home,13,24,11
8701,1,home,0,7,7
8701,2,work,7,13,6
8701,3,home,13,24,11
8702,1,home,0,7,7
8702,2,work,7,13,6
8702,3,home,13,24,11
8703,1,home,0,6,6
8703,2,work,6,13,7
8703,3,shop,13,14,1
8703,4,home,14,21,7
8703,5,work,21,22,1
8703,6,home,22,24,2
8704,1,home,0,7,7
8704,2,work,7,13,6
8704,3,shop,13,14,1
8704,4,work,14,20,6
8704,5,home,20,24,4
8705,1,home,0,7,7
8705,2,work,7,13,6
8705,3,home,13,21,8
8705,4,work,21,22,1
8705,5,home,22,24,2
8706,1,home,0,6,6
8706,2,work,6,13,7
8706,3,home,13,17,4
8706,4,work,17,20,3
8706,5,home,20,24,4
8707,1,home,0,8,8
8707,2,work,8,15,7
8707,3,shop,15,17,2
8707,4,work,17,20,3
8707,5,home,20,24,4
8708,1,home,0,7,7
8708,2,work,7,13,6
8708,3,home,13,24,11
8709,1,home,0,6,6
8709,2,shop,6,7,1
8709,3,home,7,9,2
8709,4,education,9,12,3
8709,5,home,12,18,6
8709,6,shop,18,19,1
8709,7,home,19,24,5
8710,1,home,0,7,7
8710,2,shop,7,9,2
8710,3,education,9,12,3
8710,4,home,12,20,8
8710,5,shop,20,21,1
8710,6,home,21,24,3
8711,1,home,0,7,7
8711,2,work,7,9,2
8711,3,home,9,13,4
8711,4,work,13,15,2
8711,5,home,15,22,7
8711,6,work,22,23,1
8711,7,home,23,24,1
8712,1,home,0,8,8
8712,2,work,8,17,9
8712,3,home,17,23,6
8712,4,work,23,24,1
8713,1,home,0,6,6
8713,2,work,6,8,2
8713,3,home,8,12,4
8713,4,work,12,14,2
8713,5,home,14,21,7
8713,6,work,21,22,1
8713,7,home,22,24,2
8714,1,home,0,6,6
8714,2,work,6,13,7
8714,3,home,13,14,1
8714,4,work,14,18,4
8714,5,home,18,24,6
8715,1,work,0,9,9
8715,2,shop,9,10,1
8715,3,work,10,17,7
8715,4,home,17,24,7
8716,1,home,0,6,6
8716,2,shop,6,7,1
8716,3,home,7,10,3
8716,4,education,10,13,3
8716,5,shop,13,15,2
8716,6,home,15,21,6
8716,7,shop,21,22,1
8716,8,home,22,24,2
8717,1,home,0,8,8
8717,2,work,8,15,7
8717,3,shop,15,16,1
8717,4,work,16,20,4
8717,5,home,20,24,4
8718,1,home,0,6,6
8718,2,shop,6,7,1
8718,3,home,7,9,2
8718,4,education,9,11,2
8718,5,home,11,17,6
8718,6,shop,17,19,2
8718,7,home,19,24,5
8719,1,home,0,8,8
8719,2,work,8,15,7
8719,3,home,15,20,5
8719,4,shop,20,21,1
8719,5,home,21,24,3
8720,1,home,0,8,8
8720,2,work,8,15,7
8720,3,shop,15,16,1
8720,4,home,16,24,8
8721,1,home,0,7,7
8721,2,education,7,12,5
8721,3,home,12,19,7
8721,4,shop,19,21,2
8721,5,home,21,24,3
8722,1,home,0,7,7
8722,2,work,7,14,7
8722,3,home,14,18,4
8722,4,work,18,20,2
8722,5,home,20,24,4
8723,1,home,0,8,8
8723,2,work,8,14,6
8723,3,shop,14,15,1
8723,4,home,15,24,9
8724,1,home,0,9,9
8724,2,work,9,17,8
8724,3,home,17,22,5
8724,4,work,22,23,1
8724,5,home,23,24,1
8725,1,home,0,8,8
8725,2,work,8,14,6
8725,3,shop,14,15,1
8725,4,home,15,24,9
8726,1,home,0,6,6
8726,2,shop,6,7,1
8726,3,work,7,14,7
8726,4,home,14,18,4
8726,5,work,18,20,2
8726,6,home,20,24,4
8727,1,home,0,7,7
8727,2,education,7,12,5
8727,3,home,12,19,7
8727,4,shop,19,20,1
8727,5,home,20,24,4
8728,1,home,0,6,6
8728,2,work,6,13,7
8728,3,home,13,22,9
8728,4,work,22,23,1
8728,5,home,23,24,1
8729,1,home,0,6,6
8729,2,work,6,14,8
8729,3,home,14,24,10
8730,1,home,0,8,8
8730,2,work,8,15,7
8730,3,home,15,24,9
8731,1,home,0,7,7
8731,2,work,7,14,7
8731,3,home,14,22,8
8731,4,work,22,23,1
8731,5,home,23,24,1
8732,1,home,0,7,7
8732,2,education,7,12,5
8732,3,shop,12,14,2
8732,4,education,14,16,2
8732,5,home,16,24,8
8733,1,home,0,7,7
8733,2,education,7,11,4
8733,3,home,11,14,3
8733,4,education,14,16,2
8733,5,shop,16,18,2
8733,6,home,18,24,6
8734,1,home,0,6,6
8734,2,work,6,8,2
8734,3,home,8,9,1
8734,4,work,9,11,2
8734,5,home,11,17,6
8734,6,work,17,19,2
8734,7,home,19,24,5
8735,1,home,0,7,7
8735,2,work,7,14,7
8735,3,home,14,24,10
8736,1,home,0,7,7
8736,2,work,7,14,7
8736,3,shop,14,15,1
8736,4,work,15,20,5
8736,5,home,20,24,4
8737,1,home,0,8,8
8737,2,work,8,15,7
8737,3,home,15,24,9
8738,1,home,0,7,7
8738,2,work,7,13,6
8738,3,shop,13,14,1
8738,4,home,14,16,2
8738,5,work,16,20,4
8738,6,home,20,24,4
8739,1,home,0,8,8
8739,2,work,8,14,6
8739,3,home,14,18,4
8739,4,shop,18,19,1
8739,5,home,19,24,5
8740,1,home,0,8,8
8740,2,work,8,16,8
8740,3,home,16,24,8
8741,1,home,0,6,6
8741,2,shop,6,7,1
8741,3,home,7,9,2
8741,4,education,9,12,3
8741,5,shop,12,14,2
8741,6,education,14,16,2
8741,7,home,16,24,8
8742,1,home,0,8,8
8742,2,work,8,14,6
8742,3,home,14,24,10
8743,1,home,0,8,8
8743,2,education,8,12,4
8743,3,home,12,16,4
8743,4,work,16,20,4
8743,5,home,20,24,4
8744,1,home,0,8,8
8744,2,work,8,15,7
8744,3,home,15,24,9
8745,1,home,0,8,8
8745,2,education,8,12,4
8745,3,shop,12,13,1
8745,4,education,13,15,2
8745,5,shop,15,16,1
8745,6,home,16,24,8
8746,1,home,0,8,8
8746,2,work,8,15,7
8746,3,home,15,21,6
8746,4,shop,21,22,1
8746,5,home,22,24,2
8747,1,home,0,6,6
8747,2,shop,6,7,1
8747,3,home,7,10,3
8747,4,education,10,14,4
8747,5,shop,14,16,2
8747,6,home,16,24,8
8748,1,home,0,6,6
8748,2,work,6,13,7
8748,3,home,13,23,10
8748,4,work,23,24,1
8749,1,home,0,8,8
8749,2,work,8,15,7
8749,3,home,15,24,9
8750,1,home,0,8,8
8750,2,work,8,17,9
8750,3,home,17,22,5
8750,4,work,22,23,1
8750,5,home,23,24,1
8751,1,home,0,6,6
8751,2,work,6,13,7
8751,3,home,13,22,9
8751,4,work,22,23,1
8751,5,home,23,24,1
8752,1,home,0,9,9
8752,2,education,9,12,3
8752,3,home,12,22,10
8752,4,work,22,23,1
8752,5,home,23,24,1
8753,1,home,0,8,8
8753,2,work,8,15,7
8753,3,home,15,22,7
8753,4,work,22,23,1
8753,5,home,23,24,1
8754,1,home,0,6,6
8754,2,work,6,7,1
8754,3,home,7,9,2
8754,4,work,9,10,1
8754,5,home,10,16,6
8754,6,work,16,18,2
8754,7,home,18,24,6
8755,1,home,0,6,6
8755,2,work,6,8,2
8755,3,home,8,14,6
8755,4,work,14,17,3
8755,5,home,17,23,6
8755,6,work,23,24,1
8756,1,home,0,6,6
8756,2,shop,6,7,1
8756,3,home,7,12,5
8756,4,education,12,16,4
8756,5,home,16,24,8
8757,1,home,0,8,8
8757,2,work,8,13,5
8757,3,shop,13,14,1
8757,4,work,14,19,5
8757,5,home,19,23,4
8757,6,work,23,24,1
8758,1,home,0,7,7
8758,2,shop,7,8,1
8758,3,education,8,11,3
8758,4,home,11,18,7
8758,5,shop,18,19,1
8758,6,home,19,24,5
8759,1,home,0,6,6
8759,2,shop,6,7,1
8759,3,home,7,9,2
8759,4,education,9,11,2
8759,5,home,11,19,8
8759,6,shop,19,20,1
8759,7,home,20,24,4
8760,1,home,0,7,7
8760,2,work,7,14,7
8760,3,shop,14,15,1
8760,4,home,15,24,9
8761,1,home,0,6,6
8761,2,work,6,13,7
8761,3,home,13,22,9
8761,4,work,22,23,1
8761,5,home,23,24,1
8762,1,home,0,7,7
8762,2,work,7,14,7
8762,3,home,14,24,10
8763,1,home,0,8,8
8763,2,work,8,14,6
8763,3,shop,14,15,1
8763,4,work,15,20,5
8763,5,home,20,24,4
8764,1,home,0,8,8
8764,2,education,8,11,3
8764,3,home,11,20,9
8764,4,shop,20,21,1
8764,5,home,21,24,3
8765,1,home,0,8,8
8765,2,work,8,15,7
8765,3,home,15,22,7
8765,4,work,22,23,1
8765,5,home,23,24,1
8766,1,home,0,8,8
8766,2,work,8,15,7
8766,3,home,15,24,9
8767,1,work,0,8,8
8767,2,shop,8,9,1
8767,3,work,9,15,6
8767,4,shop,15,16,1
8767,5,home,16,24,8
8768,1,home,0,8,8
8768,2,work,8,15,7
8768,3,shop,15,16,1
8768,4,work,16,20,4
8768,5,home,20,24,4
8769,1,home,0,7,7
8769,2,work,7,13,6
8769,3,shop,13,14,1
8769,4,work,14,20,6
8769,5,home,20,24,4
8770,1,home,0,7,7
8770,2,education,7,11,4
8770,3,home,11,18,7
8770,4,shop,18,19,1
8770,5,home,19,24,5
8771,1,home,0,6,6
8771,2,work,6,13,7
8771,3,home,13,24,11
8772,1,home,0,7,7
8772,2,work,7,14,7
8772,3,home,14,18,4
8772,4,work,18,20,2
8772,5,home,20,24,4
8773,1,home,0,6,6
8773,2,work,6,13,7
8773,3,home,13,19,6
8773,4,shop,19,20,1
8773,5,home,20,24,4
8774,1,home,0,7,7
8774,2,work,7,9,2
8774,3,home,9,13,4
8774,4,work,13,16,3
8774,5,home,16,22,6
8774,6,work,22,23,1
8774,7,home,23,24,1
8775,1,home,0,7,7
8775,2,work,7,14,7
8775,3,shop,14,15,1
8775,4,work,15,19,4
8775,5,home,19,24,5
8776,1,home,0,7,7
8776,2,work,7,9,2
8776,3,home,9,13,4
8776,4,work,13,15,2
8776,5,home,15,21,6
8776,6,work,21,22,1
8776,7,home,22,24,2
8777,1,home,0,8,8
8777,2,work,8,14,6
8777,3,home,14,24,10
8778,1,home,0,6,6
8778,2,work,6,13,7
8778,3,home,13,18,5
8778,4,work,18,20,2
8778,5,home,20,24,4
8779,1,home,0,8,8
8779,2,shop,8,9,1
8779,3,home,9,13,4
8779,4,education,13,17,4
8779,5,home,17,24,7
8780,1,home,0,6,6
8780,2,work,6,13,7
8780,3,shop,13,14,1
8780,4,home,14,24,10
8781,1,home,0,6,6
8781,2,shop,6,7,1
8781,3,work,7,13,6
8781,4,home,13,17,4
8781,5,work,17,19,2
8781,6,home,19,24,5
8782,1,home,0,7,7
8782,2,work,7,13,6
8782,3,shop,13,14,1
8782,4,work,14,19,5
8782,5,home,19,24,5
8783,1,home,0,6,6
8783,2,work,6,8,2
8783,3,home,8,11,3
8783,4,work,11,13,2
8783,5,home,13,16,3
8783,6,work,16,19,3
8783,7,home,19,24,5
8784,1,home,0,8,8
8784,2,shop,8,9,1
8784,3,work,9,17,8
8784,4,home,17,24,7
8785,1,home,0,8,8
8785,2,work,8,14,6
8785,3,shop,14,15,1
8785,4,home,15,21,6
8785,5,shop,21,22,1
8785,6,home,22,24,2
8786,1,home,0,6,6
8786,2,work,6,8,2
8786,3,home,8,13,5
8786,4,work,13,15,2
8786,5,home,15,23,8
8786,6,work,23,24,1
8787,1,home,0,6,6
8787,2,work,6,13,7
8787,3,shop,13,14,1
8787,4,education,14,17,3
8787,5,home,17,23,6
8787,6,work,23,24,1
8788,1,home,0,6,6
8788,2,shop,6,8,2
8788,3,home,8,12,4
8788,4,education,12,14,2
8788,5,work,14,19,5
8788,6,home,19,24,5
8789,1,home,0,7,7
8789,2,shop,7,9,2
8789,3,education,9,12,3
8789,4,home,12,19,7
8789,5,shop,19,20,1
8789,6,home,20,24,4
8790,1,home,0,8,8
8790,2,work,8,15,7
8790,3,home,15,24,9
8791,1,home,0,8,8
8791,2,education,8,12,4
8791,3,work,12,19,7
8791,4,home,19,24,5
8792,1,home,0,6,6
8792,2,work,6,8,2
8792,3,home,8,13,5
8792,4,work,13,15,2
8792,5,home,15,21,6
8792,6,shop,21,22,1
8792,7,home,22,24,2
8793,1,home,0,6,6
8793,2,shop,6,7,1
8793,3,home,7,10,3
8793,4,education,10,13,3
8793,5,shop,13,15,2
8793,6,home,15,24,9
8794,1,home,0,7,7
8794,2,work,7,13,6
8794,3,home,13,24,11
8795,1,home,0,6,6
8795,2,shop,6,7,1
8795,3,home,7,13,6
8795,4,education,13,16,3
8795,5,home,16,24,8
8796,1,home,0,8,8
8796,2,work,8,15,7
8796,3,shop,15,16,1
8796,4,work,16,20,4
8796,5,home,20,24,4
8797,1,home,0,7,7
8797,2,work,7,14,7
8797,3,home,14,23,9
8797,4,work,23,24,1
8798,1,home,0,7,7
8798,2,work,7,14,7
8798,3,home,14,21,7
8798,4,work,21,22,1
8798,5,home,22,24,2
8799,1,home,0,6,6
8799,2,work,6,13,7
8799,3,shop,13,14,1
8799,4,home,14,24,10
8800,1,home,0,8,8
8800,2,work,8,15,7
8800,3,home,15,24,9
8801,1,home,0,7,7
8801,2,work,7,13,6
8801,3,shop,13,14,1
8801,4,home,14,24,10
8802,1,home,0,7,7
8802,2,work,7,14,7
8802,3,home,14,19,5
8802,4,shop,19,20,1
8802,5,home,20,24,4
8803,1,home,0,7,7
8803,2,work,7,14,7
8803,3,home,14,18,4
8803,4,shop,18,19,1
8803,5,home,19,24,5
8804,1,home,0,7,7
8804,2,education,7,11,4
8804,3,home,11,19,8
8804,4,shop,19,20,1
8804,5,home,20,24,4
8805,1,home,0,7,7
8805,2,education,7,13,6
8805,3,shop,13,15,2
8805,4,home,15,24,9
8806,1,home,0,7,7
8806,2,work,7,14,7
8806,3,shop,14,15,1
8806,4,work,15,20,5
8806,5,home,20,24,4
8807,1,home,0,7,7
8807,2,work,7,13,6
8807,3,shop,13,14,1
8807,4,home,14,24,10
8808,1,home,0,6,6
8808,2,shop,6,7,1
8808,3,work,7,13,6
8808,4,home,13,24,11
8809,1,home,0,6,6
8809,2,work,6,13,7
8809,3,home,13,17,4
8809,4,work,17,20,3
8809,5,home,20,24,4
8810,1,home,0,7,7
8810,2,education,7,11,4
8810,3,home,11,17,6
8810,4,shop,17,18,1
8810,5,home,18,24,6
8811,1,home,0,8,8
8811,2,education,8,11,3
8811,3,home,11,14,3
8811,4,work,14,20,6
8811,5,home,20,24,4
8812,1,home,0,6,6
8812,2,shop,6,7,1
8812,3,home,7,10,3
8812,4,education,10,12,2
8812,5,home,12,18,6
8812,6,shop,18,20,2
8812,7,home,20,24,4
8813,1,home,0,6,6
8813,2,work,6,13,7
8813,3,shop,13,14,1
8813,4,home,14,24,10
8814,1,home,0,7,7
8814,2,shop,7,8,1
8814,3,education,8,11,3
8814,4,home,11,19,8
8814,5,shop,19,20,1
8814,6,home,20,24,4
8815,1,home,0,7,7
8815,2,work,7,14,7
8815,3,shop,14,15,1
8815,4,home,15,24,9
8816,1,home,0,8,8
8816,2,work,8,13,5
8816,3,shop,13,14,1
8816,4,work,14,19,5
8816,5,home,19,24,5
8817,1,home,0,8,8
8817,2,work,8,15,7
8817,3,home,15,24,9
8818,1,home,0,7,7
8818,2,education,7,12,5
8818,3,shop,12,14,2
8818,4,education,14,16,2
8818,5,home,16,24,8
8819,1,home,0,9,9
8819,2,work,9,16,7
8819,3,shop,16,17,1
8819,4,work,17,20,3
8819,5,home,20,24,4
8820,1,home,0,6,6
8820,2,shop,6,7,1
8820,3,home,7,10,3
8820,4,education,10,13,3
8820,5,home,13,20,7
8820,6,shop,20,21,1
8820,7,home,21,24,3
8821,1,home,0,8,8
8821,2,education,8,12,4
8821,3,home,12,18,6
8821,4,shop,18,19,1
8821,5,home,19,24,5
8822,1,home,0,8,8
8822,2,work,8,16,8
8822,3,home,16,22,6
8822,4,work,22,23,1
8822,5,home,23,24,1
8823,1,home,0,7,7
8823,2,work,7,13,6
8823,3,home,13,18,5
8823,4,work,18,20,2
8823,5,home,20,24,4
8824,1,home,0,6,6
8824,2,work,6,8,2
8824,3,home,8,15,7
8824,4,work,15,17,2
8824,5,home,17,21,4
8824,6,work,21,22,1
8824,7,home,22,24,2
8825,1,home,0,7,7
8825,2,work,7,14,7
8825,3,shop,14,15,1
8825,4,home,15,22,7
8825,5,work,22,23,1
8825,6,home,23,24,1
8826,1,home,0,8,8
8826,2,work,8,16,8
8826,3,home,16,21,5
8826,4,work,21,22,1
8826,5,home,22,24,2
8827,1,home,0,8,8
8827,2,work,8,15,7
8827,3,home,15,24,9
8828,1,home,0,8,8
8828,2,work,8,14,6
8828,3,shop,14,15,1
8828,4,home,15,24,9
8829,1,home,0,6,6
8829,2,shop,6,7,1
8829,3,work,7,13,6
8829,4,home,13,24,11
8830,1,home,0,6,6
8830,2,shop,6,7,1
8830,3,work,7,14,7
8830,4,home,14,24,10
8831,1,home,0,6,6
8831,2,shop,6,7,1
8831,3,home,7,10,3
8831,4,education,10,11,1
8831,5,home,11,18,7
8831,6,shop,18,19,1
8831,7,home,19,24,5
8832,1,home,0,7,7
8832,2,work,7,14,7
8832,3,home,14,24,10
8833,1,home,0,8,8
8833,2,shop,8,9,1
8833,3,home,9,10,1
8833,4,work,10,17,7
8833,5,home,17,22,5
8833,6,work,22,23,1
8833,7,home,23,24,1
8834,1,home,0,8,8
8834,2,work,8,15,7
8834,3,shop,15,16,1
8834,4,home,16,22,6
8834,5,work,22,23,1
8834,6,home,23,24,1
8835,1,home,0,6,6
8835,2,work,6,8,2
8835,3,home,8,12,4
8835,4,work,12,14,2
8835,5,home,14,17,3
8835,6,work,17,19,2
8835,7,home,19,23,4
8835,8,work,23,24,1
8836,1,home,0,7,7
8836,2,work,7,13,6
8836,3,shop,13,14,1
8836,4,home,14,24,10
8837,1,home,0,7,7
8837,2,work,7,13,6
8837,3,shop,13,14,1
8837,4,home,14,24,10
8838,1,home,0,7,7
8838,2,education,7,11,4
8838,3,home,11,14,3
8838,4,education,14,17,3
8838,5,home,17,24,7
8839,1,home,0,8,8
8839,2,work,8,15,7
8839,3,home,15,24,9
8840,1,home,0,8,8
8840,2,work,8,14,6
8840,3,home,14,21,7
8840,4,work,21,22,1
8840,5,home,22,24,2
8841,1,home,0,7,7
8841,2,work,7,13,6
8841,3,shop,13,14,1
8841,4,home,14,24,10
8842,1,home,0,7,7
8842,2,education,7,11,4
8842,3,home,11,19,8
8842,4,shop,19,20,1
8842,5,home,20,24,4
8843,1,home,0,6,6
8843,2,work,6,13,7
8843,3,home,13,23,10
8843,4,work,23,24,1
8844,1,home,0,8,8
8844,2,work,8,15,7
8844,3,home,15,24,9
8845,1,home,0,7,7
8845,2,education,7,12,5
8845,3,home,12,19,7
8845,4,shop,19,20,1
8845,5,home,20,24,4
8846,1,home,0,6,6
8846,2,work,6,8,2
8846,3,home,8,13,5
8846,4,work,13,15,2
8846,5,home,15,21,6
8846,6,work,21,22,1
8846,7,home,22,24,2
8847,1,home,0,7,7
8847,2,education,7,11,4
8847,3,home,11,15,4
8847,4,shop,15,16,1
8847,5,home,16,24,8
8848,1,home,0,8,8
8848,2,education,8,12,4
8848,3,home,12,18,6
8848,4,shop,18,19,1
8848,5,home,19,24,5
8849,1,home,0,6,6
8849,2,work,6,13,7
8849,3,home,13,17,4
8849,4,shop,17,19,2
8849,5,home,19,24,5
8850,1,home,0,8,8
8850,2,work,8,15,7
8850,3,home,15,24,9
8851,1,home,0,7,7
8851,2,education,7,11,4
8851,3,home,11,14,3
8851,4,education,14,16,2
8851,5,home,16,24,8
8852,1,home,0,8,8
8852,2,work,8,15,7
8852,3,home,15,24,9
8853,1,home,0,6,6
8853,2,work,6,8,2
8853,3,home,8,14,6
8853,4,work,14,15,1
8853,5,home,15,22,7
8853,6,work,22,23,1
8853,7,home,23,24,1
8854,1,home,0,7,7
8854,2,work,7,8,1
8854,3,home,8,12,4
8854,4,work,12,14,2
8854,5,home,14,21,7
8854,6,work,21,22,1
8854,7,home,22,24,2
8855,1,home,0,8,8
8855,2,work,8,15,7
8855,3,home,15,19,4
8855,4,shop,19,20,1
8855,5,home,20,24,4
8856,1,home,0,6,6
8856,2,shop,6,7,1
8856,3,work,7,13,6
8856,4,home,13,16,3
8856,5,work,16,19,3
8856,6,education,19,20,1
8856,7,home,20,24,4
8857,1,home,0,6,6
8857,2,work,6,13,7
8857,3,home,13,24,11
8858,1,home,0,8,8
8858,2,work,8,15,7
8858,3,home,15,24,9
8859,1,home,0,7,7
8859,2,work,7,13,6
8859,3,shop,13,14,1
8859,4,home,14,24,10
8860,1,home,0,7,7
8860,2,work,7,13,6
8860,3,shop,13,14,1
8860,4,home,14,24,10
8861,1,home,0,9,9
8861,2,work,9,17,8
8861,3,home,17,24,7
8862,1,home,0,6,6
8862,2,work,6,8,2
8862,3,home,8,12,4
8862,4,work,12,14,2
8862,5,home,14,18,4
8862,6,work,18,19,1
8862,7,home,19,23,4
8862,8,work,23,24,1
8863,1,home,0,8,8
8863,2,education,8,11,3
8863,3,home,11,18,7
8863,4,shop,18,19,1
8863,5,home,19,24,5
8864,1,home,0,7,7
8864,2,shop,7,8,1
8864,3,home,8,13,5
8864,4,education,13,16,3
8864,5,home,16,24,8
8865,1,home,0,7,7
8865,2,work,7,14,7
8865,3,home,14,24,10
8866,1,home,0,8,8
8866,2,shop,8,9,1
8866,3,work,9,16,7
8866,4,home,16,24,8
8867,1,home,0,6,6
8867,2,work,6,9,3
8867,3,home,9,13,4
8867,4,work,13,15,2
8867,5,home,15,21,6
8867,6,work,21,22,1
8867,7,home,22,24,2
8868,1,home,0,7,7
8868,2,shop,7,8,1
8868,3,education,8,12,4
8868,4,home,12,18,6
8868,5,shop,18,19,1
8868,6,home,19,24,5
8869,1,home,0,7,7
8869,2,education,7,12,5
8869,3,shop,12,14,2
8869,4,education,14,16,2
8869,5,home,16,24,8
8870,1,home,0,8,8
8870,2,work,8,15,7
8870,3,home,15,21,6
8870,4,work,21,22,1
8870,5,home,22,24,2
8871,1,home,0,7,7
8871,2,work,7,14,7
8871,3,shop,14,15,1
8871,4,home,15,24,9
8872,1,home,0,7,7
8872,2,work,7,14,7
8872,3,home,14,24,10
8873,1,home,0,6,6
8873,2,work,6,13,7
8873,3,shop,13,14,1
8873,4,work,14,19,5
8873,5,home,19,24,5
8874,1,home,0,7,7
8874,2,shop,7,8,1
8874,3,work,8,14,6
8874,4,home,14,24,10
8875,1,home,0,6,6
8875,2,shop,6,7,1
8875,3,work,7,14,7
8875,4,home,14,24,10
8876,1,home,0,6,6
8876,2,work,6,13,7
8876,3,home,13,18,5
8876,4,work,18,20,2
8876,5,home,20,24,4
8877,1,home,0,8,8
8877,2,work,8,15,7
8877,3,home,15,24,9
8878,1,home,0,7,7
8878,2,work,7,14,7
8878,3,home,14,24,10
8879,1,home,0,7,7
8879,2,shop,7,9,2
8879,3,education,9,11,2
8879,4,home,11,20,9
8879,5,shop,20,21,1
8879,6,home,21,24,3
8880,1,home,0,7,7
8880,2,work,7,13,6
8880,3,shop,13,14,1
8880,4,work,14,19,5
8880,5,education,19,20,1
8880,6,home,20,24,4
8881,1,home,0,7,7
8881,2,work,7,14,7
8881,3,home,14,21,7
8881,4,shop,21,22,1
8881,5,home,22,24,2
8882,1,home,0,8,8
8882,2,education,8,14,6
8882,3,shop,14,15,1
8882,4,work,15,20,5
8882,5,home,20,24,4
8883,1,home,0,6,6
8883,2,shop,6,7,1
8883,3,home,7,8,1
8883,4,education,8,12,4
8883,5,home,12,16,4
8883,6,work,16,20,4
8883,7,home,20,23,3
8883,8,work,23,24,1
8884,1,home,0,7,7
8884,2,work,7,13,6
8884,3,home,13,24,11
8885,1,home,0,8,8
8885,2,work,8,13,5
8885,3,home,13,18,5
8885,4,shop,18,19,1
8885,5,home,19,24,5
8886,1,home,0,8,8
8886,2,education,8,11,3
8886,3,home,11,17,6
8886,4,shop,17,18,1
8886,5,home,18,24,6
8887,1,home,0,7,7
8887,2,shop,7,8,1
8887,3,education,8,11,3
8887,4,home,11,19,8
8887,5,shop,19,21,2
8887,6,home,21,24,3
8888,1,home,0,8,8
8888,2,work,8,15,7
8888,3,home,15,24,9
8889,1,home,0,7,7
8889,2,work,7,14,7
8889,3,shop,14,15,1
8889,4,home,15,24,9
8890,1,home,0,8,8
8890,2,education,8,12,4
8890,3,home,12,20,8
8890,4,shop,20,21,1
8890,5,home,21,24,3
8891,1,home,0,9,9
8891,2,work,9,16,7
8891,3,home,16,24,8
8892,1,home,0,7,7
8892,2,education,7,11,4
8892,3,home,11,18,7
8892,4,shop,18,19,1
8892,5,home,19,24,5
8893,1,home,0,6,6
8893,2,work,6,13,7
8893,3,home,13,24,11
8894,1,home,0,6,6
8894,2,work,6,13,7
8894,3,shop,13,14,1
8894,4,home,14,21,7
8894,5,work,21,22,1
8894,6,home,22,24,2
8895,1,home,0,7,7
8895,2,work,7,14,7
8895,3,home,14,24,10
8896,1,home,0,8,8
8896,2,education,8,12,4
8896,3,work,12,18,6
8896,4,home,18,23,5
8896,5,work,23,24,1
8897,1,home,0,6,6
8897,2,work,6,13,7
8897,3,home,13,17,4
8897,4,work,17,20,3
8897,5,home,20,24,4
8898,1,home,0,6,6
8898,2,work,6,8,2
8898,3,home,8,12,4
8898,4,work,12,14,2
8898,5,home,14,18,4
8898,6,work,18,20,2
8898,7,home,20,24,4
8899,1,home,0,6,6
8899,2,work,6,13,7
8899,3,shop,13,14,1
8899,4,work,14,19,5
8899,5,home,19,24,5
8900,1,home,0,9,9
8900,2,education,9,12,3
8900,3,work,12,18,6
8900,4,home,18,24,6
8901,1,home,0,7,7
8901,2,work,7,13,6
8901,3,home,13,17,4
8901,4,work,17,19,2
8901,5,home,19,24,5
8902,1,home,0,6,6
8902,2,shop,6,7,1
8902,3,home,7,10,3
8902,4,education,10,13,3
8902,5,home,13,20,7
8902,6,shop,20,21,1
8902,7,home,21,24,3
8903,1,home,0,6,6
8903,2,shop,6,7,1
8903,3,home,7,13,6
8903,4,education,13,16,3
8903,5,home,16,24,8
8904,1,home,0,7,7
8904,2,work,7,9,2
8904,3,home,9,16,7
8904,4,work,16,18,2
8904,5,home,18,24,6
8905,1,home,0,7,7
8905,2,work,7,14,7
8905,3,shop,14,15,1
8905,4,work,15,20,5
8905,5,home,20,24,4
8906,1,home,0,6,6
8906,2,work,6,13,7
8906,3,home,13,17,4
8906,4,work,17,19,2
8906,5,home,19,24,5
8907,1,home,0,7,7
8907,2,work,7,13,6
8907,3,shop,13,14,1
8907,4,work,14,19,5
8907,5,home,19,23,4
8907,6,work,23,24,1
8908,1,home,0,8,8
8908,2,work,8,14,6
8908,3,home,14,24,10
8909,1,home,0,6,6
8909,2,work,6,8,2
8909,3,home,8,15,7
8909,4,work,15,17,2
8909,5,home,17,24,7
8910,1,home,0,6,6
8910,2,work,6,8,2
8910,3,home,8,9,1
8910,4,work,9,11,2
8910,5,home,11,17,6
8910,6,work,17,19,2
8910,7,home,19,24,5
8911,1,home,0,8,8
8911,2,shop,8,9,1
8911,3,work,9,16,7
8911,4,home,16,24,8
8912,1,home,0,7,7
8912,2,work,7,9,2
8912,3,home,9,13,4
8912,4,work,13,16,3
8912,5,home,16,22,6
8912,6,work,22,23,1
8912,7,home,23,24,1
8913,1,home,0,6,6
8913,2,shop,6,7,1
8913,3,home,7,9,2
8913,4,work,9,17,8
8913,5,home,17,21,4
8913,6,shop,21,22,1
8913,7,home,22,24,2
8914,1,home,0,7,7
8914,2,work,7,13,6
8914,3,shop,13,14,1
8914,4,work,14,19,5
8914,5,home,19,24,5
8915,1,home,0,6,6
8915,2,work,6,8,2
8915,3,home,8,9,1
8915,4,work,9,11,2
8915,5,home,11,14,3
8915,6,work,14,16,2
8915,7,home,16,23,7
8915,8,work,23,24,1
8916,1,home,0,8,8
8916,2,work,8,15,7
8916,3,home,15,24,9
8917,1,home,0,6,6
8917,2,work,6,8,2
8917,3,home,8,14,6
8917,4,education,14,16,2
8917,5,home,16,23,7
8917,6,work,23,24,1
8918,1,home,0,7,7
8918,2,work,7,15,8
8918,3,home,15,24,9
8919,1,home,0,6,6
8919,2,work,6,8,2
8919,3,home,8,9,1
8919,4,work,9,11,2
8919,5,home,11,14,3
8919,6,work,14,16,2
8919,7,home,16,22,6
8919,8,work,22,23,1
8919,9,home,23,24,1
8920,1,home,0,7,7
8920,2,work,7,14,7
8920,3,home,14,24,10
8921,1,home,0,8,8
8921,2,shop,8,9,1
8921,3,home,9,14,5
8921,4,shop,14,15,1
8921,5,work,15,20,5
8921,6,home,20,24,4
8922,1,home,0,7,7
8922,2,education,7,11,4
8922,3,home,11,20,9
8922,4,shop,20,21,1
8922,5,home,21,24,3
8923,1,home,0,7,7
8923,2,shop,7,8,1
8923,3,work,8,15,7
8923,4,home,15,24,9
8924,1,home,0,7,7
8924,2,work,7,13,6
8924,3,home,13,24,11
8925,1,home,0,8,8
8925,2,work,8,15,7
8925,3,home,15,23,8
8925,4,work,23,24,1
8926,1,home,0,7,7
8926,2,work,7,13,6
8926,3,shop,13,14,1
8926,4,home,14,21,7
8926,5,shop,21,22,1
8926,6,home,22,24,2
8927,1,home,0,9,9
8927,2,work,9,15,6
8927,3,home,15,24,9
8928,1,home,0,7,7
8928,2,work,7,13,6
8928,3,home,13,17,4
8928,4,work,17,20,3
8928,5,home,20,24,4
8929,1,home,0,7,7
8929,2,work,7,14,7
8929,3,shop,14,15,1
8929,4,work,15,20,5
8929,5,home,20,24,4
8930,1,home,0,7,7
8930,2,work,7,9,2
8930,3,home,9,13,4
8930,4,work,13,15,2
8930,5,home,15,23,8
8930,6,work,23,24,1
8931,1,home,0,7,7
8931,2,shop,7,8,1
8931,3,home,8,14,6
8931,4,work,14,20,6
8931,5,home,20,24,4
8932,1,home,0,8,8
8932,2,education,8,11,3
8932,3,home,11,19,8
8932,4,shop,19,20,1
8932,5,home,20,24,4
8933,1,home,0,7,7
8933,2,work,7,15,8
8933,3,home,15,24,9
8934,1,home,0,6,6
8934,2,work,6,8,2
8934,3,home,8,9,1
8934,4,work,9,11,2
8934,5,home,11,18,7
8934,6,shop,18,19,1
8934,7,home,19,23,4
8934,8,work,23,24,1
8935,1,home,0,7,7
8935,2,shop,7,8,1
8935,3,education,8,11,3
8935,4,home,11,19,8
8935,5,shop,19,21,2
8935,6,home,21,24,3
8936,1,home,0,7,7
8936,2,work,7,13,6
8936,3,shop,13,14,1
8936,4,home,14,23,9
8936,5,work,23,24,1
8937,1,home,0,7,7
8937,2,shop,7,8,1
8937,3,education,8,11,3
8937,4,home,11,17,6
8937,5,shop,17,18,1
8937,6,home,18,24,6
8938,1,home,0,6,6
8938,2,work,6,13,7
8938,3,home,13,24,11
8939,1,home,0,7,7
8939,2,education,7,11,4
8939,3,home,11,20,9
8939,4,shop,20,21,1
8939,5,home,21,24,3
8940,1,home,0,6,6
8940,2,work,6,13,7
8940,3,shop,13,14,1
8940,4,work,14,19,5
8940,5,home,19,24,5
8941,1,home,0,7,7
8941,2,work,7,14,7
8941,3,shop,14,15,1
8941,4,home,15,20,5
8941,5,shop,20,21,1
8941,6,home,21,24,3
8942,1,home,0,8,8
8942,2,work,8,15,7
8942,3,home,15,20,5
8942,4,shop,20,21,1
8942,5,home,21,24,3
8943,1,home,0,7,7
8943,2,work,7,14,7
8943,3,shop,14,15,1
8943,4,home,15,21,6
8943,5,work,21,22,1
8943,6,home,22,24,2
8944,1,home,0,7,7
8944,2,work,7,14,7
8944,3,shop,14,15,1
8944,4,work,15,16,1
8944,5,home,16,24,8
8945,1,home,0,7,7
8945,2,work,7,9,2
8945,3,home,9,16,7
8945,4,work,16,18,2
8945,5,home,18,22,4
8945,6,work,22,23,1
8945,7,home,23,24,1
8946,1,home,0,6,6
8946,2,work,6,13,7
8946,3,home,13,16,3
8946,4,work,16,20,4
8946,5,home,20,24,4
8947,1,home,0,7,7
8947,2,work,7,14,7
8947,3,home,14,18,4
8947,4,work,18,19,1
8947,5,home,19,24,5
8948,1,home,0,6,6
8948,2,work,6,7,1
8948,3,home,7,13,6
8948,4,work,13,14,1
8948,5,home,14,21,7
8948,6,work,21,22,1
8948,7,home,22,24,2
8949,1,home,0,7,7
8949,2,education,7,11,4
8949,3,home,11,14,3
8949,4,education,14,17,3
8949,5,shop,17,19,2
8949,6,home,19,24,5
8950,1,home,0,7,7
8950,2,work,7,14,7
8950,3,home,14,21,7
8950,4,work,21,22,1
8950,5,home,22,24,2
8951,1,home,0,8,8
8951,2,work,8,15,7
8951,3,home,15,20,5
8951,4,shop,20,21,1
8951,5,home,21,24,3
8952,1,home,0,7,7
8952,2,work,7,14,7
8952,3,home,14,24,10
8953,1,home,0,7,7
8953,2,work,7,13,6
8953,3,home,13,24,11
8954,1,home,0,8,8
8954,2,work,8,15,7
8954,3,home,15,24,9
8955,1,home,0,7,7
8955,2,education,7,11,4
8955,3,home,11,18,7
8955,4,shop,18,19,1
8955,5,home,19,24,5
8956,1,home,0,6,6
8956,2,work,6,13,7
8956,3,shop,13,15,2
8956,4,work,15,19,4
8956,5,home,19,24,5
8957,1,work,0,2,2
8957,2,home,2,7,5
8957,3,work,7,9,2
8957,4,home,9,15,6
8957,5,work,15,17,2
8957,6,home,17,24,7
8958,1,work,0,1,1
8958,2,home,1,7,6
8958,3,shop,7,8,1
8958,4,education,8,11,3
8958,5,home,11,18,7
8958,6,shop,18,19,1
8958,7,home,19,24,5
8959,1,home,0,8,8
8959,2,education,8,11,3
8959,3,home,11,15,4
8959,4,work,15,20,5
8959,5,home,20,24,4
8960,1,home,0,7,7
8960,2,work,7,13,6
8960,3,shop,13,15,2
8960,4,work,15,20,5
8960,5,home,20,24,4
8961,1,home,0,8,8
8961,2,work,8,13,5
8961,3,home,13,17,4
8961,4,work,17,20,3
8961,5,home,20,24,4
8962,1,home,0,6,6
8962,2,shop,6,7,1
8962,3,work,7,9,2
8962,4,home,9,14,5
8962,5,work,14,17,3
8962,6,home,17,24,7
8963,1,home,0,7,7
8963,2,work,7,14,7
8963,3,shop,14,15,1
8963,4,home,15,24,9
8964,1,home,0,6,6
8964,2,shop,6,7,1
8964,3,home,7,9,2
8964,4,education,9,12,3
8964,5,home,12,20,8
8964,6,shop,20,21,1
8964,7,home,21,24,3
8965,1,home,0,6,6
8965,2,work,6,14,8
8965,3,home,14,24,10
8966,1,home,0,7,7
8966,2,education,7,11,4
8966,3,home,11,13,2
8966,4,education,13,14,1
8966,5,shop,14,16,2
8966,6,home,16,24,8
8967,1,home,0,7,7
8967,2,work,7,13,6
8967,3,shop,13,14,1
8967,4,home,14,24,10
8968,1,home,0,7,7
8968,2,work,7,13,6
8968,3,home,13,21,8
8968,4,work,21,22,1
8968,5,home,22,24,2
8969,1,home,0,7,7
8969,2,work,7,14,7
8969,3,shop,14,15,1
8969,4,home,15,24,9
8970,1,home,0,6,6
8970,2,work,6,13,7
8970,3,shop,13,14,1
8970,4,work,14,19,5
8970,5,home,19,24,5
8971,1,home,0,9,9
8971,2,work,9,16,7
8971,3,home,16,24,8
8972,1,home,0,7,7
8972,2,education,7,11,4
8972,3,home,11,19,8
8972,4,shop,19,20,1
8972,5,home,20,24,4
8973,1,home,0,7,7
8973,2,education,7,11,4
8973,3,home,11,14,3
8973,4,education,14,16,2
8973,5,home,16,24,8
8974,1,home,0,7,7
8974,2,shop,7,8,1
8974,3,education,8,12,4
8974,4,home,12,18,6
8974,5,shop,18,19,1
8974,6,home,19,24,5
8975,1,home,0,6,6
8975,2,work,6,13,7
8975,3,home,13,24,11
8976,1,home,0,7,7
8976,2,work,7,13,6
8976,3,shop,13,15,2
8976,4,work,15,20,5
8976,5,home,20,24,4
8977,1,home,0,6,6
8977,2,work,6,13,7
8977,3,shop,13,14,1
8977,4,work,14,19,5
8977,5,home,19,24,5
8978,1,home,0,8,8
8978,2,work,8,14,6
8978,3,home,14,24,10
8979,1,home,0,7,7
8979,2,education,7,11,4
8979,3,home,11,18,7
8979,4,shop,18,19,1
8979,5,home,19,24,5
8980,1,home,0,8,8
8980,2,education,8,11,3
8980,3,home,11,14,3
8980,4,education,14,16,2
8980,5,home,16,24,8
8981,1,home,0,6,6
8981,2,work,6,13,7
8981,3,home,13,24,11
8982,1,home,0,7,7
8982,2,work,7,13,6
8982,3,home,13,24,11
8983,1,home,0,8,8
8983,2,work,8,15,7
8983,3,home,15,22,7
8983,4,work,22,23,1
8983,5,home,23,24,1
8984,1,home,0,8,8
8984,2,education,8,12,4
8984,3,shop,12,14,2
8984,4,education,14,16,2
8984,5,home,16,24,8
8985,1,home,0,7,7
8985,2,work,7,13,6
8985,3,home,13,16,3
8985,4,work,16,20,4
8985,5,home,20,24,4
8986,1,home,0,7,7
8986,2,work,7,15,8
8986,3,shop,15,16,1
8986,4,work,16,20,4
8986,5,home,20,24,4
8987,1,home,0,7,7
8987,2,work,7,14,7
8987,3,shop,14,15,1
8987,4,work,15,19,4
8987,5,home,19,24,5
8988,1,home,0,6,6
8988,2,work,6,7,1
8988,3,home,7,8,1
8988,4,work,8,10,2
8988,5,home,10,14,4
8988,6,work,14,16,2
8988,7,home,16,21,5
8988,8,work,21,22,1
8988,9,home,22,24,2
8989,1,home,0,8,8
8989,2,work,8,15,7
8989,3,home,15,22,7
8989,4,work,22,23,1
8989,5,home,23,24,1
8990,1,home,0,6,6
8990,2,shop,6,7,1
8990,3,home,7,9,2
8990,4,education,9,12,3
8990,5,shop,12,14,2
8990,6,home,14,20,6
8990,7,shop,20,21,1
8990,8,home,21,24,3
8991,1,home,0,6,6
8991,2,work,6,8,2
8991,3,home,8,14,6
8991,4,work,14,17,3
8991,5,home,17,24,7
8992,1,home,0,7,7
8992,2,work,7,14,7
8992,3,home,14,24,10
8993,1,home,0,7,7
8993,2,education,7,11,4
8993,3,home,11,14,3
8993,4,education,14,16,2
8993,5,home,16,24,8
8994,1,home,0,7,7
8994,2,education,7,11,4
8994,3,home,11,18,7
8994,4,shop,18,19,1
8994,5,home,19,24,5
8995,1,home,0,6,6
8995,2,work,6,13,7
8995,3,home,13,16,3
8995,4,work,16,20,4
8995,5,home,20,24,4
8996,1,home,0,6,6
8996,2,work,6,13,7
8996,3,home,13,18,5
8996,4,shop,18,19,1
8996,5,home,19,24,5
8997,1,home,0,6,6
8997,2,shop,6,7,1
8997,3,work,7,14,7
8997,4,home,14,24,10
8998,1,home,0,6,6
8998,2,shop,6,7,1
8998,3,home,7,13,6
8998,4,education,13,16,3
8998,5,home,16,24,8
8999,1,home,0,6,6
8999,2,work,6,8,2
8999,3,home,8,13,5
8999,4,work,13,15,2
8999,5,home,15,21,6
8999,6,work,21,22,1
8999,7,home,22,24,2
9000,1,home,0,6,6
9000,2,work,6,8,2
9000,3,home,8,12,4
9000,4,work,12,14,2
9000,5,home,14,21,7
9000,6,work,21,22,1
9000,7,home,22,24,2
9001,1,home,0,6,6
9001,2,work,6,13,7
9001,3,shop,13,14,1
9001,4,work,14,20,6
9001,5,home,20,24,4
9002,1,home,0,7,7
9002,2,education,7,11,4
9002,3,home,11,15,4
9002,4,shop,15,16,1
9002,5,home,16,24,8
9003,1,home,0,6,6
9003,2,work,6,13,7
9003,3,home,13,24,11
9004,1,home,0,7,7
9004,2,education,7,11,4
9004,3,home,11,17,6
9004,4,shop,17,18,1
9004,5,home,18,24,6
9005,1,home,0,7,7
9005,2,shop,7,8,1
9005,3,education,8,12,4
9005,4,shop,12,13,1
9005,5,education,13,16,3
9005,6,home,16,24,8
9006,1,home,0,8,8
9006,2,shop,8,10,2
9006,3,home,10,14,4
9006,4,work,14,20,6
9006,5,home,20,24,4
9007,1,home,0,7,7
9007,2,work,7,13,6
9007,3,home,13,17,4
9007,4,work,17,20,3
9007,5,home,20,24,4
9008,1,home,0,7,7
9008,2,work,7,14,7
9008,3,home,14,24,10
9009,1,home,0,7,7
9009,2,work,7,14,7
9009,3,home,14,24,10
9010,1,home,0,7,7
9010,2,shop,7,8,1
9010,3,work,8,14,6
9010,4,home,14,24,10
9011,1,home,0,9,9
9011,2,shop,9,10,1
9011,3,home,10,14,4
9011,4,work,14,20,6
9011,5,home,20,24,4
9012,1,home,0,6,6
9012,2,work,6,13,7
9012,3,home,13,17,4
9012,4,work,17,20,3
9012,5,home,20,24,4
9013,1,home,0,8,8
9013,2,work,8,14,6
9013,3,shop,14,15,1
9013,4,home,15,24,9
9014,1,home,0,8,8
9014,2,work,8,15,7
9014,3,home,15,20,5
9014,4,shop,20,21,1
9014,5,home,21,24,3
9015,1,home,0,7,7
9015,2,education,7,11,4
9015,3,home,11,16,5
9015,4,shop,16,18,2
9015,5,home,18,24,6
9016,1,home,0,6,6
9016,2,shop,6,7,1
9016,3,home,7,10,3
9016,4,education,10,13,3
9016,5,shop,13,15,2
9016,6,home,15,24,9
9017,1,home,0,7,7
9017,2,shop,7,8,1
9017,3,home,8,9,1
9017,4,work,9,16,7
9017,5,home,16,22,6
9017,6,work,22,23,1
9017,7,home,23,24,1
9018,1,home,0,8,8
9018,2,work,8,15,7
9018,3,home,15,24,9
9019,1,home,0,7,7
9019,2,work,7,13,6
9019,3,home,13,24,11
9020,1,home,0,8,8
9020,2,education,8,13,5
9020,3,shop,13,15,2
9020,4,home,15,24,9
9021,1,home,0,6,6
9021,2,work,6,13,7
9021,3,shop,13,14,1
9021,4,work,14,19,5
9021,5,home,19,24,5
9022,1,home,0,6,6
9022,2,shop,6,7,1
9022,3,home,7,9,2
9022,4,education,9,12,3
9022,5,home,12,18,6
9022,6,shop,18,19,1
9022,7,home,19,24,5
9023,1,home,0,7,7
9023,2,work,7,14,7
9023,3,shop,14,15,1
9023,4,home,15,24,9
9024,1,home,0,6,6
9024,2,work,6,8,2
9024,3,home,8,12,4
9024,4,work,12,14,2
9024,5,home,14,21,7
9024,6,work,21,22,1
9024,7,home,22,24,2
9025,1,home,0,7,7
9025,2,work,7,13,6
9025,3,home,13,24,11
9026,1,home,0,6,6
9026,2,work,6,13,7
9026,3,home,13,24,11
9027,1,home,0,6,6
9027,2,shop,6,7,1
9027,3,work,7,13,6
9027,4,home,13,23,10
9027,5,work,23,24,1
9028,1,home,0,8,8
9028,2,work,8,15,7
9028,3,shop,15,16,1
9028,4,work,16,19,3
9028,5,home,19,24,5
9029,1,home,0,8,8
9029,2,work,8,14,6
9029,3,shop,14,15,1
9029,4,work,15,19,4
9029,5,home,19,24,5
9030,1,home,0,7,7
9030,2,education,7,11,4
9030,3,home,11,17,6
9030,4,shop,17,18,1
9030,5,home,18,24,6
9031,1,home,0,6,6
9031,2,work,6,13,7
9031,3,home,13,17,4
9031,4,shop,17,18,1
9031,5,home,18,24,6
9032,1,home,0,6,6
9032,2,shop,6,7,1
9032,3,work,7,13,6
9032,4,home,13,17,4
9032,5,work,17,19,2
9032,6,home,19,24,5
9033,1,home,0,6,6
9033,2,work,6,13,7
9033,3,home,13,16,3
9033,4,work,16,19,3
9033,5,home,19,24,5
9034,1,home,0,6,6
9034,2,shop,6,7,1
9034,3,home,7,10,3
9034,4,work,10,17,7
9034,5,home,17,21,4
9034,6,work,21,22,1
9034,7,home,22,24,2
9035,1,home,0,6,6
9035,2,shop,6,7,1
9035,3,home,7,10,3
9035,4,education,10,12,2
9035,5,shop,12,14,2
9035,6,education,14,16,2
9035,7,shop,16,17,1
9035,8,home,17,24,7
9036,1,home,0,8,8
9036,2,work,8,15,7
9036,3,home,15,24,9
9037,1,home,0,7,7
9037,2,work,7,8,1
9037,3,home,8,13,5
9037,4,work,13,15,2
9037,5,home,15,22,7
9037,6,work,22,23,1
9037,7,home,23,24,1
9038,1,home,0,7,7
9038,2,work,7,14,7
9038,3,home,14,24,10
9039,1,home,0,7,7
9039,2,work,7,14,7
9039,3,home,14,18,4
9039,4,work,18,20,2
9039,5,home,20,24,4
9040,1,home,0,7,7
9040,2,work,7,9,2
9040,3,home,9,13,4
9040,4,work,13,15,2
9040,5,home,15,21,6
9040,6,work,21,22,1
9040,7,home,22,24,2
9041,1,home,0,7,7
9041,2,work,7,14,7
9041,3,home,14,18,4
9041,4,work,18,20,2
9041,5,home,20,24,4
9042,1,home,0,7,7
9042,2,work,7,15,8
9042,3,home,15,24,9
9043,1,home,0,6,6
9043,2,shop,6,7,1
9043,3,home,7,10,3
9043,4,education,10,11,1
9043,5,home,11,17,6
9043,6,shop,17,18,1
9043,7,home,18,24,6
9044,1,home,0,6,6
9044,2,work,6,8,2
9044,3,home,8,13,5
9044,4,work,13,15,2
9044,5,home,15,22,7
9044,6,work,22,23,1
9044,7,home,23,24,1
9045,1,home,0,8,8
9045,2,work,8,14,6
9045,3,home,14,24,10
9046,1,home,0,6,6
9046,2,shop,6,7,1
9046,3,work,7,13,6
9046,4,home,13,14,1
9046,5,education,14,16,2
9046,6,home,16,22,6
9046,7,work,22,23,1
9046,8,home,23,24,1
9047,1,home,0,6,6
9047,2,work,6,13,7
9047,3,shop,13,14,1
9047,4,work,14,20,6
9047,5,home,20,24,4
9048,1,home,0,8,8
9048,2,work,8,14,6
9048,3,home,14,24,10
9049,1,home,0,6,6
9049,2,shop,6,7,1
9049,3,home,7,10,3
9049,4,education,10,13,3
9049,5,shop,13,15,2
9049,6,home,15,24,9
9050,1,home,0,7,7
9050,2,shop,7,9,2
9050,3,education,9,13,4
9050,4,home,13,17,4
9050,5,shop,17,18,1
9050,6,home,18,24,6
9051,1,home,0,7,7
9051,2,education,7,12,5
9051,3,home,12,19,7
9051,4,shop,19,20,1
9051,5,home,20,24,4
9052,1,home,0,7,7
9052,2,work,7,13,6
9052,3,shop,13,14,1
9052,4,home,14,24,10
9053,1,home,0,7,7
9053,2,work,7,14,7
9053,3,shop,14,15,1
9053,4,home,15,21,6
9053,5,work,21,22,1
9053,6,home,22,24,2
9054,1,home,0,8,8
9054,2,work,8,14,6
9054,3,home,14,24,10
9055,1,home,0,7,7
9055,2,work,7,14,7
9055,3,shop,14,15,1
9055,4,home,15,17,2
9055,5,work,17,20,3
9055,6,home,20,24,4
9056,1,home,0,7,7
9056,2,work,7,14,7
9056,3,home,14,18,4
9056,4,work,18,20,2
9056,5,home,20,24,4
9057,1,home,0,7,7
9057,2,work,7,13,6
9057,3,shop,13,14,1
9057,4,work,14,18,4
9057,5,home,18,24,6
9058,1,home,0,6,6
9058,2,work,6,13,7
9058,3,shop,13,14,1
9058,4,home,14,24,10
9059,1,home,0,6,6
9059,2,shop,6,7,1
9059,3,home,7,10,3
9059,4,education,10,16,6
9059,5,shop,16,18,2
9059,6,home,18,24,6
9060,1,home,0,7,7
9060,2,education,7,11,4
9060,3,home,11,19,8
9060,4,shop,19,21,2
9060,5,home,21,24,3
9061,1,home,0,7,7
9061,2,work,7,14,7
9061,3,home,14,20,6
9061,4,shop,20,21,1
9061,5,home,21,24,3
9062,1,home,0,6,6
9062,2,work,6,13,7
9062,3,shop,13,14,1
9062,4,work,14,19,5
9062,5,home,19,24,5
9063,1,home,0,7,7
9063,2,work,7,10,3
9063,3,home,10,16,6
9063,4,work,16,19,3
9063,5,home,19,24,5
9064,1,home,0,7,7
9064,2,shop,7,8,1
9064,3,work,8,15,7
9064,4,home,15,24,9
9065,1,home,0,6,6
9065,2,work,6,13,7
9065,3,home,13,17,4
9065,4,work,17,19,2
9065,5,home,19,24,5
9066,1,work,0,9,9
9066,2,shop,9,10,1
9066,3,home,10,16,6
9066,4,work,16,20,4
9066,5,home,20,24,4
9067,1,home,0,7,7
9067,2,education,7,11,4
9067,3,home,11,19,8
9067,4,shop,19,21,2
9067,5,home,21,24,3
9068,1,home,0,8,8
9068,2,work,8,16,8
9068,3,home,16,20,4
9068,4,shop,20,21,1
9068,5,home,21,24,3
9069,1,home,0,6,6
9069,2,work,6,8,2
9069,3,home,8,9,1
9069,4,work,9,11,2
9069,5,home,11,18,7
9069,6,work,18,19,1
9069,7,home,19,24,5
9070,1,home,0,6,6
9070,2,work,6,13,7
9070,3,home,13,23,10
9070,4,work,23,24,1
9071,1,home,0,8,8
9071,2,work,8,15,7
9071,3,home,15,24,9
9072,1,home,0,6,6
9072,2,work,6,12,6
9072,3,shop,12,13,1
9072,4,work,13,19,6
9072,5,home,19,24,5
9073,1,home,0,7,7
9073,2,shop,7,9,2
9073,3,education,9,12,3
9073,4,shop,12,14,2
9073,5,education,14,16,2
9073,6,home,16,24,8
9074,1,home,0,8,8
9074,2,work,8,15,7
9074,3,home,15,24,9
9075,1,home,0,8,8
9075,2,work,8,13,5
9075,3,home,13,18,5
9075,4,work,18,20,2
9075,5,home,20,24,4
9076,1,home,0,6,6
9076,2,shop,6,7,1
9076,3,home,7,13,6
9076,4,education,13,16,3
9076,5,home,16,24,8
9077,1,home,0,9,9
9077,2,work,9,16,7
9077,3,home,16,21,5
9077,4,work,21,22,1
9077,5,home,22,24,2
9078,1,home,0,8,8
9078,2,work,8,14,6
9078,3,home,14,24,10
9079,1,home,0,8,8
9079,2,education,8,12,4
9079,3,shop,12,14,2
9079,4,education,14,16,2
9079,5,shop,16,17,1
9079,6,home,17,24,7
9080,1,home,0,8,8
9080,2,shop,8,10,2
9080,3,education,10,12,2
9080,4,home,12,15,3
9080,5,shop,15,17,2
9080,6,home,17,24,7
9081,1,home,0,7,7
9081,2,education,7,11,4
9081,3,home,11,17,6
9081,4,shop,17,19,2
9081,5,home,19,24,5
9082,1,home,0,8,8
9082,2,shop,8,9,1
9082,3,work,9,17,8
9082,4,home,17,24,7
9083,1,home,0,7,7
9083,2,work,7,13,6
9083,3,home,13,23,10
9083,4,work,23,24,1
9084,1,home,0,6,6
9084,2,work,6,7,1
9084,3,home,7,9,2
9084,4,work,9,11,2
9084,5,home,11,21,10
9084,6,work,21,22,1
9084,7,home,22,24,2
9085,1,home,0,6,6
9085,2,work,6,13,7
9085,3,home,13,24,11
9086,1,home,0,7,7
9086,2,work,7,13,6
9086,3,home,13,17,4
9086,4,work,17,20,3
9086,5,home,20,24,4
9087,1,home,0,7,7
9087,2,work,7,13,6
9087,3,shop,13,14,1
9087,4,work,14,16,2
9087,5,home,16,24,8
9088,1,home,0,8,8
9088,2,work,8,15,7
9088,3,home,15,24,9
9089,1,home,0,8,8
9089,2,work,8,14,6
9089,3,home,14,17,3
9089,4,work,17,20,3
9089,5,home,20,24,4
9090,1,home,0,6,6
9090,2,shop,6,7,1
9090,3,work,7,13,6
9090,4,shop,13,14,1
9090,5,work,14,19,5
9090,6,home,19,24,5
9091,1,home,0,7,7
9091,2,work,7,13,6
9091,3,home,13,20,7
9091,4,shop,20,21,1
9091,5,home,21,24,3
9092,1,home,0,7,7
9092,2,work,7,13,6
9092,3,shop,13,14,1
9092,4,work,14,20,6
9092,5,home,20,24,4
9093,1,home,0,6,6
9093,2,work,6,13,7
9093,3,home,13,24,11
9094,1,home,0,7,7
9094,2,work,7,14,7
9094,3,home,14,16,2
9094,4,work,16,20,4
9094,5,home,20,24,4
9095,1,home,0,7,7
9095,2,work,7,14,7
9095,3,shop,14,15,1
9095,4,work,15,20,5
9095,5,home,20,24,4
9096,1,home,0,8,8
9096,2,shop,8,9,1
9096,3,home,9,15,6
9096,4,work,15,19,4
9096,5,home,19,23,4
9096,6,work,23,24,1
9097,1,home,0,7,7
9097,2,work,7,14,7
9097,3,shop,14,15,1
9097,4,work,15,19,4
9097,5,home,19,24,5
9098,1,home,0,8,8
9098,2,education,8,11,3
9098,3,home,11,18,7
9098,4,shop,18,20,2
9098,5,home,20,24,4
9099,1,home,0,8,8
9099,2,education,8,11,3
9099,3,home,11,18,7
9099,4,shop,18,19,1
9099,5,home,19,24,5
9100,1,home,0,8,8
9100,2,work,8,15,7
9100,3,shop,15,16,1
9100,4,work,16,20,4
9100,5,home,20,24,4
9101,1,home,0,8,8
9101,2,work,8,15,7
9101,3,home,15,22,7
9101,4,work,22,23,1
9101,5,home,23,24,1
9102,1,home,0,6,6
9102,2,work,6,7,1
9102,3,home,7,9,2
9102,4,work,9,11,2
9102,5,home,11,16,5
9102,6,work,16,18,2
9102,7,home,18,24,6
9103,1,home,0,6,6
9103,2,work,6,13,7
9103,3,shop,13,14,1
9103,4,work,14,19,5
9103,5,home,19,24,5
9104,1,home,0,7,7
9104,2,education,7,11,4
9104,3,home,11,18,7
9104,4,shop,18,20,2
9104,5,home,20,24,4
9105,1,home,0,8,8
9105,2,education,8,11,3
9105,3,home,11,17,6
9105,4,shop,17,18,1
9105,5,home,18,24,6
9106,1,home,0,8,8
9106,2,work,8,15,7
9106,3,home,15,19,4
9106,4,shop,19,20,1
9106,5,home,20,24,4
9107,1,home,0,6,6
9107,2,work,6,13,7
9107,3,home,13,18,5
9107,4,work,18,20,2
9107,5,home,20,24,4
9108,1,home,0,7,7
9108,2,work,7,13,6
9108,3,home,13,18,5
9108,4,work,18,20,2
9108,5,home,20,24,4
9109,1,home,0,7,7
9109,2,work,7,13,6
9109,3,home,13,23,10
9109,4,work,23,24,1
9110,1,home,0,8,8
9110,2,shop,8,9,1
9110,3,work,9,16,7
9110,4,home,16,24,8
9111,1,home,0,7,7
9111,2,education,7,11,4
9111,3,home,11,14,3
9111,4,education,14,17,3
9111,5,home,17,24,7
9112,1,home,0,7,7
9112,2,work,7,14,7
9112,3,shop,14,15,1
9112,4,home,15,22,7
9112,5,work,22,23,1
9112,6,home,23,24,1
9113,1,home,0,7,7
9113,2,education,7,11,4
9113,3,home,11,17,6
9113,4,shop,17,18,1
9113,5,home,18,24,6
9114,1,home,0,7,7
9114,2,work,7,9,2
9114,3,home,9,13,4
9114,4,work,13,15,2
9114,5,home,15,22,7
9114,6,work,22,23,1
9114,7,home,23,24,1
9115,1,home,0,7,7
9115,2,work,7,9,2
9115,3,home,9,14,5
9115,4,work,14,15,1
9115,5,home,15,21,6
9115,6,work,21,22,1
9115,7,home,22,24,2
9116,1,home,0,8,8
9116,2,shop,8,9,1
9116,3,home,9,12,3
9116,4,work,12,18,6
9116,5,home,18,24,6
9117,1,home,0,7,7
9117,2,work,7,13,6
9117,3,home,13,24,11
9118,1,home,0,8,8
9118,2,work,8,15,7
9118,3,home,15,24,9
9119,1,home,0,7,7
9119,2,education,7,12,5
9119,3,home,12,21,9
9119,4,shop,21,22,1
9119,5,home,22,24,2
9120,1,home,0,7,7
9120,2,work,7,13,6
9120,3,shop,13,14,1
9120,4,work,14,19,5
9120,5,home,19,24,5
9121,1,home,0,8,8
9121,2,education,8,12,4
9121,3,home,12,17,5
9121,4,work,17,20,3
9121,5,home,20,24,4
9122,1,home,0,7,7
9122,2,education,7,11,4
9122,3,home,11,19,8
9122,4,shop,19,20,1
9122,5,home,20,24,4
9123,1,home,0,7,7
9123,2,shop,7,9,2
9123,3,education,9,12,3
9123,4,home,12,21,9
9123,5,shop,21,22,1
9123,6,home,22,24,2
9124,1,home,0,6,6
9124,2,work,6,13,7
9124,3,home,13,23,10
9124,4,work,23,24,1
9125,1,home,0,6,6
9125,2,work,6,13,7
9125,3,shop,13,14,1
9125,4,home,14,24,10
9126,1,home,0,6,6
9126,2,shop,6,7,1
9126,3,work,7,14,7
9126,4,shop,14,15,1
9126,5,home,15,24,9
9127,1,home,0,7,7
9127,2,education,7,12,5
9127,3,shop,12,14,2
9127,4,education,14,16,2
9127,5,home,16,24,8
9128,1,home,0,7,7
9128,2,education,7,11,4
9128,3,home,11,19,8
9128,4,shop,19,20,1
9128,5,home,20,24,4
9129,1,home,0,7,7
9129,2,work,7,13,6
9129,3,home,13,18,5
9129,4,work,18,20,2
9129,5,home,20,24,4
9130,1,home,0,8,8
9130,2,shop,8,9,1
9130,3,work,9,17,8
9130,4,home,17,23,6
9130,5,work,23,24,1
9131,1,home,0,8,8
9131,2,shop,8,9,1
9131,3,home,9,14,5
9131,4,work,14,19,5
9131,5,home,19,24,5
9132,1,home,0,8,8
9132,2,work,8,15,7
9132,3,home,15,24,9
9133,1,home,0,7,7
9133,2,work,7,14,7
9133,3,shop,14,15,1
9133,4,home,15,24,9
9134,1,home,0,6,6
9134,2,work,6,8,2
9134,3,home,8,11,3
9134,4,work,11,13,2
9134,5,home,13,21,8
9134,6,work,21,22,1
9134,7,home,22,24,2
9135,1,home,0,6,6
9135,2,work,6,13,7
9135,3,shop,13,14,1
9135,4,home,14,24,10
9136,1,home,0,7,7
9136,2,work,7,14,7
9136,3,home,14,23,9
9136,4,work,23,24,1
9137,1,home,0,6,6
9137,2,work,6,8,2
9137,3,home,8,13,5
9137,4,work,13,15,2
9137,5,home,15,23,8
9137,6,work,23,24,1
9138,1,home,0,6,6
9138,2,shop,6,7,1
9138,3,home,7,9,2
9138,4,education,9,13,4
9138,5,shop,13,15,2
9138,6,home,15,21,6
9138,7,shop,21,22,1
9138,8,home,22,24,2
9139,1,home,0,7,7
9139,2,work,7,10,3
9139,3,shop,10,11,1
9139,4,work,11,13,2
9139,5,home,13,24,11
9140,1,home,0,8,8
9140,2,work,8,14,6
9140,3,shop,14,15,1
9140,4,home,15,21,6
9140,5,work,21,22,1
9140,6,home,22,24,2
9141,1,home,0,7,7
9141,2,education,7,11,4
9141,3,home,11,18,7
9141,4,shop,18,19,1
9141,5,home,19,24,5
9142,1,home,0,6,6
9142,2,work,6,12,6
9142,3,shop,12,13,1
9142,4,work,13,19,6
9142,5,home,19,24,5
9143,1,home,0,8,8
9143,2,education,8,13,5
9143,3,shop,13,15,2
9143,4,home,15,24,9
9144,1,home,0,6,6
9144,2,shop,6,7,1
9144,3,home,7,10,3
9144,4,education,10,13,3
9144,5,home,13,24,11
9145,1,home,0,6,6
9145,2,shop,6,7,1
9145,3,home,7,10,3
9145,4,education,10,14,4
9145,5,home,14,24,10
9146,1,home,0,6,6
9146,2,work,6,13,7
9146,3,shop,13,14,1
9146,4,work,14,19,5
9146,5,home,19,24,5
9147,1,home,0,7,7
9147,2,work,7,13,6
9147,3,home,13,17,4
9147,4,work,17,20,3
9147,5,home,20,24,4
9148,1,home,0,7,7
9148,2,work,7,13,6
9148,3,home,13,24,11
9149,1,home,0,7,7
9149,2,work,7,13,6
9149,3,shop,13,14,1
9149,4,home,14,22,8
9149,5,work,22,23,1
9149,6,home,23,24,1
9150,1,home,0,6,6
9150,2,shop,6,7,1
9150,3,home,7,10,3
9150,4,education,10,12,2
9150,5,home,12,19,7
9150,6,shop,19,20,1
9150,7,home,20,24,4
9151,1,home,0,7,7
9151,2,education,7,11,4
9151,3,home,11,19,8
9151,4,shop,19,20,1
9151,5,home,20,24,4
9152,1,home,0,7,7
9152,2,work,7,9,2
9152,3,home,9,16,7
9152,4,work,16,18,2
9152,5,home,18,24,6
9153,1,home,0,8,8
9153,2,work,8,15,7
9153,3,home,15,24,9
9154,1,home,0,7,7
9154,2,shop,7,8,1
9154,3,education,8,11,3
9154,4,home,11,14,3
9154,5,education,14,16,2
9154,6,shop,16,17,1
9154,7,home,17,24,7
9155,1,home,0,6,6
9155,2,work,6,8,2
9155,3,home,8,14,6
9155,4,work,14,16,2
9155,5,home,16,23,7
9155,6,work,23,24,1
9156,1,home,0,7,7
9156,2,work,7,14,7
9156,3,shop,14,15,1
9156,4,work,15,20,5
9156,5,home,20,24,4
9157,1,home,0,6,6
9157,2,work,6,13,7
9157,3,home,13,21,8
9157,4,shop,21,22,1
9157,5,home,22,24,2
9158,1,home,0,8,8
9158,2,work,8,15,7
9158,3,home,15,24,9
9159,1,home,0,8,8
9159,2,work,8,14,6
9159,3,home,14,24,10
9160,1,home,0,8,8
9160,2,education,8,11,3
9160,3,home,11,19,8
9160,4,shop,19,20,1
9160,5,home,20,24,4
9161,1,home,0,7,7
9161,2,work,7,13,6
9161,3,shop,13,14,1
9161,4,home,14,22,8
9161,5,work,22,23,1
9161,6,home,23,24,1
9162,1,home,0,6,6
9162,2,shop,6,7,1
9162,3,home,7,13,6
9162,4,education,13,16,3
9162,5,home,16,20,4
9162,6,shop,20,21,1
9162,7,home,21,24,3
9163,1,home,0,8,8
9163,2,education,8,11,3
9163,3,home,11,13,2
9163,4,shop,13,14,1
9163,5,home,14,24,10
9164,1,home,0,7,7
9164,2,work,7,8,1
9164,3,home,8,13,5
9164,4,work,13,15,2
9164,5,home,15,22,7
9164,6,work,22,23,1
9164,7,home,23,24,1
9165,1,home,0,6,6
9165,2,work,6,13,7
9165,3,home,13,17,4
9165,4,work,17,20,3
9165,5,home,20,24,4
9166,1,home,0,6,6
9166,2,shop,6,7,1
9166,3,home,7,10,3
9166,4,education,10,13,3
9166,5,shop,13,15,2
9166,6,home,15,24,9
9167,1,home,0,6,6
9167,2,work,6,13,7
9167,3,home,13,17,4
9167,4,work,17,20,3
9167,5,home,20,24,4
9168,1,home,0,7,7
9168,2,shop,7,8,1
9168,3,work,8,15,7
9168,4,home,15,23,8
9168,5,work,23,24,1
9169,1,home,0,8,8
9169,2,work,8,15,7
9169,3,home,15,24,9
9170,1,home,0,7,7
9170,2,work,7,13,6
9170,3,home,13,24,11
9171,1,home,0,7,7
9171,2,work,7,13,6
9171,3,home,13,19,6
9171,4,shop,19,20,1
9171,5,home,20,24,4
9172,1,home,0,8,8
9172,2,shop,8,9,1
9172,3,home,9,15,6
9172,4,work,15,20,5
9172,5,home,20,24,4
9173,1,home,0,6,6
9173,2,shop,6,7,1
9173,3,work,7,14,7
9173,4,home,14,24,10
9174,1,home,0,7,7
9174,2,education,7,11,4
9174,3,home,11,18,7
9174,4,shop,18,19,1
9174,5,home,19,24,5
9175,1,home,0,6,6
9175,2,work,6,13,7
9175,3,home,13,21,8
9175,4,work,21,22,1
9175,5,home,22,24,2
9176,1,home,0,8,8
9176,2,work,8,17,9
9176,3,home,17,22,5
9176,4,work,22,23,1
9176,5,home,23,24,1
9177,1,home,0,6,6
9177,2,work,6,13,7
9177,3,home,13,24,11
9178,1,home,0,9,9
9178,2,work,9,15,6
9178,3,shop,15,16,1
9178,4,work,16,20,4
9178,5,home,20,24,4
9179,1,home,0,8,8
9179,2,work,8,15,7
9179,3,home,15,24,9
9180,1,home,0,7,7
9180,2,work,7,13,6
9180,3,home,13,24,11
9181,1,home,0,7,7
9181,2,shop,7,8,1
9181,3,education,8,11,3
9181,4,home,11,18,7
9181,5,shop,18,20,2
9181,6,home,20,24,4
9182,1,home,0,6,6
9182,2,shop,6,7,1
9182,3,home,7,10,3
9182,4,education,10,12,2
9182,5,shop,12,14,2
9182,6,home,14,20,6
9182,7,shop,20,21,1
9182,8,home,21,24,3
9183,1,home,0,7,7
9183,2,education,7,11,4
9183,3,home,11,19,8
9183,4,shop,19,20,1
9183,5,home,20,24,4
9184,1,home,0,8,8
9184,2,work,8,14,6
9184,3,home,14,24,10
9185,1,home,0,8,8
9185,2,work,8,15,7
9185,3,home,15,22,7
9185,4,work,22,23,1
9185,5,home,23,24,1
9186,1,work,0,8,8
9186,2,shop,8,9,1
9186,3,work,9,16,7
9186,4,home,16,24,8
9187,1,home,0,9,9
9187,2,education,9,15,6
9187,3,home,15,24,9
9188,1,home,0,6,6
9188,2,shop,6,7,1
9188,3,home,7,10,3
9188,4,education,10,13,3
9188,5,shop,13,15,2
9188,6,home,15,21,6
9188,7,shop,21,22,1
9188,8,home,22,24,2
9189,1,home,0,8,8
9189,2,work,8,15,7
9189,3,home,15,24,9
9190,1,home,0,6,6
9190,2,work,6,8,2
9190,3,home,8,12,4
9190,4,shop,12,13,1
9190,5,work,13,15,2
9190,6,home,15,22,7
9190,7,work,22,23,1
9190,8,home,23,24,1
9191,1,home,0,6,6
9191,2,work,6,13,7
9191,3,shop,13,14,1
9191,4,home,14,18,4
9191,5,work,18,20,2
9191,6,home,20,24,4
9192,1,home,0,6,6
9192,2,shop,6,7,1
9192,3,home,7,10,3
9192,4,education,10,16,6
9192,5,home,16,24,8
9193,1,home,0,7,7
9193,2,education,7,12,5
9193,3,home,12,21,9
9193,4,shop,21,22,1
9193,5,home,22,24,2
9194,1,home,0,7,7
9194,2,work,7,13,6
9194,3,home,13,16,3
9194,4,work,16,20,4
9194,5,home,20,24,4
9195,1,home,0,7,7
9195,2,work,7,13,6
9195,3,home,13,20,7
9195,4,shop,20,21,1
9195,5,home,21,24,3
9196,1,home,0,7,7
9196,2,work,7,13,6
9196,3,shop,13,14,1
9196,4,home,14,24,10
9197,1,home,0,7,7
9197,2,work,7,14,7
9197,3,home,14,24,10
9198,1,home,0,8,8
9198,2,education,8,12,4
9198,3,shop,12,14,2
9198,4,home,14,24,10
9199,1,home,0,7,7
9199,2,work,7,13,6
9199,3,shop,13,14,1
9199,4,work,14,20,6
9199,5,home,20,24,4
9200,1,home,0,8,8
9200,2,work,8,15,7
9200,3,shop,15,16,1
9200,4,work,16,20,4
9200,5,home,20,24,4
9201,1,home,0,7,7
9201,2,education,7,12,5
9201,3,shop,12,14,2
9201,4,education,14,16,2
9201,5,home,16,24,8
9202,1,home,0,8,8
9202,2,work,8,16,8
9202,3,home,16,24,8
9203,1,home,0,7,7
9203,2,education,7,11,4
9203,3,home,11,18,7
9203,4,shop,18,20,2
9203,5,home,20,24,4
9204,1,home,0,6,6
9204,2,shop,6,7,1
9204,3,home,7,9,2
9204,4,work,9,19,10
9204,5,home,19,24,5
9205,1,home,0,6,6
9205,2,work,6,8,2
9205,3,home,8,9,1
9205,4,work,9,11,2
9205,5,home,11,17,6
9205,6,work,17,19,2
9205,7,home,19,24,5
9206,1,home,0,7,7
9206,2,work,7,9,2
9206,3,home,9,10,1
9206,4,work,10,12,2
9206,5,shop,12,13,1
9206,6,work,13,15,2
9206,7,home,15,22,7
9206,8,work,22,23,1
9206,9,home,23,24,1
9207,1,home,0,8,8
9207,2,work,8,15,7
9207,3,home,15,22,7
9207,4,work,22,23,1
9207,5,home,23,24,1
9208,1,home,0,6,6
9208,2,work,6,12,6
9208,3,shop,12,13,1
9208,4,work,13,19,6
9208,5,home,19,24,5
9209,1,home,0,7,7
9209,2,work,7,13,6
9209,3,home,13,17,4
9209,4,work,17,20,3
9209,5,home,20,24,4
9210,1,home,0,7,7
9210,2,work,7,9,2
9210,3,home,9,10,1
9210,4,work,10,12,2
9210,5,home,12,18,6
9210,6,work,18,20,2
9210,7,home,20,24,4
9211,1,home,0,7,7
9211,2,work,7,13,6
9211,3,shop,13,14,1
9211,4,work,14,19,5
9211,5,home,19,24,5
9212,1,home,0,6,6
9212,2,work,6,13,7
9212,3,home,13,21,8
9212,4,work,21,22,1
9212,5,home,22,24,2
9213,1,home,0,8,8
9213,2,work,8,15,7
9213,3,home,15,24,9
9214,1,home,0,8,8
9214,2,work,8,14,6
9214,3,home,14,24,10
9215,1,home,0,6,6
9215,2,shop,6,7,1
9215,3,home,7,9,2
9215,4,work,9,16,7
9215,5,home,16,24,8
9216,1,home,0,6,6
9216,2,work,6,13,7
9216,3,home,13,17,4
9216,4,work,17,20,3
9216,5,home,20,24,4
9217,1,home,0,6,6
9217,2,shop,6,7,1
9217,3,home,7,10,3
9217,4,education,10,12,2
9217,5,home,12,19,7
9217,6,shop,19,21,2
9217,7,home,21,24,3
9218,1,home,0,7,7
9218,2,work,7,14,7
9218,3,shop,14,15,1
9218,4,home,15,23,8
9218,5,work,23,24,1
9219,1,home,0,6,6
9219,2,work,6,13,7
9219,3,shop,13,14,1
9219,4,work,14,19,5
9219,5,home,19,24,5
9220,1,home,0,7,7
9220,2,work,7,8,1
9220,3,home,8,9,1
9220,4,work,9,11,2
9220,5,home,11,17,6
9220,6,work,17,19,2
9220,7,home,19,24,5
9221,1,home,0,7,7
9221,2,shop,7,8,1
9221,3,education,8,12,4
9221,4,home,12,19,7
9221,5,shop,19,21,2
9221,6,home,21,24,3
9222,1,home,0,7,7
9222,2,work,7,13,6
9222,3,shop,13,14,1
9222,4,work,14,19,5
9222,5,home,19,24,5
9223,1,home,0,8,8
9223,2,work,8,15,7
9223,3,home,15,24,9
9224,1,home,0,6,6
9224,2,work,6,13,7
9224,3,home,13,24,11
9225,1,home,0,7,7
9225,2,work,7,14,7
9225,3,home,14,21,7
9225,4,work,21,22,1
9225,5,home,22,24,2
9226,1,home,0,9,9
9226,2,work,9,15,6
9226,3,home,15,22,7
9226,4,work,22,23,1
9226,5,home,23,24,1
9227,1,home,0,7,7
9227,2,work,7,14,7
9227,3,home,14,17,3
9227,4,work,17,20,3
9227,5,home,20,24,4
9228,1,home,0,8,8
9228,2,work,8,15,7
9228,3,home,15,18,3
9228,4,work,18,20,2
9228,5,home,20,24,4
9229,1,home,0,6,6
9229,2,shop,6,7,1
9229,3,work,7,14,7
9229,4,home,14,24,10
9230,1,home,0,6,6
9230,2,shop,6,7,1
9230,3,work,7,14,7
9230,4,home,14,24,10
9231,1,home,0,6,6
9231,2,work,6,8,2
9231,3,home,8,9,1
9231,4,work,9,11,2
9231,5,home,11,15,4
9231,6,work,15,17,2
9231,7,home,17,23,6
9231,8,work,23,24,1
9232,1,home,0,7,7
9232,2,education,7,11,4
9232,3,home,11,19,8
9232,4,shop,19,20,1
9232,5,home,20,24,4
9233,1,home,0,6,6
9233,2,work,6,13,7
9233,3,home,13,24,11
9234,1,home,0,7,7
9234,2,work,7,13,6
9234,3,shop,13,14,1
9234,4,work,14,20,6
9234,5,home,20,24,4
9235,1,home,0,6,6
9235,2,shop,6,7,1
9235,3,home,7,9,2
9235,4,education,9,12,3
9235,5,shop,12,14,2
9235,6,education,14,16,2
9235,7,home,16,24,8
9236,1,home,0,7,7
9236,2,work,7,9,2
9236,3,home,9,14,5
9236,4,shop,14,15,1
9236,5,work,15,17,2
9236,6,home,17,24,7
9237,1,home,0,7,7
9237,2,work,7,14,7
9237,3,shop,14,15,1
9237,4,work,15,20,5
9237,5,home,20,24,4
9238,1,home,0,7,7
9238,2,education,7,11,4
9238,3,home,11,18,7
9238,4,shop,18,19,1
9238,5,home,19,24,5
9239,1,home,0,7,7
9239,2,work,7,14,7
9239,3,shop,14,15,1
9239,4,home,15,24,9
9240,1,home,0,7,7
9240,2,shop,7,8,1
9240,3,education,8,11,3
9240,4,home,11,19,8
9240,5,shop,19,20,1
9240,6,home,20,24,4
9241,1,home,0,7,7
9241,2,shop,7,8,1
9241,3,home,8,13,5
9241,4,work,13,19,6
9241,5,home,19,24,5
9242,1,home,0,8,8
9242,2,education,8,12,4
9242,3,work,12,19,7
9242,4,home,19,24,5
9243,1,home,0,7,7
9243,2,work,7,13,6
9243,3,home,13,15,2
9243,4,work,15,20,5
9243,5,home,20,24,4
9244,1,home,0,8,8
9244,2,work,8,14,6
9244,3,home,14,23,9
9244,4,work,23,24,1
9245,1,home,0,6,6
9245,2,shop,6,7,1
9245,3,home,7,13,6
9245,4,education,13,16,3
9245,5,home,16,24,8
9246,1,home,0,7,7
9246,2,shop,7,8,1
9246,3,education,8,13,5
9246,4,shop,13,15,2
9246,5,home,15,24,9
9247,1,home,0,7,7
9247,2,work,7,9,2
9247,3,home,9,14,5
9247,4,work,14,17,3
9247,5,home,17,21,4
9247,6,work,21,22,1
9247,7,home,22,24,2
9248,1,home,0,7,7
9248,2,work,7,9,2
9248,3,home,9,13,4
9248,4,work,13,16,3
9248,5,shop,16,17,1
9248,6,home,17,22,5
9248,7,work,22,23,1
9248,8,home,23,24,1
9249,1,home,0,7,7
9249,2,education,7,12,5
9249,3,home,12,19,7
9249,4,shop,19,20,1
9249,5,home,20,24,4
9250,1,home,0,6,6
9250,2,work,6,8,2
9250,3,home,8,14,6
9250,4,work,14,16,2
9250,5,home,16,23,7
9250,6,work,23,24,1
9251,1,home,0,7,7
9251,2,work,7,8,1
9251,3,home,8,10,2
9251,4,work,10,12,2
9251,5,home,12,14,2
9251,6,work,14,16,2
9251,7,home,16,22,6
9251,8,work,22,23,1
9251,9,home,23,24,1
9252,1,home,0,7,7
9252,2,education,7,11,4
9252,3,home,11,17,6
9252,4,shop,17,19,2
9252,5,home,19,24,5
9253,1,home,0,7,7
9253,2,shop,7,9,2
9253,3,education,9,11,2
9253,4,home,11,15,4
9253,5,shop,15,17,2
9253,6,home,17,24,7
9254,1,home,0,8,8
9254,2,work,8,15,7
9254,3,shop,15,16,1
9254,4,home,16,22,6
9254,5,work,22,23,1
9254,6,home,23,24,1
9255,1,home,0,8,8
9255,2,work,8,15,7
9255,3,home,15,24,9
9256,1,home,0,8,8
9256,2,education,8,12,4
9256,3,home,12,16,4
9256,4,work,16,20,4
9256,5,home,20,24,4
9257,1,home,0,6,6
9257,2,work,6,13,7
9257,3,home,13,20,7
9257,4,shop,20,21,1
9257,5,home,21,24,3
9258,1,home,0,8,8
9258,2,work,8,15,7
9258,3,home,15,24,9
9259,1,home,0,8,8
9259,2,work,8,14,6
9259,3,shop,14,15,1
9259,4,home,15,24,9
9260,1,home,0,6,6
9260,2,work,6,14,8
9260,3,shop,14,15,1
9260,4,work,15,19,4
9260,5,home,19,24,5
9261,1,home,0,7,7
9261,2,education,7,12,5
9261,3,shop,12,13,1
9261,4,education,13,16,3
9261,5,home,16,24,8
9262,1,home,0,7,7
9262,2,education,7,11,4
9262,3,home,11,17,6
9262,4,shop,17,19,2
9262,5,home,19,24,5
9263,1,home,0,6,6
9263,2,shop,6,7,1
9263,3,work,7,14,7
9263,4,home,14,22,8
9263,5,work,22,23,1
9263,6,home,23,24,1
9264,1,home,0,7,7
9264,2,work,7,13,6
9264,3,home,13,24,11
9265,1,home,0,6,6
9265,2,shop,6,7,1
9265,3,home,7,12,5
9265,4,work,12,14,2
9265,5,home,14,15,1
9265,6,work,15,20,5
9265,7,home,20,24,4
9266,1,home,0,7,7
9266,2,work,7,14,7
9266,3,shop,14,15,1
9266,4,home,15,24,9
9267,1,home,0,8,8
9267,2,education,8,13,5
9267,3,shop,13,15,2
9267,4,home,15,21,6
9267,5,shop,21,22,1
9267,6,home,22,24,2
9268,1,home,0,6,6
9268,2,work,6,8,2
9268,3,home,8,14,6
9268,4,work,14,16,2
9268,5,home,16,22,6
9268,6,work,22,23,1
9268,7,home,23,24,1
9269,1,home,0,7,7
9269,2,education,7,12,5
9269,3,shop,12,14,2
9269,4,education,14,16,2
9269,5,home,16,24,8
9270,1,home,0,7,7
9270,2,shop,7,8,1
9270,3,home,8,12,4
9270,4,education,12,15,3
9270,5,work,15,20,5
9270,6,home,20,24,4
9271,1,home,0,9,9
9271,2,education,9,14,5
9271,3,shop,14,16,2
9271,4,home,16,23,7
9271,5,work,23,24,1
9272,1,home,0,6,6
9272,2,shop,6,7,1
9272,3,work,7,14,7
9272,4,home,14,23,9
9272,5,work,23,24,1
9273,1,home,0,8,8
9273,2,education,8,13,5
9273,3,shop,13,14,1
9273,4,home,14,24,10
9274,1,home,0,6,6
9274,2,shop,6,7,1
9274,3,work,7,13,6
9274,4,home,13,24,11
9275,1,home,0,6,6
9275,2,shop,6,7,1
9275,3,home,7,9,2
9275,4,education,9,12,3
9275,5,shop,12,14,2
9275,6,education,14,16,2
9275,7,home,16,24,8
9276,1,home,0,6,6
9276,2,work,6,8,2
9276,3,home,8,15,7
9276,4,work,15,17,2
9276,5,home,17,23,6
9276,6,work,23,24,1
9277,1,home,0,6,6
9277,2,work,6,7,1
9277,3,home,7,8,1
9277,4,work,8,10,2
9277,5,home,10,15,5
9277,6,work,15,17,2
9277,7,home,17,24,7
9278,1,home,0,7,7
9278,2,education,7,11,4
9278,3,home,11,17,6
9278,4,shop,17,18,1
9278,5,home,18,24,6
9279,1,home,0,8,8
9279,2,education,8,11,3
9279,3,home,11,16,5
9279,4,shop,16,17,1
9279,5,work,17,20,3
9279,6,home,20,24,4
9280,1,home,0,8,8
9280,2,work,8,16,8
9280,3,home,16,24,8
9281,1,home,0,8,8
9281,2,shop,8,9,1
9281,3,work,9,16,7
9281,4,home,16,24,8
9282,1,home,0,7,7
9282,2,work,7,14,7
9282,3,home,14,19,5
9282,4,shop,19,20,1
9282,5,home,20,24,4
9283,1,home,0,7,7
9283,2,work,7,14,7
9283,3,home,14,19,5
9283,4,shop,19,20,1
9283,5,home,20,24,4
9284,1,home,0,7,7
9284,2,shop,7,8,1
9284,3,home,8,16,8
9284,4,shop,16,17,1
9284,5,home,17,23,6
9284,6,work,23,24,1
9285,1,home,0,7,7
9285,2,work,7,14,7
9285,3,home,14,24,10
9286,1,home,0,7,7
9286,2,education,7,12,5
9286,3,home,12,19,7
9286,4,shop,19,21,2
9286,5,home,21,24,3
9287,1,home,0,7,7
9287,2,work,7,13,6
9287,3,home,13,22,9
9287,4,work,22,23,1
9287,5,home,23,24,1
9288,1,home,0,7,7
9288,2,work,7,13,6
9288,3,shop,13,15,2
9288,4,home,15,24,9
9289,1,home,0,6,6
9289,2,shop,6,7,1
9289,3,home,7,13,6
9289,4,education,13,16,3
9289,5,home,16,24,8
9290,1,home,0,6,6
9290,2,work,6,13,7
9290,3,shop,13,14,1
9290,4,home,14,23,9
9290,5,work,23,24,1
9291,1,home,0,6,6
9291,2,work,6,8,2
9291,3,home,8,13,5
9291,4,work,13,16,3
9291,5,home,16,22,6
9291,6,work,22,23,1
9291,7,home,23,24,1
9292,1,home,0,7,7
9292,2,work,7,13,6
9292,3,home,13,24,11
9293,1,home,0,7,7
9293,2,work,7,13,6
9293,3,shop,13,14,1
9293,4,work,14,20,6
9293,5,home,20,24,4
9294,1,home,0,8,8
9294,2,work,8,16,8
9294,3,home,16,23,7
9294,4,work,23,24,1
9295,1,home,0,7,7
9295,2,education,7,11,4
9295,3,home,11,18,7
9295,4,shop,18,19,1
9295,5,home,19,24,5
9296,1,home,0,6,6
9296,2,work,6,8,2
9296,3,home,8,12,4
9296,4,work,12,14,2
9296,5,home,14,22,8
9296,6,work,22,23,1
9296,7,home,23,24,1
9297,1,home,0,6,6
9297,2,shop,6,7,1
9297,3,home,7,10,3
9297,4,education,10,12,2
9297,5,home,12,20,8
9297,6,shop,20,21,1
9297,7,home,21,24,3
9298,1,home,0,6,6
9298,2,work,6,13,7
9298,3,home,13,21,8
9298,4,shop,21,22,1
9298,5,home,22,24,2
9299,1,home,0,6,6
9299,2,work,6,13,7
9299,3,shop,13,14,1
9299,4,work,14,20,6
9299,5,home,20,24,4
9300,1,home,0,9,9
9300,2,education,9,12,3
9300,3,work,12,20,8
9300,4,home,20,24,4
9301,1,home,0,7,7
9301,2,work,7,15,8
9301,3,home,15,24,9
9302,1,home,0,7,7
9302,2,shop,7,8,1
9302,3,work,8,15,7
9302,4,home,15,24,9
9303,1,home,0,8,8
9303,2,work,8,15,7
9303,3,home,15,24,9
9304,1,home,0,8,8
9304,2,work,8,15,7
9304,3,shop,15,16,1
9304,4,home,16,24,8
9305,1,home,0,6,6
9305,2,work,6,13,7
9305,3,home,13,18,5
9305,4,work,18,20,2
9305,5,home,20,24,4
9306,1,home,0,7,7
9306,2,work,7,13,6
9306,3,home,13,20,7
9306,4,shop,20,21,1
9306,5,home,21,24,3
9307,1,home,0,8,8
9307,2,work,8,14,6
9307,3,home,14,23,9
9307,4,work,23,24,1
9308,1,home,0,6,6
9308,2,work,6,13,7
9308,3,home,13,18,5
9308,4,work,18,20,2
9308,5,home,20,24,4
9309,1,home,0,8,8
9309,2,work,8,14,6
9309,3,home,14,24,10
9310,1,home,0,6,6
9310,2,work,6,13,7
9310,3,home,13,18,5
9310,4,work,18,20,2
9310,5,home,20,24,4
9311,1,home,0,7,7
9311,2,work,7,13,6
9311,3,home,13,24,11
9312,1,home,0,6,6
9312,2,work,6,13,7
9312,3,home,13,20,7
9312,4,shop,20,21,1
9312,5,home,21,24,3
9313,1,home,0,6,6
9313,2,work,6,12,6
9313,3,shop,12,13,1
9313,4,work,13,19,6
9313,5,home,19,24,5
9314,1,home,0,7,7
9314,2,work,7,13,6
9314,3,home,13,24,11
9315,1,home,0,6,6
9315,2,work,6,8,2
9315,3,home,8,9,1
9315,4,work,9,10,1
9315,5,home,10,15,5
9315,6,work,15,18,3
9315,7,home,18,21,3
9315,8,shop,21,22,1
9315,9,home,22,24,2
9316,1,home,0,7,7
9316,2,work,7,13,6
9316,3,home,13,15,2
9316,4,work,15,20,5
9316,5,home,20,24,4
9317,1,home,0,6,6
9317,2,shop,6,7,1
9317,3,work,7,14,7
9317,4,home,14,24,10
9318,1,home,0,7,7
9318,2,shop,7,8,1
9318,3,home,8,9,1
9318,4,work,9,16,7
9318,5,home,16,24,8
9319,1,home,0,6,6
9319,2,shop,6,7,1
9319,3,home,7,9,2
9319,4,education,9,12,3
9319,5,shop,12,13,1
9319,6,education,13,16,3
9319,7,home,16,24,8
9320,1,home,0,7,7
9320,2,shop,7,8,1
9320,3,work,8,14,6
9320,4,home,14,24,10
9321,1,home,0,7,7
9321,2,work,7,14,7
9321,3,home,14,24,10
9322,1,home,0,7,7
9322,2,shop,7,8,1
9322,3,home,8,13,5
9322,4,education,13,16,3
9322,5,home,16,24,8
9323,1,home,0,7,7
9323,2,work,7,13,6
9323,3,home,13,17,4
9323,4,work,17,20,3
9323,5,home,20,24,4
9324,1,home,0,7,7
9324,2,education,7,11,4
9324,3,home,11,19,8
9324,4,shop,19,20,1
9324,5,home,20,24,4
9325,1,home,0,7,7
9325,2,shop,7,9,2
9325,3,education,9,14,5
9325,4,shop,14,16,2
9325,5,home,16,24,8
9326,1,home,0,6,6
9326,2,work,6,8,2
9326,3,home,8,14,6
9326,4,work,14,17,3
9326,5,home,17,24,7
9327,1,home,0,7,7
9327,2,work,7,13,6
9327,3,home,13,24,11
9328,1,home,0,6,6
9328,2,work,6,8,2
9328,3,home,8,14,6
9328,4,work,14,17,3
9328,5,home,17,24,7
9329,1,home,0,7,7
9329,2,work,7,14,7
9329,3,shop,14,15,1
9329,4,home,15,16,1
9329,5,work,16,20,4
9329,6,home,20,24,4
9330,1,home,0,7,7
9330,2,education,7,12,5
9330,3,home,12,19,7
9330,4,shop,19,20,1
9330,5,home,20,24,4
9331,1,home,0,7,7
9331,2,work,7,14,7
9331,3,home,14,24,10
9332,1,home,0,7,7
9332,2,work,7,13,6
9332,3,home,13,18,5
9332,4,work,18,20,2
9332,5,home,20,24,4
9333,1,home,0,8,8
9333,2,work,8,15,7
9333,3,home,15,24,9
9334,1,home,0,9,9
9334,2,work,9,16,7
9334,3,home,16,24,8
9335,1,home,0,7,7
9335,2,shop,7,8,1
9335,3,education,8,11,3
9335,4,home,11,17,6
9335,5,shop,17,18,1
9335,6,home,18,24,6
9336,1,home,0,7,7
9336,2,shop,7,9,2
9336,3,education,9,12,3
9336,4,shop,12,13,1
9336,5,education,13,16,3
9336,6,home,16,24,8
9337,1,home,0,7,7
9337,2,shop,7,8,1
9337,3,work,8,17,9
9337,4,home,17,24,7
9338,1,home,0,6,6
9338,2,work,6,13,7
9338,3,shop,13,14,1
9338,4,work,14,20,6
9338,5,home,20,24,4
9339,1,home,0,6,6
9339,2,shop,6,7,1
9339,3,home,7,13,6
9339,4,education,13,16,3
9339,5,home,16,24,8
9340,1,home,0,7,7
9340,2,education,7,12,5
9340,3,shop,12,14,2
9340,4,education,14,16,2
9340,5,home,16,24,8
9341,1,home,0,6,6
9341,2,work,6,8,2
9341,3,home,8,14,6
9341,4,shop,14,15,1
9341,5,work,15,17,2
9341,6,home,17,24,7
9342,1,home,0,8,8
9342,2,shop,8,9,1
9342,3,home,9,14,5
9342,4,shop,14,15,1
9342,5,work,15,20,5
9342,6,home,20,24,4
9343,1,home,0,6,6
9343,2,work,6,13,7
9343,3,shop,13,14,1
9343,4,work,14,19,5
9343,5,home,19,24,5
9344,1,home,0,6,6
9344,2,work,6,13,7
9344,3,home,13,24,11
9345,1,home,0,7,7
9345,2,shop,7,8,1
9345,3,education,8,12,4
9345,4,home,12,18,6
9345,5,shop,18,19,1
9345,6,home,19,24,5
9346,1,home,0,8,8
9346,2,work,8,14,6
9346,3,shop,14,15,1
9346,4,home,15,21,6
9346,5,work,21,22,1
9346,6,home,22,24,2
9347,1,home,0,6,6
9347,2,work,6,13,7
9347,3,home,13,22,9
9347,4,work,22,23,1
9347,5,home,23,24,1
9348,1,home,0,7,7
9348,2,work,7,13,6
9348,3,home,13,21,8
9348,4,work,21,22,1
9348,5,home,22,24,2
9349,1,home,0,7,7
9349,2,shop,7,8,1
9349,3,education,8,11,3
9349,4,home,11,19,8
9349,5,shop,19,21,2
9349,6,home,21,24,3
9350,1,home,0,7,7
9350,2,work,7,13,6
9350,3,shop,13,14,1
9350,4,home,14,24,10
9351,1,home,0,7,7
9351,2,work,7,13,6
9351,3,shop,13,14,1
9351,4,home,14,23,9
9351,5,work,23,24,1
9352,1,home,0,6,6
9352,2,shop,6,7,1
9352,3,work,7,13,6
9352,4,home,13,24,11
9353,1,home,0,7,7
9353,2,work,7,13,6
9353,3,home,13,17,4
9353,4,shop,17,18,1
9353,5,home,18,24,6
9354,1,home,0,6,6
9354,2,shop,6,7,1
9354,3,home,7,8,1
9354,4,education,8,12,4
9354,5,home,12,19,7
9354,6,shop,19,21,2
9354,7,home,21,24,3
9355,1,home,0,7,7
9355,2,work,7,14,7
9355,3,shop,14,15,1
9355,4,home,15,24,9
9356,1,home,0,7,7
9356,2,work,7,14,7
9356,3,home,14,21,7
9356,4,work,21,22,1
9356,5,home,22,24,2
9357,1,home,0,7,7
9357,2,work,7,10,3
9357,3,home,10,16,6
9357,4,work,16,18,2
9357,5,home,18,21,3
9357,6,work,21,22,1
9357,7,home,22,24,2
9358,1,home,0,7,7
9358,2,education,7,12,5
9358,3,shop,12,14,2
9358,4,education,14,16,2
9358,5,shop,16,17,1
9358,6,home,17,24,7
9359,1,home,0,7,7
9359,2,work,7,13,6
9359,3,home,13,24,11
9360,1,home,0,7,7
9360,2,shop,7,8,1
9360,3,education,8,12,4
9360,4,shop,12,13,1
9360,5,education,13,16,3
9360,6,home,16,24,8
9361,1,home,0,8,8
9361,2,work,8,14,6
9361,3,home,14,22,8
9361,4,work,22,23,1
9361,5,home,23,24,1
9362,1,home,0,7,7
9362,2,work,7,12,5
9362,3,shop,12,13,1
9362,4,education,13,16,3
9362,5,home,16,21,5
9362,6,work,21,22,1
9362,7,home,22,24,2
9363,1,home,0,8,8
9363,2,work,8,14,6
9363,3,home,14,15,1
9363,4,work,15,20,5
9363,5,home,20,24,4
9364,1,home,0,6,6
9364,2,work,6,13,7
9364,3,home,13,23,10
9364,4,work,23,24,1
9365,1,home,0,6,6
9365,2,work,6,13,7
9365,3,shop,13,14,1
9365,4,home,14,23,9
9365,5,work,23,24,1
9366,1,home,0,8,8
9366,2,work,8,14,6
9366,3,home,14,23,9
9366,4,work,23,24,1
9367,1,home,0,7,7
9367,2,shop,7,8,1
9367,3,work,8,15,7
9367,4,home,15,24,9
9368,1,home,0,7,7
9368,2,shop,7,8,1
9368,3,education,8,11,3
9368,4,home,11,14,3
9368,5,education,14,16,2
9368,6,home,16,24,8
9369,1,home,0,6,6
9369,2,shop,6,7,1
9369,3,work,7,13,6
9369,4,home,13,17,4
9369,5,shop,17,18,1
9369,6,home,18,24,6
9370,1,home,0,7,7
9370,2,work,7,9,2
9370,3,home,9,15,6
9370,4,work,15,17,2
9370,5,home,17,21,4
9370,6,work,21,22,1
9370,7,home,22,24,2
9371,1,home,0,7,7
9371,2,shop,7,8,1
9371,3,education,8,12,4
9371,4,home,12,18,6
9371,5,shop,18,19,1
9371,6,home,19,24,5
9372,1,home,0,7,7
9372,2,work,7,13,6
9372,3,home,13,24,11
9373,1,home,0,9,9
9373,2,work,9,13,4
9373,3,shop,13,14,1
9373,4,work,14,19,5
9373,5,home,19,24,5
9374,1,home,0,6,6
9374,2,work,6,8,2
9374,3,home,8,12,4
9374,4,work,12,14,2
9374,5,home,14,22,8
9374,6,work,22,23,1
9374,7,home,23,24,1
9375,1,home,0,8,8
9375,2,work,8,14,6
9375,3,home,14,20,6
9375,4,shop,20,21,1
9375,5,home,21,24,3
9376,1,home,0,7,7
9376,2,education,7,11,4
9376,3,home,11,18,7
9376,4,shop,18,19,1
9376,5,home,19,24,5
9377,1,home,0,9,9
9377,2,education,9,12,3
9377,3,home,12,16,4
9377,4,shop,16,17,1
9377,5,home,17,24,7
9378,1,home,0,8,8
9378,2,work,8,15,7
9378,3,home,15,24,9
9379,1,home,0,6,6
9379,2,work,6,9,3
9379,3,home,9,11,2
9379,4,work,11,13,2
9379,5,home,13,21,8
9379,6,work,21,22,1
9379,7,home,22,24,2
9380,1,home,0,6,6
9380,2,work,6,8,2
9380,3,home,8,14,6
9380,4,work,14,17,3
9380,5,home,17,23,6
9380,6,work,23,24,1
9381,1,home,0,7,7
9381,2,education,7,12,5
9381,3,home,12,17,5
9381,4,shop,17,19,2
9381,5,home,19,24,5
9382,1,home,0,7,7
9382,2,work,7,9,2
9382,3,home,9,15,6
9382,4,work,15,17,2
9382,5,home,17,22,5
9382,6,work,22,23,1
9382,7,home,23,24,1
9383,1,home,0,9,9
9383,2,work,9,16,7
9383,3,shop,16,17,1
9383,4,home,17,24,7
9384,1,home,0,8,8
9384,2,work,8,15,7
9384,3,home,15,24,9
9385,1,home,0,8,8
9385,2,education,8,11,3
9385,3,shop,11,12,1
9385,4,work,12,19,7
9385,5,home,19,24,5
9386,1,home,0,7,7
9386,2,education,7,12,5
9386,3,shop,12,14,2
9386,4,education,14,16,2
9386,5,home,16,24,8
9387,1,home,0,6,6
9387,2,work,6,13,7
9387,3,home,13,18,5
9387,4,work,18,20,2
9387,5,home,20,24,4
9388,1,home,0,8,8
9388,2,work,8,14,6
9388,3,home,14,20,6
9388,4,shop,20,21,1
9388,5,home,21,24,3
9389,1,home,0,7,7
9389,2,work,7,14,7
9389,3,home,14,24,10
9390,1,home,0,7,7
9390,2,education,7,12,5
9390,3,shop,12,14,2
9390,4,home,14,19,5
9390,5,shop,19,20,1
9390,6,home,20,24,4
9391,1,home,0,8,8
9391,2,work,8,14,6
9391,3,shop,14,15,1
9391,4,home,15,24,9
9392,1,home,0,8,8
9392,2,education,8,11,3
9392,3,home,11,24,13
9393,1,home,0,6,6
9393,2,work,6,7,1
9393,3,home,7,9,2
9393,4,work,9,10,1
9393,5,home,10,15,5
9393,6,work,15,18,3
9393,7,home,18,24,6
9394,1,home,0,8,8
9394,2,work,8,14,6
9394,3,home,14,24,10
9395,1,home,0,8,8
9395,2,work,8,15,7
9395,3,home,15,21,6
9395,4,work,21,22,1
9395,5,home,22,24,2
9396,1,home,0,6,6
9396,2,work,6,13,7
9396,3,home,13,17,4
9396,4,work,17,20,3
9396,5,home,20,24,4
9397,1,home,0,7,7
9397,2,work,7,14,7
9397,3,shop,14,16,2
9397,4,work,16,20,4
9397,5,home,20,24,4
9398,1,home,0,7,7
9398,2,shop,7,9,2
9398,3,education,9,12,3
9398,4,shop,12,14,2
9398,5,home,14,20,6
9398,6,shop,20,21,1
9398,7,home,21,24,3
9399,1,home,0,6,6
9399,2,work,6,13,7
9399,3,shop,13,14,1
9399,4,work,14,19,5
9399,5,home,19,24,5
9400,1,home,0,7,7
9400,2,work,7,14,7
9400,3,shop,14,15,1
9400,4,work,15,20,5
9400,5,home,20,24,4
9401,1,home,0,6,6
9401,2,work,6,13,7
9401,3,shop,13,14,1
9401,4,work,14,20,6
9401,5,home,20,24,4
9402,1,home,0,6,6
9402,2,work,6,13,7
9402,3,shop,13,14,1
9402,4,work,14,19,5
9402,5,home,19,24,5
9403,1,home,0,6,6
9403,2,work,6,13,7
9403,3,shop,13,14,1
9403,4,work,14,18,4
9403,5,home,18,24,6
9404,1,home,0,8,8
9404,2,work,8,15,7
9404,3,home,15,23,8
9404,4,work,23,24,1
9405,1,home,0,7,7
9405,2,education,7,11,4
9405,3,home,11,17,6
9405,4,shop,17,18,1
9405,5,home,18,24,6
9406,1,home,0,6,6
9406,2,shop,6,7,1
9406,3,home,7,9,2
9406,4,education,9,12,3
9406,5,shop,12,14,2
9406,6,education,14,16,2
9406,7,home,16,24,8
9407,1,home,0,7,7
9407,2,education,7,11,4
9407,3,home,11,18,7
9407,4,shop,18,20,2
9407,5,home,20,24,4
9408,1,home,0,6,6
9408,2,work,6,13,7
9408,3,home,13,20,7
9408,4,shop,20,21,1
9408,5,home,21,24,3
9409,1,home,0,7,7
9409,2,work,7,14,7
9409,3,shop,14,15,1
9409,4,home,15,24,9
9410,1,home,0,7,7
9410,2,work,7,9,2
9410,3,home,9,10,1
9410,4,work,10,11,1
9410,5,home,11,17,6
9410,6,work,17,19,2
9410,7,home,19,24,5
9411,1,home,0,6,6
9411,2,work,6,13,7
9411,3,shop,13,14,1
9411,4,home,14,21,7
9411,5,work,21,22,1
9411,6,home,22,24,2
9412,1,home,0,6,6
9412,2,shop,6,7,1
9412,3,home,7,10,3
9412,4,education,10,13,3
9412,5,shop,13,15,2
9412,6,home,15,21,6
9412,7,shop,21,22,1
9412,8,home,22,24,2
9413,1,home,0,10,10
9413,2,work,10,13,3
9413,3,home,13,17,4
9413,4,work,17,20,3
9413,5,home,20,24,4
9414,1,home,0,8,8
9414,2,work,8,14,6
9414,3,shop,14,15,1
9414,4,home,15,24,9
9415,1,home,0,7,7
9415,2,shop,7,8,1
9415,3,work,8,15,7
9415,4,home,15,23,8
9415,5,work,23,24,1
9416,1,home,0,7,7
9416,2,work,7,14,7
9416,3,home,14,22,8
9416,4,work,22,23,1
9416,5,home,23,24,1
9417,1,home,0,7,7
9417,2,education,7,11,4
9417,3,home,11,14,3
9417,4,education,14,16,2
9417,5,home,16,24,8
9418,1,home,0,7,7
9418,2,work,7,14,7
9418,3,shop,14,15,1
9418,4,home,15,24,9
9419,1,home,0,8,8
9419,2,work,8,15,7
9419,3,home,15,19,4
9419,4,shop,19,20,1
9419,5,home,20,23,3
9419,6,work,23,24,1
9420,1,home,0,6,6
9420,2,shop,6,7,1
9420,3,home,7,10,3
9420,4,education,10,15,5
9420,5,shop,15,16,1
9420,6,home,16,24,8
9421,1,home,0,7,7
9421,2,work,7,14,7
9421,3,home,14,20,6
9421,4,shop,20,21,1
9421,5,home,21,24,3
9422,1,home,0,6,6
9422,2,work,6,14,8
9422,3,shop,14,15,1
9422,4,work,15,20,5
9422,5,home,20,24,4
9423,1,home,0,7,7
9423,2,shop,7,8,1
9423,3,education,8,11,3
9423,4,home,11,14,3
9423,5,education,14,16,2
9423,6,shop,16,18,2
9423,7,home,18,24,6
9424,1,home,0,6,6
9424,2,shop,6,7,1
9424,3,home,7,8,1
9424,4,education,8,12,4
9424,5,work,12,19,7
9424,6,home,19,24,5
9425,1,home,0,7,7
9425,2,work,7,13,6
9425,3,home,13,24,11
9426,1,home,0,7,7
9426,2,work,7,13,6
9426,3,home,13,20,7
9426,4,shop,20,21,1
9426,5,home,21,24,3
9427,1,home,0,6,6
9427,2,work,6,8,2
9427,3,home,8,13,5
9427,4,work,13,16,3
9427,5,home,16,24,8
9428,1,home,0,6,6
9428,2,work,6,13,7
9428,3,home,13,23,10
9428,4,work,23,24,1
9429,1,home,0,9,9
9429,2,work,9,16,7
9429,3,home,16,20,4
9429,4,shop,20,21,1
9429,5,home,21,24,3
9430,1,home,0,7,7
9430,2,work,7,15,8
9430,3,home,15,18,3
9430,4,work,18,20,2
9430,5,home,20,24,4
9431,1,home,0,7,7
9431,2,work,7,13,6
9431,3,shop,13,14,1
9431,4,home,14,24,10
9432,1,home,0,8,8
9432,2,work,8,13,5
9432,3,home,13,18,5
9432,4,work,18,20,2
9432,5,home,20,24,4
9433,1,home,0,7,7
9433,2,work,7,14,7
9433,3,home,14,24,10
9434,1,home,0,8,8
9434,2,work,8,15,7
9434,3,home,15,21,6
9434,4,work,21,22,1
9434,5,home,22,24,2
9435,1,home,0,8,8
9435,2,shop,8,9,1
9435,3,work,9,15,6
9435,4,home,15,22,7
9435,5,work,22,23,1
9435,6,home,23,24,1
9436,1,home,0,7,7
9436,2,work,7,13,6
9436,3,shop,13,14,1
9436,4,home,14,22,8
9436,5,work,22,23,1
9436,6,home,23,24,1
9437,1,home,0,7,7
9437,2,work,7,14,7
9437,3,home,14,18,4
9437,4,work,18,20,2
9437,5,home,20,24,4
9438,1,home,0,8,8
9438,2,work,8,15,7
9438,3,home,15,21,6
9438,4,work,21,22,1
9438,5,home,22,24,2
9439,1,home,0,7,7
9439,2,work,7,9,2
9439,3,home,9,16,7
9439,4,work,16,18,2
9439,5,home,18,24,6
9440,1,home,0,7,7
9440,2,work,7,14,7
9440,3,home,14,24,10
9441,1,home,0,7,7
9441,2,education,7,12,5
9441,3,home,12,20,8
9441,4,shop,20,21,1
9441,5,home,21,24,3
9442,1,home,0,6,6
9442,2,work,6,13,7
9442,3,home,13,17,4
9442,4,work,17,20,3
9442,5,home,20,24,4
9443,1,home,0,9,9
9443,2,education,9,16,7
9443,3,home,16,24,8
9444,1,home,0,8,8
9444,2,education,8,11,3
9444,3,home,11,24,13
9445,1,home,0,7,7
9445,2,work,7,14,7
9445,3,shop,14,15,1
9445,4,work,15,20,5
9445,5,home,20,24,4
9446,1,home,0,6,6
9446,2,work,6,13,7
9446,3,shop,13,14,1
9446,4,home,14,21,7
9446,5,shop,21,22,1
9446,6,home,22,24,2
9447,1,home,0,7,7
9447,2,work,7,13,6
9447,3,shop,13,14,1
9447,4,work,14,20,6
9447,5,home,20,24,4
9448,1,home,0,6,6
9448,2,shop,6,7,1
9448,3,home,7,9,2
9448,4,work,9,15,6
9448,5,home,15,24,9
9449,1,home,0,8,8
9449,2,work,8,14,6
9449,3,home,14,24,10
9450,1,home,0,6,6
9450,2,work,6,8,2
9450,3,home,8,14,6
9450,4,work,14,16,2
9450,5,home,16,23,7
9450,6,work,23,24,1
9451,1,home,0,6,6
9451,2,work,6,8,2
9451,3,home,8,9,1
9451,4,work,9,11,2
9451,5,home,11,15,4
9451,6,work,15,17,2
9451,7,home,17,24,7
9452,1,home,0,6,6
9452,2,work,6,13,7
9452,3,home,13,24,11
9453,1,home,0,8,8
9453,2,work,8,14,6
9453,3,home,14,22,8
9453,4,work,22,23,1
9453,5,home,23,24,1
9454,1,home,0,8,8
9454,2,work,8,15,7
9454,3,shop,15,16,1
9454,4,home,16,24,8
9455,1,home,0,7,7
9455,2,education,7,12,5
9455,3,home,12,16,4
9455,4,shop,16,17,1
9455,5,home,17,24,7
9456,1,home,0,8,8
9456,2,work,8,10,2
9456,3,home,10,14,4
9456,4,work,14,16,2
9456,5,home,16,22,6
9456,6,work,22,23,1
9456,7,home,23,24,1
9457,1,home,0,7,7
9457,2,work,7,14,7
9457,3,shop,14,15,1
9457,4,home,15,24,9
9458,1,home,0,8,8
9458,2,work,8,16,8
9458,3,home,16,24,8
9459,1,home,0,7,7
9459,2,work,7,14,7
9459,3,home,14,24,10
9460,1,home,0,7,7
9460,2,work,7,13,6
9460,3,shop,13,14,1
9460,4,home,14,21,7
9460,5,shop,21,22,1
9460,6,home,22,24,2
9461,1,home,0,6,6
9461,2,work,6,8,2
9461,3,home,8,12,4
9461,4,work,12,14,2
9461,5,home,14,18,4
9461,6,work,18,19,1
9461,7,home,19,23,4
9461,8,work,23,24,1
9462,1,home,0,6,6
9462,2,work,6,8,2
9462,3,shop,8,9,1
9462,4,work,9,11,2
9462,5,home,11,16,5
9462,6,work,16,19,3
9462,7,home,19,24,5
9463,1,home,0,7,7
9463,2,work,7,14,7
9463,3,home,14,18,4
9463,4,work,18,20,2
9463,5,home,20,24,4
9464,1,home,0,7,7
9464,2,work,7,13,6
9464,3,shop,13,14,1
9464,4,work,14,20,6
9464,5,home,20,24,4
9465,1,home,0,7,7
9465,2,shop,7,8,1
9465,3,work,8,15,7
9465,4,home,15,24,9
9466,1,home,0,6,6
9466,2,work,6,13,7
9466,3,home,13,24,11
9467,1,home,0,6,6
9467,2,shop,6,7,1
9467,3,work,7,13,6
9467,4,home,13,17,4
9467,5,work,17,20,3
9467,6,home,20,24,4
9468,1,home,0,7,7
9468,2,work,7,14,7
9468,3,home,14,18,4
9468,4,work,18,20,2
9468,5,home,20,24,4
9469,1,home,0,8,8
9469,2,work,8,15,7
9469,3,home,15,21,6
9469,4,work,21,22,1
9469,5,home,22,24,2
9470,1,home,0,6,6
9470,2,work,6,13,7
9470,3,shop,13,14,1
9470,4,work,14,20,6
9470,5,home,20,24,4
9471,1,home,0,7,7
9471,2,work,7,13,6
9471,3,shop,13,14,1
9471,4,work,14,20,6
9471,5,home,20,24,4
9472,1,home,0,8,8
9472,2,work,8,14,6
9472,3,home,14,22,8
9472,4,work,22,23,1
9472,5,home,23,24,1
9473,1,home,0,8,8
9473,2,work,8,16,8
9473,3,home,16,21,5
9473,4,work,21,22,1
9473,5,home,22,24,2
9474,1,home,0,7,7
9474,2,work,7,15,8
9474,3,home,15,24,9
9475,1,home,0,6,6
9475,2,shop,6,7,1
9475,3,home,7,9,2
9475,4,education,9,12,3
9475,5,home,12,19,7
9475,6,shop,19,20,1
9475,7,home,20,24,4
9476,1,home,0,6,6
9476,2,work,6,8,2
9476,3,home,8,13,5
9476,4,work,13,15,2
9476,5,home,15,23,8
9476,6,work,23,24,1
9477,1,home,0,7,7
9477,2,education,7,12,5
9477,3,home,12,19,7
9477,4,shop,19,20,1
9477,5,home,20,24,4
9478,1,home,0,7,7
9478,2,education,7,12,5
9478,3,shop,12,14,2
9478,4,education,14,16,2
9478,5,home,16,24,8
9479,1,home,0,8,8
9479,2,work,8,14,6
9479,3,shop,14,15,1
9479,4,home,15,24,9
9480,1,home,0,8,8
9480,2,work,8,17,9
9480,3,home,17,22,5
9480,4,work,22,23,1
9480,5,home,23,24,1
9481,1,home,0,8,8
9481,2,work,8,16,8
9481,3,home,16,24,8
9482,1,home,0,7,7
9482,2,work,7,13,6
9482,3,home,13,24,11
9483,1,home,0,8,8
9483,2,work,8,15,7
9483,3,home,15,24,9
9484,1,home,0,8,8
9484,2,work,8,15,7
9484,3,home,15,24,9
9485,1,home,0,8,8
9485,2,work,8,15,7
9485,3,shop,15,16,1
9485,4,home,16,24,8
9486,1,home,0,7,7
9486,2,work,7,13,6
9486,3,home,13,21,8
9486,4,shop,21,22,1
9486,5,home,22,24,2
9487,1,home,0,7,7
9487,2,work,7,14,7
9487,3,home,14,24,10
9488,1,home,0,7,7
9488,2,work,7,14,7
9488,3,home,14,24,10
9489,1,home,0,7,7
9489,2,education,7,11,4
9489,3,home,11,17,6
9489,4,shop,17,18,1
9489,5,home,18,24,6
9490,1,home,0,7,7
9490,2,work,7,13,6
9490,3,shop,13,14,1
9490,4,work,14,19,5
9490,5,home,19,24,5
9491,1,home,0,9,9
9491,2,work,9,15,6
9491,3,shop,15,16,1
9491,4,home,16,24,8
9492,1,home,0,7,7
9492,2,work,7,14,7
9492,3,shop,14,15,1
9492,4,home,15,24,9
9493,1,home,0,6,6
9493,2,work,6,8,2
9493,3,home,8,12,4
9493,4,work,12,13,1
9493,5,home,13,16,3
9493,6,work,16,18,2
9493,7,home,18,24,6
9494,1,home,0,7,7
9494,2,education,7,11,4
9494,3,home,11,18,7
9494,4,shop,18,19,1
9494,5,home,19,24,5
9495,1,home,0,7,7
9495,2,shop,7,8,1
9495,3,education,8,11,3
9495,4,home,11,13,2
9495,5,education,13,16,3
9495,6,home,16,24,8
9496,1,home,0,7,7
9496,2,education,7,11,4
9496,3,home,11,19,8
9496,4,shop,19,20,1
9496,5,home,20,24,4
9497,1,home,0,7,7
9497,2,work,7,9,2
9497,3,home,9,16,7
9497,4,work,16,18,2
9497,5,home,18,24,6
9498,1,home,0,6,6
9498,2,work,6,13,7
9498,3,home,13,24,11
9499,1,home,0,7,7
9499,2,work,7,14,7
9499,3,home,14,23,9
9499,4,work,23,24,1
9500,1,home,0,7,7
9500,2,work,7,12,5
9500,3,shop,12,13,1
9500,4,education,13,15,2
9500,5,work,15,19,4
9500,6,home,19,24,5
9501,1,home,0,7,7
9501,2,shop,7,8,1
9501,3,work,8,15,7
9501,4,home,15,24,9
9502,1,home,0,7,7
9502,2,work,7,13,6
9502,3,home,13,20,7
9502,4,shop,20,21,1
9502,5,home,21,24,3
9503,1,home,0,7,7
9503,2,work,7,13,6
9503,3,home,13,18,5
9503,4,shop,18,19,1
9503,5,home,19,24,5
9504,1,home,0,7,7
9504,2,shop,7,8,1
9504,3,home,8,21,13
9504,4,work,21,22,1
9504,5,home,22,24,2
9505,1,home,0,7,7
9505,2,work,7,13,6
9505,3,home,13,18,5
9505,4,work,18,20,2
9505,5,home,20,24,4
9506,1,home,0,7,7
9506,2,work,7,13,6
9506,3,home,13,18,5
9506,4,work,18,20,2
9506,5,home,20,24,4
9507,1,home,0,8,8
9507,2,work,8,16,8
9507,3,shop,16,17,1
9507,4,home,17,24,7
9508,1,home,0,7,7
9508,2,work,7,14,7
9508,3,home,14,21,7
9508,4,work,21,22,1
9508,5,home,22,24,2
9509,1,home,0,7,7
9509,2,education,7,11,4
9509,3,home,11,17,6
9509,4,shop,17,18,1
9509,5,home,18,24,6
9510,1,home,0,7,7
9510,2,work,7,14,7
9510,3,home,14,18,4
9510,4,shop,18,19,1
9510,5,home,19,24,5
9511,1,home,0,6,6
9511,2,shop,6,7,1
9511,3,work,7,13,6
9511,4,home,13,18,5
9511,5,work,18,20,2
9511,6,home,20,24,4
9512,1,home,0,7,7
9512,2,shop,7,8,1
9512,3,home,8,12,4
9512,4,work,12,18,6
9512,5,home,18,24,6
9513,1,home,0,7,7
9513,2,work,7,13,6
9513,3,home,13,24,11
9514,1,home,0,7,7
9514,2,education,7,12,5
9514,3,home,12,21,9
9514,4,shop,21,22,1
9514,5,home,22,24,2
9515,1,home,0,8,8
9515,2,work,8,15,7
9515,3,home,15,24,9
9516,1,home,0,7,7
9516,2,work,7,13,6
9516,3,shop,13,14,1
9516,4,work,14,19,5
9516,5,home,19,24,5
9517,1,home,0,7,7
9517,2,work,7,8,1
9517,3,home,8,14,6
9517,4,work,14,16,2
9517,5,home,16,22,6
9517,6,work,22,23,1
9517,7,home,23,24,1
9518,1,home,0,6,6
9518,2,work,6,13,7
9518,3,home,13,16,3
9518,4,work,16,20,4
9518,5,home,20,24,4
9519,1,home,0,8,8
9519,2,work,8,14,6
9519,3,shop,14,15,1
9519,4,work,15,20,5
9519,5,home,20,24,4
9520,1,home,0,7,7
9520,2,shop,7,8,1
9520,3,work,8,16,8
9520,4,home,16,24,8
9521,1,home,0,8,8
9521,2,work,8,15,7
9521,3,home,15,24,9
9522,1,home,0,7,7
9522,2,education,7,12,5
9522,3,home,12,19,7
9522,4,shop,19,20,1
9522,5,home,20,24,4
9523,1,home,0,6,6
9523,2,work,6,8,2
9523,3,home,8,14,6
9523,4,work,14,17,3
9523,5,home,17,23,6
9523,6,work,23,24,1
9524,1,home,0,9,9
9524,2,work,9,13,4
9524,3,home,13,21,8
9524,4,shop,21,22,1
9524,5,home,22,24,2
9525,1,home,0,8,8
9525,2,work,8,15,7
9525,3,home,15,21,6
9525,4,work,21,22,1
9525,5,home,22,24,2
9526,1,home,0,6,6
9526,2,work,6,13,7
9526,3,shop,13,15,2
9526,4,work,15,20,5
9526,5,home,20,24,4
9527,1,home,0,7,7
9527,2,work,7,13,6
9527,3,shop,13,14,1
9527,4,home,14,24,10
9528,1,home,0,6,6
9528,2,shop,6,7,1
9528,3,work,7,13,6
9528,4,home,13,18,5
9528,5,work,18,20,2
9528,6,home,20,24,4
9529,1,home,0,6,6
9529,2,work,6,13,7
9529,3,home,13,24,11
9530,1,home,0,7,7
9530,2,work,7,14,7
9530,3,home,14,19,5
9530,4,shop,19,20,1
9530,5,home,20,24,4
9531,1,work,0,1,1
9531,2,home,1,8,7
9531,3,education,8,11,3
9531,4,home,11,14,3
9531,5,education,14,16,2
9531,6,home,16,24,8
9532,1,home,0,7,7
9532,2,work,7,13,6
9532,3,shop,13,14,1
9532,4,home,14,24,10
9533,1,home,0,7,7
9533,2,work,7,14,7
9533,3,shop,14,15,1
9533,4,work,15,20,5
9533,5,home,20,24,4
9534,1,home,0,7,7
9534,2,shop,7,8,1
9534,3,work,8,15,7
9534,4,shop,15,16,1
9534,5,home,16,24,8
9535,1,home,0,8,8
9535,2,education,8,11,3
9535,3,home,11,20,9
9535,4,shop,20,21,1
9535,5,home,21,24,3
9536,1,home,0,7,7
9536,2,work,7,14,7
9536,3,home,14,22,8
9536,4,work,22,23,1
9536,5,home,23,24,1
9537,1,home,0,6,6
9537,2,work,6,7,1
9537,3,home,7,8,1
9537,4,work,8,10,2
9537,5,home,10,16,6
9537,6,work,16,18,2
9537,7,home,18,24,6
9538,1,home,0,6,6
9538,2,work,6,13,7
9538,3,home,13,22,9
9538,4,work,22,23,1
9538,5,home,23,24,1
9539,1,home,0,8,8
9539,2,work,8,16,8
9539,3,home,16,24,8
9540,1,home,0,7,7
9540,2,work,7,14,7
9540,3,home,14,17,3
9540,4,shop,17,18,1
9540,5,home,18,24,6
9541,1,home,0,7,7
9541,2,work,7,9,2
9541,3,home,9,15,6
9541,4,work,15,17,2
9541,5,home,17,23,6
9541,6,work,23,24,1
9542,1,home,0,6,6
9542,2,work,6,8,2
9542,3,home,8,14,6
9542,4,work,14,17,3
9542,5,home,17,24,7
9543,1,home,0,8,8
9543,2,education,8,13,5
9543,3,home,13,17,4
9543,4,work,17,20,3
9543,5,home,20,24,4
9544,1,home,0,8,8
9544,2,work,8,16,8
9544,3,home,16,24,8
9545,1,home,0,8,8
9545,2,work,8,15,7
9545,3,home,15,24,9
9546,1,home,0,7,7
9546,2,work,7,15,8
9546,3,shop,15,16,1
9546,4,work,16,20,4
9546,5,home,20,24,4
9547,1,home,0,8,8
9547,2,education,8,10,2
9547,3,home,10,14,4
9547,4,education,14,17,3
9547,5,home,17,24,7
9548,1,home,0,8,8
9548,2,work,8,14,6
9548,3,home,14,24,10
9549,1,home,0,7,7
9549,2,work,7,13,6
9549,3,shop,13,15,2
9549,4,home,15,24,9
9550,1,home,0,7,7
9550,2,work,7,8,1
9550,3,home,8,10,2
9550,4,work,10,12,2
9550,5,home,12,18,6
9550,6,work,18,19,1
9550,7,home,19,24,5
9551,1,home,0,7,7
9551,2,work,7,13,6
9551,3,shop,13,14,1
9551,4,home,14,24,10
9552,1,home,0,8,8
9552,2,work,8,15,7
9552,3,home,15,24,9
9553,1,home,0,7,7
9553,2,education,7,12,5
9553,3,shop,12,14,2
9553,4,education,14,16,2
9553,5,home,16,24,8
9554,1,home,0,8,8
9554,2,work,8,14,6
9554,3,shop,14,15,1
9554,4,home,15,24,9
9555,1,home,0,7,7
9555,2,education,7,12,5
9555,3,home,12,21,9
9555,4,shop,21,22,1
9555,5,home,22,24,2
9556,1,home,0,6,6
9556,2,work,6,8,2
9556,3,home,8,12,4
9556,4,work,12,14,2
9556,5,home,14,21,7
9556,6,work,21,22,1
9556,7,home,22,24,2
9557,1,home,0,6,6
9557,2,work,6,13,7
9557,3,shop,13,14,1
9557,4,work,14,20,6
9557,5,home,20,24,4
9558,1,home,0,6,6
9558,2,work,6,13,7
9558,3,home,13,17,4
9558,4,work,17,20,3
9558,5,home,20,24,4
9559,1,home,0,9,9
9559,2,education,9,12,3
9559,3,home,12,14,2
9559,4,work,14,20,6
9559,5,home,20,24,4
9560,1,home,0,6,6
9560,2,work,6,7,1
9560,3,home,7,13,6
9560,4,work,13,14,1
9560,5,home,14,17,3
9560,6,work,17,19,2
9560,7,home,19,24,5
9561,1,home,0,7,7
9561,2,shop,7,8,1
9561,3,education,8,11,3
9561,4,home,11,14,3
9561,5,education,14,17,3
9561,6,home,17,24,7
9562,1,home,0,7,7
9562,2,work,7,13,6
9562,3,shop,13,14,1
9562,4,work,14,19,5
9562,5,home,19,24,5
9563,1,home,0,7,7
9563,2,work,7,13,6
9563,3,shop,13,14,1
9563,4,work,14,19,5
9563,5,home,19,24,5
9564,1,home,0,8,8
9564,2,work,8,14,6
9564,3,shop,14,15,1
9564,4,work,15,19,4
9564,5,home,19,24,5
9565,1,home,0,8,8
9565,2,work,8,14,6
9565,3,home,14,18,4
9565,4,work,18,20,2
9565,5,home,20,24,4
9566,1,work,0,2,2
9566,2,home,2,6,4
9566,3,work,6,8,2
9566,4,home,8,13,5
9566,5,work,13,15,2
9566,6,home,15,21,6
9566,7,work,21,22,1
9566,8,home,22,24,2
9567,1,home,0,6,6
9567,2,work,6,8,2
9567,3,home,8,12,4
9567,4,work,12,14,2
9567,5,home,14,18,4
9567,6,work,18,19,1
9567,7,home,19,24,5
9568,1,home,0,7,7
9568,2,work,7,14,7
9568,3,home,14,21,7
9568,4,work,21,22,1
9568,5,home,22,24,2
9569,1,home,0,8,8
9569,2,education,8,11,3
9569,3,home,11,16,5
9569,4,work,16,19,3
9569,5,home,19,24,5
9570,1,home,0,8,8
9570,2,work,8,15,7
9570,3,home,15,24,9
9571,1,home,0,6,6
9571,2,work,6,13,7
9571,3,shop,13,14,1
9571,4,home,14,24,10
9572,1,home,0,7,7
9572,2,work,7,13,6
9572,3,shop,13,14,1
9572,4,home,14,21,7
9572,5,work,21,22,1
9572,6,home,22,24,2
9573,1,home,0,7,7
9573,2,work,7,13,6
9573,3,shop,13,14,1
9573,4,education,14,16,2
9573,5,home,16,24,8
9574,1,home,0,7,7
9574,2,work,7,13,6
9574,3,shop,13,14,1
9574,4,work,14,20,6
9574,5,home,20,24,4
9575,1,home,0,7,7
9575,2,work,7,13,6
9575,3,home,13,17,4
9575,4,work,17,20,3
9575,5,home,20,24,4
9576,1,home,0,6,6
9576,2,work,6,8,2
9576,3,home,8,14,6
9576,4,work,14,17,3
9576,5,home,17,24,7
9577,1,home,0,8,8
9577,2,work,8,15,7
9577,3,home,15,24,9
9578,1,home,0,8,8
9578,2,work,8,15,7
9578,3,home,15,24,9
9579,1,home,0,6,6
9579,2,work,6,8,2
9579,3,home,8,9,1
9579,4,work,9,10,1
9579,5,home,10,15,5
9579,6,work,15,17,2
9579,7,home,17,24,7
9580,1,home,0,6,6
9580,2,work,6,12,6
9580,3,shop,12,13,1
9580,4,work,13,19,6
9580,5,home,19,24,5
9581,1,home,0,8,8
9581,2,education,8,14,6
9581,3,home,14,18,4
9581,4,work,18,20,2
9581,5,home,20,24,4
9582,1,home,0,7,7
9582,2,work,7,14,7
9582,3,home,14,24,10
9583,1,home,0,6,6
9583,2,work,6,14,8
9583,3,home,14,15,1
9583,4,work,15,18,3
9583,5,home,18,24,6
9584,1,home,0,7,7
9584,2,work,7,13,6
9584,3,home,13,24,11
9585,1,home,0,9,9
9585,2,education,9,16,7
9585,3,shop,16,17,1
9585,4,home,17,24,7
9586,1,home,0,7,7
9586,2,work,7,13,6
9586,3,home,13,23,10
9586,4,work,23,24,1
9587,1,home,0,8,8
9587,2,work,8,14,6
9587,3,home,14,18,4
9587,4,work,18,20,2
9587,5,home,20,24,4
9588,1,home,0,8,8
9588,2,education,8,11,3
9588,3,home,11,18,7
9588,4,shop,18,20,2
9588,5,home,20,24,4
9589,1,home,0,7,7
9589,2,work,7,13,6
9589,3,home,13,18,5
9589,4,shop,18,19,1
9589,5,home,19,24,5
9590,1,home,0,7,7
9590,2,education,7,12,5
9590,3,home,12,16,4
9590,4,shop,16,18,2
9590,5,home,18,24,6
9591,1,home,0,6,6
9591,2,work,6,13,7
9591,3,home,13,24,11
9592,1,home,0,6,6
9592,2,work,6,13,7
9592,3,shop,13,14,1
9592,4,work,14,19,5
9592,5,home,19,24,5
9593,1,home,0,7,7
9593,2,work,7,14,7
9593,3,shop,14,15,1
9593,4,home,15,24,9
9594,1,home,0,7,7
9594,2,shop,7,8,1
9594,3,home,8,12,4
9594,4,education,12,16,4
9594,5,home,16,24,8
9595,1,home,0,6,6
9595,2,work,6,13,7
9595,3,home,13,24,11
9596,1,home,0,6,6
9596,2,work,6,13,7
9596,3,home,13,16,3
9596,4,work,16,20,4
9596,5,home,20,24,4
9597,1,home,0,7,7
9597,2,work,7,14,7
9597,3,shop,14,15,1
9597,4,home,15,24,9
9598,1,home,0,7,7
9598,2,shop,7,9,2
9598,3,work,9,18,9
9598,4,home,18,24,6
9599,1,home,0,8,8
9599,2,work,8,15,7
9599,3,home,15,24,9
9600,1,home,0,9,9
9600,2,work,9,15,6
9600,3,home,15,24,9
9601,1,home,0,7,7
9601,2,work,7,13,6
9601,3,home,13,17,4
9601,4,work,17,20,3
9601,5,home,20,24,4
9602,1,home,0,7,7
9602,2,education,7,11,4
9602,3,home,11,16,5
9602,4,shop,16,17,1
9602,5,home,17,24,7
9603,1,home,0,8,8
9603,2,work,8,15,7
9603,3,home,15,24,9
9604,1,home,0,6,6
9604,2,work,6,8,2
9604,3,home,8,13,5
9604,4,work,13,15,2
9604,5,home,15,21,6
9604,6,work,21,22,1
9604,7,home,22,24,2
9605,1,home,0,6,6
9605,2,shop,6,7,1
9605,3,home,7,13,6
9605,4,education,13,16,3
9605,5,home,16,24,8
9606,1,home,0,6,6
9606,2,shop,6,7,1
9606,3,home,7,13,6
9606,4,education,13,16,3
9606,5,home,16,24,8
9607,1,home,0,6,6
9607,2,work,6,8,2
9607,3,home,8,15,7
9607,4,work,15,18,3
9607,5,home,18,24,6
9608,1,home,0,7,7
9608,2,work,7,13,6
9608,3,home,13,22,9
9608,4,work,22,23,1
9608,5,home,23,24,1
9609,1,home,0,7,7
9609,2,work,7,13,6
9609,3,home,13,22,9
9609,4,work,22,23,1
9609,5,home,23,24,1
9610,1,home,0,8,8
9610,2,education,8,12,4
9610,3,shop,12,13,1
9610,4,work,13,19,6
9610,5,home,19,24,5
9611,1,home,0,7,7
9611,2,work,7,13,6
9611,3,home,13,24,11
9612,1,home,0,6,6
9612,2,shop,6,7,1
9612,3,home,7,11,4
9612,4,work,11,18,7
9612,5,home,18,24,6
9613,1,home,0,8,8
9613,2,work,8,14,6
9613,3,home,14,24,10
9614,1,home,0,5,5
9614,2,work,5,12,7
9614,3,shop,12,13,1
9614,4,work,13,19,6
9614,5,home,19,24,5
9615,1,home,0,7,7
9615,2,work,7,13,6
9615,3,home,13,17,4
9615,4,shop,17,18,1
9615,5,home,18,24,6
9616,1,home,0,7,7
9616,2,education,7,11,4
9616,3,home,11,19,8
9616,4,shop,19,21,2
9616,5,home,21,24,3
9617,1,home,0,7,7
9617,2,education,7,12,5
9617,3,shop,12,13,1
9617,4,home,13,20,7
9617,5,shop,20,21,1
9617,6,home,21,24,3
9618,1,home,0,6,6
9618,2,shop,6,7,1
9618,3,home,7,13,6
9618,4,education,13,16,3
9618,5,home,16,24,8
9619,1,home,0,7,7
9619,2,work,7,13,6
9619,3,shop,13,14,1
9619,4,work,14,19,5
9619,5,home,19,24,5
9620,1,home,0,6,6
9620,2,shop,6,7,1
9620,3,home,7,9,2
9620,4,education,9,12,3
9620,5,home,12,19,7
9620,6,shop,19,21,2
9620,7,home,21,24,3
9621,1,home,0,7,7
9621,2,education,7,11,4
9621,3,home,11,14,3
9621,4,education,14,16,2
9621,5,shop,16,18,2
9621,6,home,18,24,6
9622,1,home,0,8,8
9622,2,work,8,13,5
9622,3,shop,13,14,1
9622,4,home,14,24,10
9623,1,home,0,7,7
9623,2,work,7,13,6
9623,3,home,13,16,3
9623,4,work,16,20,4
9623,5,home,20,24,4
9624,1,home,0,6,6
9624,2,shop,6,7,1
9624,3,work,7,14,7
9624,4,shop,14,15,1
9624,5,home,15,21,6
9624,6,work,21,22,1
9624,7,home,22,24,2
9625,1,work,0,9,9
9625,2,shop,9,10,1
9625,3,work,10,17,7
9625,4,home,17,24,7
9626,1,home,0,6,6
9626,2,shop,6,7,1
9626,3,work,7,14,7
9626,4,home,14,24,10
9627,1,home,0,6,6
9627,2,work,6,7,1
9627,3,home,7,14,7
9627,4,work,14,16,2
9627,5,home,16,23,7
9627,6,work,23,24,1
9628,1,home,0,8,8
9628,2,work,8,15,7
9628,3,home,15,24,9
9629,1,home,0,6,6
9629,2,work,6,8,2
9629,3,home,8,12,4
9629,4,work,12,13,1
9629,5,home,13,17,4
9629,6,work,17,19,2
9629,7,home,19,24,5
9630,1,home,0,8,8
9630,2,education,8,11,3
9630,3,home,11,17,6
9630,4,work,17,20,3
9630,5,home,20,24,4
9631,1,home,0,7,7
9631,2,work,7,13,6
9631,3,home,13,21,8
9631,4,work,21,22,1
9631,5,home,22,24,2
9632,1,home,0,7,7
9632,2,work,7,13,6
9632,3,home,13,24,11
9633,1,home,0,6,6
9633,2,work,6,13,7
9633,3,home,13,24,11
9634,1,home,0,6,6
9634,2,work,6,13,7
9634,3,home,13,16,3
9634,4,work,16,20,4
9634,5,home,20,24,4
9635,1,home,0,6,6
9635,2,work,6,8,2
9635,3,home,8,13,5
9635,4,work,13,15,2
9635,5,home,15,20,5
9635,6,shop,20,21,1
9635,7,home,21,24,3
9636,1,home,0,8,8
9636,2,work,8,14,6
9636,3,home,14,22,8
9636,4,work,22,23,1
9636,5,home,23,24,1
9637,1,home,0,7,7
9637,2,shop,7,8,1
9637,3,home,8,16,8
9637,4,work,16,19,3
9637,5,home,19,23,4
9637,6,work,23,24,1
9638,1,home,0,7,7
9638,2,work,7,9,2
9638,3,home,9,16,7
9638,4,work,16,18,2
9638,5,home,18,22,4
9638,6,work,22,23,1
9638,7,home,23,24,1
9639,1,home,0,7,7
9639,2,work,7,14,7
9639,3,home,14,24,10
9640,1,home,0,6,6
9640,2,work,6,8,2
9640,3,home,8,12,4
9640,4,work,12,14,2
9640,5,home,14,21,7
9640,6,work,21,22,1
9640,7,home,22,24,2
9641,1,home,0,7,7
9641,2,work,7,14,7
9641,3,shop,14,15,1
9641,4,home,15,24,9
9642,1,home,0,7,7
9642,2,work,7,13,6
9642,3,home,13,24,11
9643,1,home,0,7,7
9643,2,work,7,8,1
9643,3,home,8,9,1
9643,4,work,9,11,2
9643,5,home,11,15,4
9643,6,work,15,17,2
9643,7,home,17,22,5
9643,8,work,22,23,1
9643,9,home,23,24,1
9644,1,home,0,7,7
9644,2,work,7,13,6
9644,3,home,13,24,11
9645,1,home,0,7,7
9645,2,work,7,13,6
9645,3,home,13,18,5
9645,4,work,18,20,2
9645,5,home,20,24,4
9646,1,home,0,7,7
9646,2,education,7,14,7
9646,3,shop,14,16,2
9646,4,home,16,24,8
9647,1,home,0,6,6
9647,2,work,6,8,2
9647,3,home,8,12,4
9647,4,work,12,13,1
9647,5,home,13,22,9
9647,6,work,22,23,1
9647,7,home,23,24,1
9648,1,home,0,8,8
9648,2,work,8,16,8
9648,3,shop,16,17,1
9648,4,work,17,20,3
9648,5,home,20,24,4
9649,1,home,0,8,8
9649,2,work,8,15,7
9649,3,home,15,24,9
9650,1,home,0,7,7
9650,2,work,7,13,6
9650,3,home,13,17,4
9650,4,work,17,20,3
9650,5,home,20,24,4
9651,1,home,0,7,7
9651,2,education,7,12,5
9651,3,shop,12,13,1
9651,4,home,13,19,6
9651,5,shop,19,20,1
9651,6,home,20,24,4
9652,1,home,0,6,6
9652,2,work,6,8,2
9652,3,home,8,9,1
9652,4,work,9,11,2
9652,5,home,11,16,5
9652,6,work,16,18,2
9652,7,home,18,24,6
9653,1,home,0,7,7
9653,2,work,7,13,6
9653,3,home,13,24,11
9654,1,home,0,6,6
9654,2,work,6,8,2
9654,3,home,8,12,4
9654,4,work,12,15,3
9654,5,home,15,23,8
9654,6,work,23,24,1
9655,1,home,0,6,6
9655,2,work,6,13,7
9655,3,shop,13,15,2
9655,4,work,15,20,5
9655,5,home,20,24,4
9656,1,home,0,8,8
9656,2,work,8,14,6
9656,3,home,14,18,4
9656,4,work,18,20,2
9656,5,home,20,24,4
9657,1,home,0,8,8
9657,2,education,8,14,6
9657,3,shop,14,15,1
9657,4,home,15,24,9
9658,1,home,0,7,7
9658,2,work,7,15,8
9658,3,home,15,24,9
9659,1,home,0,6,6
9659,2,work,6,13,7
9659,3,home,13,17,4
9659,4,shop,17,18,1
9659,5,home,18,24,6
9660,1,home,0,7,7
9660,2,work,7,13,6
9660,3,home,13,21,8
9660,4,shop,21,22,1
9660,5,home,22,24,2
9661,1,home,0,7,7
9661,2,education,7,11,4
9661,3,home,11,15,4
9661,4,shop,15,16,1
9661,5,home,16,24,8
9662,1,home,0,9,9
9662,2,work,9,14,5
9662,3,home,14,21,7
9662,4,work,21,22,1
9662,5,home,22,24,2
9663,1,home,0,8,8
9663,2,work,8,13,5
9663,3,shop,13,14,1
9663,4,work,14,19,5
9663,5,home,19,24,5
9664,1,home,0,9,9
9664,2,work,9,16,7
9664,3,home,16,24,8
9665,1,home,0,8,8
9665,2,work,8,15,7
9665,3,home,15,24,9
9666,1,home,0,8,8
9666,2,work,8,15,7
9666,3,home,15,19,4
9666,4,shop,19,20,1
9666,5,home,20,24,4
9667,1,home,0,7,7
9667,2,work,7,9,2
9667,3,home,9,14,5
9667,4,work,14,17,3
9667,5,home,17,24,7
9668,1,home,0,7,7
9668,2,education,7,11,4
9668,3,home,11,18,7
9668,4,shop,18,19,1
9668,5,home,19,24,5
9669,1,home,0,7,7
9669,2,shop,7,9,2
9669,3,education,9,13,4
9669,4,home,13,24,11
9670,1,home,0,7,7
9670,2,work,7,13,6
9670,3,shop,13,14,1
9670,4,education,14,17,3
9670,5,shop,17,18,1
9670,6,home,18,24,6
9671,1,home,0,7,7
9671,2,education,7,11,4
9671,3,home,11,14,3
9671,4,education,14,16,2
9671,5,home,16,24,8
9672,1,home,0,7,7
9672,2,work,7,9,2
9672,3,home,9,14,5
9672,4,work,14,15,1
9672,5,home,15,22,7
9672,6,work,22,23,1
9672,7,home,23,24,1
9673,1,home,0,8,8
9673,2,education,8,12,4
9673,3,home,12,16,4
9673,4,work,16,20,4
9673,5,home,20,24,4
9674,1,home,0,7,7
9674,2,education,7,11,4
9674,3,home,11,17,6
9674,4,shop,17,18,1
9674,5,home,18,24,6
9675,1,home,0,6,6
9675,2,work,6,13,7
9675,3,home,13,17,4
9675,4,shop,17,18,1
9675,5,home,18,24,6
9676,1,home,0,7,7
9676,2,education,7,13,6
9676,3,shop,13,15,2
9676,4,home,15,24,9
9677,1,home,0,7,7
9677,2,work,7,14,7
9677,3,shop,14,15,1
9677,4,work,15,20,5
9677,5,home,20,24,4
9678,1,home,0,8,8
9678,2,education,8,13,5
9678,3,shop,13,14,1
9678,4,work,14,20,6
9678,5,home,20,24,4
9679,1,home,0,6,6
9679,2,work,6,8,2
9679,3,home,8,15,7
9679,4,work,15,18,3
9679,5,home,18,24,6
9680,1,home,0,9,9
9680,2,work,9,13,4
9680,3,shop,13,14,1
9680,4,work,14,20,6
9680,5,home,20,24,4
9681,1,home,0,7,7
9681,2,work,7,13,6
9681,3,home,13,24,11
9682,1,home,0,6,6
9682,2,shop,6,7,1
9682,3,home,7,13,6
9682,4,education,13,16,3
9682,5,home,16,24,8
9683,1,home,0,6,6
9683,2,work,6,13,7
9683,3,shop,13,14,1
9683,4,home,14,22,8
9683,5,work,22,23,1
9683,6,home,23,24,1
9684,1,home,0,6,6
9684,2,work,6,12,6
9684,3,shop,12,13,1
9684,4,work,13,19,6
9684,5,home,19,24,5
9685,1,home,0,6,6
9685,2,work,6,13,7
9685,3,home,13,18,5
9685,4,work,18,20,2
9685,5,home,20,24,4
9686,1,home,0,6,6
9686,2,work,6,13,7
9686,3,shop,13,14,1
9686,4,work,14,20,6
9686,5,home,20,24,4
9687,1,home,0,6,6
9687,2,work,6,13,7
9687,3,home,13,24,11
9688,1,home,0,6,6
9688,2,shop,6,7,1
9688,3,work,7,13,6
9688,4,home,13,24,11
9689,1,home,0,6,6
9689,2,work,6,8,2
9689,3,home,8,9,1
9689,4,work,9,11,2
9689,5,home,11,17,6
9689,6,work,17,19,2
9689,7,home,19,24,5
9690,1,home,0,8,8
9690,2,work,8,14,6
9690,3,shop,14,15,1
9690,4,work,15,20,5
9690,5,home,20,24,4
9691,1,home,0,7,7
9691,2,work,7,13,6
9691,3,home,13,17,4
9691,4,work,17,20,3
9691,5,home,20,24,4
9692,1,home,0,7,7
9692,2,shop,7,9,2
9692,3,education,9,11,2
9692,4,home,11,17,6
9692,5,shop,17,18,1
9692,6,home,18,24,6
9693,1,home,0,7,7
9693,2,work,7,13,6
9693,3,home,13,16,3
9693,4,shop,16,17,1
9693,5,work,17,18,1
9693,6,home,18,24,6
9694,1,home,0,7,7
9694,2,work,7,13,6
9694,3,home,13,19,6
9694,4,shop,19,20,1
9694,5,home,20,24,4
9695,1,home,0,7,7
9695,2,work,7,13,6
9695,3,shop,13,14,1
9695,4,education,14,16,2
9695,5,home,16,21,5
9695,6,work,21,22,1
9695,7,home,22,24,2
9696,1,home,0,7,7
9696,2,education,7,11,4
9696,3,home,11,19,8
9696,4,shop,19,20,1
9696,5,home,20,24,4
9697,1,home,0,8,8
9697,2,work,8,15,7
9697,3,shop,15,16,1
9697,4,work,16,19,3
9697,5,home,19,24,5
9698,1,home,0,8,8
9698,2,work,8,15,7
9698,3,home,15,18,3
9698,4,shop,18,19,1
9698,5,home,19,24,5
9699,1,home,0,8,8
9699,2,shop,8,9,1
9699,3,work,9,16,7
9699,4,home,16,24,8
9700,1,home,0,7,7
9700,2,work,7,9,2
9700,3,home,9,12,3
9700,4,work,12,14,2
9700,5,home,14,21,7
9700,6,work,21,22,1
9700,7,home,22,24,2
9701,1,home,0,7,7
9701,2,work,7,13,6
9701,3,shop,13,14,1
9701,4,home,14,24,10
9702,1,home,0,8,8
9702,2,work,8,13,5
9702,3,shop,13,14,1
9702,4,work,14,19,5
9702,5,home,19,24,5
9703,1,home,0,7,7
9703,2,work,7,14,7
9703,3,shop,14,15,1
9703,4,work,15,20,5
9703,5,home,20,24,4
9704,1,home,0,6,6
9704,2,work,6,8,2
9704,3,home,8,9,1
9704,4,work,9,11,2
9704,5,home,11,16,5
9704,6,work,16,18,2
9704,7,home,18,24,6
9705,1,home,0,7,7
9705,2,education,7,11,4
9705,3,home,11,19,8
9705,4,shop,19,20,1
9705,5,home,20,24,4
9706,1,home,0,8,8
9706,2,work,8,15,7
9706,3,home,15,22,7
9706,4,work,22,23,1
9706,5,home,23,24,1
9707,1,home,0,8,8
9707,2,work,8,16,8
9707,3,shop,16,17,1
9707,4,home,17,24,7
9708,1,home,0,8,8
9708,2,work,8,15,7
9708,3,shop,15,16,1
9708,4,home,16,24,8
9709,1,home,0,8,8
9709,2,work,8,15,7
9709,3,shop,15,16,1
9709,4,home,16,24,8
9710,1,home,0,7,7
9710,2,work,7,14,7
9710,3,shop,14,15,1
9710,4,work,15,20,5
9710,5,home,20,24,4
9711,1,home,0,6,6
9711,2,work,6,13,7
9711,3,shop,13,14,1
9711,4,home,14,24,10
9712,1,home,0,6,6
9712,2,work,6,8,2
9712,3,home,8,14,6
9712,4,work,14,18,4
9712,5,home,18,24,6
9713,1,home,0,8,8
9713,2,education,8,12,4
9713,3,work,12,18,6
9713,4,home,18,24,6
9714,1,home,0,6,6
9714,2,work,6,13,7
9714,3,shop,13,14,1
9714,4,home,14,24,10
9715,1,home,0,6,6
9715,2,shop,6,7,1
9715,3,home,7,10,3
9715,4,work,10,17,7
9715,5,home,17,24,7
9716,1,home,0,6,6
9716,2,shop,6,7,1
9716,3,home,7,13,6
9716,4,education,13,16,3
9716,5,home,16,24,8
9717,1,home,0,7,7
9717,2,education,7,11,4
9717,3,home,11,18,7
9717,4,shop,18,20,2
9717,5,home,20,24,4
9718,1,home,0,8,8
9718,2,work,8,15,7
9718,3,shop,15,16,1
9718,4,work,16,20,4
9718,5,home,20,24,4
9719,1,home,0,7,7
9719,2,work,7,14,7
9719,3,shop,14,15,1
9719,4,home,15,24,9
9720,1,home,0,6,6
9720,2,shop,6,7,1
9720,3,home,7,8,1
9720,4,education,8,12,4
9720,5,home,12,20,8
9720,6,shop,20,21,1
9720,7,home,21,24,3
9721,1,home,0,8,8
9721,2,work,8,14,6
9721,3,shop,14,15,1
9721,4,work,15,19,4
9721,5,home,19,24,5
9722,1,home,0,7,7
9722,2,shop,7,9,2
9722,3,education,9,13,4
9722,4,shop,13,14,1
9722,5,education,14,16,2
9722,6,home,16,24,8
9723,1,home,0,7,7
9723,2,work,7,13,6
9723,3,shop,13,14,1
9723,4,education,14,16,2
9723,5,home,16,21,5
9723,6,work,21,22,1
9723,7,home,22,24,2
9724,1,home,0,8,8
9724,2,work,8,14,6
9724,3,shop,14,15,1
9724,4,home,15,19,4
9724,5,shop,19,20,1
9724,6,home,20,24,4
9725,1,home,0,6,6
9725,2,shop,6,7,1
9725,3,home,7,9,2
9725,4,education,9,12,3
9725,5,shop,12,13,1
9725,6,home,13,20,7
9725,7,shop,20,21,1
9725,8,home,21,24,3
9726,1,home,0,7,7
9726,2,education,7,11,4
9726,3,home,11,18,7
9726,4,shop,18,20,2
9726,5,home,20,24,4
9727,1,home,0,6,6
9727,2,work,6,13,7
9727,3,home,13,24,11
9728,1,home,0,7,7
9728,2,work,7,14,7
9728,3,home,14,18,4
9728,4,work,18,20,2
9728,5,home,20,24,4
9729,1,home,0,7,7
9729,2,shop,7,8,1
9729,3,work,8,15,7
9729,4,home,15,24,9
9730,1,home,0,8,8
9730,2,work,8,15,7
9730,3,shop,15,16,1
9730,4,home,16,24,8
9731,1,home,0,7,7
9731,2,work,7,13,6
9731,3,home,13,18,5
9731,4,work,18,20,2
9731,5,home,20,24,4
9732,1,home,0,6,6
9732,2,shop,6,7,1
9732,3,home,7,10,3
9732,4,education,10,13,3
9732,5,home,13,20,7
9732,6,shop,20,21,1
9732,7,home,21,24,3
9733,1,home,0,9,9
9733,2,work,9,16,7
9733,3,shop,16,17,1
9733,4,work,17,19,2
9733,5,home,19,24,5
9734,1,home,0,6,6
9734,2,work,6,13,7
9734,3,home,13,24,11
9735,1,home,0,7,7
9735,2,education,7,10,3
9735,3,home,10,14,4
9735,4,education,14,16,2
9735,5,home,16,24,8
9736,1,home,0,7,7
9736,2,shop,7,8,1
9736,3,education,8,14,6
9736,4,shop,14,15,1
9736,5,home,15,21,6
9736,6,shop,21,22,1
9736,7,home,22,24,2
9737,1,home,0,7,7
9737,2,work,7,14,7
9737,3,shop,14,15,1
9737,4,home,15,21,6
9737,5,work,21,22,1
9737,6,home,22,24,2
9738,1,home,0,7,7
9738,2,work,7,14,7
9738,3,home,14,20,6
9738,4,shop,20,21,1
9738,5,home,21,24,3
9739,1,home,0,6,6
9739,2,work,6,8,2
9739,3,home,8,14,6
9739,4,work,14,17,3
9739,5,home,17,23,6
9739,6,work,23,24,1
9740,1,home,0,6,6
9740,2,work,6,13,7
9740,3,home,13,24,11
9741,1,home,0,8,8
9741,2,education,8,12,4
9741,3,shop,12,14,2
9741,4,home,14,19,5
9741,5,shop,19,21,2
9741,6,home,21,24,3
9742,1,home,0,6,6
9742,2,shop,6,7,1
9742,3,home,7,13,6
9742,4,work,13,19,6
9742,5,home,19,24,5
9743,1,home,0,6,6
9743,2,shop,6,7,1
9743,3,home,7,16,9
9743,4,work,16,20,4
9743,5,home,20,24,4
9744,1,home,0,6,6
9744,2,work,6,8,2
9744,3,home,8,9,1
9744,4,work,9,11,2
9744,5,home,11,15,4
9744,6,work,15,18,3
9744,7,home,18,24,6
9745,1,home,0,6,6
9745,2,shop,6,7,1
9745,3,home,7,8,1
9745,4,work,8,9,1
9745,5,home,9,15,6
9745,6,work,15,17,2
9745,7,home,17,21,4
9745,8,work,21,22,1
9745,9,home,22,24,2
9746,1,home,0,7,7
9746,2,work,7,14,7
9746,3,home,14,24,10
9747,1,home,0,6,6
9747,2,work,6,9,3
9747,3,home,9,14,5
9747,4,work,14,16,2
9747,5,home,16,22,6
9747,6,work,22,23,1
9747,7,home,23,24,1
9748,1,home,0,6,6
9748,2,work,6,13,7
9748,3,home,13,23,10
9748,4,work,23,24,1
9749,1,home,0,7,7
9749,2,education,7,11,4
9749,3,home,11,19,8
9749,4,shop,19,20,1
9749,5,home,20,24,4
9750,1,home,0,7,7
9750,2,work,7,13,6
9750,3,home,13,16,3
9750,4,work,16,20,4
9750,5,home,20,24,4
9751,1,home,0,7,7
9751,2,work,7,13,6
9751,3,home,13,22,9
9751,4,work,22,23,1
9751,5,home,23,24,1
9752,1,home,0,6,6
9752,2,shop,6,7,1
9752,3,home,7,10,3
9752,4,education,10,13,3
9752,5,shop,13,14,1
9752,6,education,14,16,2
9752,7,shop,16,17,1
9752,8,home,17,24,7
9753,1,home,0,6,6
9753,2,work,6,13,7
9753,3,shop,13,14,1
9753,4,work,14,19,5
9753,5,home,19,24,5
9754,1,home,0,7,7
9754,2,education,7,11,4
9754,3,home,11,15,4
9754,4,shop,15,16,1
9754,5,home,16,24,8
9755,1,home,0,6,6
9755,2,shop,6,7,1
9755,3,home,7,9,2
9755,4,education,9,12,3
9755,5,home,12,18,6
9755,6,shop,18,19,1
9755,7,home,19,24,5
9756,1,home,0,6,6
9756,2,work,6,7,1
9756,3,home,7,13,6
9756,4,work,13,15,2
9756,5,home,15,21,6
9756,6,work,21,22,1
9756,7,home,22,24,2
9757,1,home,0,6,6
9757,2,shop,6,7,1
9757,3,home,7,13,6
9757,4,education,13,16,3
9757,5,home,16,24,8
9758,1,home,0,7,7
9758,2,work,7,9,2
9758,3,home,9,14,5
9758,4,work,14,17,3
9758,5,home,17,24,7
9759,1,home,0,7,7
9759,2,shop,7,8,1
9759,3,work,8,15,7
9759,4,home,15,24,9
9760,1,home,0,6,6
9760,2,work,6,13,7
9760,3,home,13,15,2
9760,4,work,15,20,5
9760,5,home,20,24,4
9761,1,home,0,7,7
9761,2,shop,7,9,2
9761,3,education,9,11,2
9761,4,home,11,17,6
9761,5,shop,17,18,1
9761,6,home,18,24,6
9762,1,home,0,6,6
9762,2,work,6,8,2
9762,3,home,8,9,1
9762,4,work,9,11,2
9762,5,home,11,14,3
9762,6,work,14,16,2
9762,7,home,16,21,5
9762,8,work,21,22,1
9762,9,home,22,24,2
9763,1,home,0,7,7
9763,2,work,7,13,6
9763,3,shop,13,14,1
9763,4,work,14,20,6
9763,5,home,20,24,4
9764,1,home,0,8,8
9764,2,work,8,13,5
9764,3,shop,13,14,1
9764,4,home,14,18,4
9764,5,work,18,20,2
9764,6,home,20,24,4
9765,1,home,0,6,6
9765,2,work,6,12,6
9765,3,shop,12,13,1
9765,4,work,13,19,6
9765,5,home,19,24,5
9766,1,home,0,7,7
9766,2,work,7,13,6
9766,3,home,13,14,1
9766,4,work,14,19,5
9766,5,home,19,24,5
9767,1,home,0,8,8
9767,2,education,8,12,4
9767,3,shop,12,13,1
9767,4,work,13,19,6
9767,5,home,19,24,5
9768,1,home,0,7,7
9768,2,education,7,12,5
9768,3,home,12,18,6
9768,4,shop,18,19,1
9768,5,home,19,24,5
9769,1,home,0,8,8
9769,2,work,8,15,7
9769,3,shop,15,16,1
9769,4,work,16,19,3
9769,5,home,19,24,5
9770,1,home,0,6,6
9770,2,work,6,8,2
9770,3,home,8,12,4
9770,4,work,12,13,1
9770,5,home,13,21,8
9770,6,work,21,22,1
9770,7,home,22,24,2
9771,1,home,0,7,7
9771,2,work,7,13,6
9771,3,home,13,24,11
9772,1,home,0,7,7
9772,2,shop,7,8,1
9772,3,work,8,14,6
9772,4,home,14,24,10
9773,1,home,0,6,6
9773,2,work,6,13,7
9773,3,shop,13,14,1
9773,4,home,14,16,2
9773,5,shop,16,17,1
9773,6,work,17,20,3
9773,7,home,20,24,4
9774,1,home,0,7,7
9774,2,work,7,10,3
9774,3,home,10,14,4
9774,4,work,14,16,2
9774,5,home,16,22,6
9774,6,work,22,23,1
9774,7,home,23,24,1
9775,1,home,0,8,8
9775,2,work,8,14,6
9775,3,home,14,24,10
9776,1,home,0,6,6
9776,2,work,6,13,7
9776,3,home,13,24,11
9777,1,home,0,6,6
9777,2,work,6,8,2
9777,3,home,8,12,4
9777,4,work,12,14,2
9777,5,shop,14,15,1
9777,6,work,15,17,2
9777,7,home,17,23,6
9777,8,work,23,24,1
9778,1,home,0,8,8
9778,2,education,8,11,3
9778,3,home,11,15,4
9778,4,work,15,20,5
9778,5,home,20,24,4
9779,1,home,0,6,6
9779,2,work,6,13,7
9779,3,home,13,24,11
9780,1,home,0,6,6
9780,2,work,6,13,7
9780,3,home,13,23,10
9780,4,work,23,24,1
9781,1,home,0,6,6
9781,2,work,6,8,2
9781,3,home,8,14,6
9781,4,work,14,16,2
9781,5,home,16,22,6
9781,6,work,22,23,1
9781,7,home,23,24,1
9782,1,home,0,7,7
9782,2,work,7,13,6
9782,3,shop,13,14,1
9782,4,home,14,18,4
9782,5,work,18,20,2
9782,6,home,20,24,4
9783,1,home,0,7,7
9783,2,work,7,13,6
9783,3,home,13,16,3
9783,4,work,16,20,4
9783,5,home,20,24,4
9784,1,home,0,7,7
9784,2,work,7,14,7
9784,3,home,14,24,10
9785,1,home,0,7,7
9785,2,work,7,14,7
9785,3,shop,14,15,1
9785,4,work,15,20,5
9785,5,home,20,24,4
9786,1,home,0,7,7
9786,2,work,7,13,6
9786,3,home,13,18,5
9786,4,work,18,20,2
9786,5,home,20,24,4
9787,1,home,0,8,8
9787,2,work,8,15,7
9787,3,home,15,20,5
9787,4,shop,20,21,1
9787,5,home,21,24,3
9788,1,home,0,6,6
9788,2,work,6,13,7
9788,3,home,13,24,11
9789,1,home,0,7,7
9789,2,shop,7,9,2
9789,3,work,9,16,7
9789,4,home,16,24,8
9790,1,home,0,7,7
9790,2,work,7,13,6
9790,3,home,13,24,11
9791,1,home,0,7,7
9791,2,education,7,10,3
9791,3,home,10,13,3
9791,4,education,13,16,3
9791,5,home,16,24,8
9792,1,home,0,7,7
9792,2,work,7,13,6
9792,3,shop,13,14,1
9792,4,work,14,19,5
9792,5,home,19,24,5
9793,1,home,0,8,8
9793,2,work,8,15,7
9793,3,home,15,24,9
9794,1,home,0,6,6
9794,2,shop,6,7,1
9794,3,home,7,8,1
9794,4,education,8,11,3
9794,5,home,11,16,5
9794,6,shop,16,17,1
9794,7,home,17,24,7
9795,1,home,0,8,8
9795,2,work,8,13,5
9795,3,home,13,17,4
9795,4,shop,17,18,1
9795,5,home,18,22,4
9795,6,work,22,23,1
9795,7,home,23,24,1
9796,1,work,0,7,7
9796,2,shop,7,8,1
9796,3,home,8,16,8
9796,4,work,16,19,3
9796,5,home,19,23,4
9796,6,work,23,24,1
9797,1,home,0,6,6
9797,2,shop,6,7,1
9797,3,home,7,13,6
9797,4,education,13,16,3
9797,5,home,16,24,8
9798,1,home,0,6,6
9798,2,work,6,12,6
9798,3,shop,12,13,1
9798,4,work,13,19,6
9798,5,home,19,24,5
9799,1,home,0,8,8
9799,2,work,8,15,7
9799,3,home,15,24,9
9800,1,home,0,7,7
9800,2,shop,7,9,2
9800,3,education,9,11,2
9800,4,home,11,18,7
9800,5,shop,18,19,1
9800,6,home,19,24,5
9801,1,home,0,8,8
9801,2,shop,8,9,1
9801,3,home,9,13,4
9801,4,work,13,20,7
9801,5,home,20,24,4
9802,1,home,0,7,7
9802,2,education,7,10,3
9802,3,home,10,13,3
9802,4,education,13,16,3
9802,5,home,16,24,8
9803,1,home,0,9,9
9803,2,work,9,16,7
9803,3,home,16,23,7
9803,4,work,23,24,1
9804,1,home,0,6,6
9804,2,work,6,13,7
9804,3,shop,13,14,1
9804,4,work,14,20,6
9804,5,home,20,24,4
9805,1,home,0,8,8
9805,2,work,8,15,7
9805,3,shop,15,16,1
9805,4,home,16,24,8
9806,1,home,0,6,6
9806,2,work,6,8,2
9806,3,home,8,12,4
9806,4,work,12,14,2
9806,5,home,14,21,7
9806,6,work,21,22,1
9806,7,home,22,24,2
9807,1,home,0,7,7
9807,2,work,7,15,8
9807,3,home,15,24,9
9808,1,home,0,6,6
9808,2,work,6,8,2
9808,3,home,8,15,7
9808,4,work,15,17,2
9808,5,home,17,24,7
9809,1,home,0,8,8
9809,2,work,8,14,6
9809,3,home,14,18,4
9809,4,work,18,20,2
9809,5,home,20,24,4
9810,1,home,0,7,7
9810,2,work,7,13,6
9810,3,home,13,24,11
9811,1,home,0,6,6
9811,2,work,6,13,7
9811,3,home,13,17,4
9811,4,work,17,19,2
9811,5,home,19,24,5
9812,1,home,0,7,7
9812,2,education,7,11,4
9812,3,home,11,14,3
9812,4,education,14,16,2
9812,5,shop,16,17,1
9812,6,home,17,24,7
9813,1,home,0,8,8
9813,2,work,8,13,5
9813,3,shop,13,14,1
9813,4,work,14,19,5
9813,5,home,19,24,5
9814,1,home,0,6,6
9814,2,shop,6,7,1
9814,3,home,7,8,1
9814,4,shop,8,10,2
9814,5,education,10,13,3
9814,6,home,13,19,6
9814,7,shop,19,21,2
9814,8,home,21,24,3
9815,1,home,0,7,7
9815,2,education,7,11,4
9815,3,home,11,18,7
9815,4,shop,18,19,1
9815,5,home,19,24,5
9816,1,home,0,7,7
9816,2,work,7,14,7
9816,3,home,14,21,7
9816,4,work,21,22,1
9816,5,home,22,24,2
9817,1,home,0,6,6
9817,2,work,6,8,2
9817,3,home,8,10,2
9817,4,work,10,12,2
9817,5,home,12,22,10
9817,6,work,22,23,1
9817,7,home,23,24,1
9818,1,home,0,7,7
9818,2,work,7,14,7
9818,3,home,14,24,10
9819,1,home,0,7,7
9819,2,work,7,13,6
9819,3,home,13,18,5
9819,4,shop,18,19,1
9819,5,home,19,24,5
9820,1,home,0,6,6
9820,2,work,6,7,1
9820,3,home,7,12,5
9820,4,work,12,14,2
9820,5,home,14,21,7
9820,6,work,21,22,1
9820,7,home,22,24,2
9821,1,home,0,6,6
9821,2,work,6,13,7
9821,3,shop,13,14,1
9821,4,work,14,20,6
9821,5,home,20,24,4
9822,1,home,0,8,8
9822,2,education,8,12,4
9822,3,shop,12,13,1
9822,4,work,13,19,6
9822,5,home,19,23,4
9822,6,work,23,24,1
9823,1,home,0,7,7
9823,2,work,7,14,7
9823,3,home,14,17,3
9823,4,shop,17,18,1
9823,5,work,18,20,2
9823,6,home,20,24,4
9824,1,home,0,7,7
9824,2,work,7,14,7
9824,3,shop,14,15,1
9824,4,home,15,23,8
9824,5,work,23,24,1
9825,1,home,0,7,7
9825,2,education,7,11,4
9825,3,home,11,16,5
9825,4,shop,16,17,1
9825,5,home,17,24,7
9826,1,home,0,6,6
9826,2,work,6,13,7
9826,3,home,13,24,11
9827,1,home,0,7,7
9827,2,work,7,13,6
9827,3,home,13,17,4
9827,4,shop,17,18,1
9827,5,home,18,24,6
9828,1,home,0,8,8
9828,2,work,8,14,6
9828,3,home,14,24,10
9829,1,home,0,5,5
9829,2,work,5,13,8
9829,3,shop,13,14,1
9829,4,home,14,21,7
9829,5,work,21,22,1
9829,6,home,22,24,2
9830,1,home,0,7,7
9830,2,education,7,11,4
9830,3,home,11,18,7
9830,4,shop,18,20,2
9830,5,home,20,24,4
9831,1,home,0,6,6
9831,2,work,6,13,7
9831,3,shop,13,14,1
9831,4,work,14,20,6
9831,5,home,20,24,4
9832,1,home,0,8,8
9832,2,work,8,14,6
9832,3,home,14,24,10
9833,1,home,0,7,7
9833,2,education,7,12,5
9833,3,home,12,20,8
9833,4,shop,20,21,1
9833,5,home,21,24,3
9834,1,home,0,8,8
9834,2,shop,8,9,1
9834,3,home,9,21,12
9834,4,work,21,22,1
9834,5,home,22,24,2
9835,1,home,0,6,6
9835,2,work,6,13,7
9835,3,shop,13,14,1
9835,4,home,14,24,10
9836,1,home,0,6,6
9836,2,work,6,13,7
9836,3,shop,13,14,1
9836,4,home,14,18,4
9836,5,work,18,20,2
9836,6,home,20,24,4
9837,1,home,0,7,7
9837,2,work,7,13,6
9837,3,home,13,22,9
9837,4,work,22,23,1
9837,5,home,23,24,1
9838,1,home,0,8,8
9838,2,work,8,14,6
9838,3,home,14,24,10
9839,1,home,0,8,8
9839,2,shop,8,9,1
9839,3,home,9,13,4
9839,4,work,13,20,7
9839,5,home,20,24,4
9840,1,home,0,6,6
9840,2,work,6,8,2
9840,3,home,8,13,5
9840,4,work,13,15,2
9840,5,home,15,21,6
9840,6,work,21,22,1
9840,7,home,22,24,2
9841,1,home,0,7,7
9841,2,education,7,11,4
9841,3,home,11,14,3
9841,4,education,14,16,2
9841,5,home,16,24,8
9842,1,home,0,6,6
9842,2,work,6,7,1
9842,3,home,7,11,4
9842,4,work,11,14,3
9842,5,home,14,21,7
9842,6,work,21,22,1
9842,7,home,22,24,2
9843,1,home,0,6,6
9843,2,work,6,8,2
9843,3,home,8,13,5
9843,4,work,13,16,3
9843,5,home,16,23,7
9843,6,work,23,24,1
9844,1,home,0,7,7
9844,2,work,7,13,6
9844,3,home,13,24,11
9845,1,home,0,7,7
9845,2,work,7,8,1
9845,3,home,8,10,2
9845,4,work,10,11,1
9845,5,home,11,15,4
9845,6,work,15,17,2
9845,7,home,17,21,4
9845,8,work,21,22,1
9845,9,home,22,24,2
9846,1,home,0,6,6
9846,2,work,6,13,7
9846,3,home,13,16,3
9846,4,work,16,20,4
9846,5,home,20,24,4
9847,1,home,0,6,6
9847,2,work,6,8,2
9847,3,home,8,9,1
9847,4,work,9,11,2
9847,5,home,11,16,5
9847,6,work,16,18,2
9847,7,home,18,22,4
9847,8,work,22,23,1
9847,9,home,23,24,1
9848,1,home,0,7,7
9848,2,education,7,12,5
9848,3,home,12,16,4
9848,4,shop,16,17,1
9848,5,home,17,24,7
9849,1,home,0,8,8
9849,2,work,8,14,6
9849,3,shop,14,15,1
9849,4,work,15,19,4
9849,5,home,19,24,5
9850,1,home,0,8,8
9850,2,work,8,15,7
9850,3,home,15,23,8
9850,4,work,23,24,1
9851,1,home,0,9,9
9851,2,work,9,15,6
9851,3,home,15,24,9
9852,1,home,0,9,9
9852,2,work,9,16,7
9852,3,home,16,21,5
9852,4,work,21,22,1
9852,5,home,22,24,2
9853,1,home,0,7,7
9853,2,work,7,9,2
9853,3,home,9,13,4
9853,4,work,13,15,2
9853,5,home,15,22,7
9853,6,work,22,23,1
9853,7,home,23,24,1
9854,1,home,0,8,8
9854,2,work,8,14,6
9854,3,home,14,24,10
9855,1,home,0,8,8
9855,2,work,8,15,7
9855,3,home,15,24,9
9856,1,home,0,7,7
9856,2,shop,7,8,1
9856,3,work,8,16,8
9856,4,home,16,22,6
9856,5,work,22,23,1
9856,6,home,23,24,1
9857,1,home,0,7,7
9857,2,work,7,13,6
9857,3,home,13,17,4
9857,4,shop,17,18,1
9857,5,home,18,24,6
9858,1,home,0,6,6
9858,2,shop,6,7,1
9858,3,work,7,14,7
9858,4,home,14,22,8
9858,5,work,22,23,1
9858,6,home,23,24,1
9859,1,home,0,7,7
9859,2,work,7,14,7
9859,3,shop,14,15,1
9859,4,home,15,24,9
9860,1,home,0,6,6
9860,2,work,6,8,2
9860,3,home,8,12,4
9860,4,work,12,14,2
9860,5,home,14,21,7
9860,6,work,21,22,1
9860,7,home,22,24,2
9861,1,home,0,8,8
9861,2,work,8,15,7
9861,3,shop,15,16,1
9861,4,home,16,23,7
9861,5,work,23,24,1
9862,1,home,0,8,8
9862,2,education,8,12,4
9862,3,home,12,21,9
9862,4,work,21,22,1
9862,5,home,22,24,2
9863,1,home,0,7,7
9863,2,work,7,14,7
9863,3,home,14,17,3
9863,4,work,17,20,3
9863,5,home,20,24,4
9864,1,home,0,7,7
9864,2,shop,7,8,1
9864,3,work,8,16,8
9864,4,home,16,24,8
9865,1,home,0,8,8
9865,2,work,8,15,7
9865,3,shop,15,16,1
9865,4,work,16,19,3
9865,5,home,19,24,5
9866,1,home,0,8,8
9866,2,work,8,14,6
9866,3,shop,14,15,1
9866,4,work,15,20,5
9866,5,home,20,24,4
9867,1,home,0,6,6
9867,2,work,6,13,7
9867,3,home,13,20,7
9867,4,shop,20,21,1
9867,5,home,21,24,3
9868,1,home,0,7,7
9868,2,work,7,13,6
9868,3,shop,13,14,1
9868,4,home,14,24,10
9869,1,home,0,7,7
9869,2,shop,7,8,1
9869,3,education,8,11,3
9869,4,home,11,17,6
9869,5,shop,17,19,2
9869,6,home,19,24,5
9870,1,home,0,6,6
9870,2,work,6,8,2
9870,3,home,8,13,5
9870,4,work,13,15,2
9870,5,home,15,21,6
9870,6,work,21,22,1
9870,7,home,22,24,2
9871,1,home,0,7,7
9871,2,shop,7,9,2
9871,3,work,9,15,6
9871,4,home,15,24,9
9872,1,home,0,7,7
9872,2,work,7,13,6
9872,3,home,13,24,11
9873,1,home,0,8,8
9873,2,work,8,15,7
9873,3,home,15,24,9
9874,1,home,0,7,7
9874,2,education,7,11,4
9874,3,home,11,17,6
9874,4,shop,17,19,2
9874,5,home,19,24,5
9875,1,home,0,6,6
9875,2,work,6,8,2
9875,3,home,8,14,6
9875,4,work,14,16,2
9875,5,home,16,22,6
9875,6,work,22,23,1
9875,7,home,23,24,1
9876,1,home,0,7,7
9876,2,work,7,13,6
9876,3,shop,13,14,1
9876,4,home,14,24,10
9877,1,home,0,6,6
9877,2,work,6,13,7
9877,3,shop,13,14,1
9877,4,work,14,20,6
9877,5,home,20,24,4
9878,1,home,0,8,8
9878,2,work,8,13,5
9878,3,home,13,23,10
9878,4,work,23,24,1
9879,1,home,0,7,7
9879,2,shop,7,8,1
9879,3,home,8,13,5
9879,4,work,13,19,6
9879,5,home,19,21,2
9879,6,work,21,22,1
9879,7,home,22,24,2
9880,1,home,0,7,7
9880,2,work,7,9,2
9880,3,home,9,15,6
9880,4,work,15,17,2
9880,5,home,17,23,6
9880,6,work,23,24,1
9881,1,home,0,7,7
9881,2,work,7,13,6
9881,3,home,13,18,5
9881,4,shop,18,19,1
9881,5,home,19,24,5
9882,1,home,0,6,6
9882,2,work,6,13,7
9882,3,home,13,24,11
9883,1,home,0,6,6
9883,2,work,6,13,7
9883,3,home,13,17,4
9883,4,shop,17,18,1
9883,5,home,18,24,6
9884,1,home,0,8,8
9884,2,work,8,16,8
9884,3,home,16,24,8
9885,1,home,0,6,6
9885,2,work,6,7,1
9885,3,home,7,8,1
9885,4,work,8,9,1
9885,5,home,9,14,5
9885,6,work,14,16,2
9885,7,home,16,21,5
9885,8,work,21,22,1
9885,9,home,22,24,2
9886,1,home,0,8,8
9886,2,work,8,15,7
9886,3,home,15,24,9
9887,1,home,0,7,7
9887,2,work,7,13,6
9887,3,shop,13,14,1
9887,4,home,14,22,8
9887,5,work,22,23,1
9887,6,home,23,24,1
9888,1,home,0,8,8
9888,2,education,8,15,7
9888,3,shop,15,16,1
9888,4,home,16,24,8
9889,1,home,0,6,6
9889,2,work,6,7,1
9889,3,home,7,9,2
9889,4,work,9,11,2
9889,5,home,11,16,5
9889,6,work,16,18,2
9889,7,home,18,24,6
9890,1,home,0,6,6
9890,2,work,6,13,7
9890,3,home,13,18,5
9890,4,shop,18,19,1
9890,5,home,19,23,4
9890,6,work,23,24,1
9891,1,home,0,7,7
9891,2,work,7,13,6
9891,3,home,13,24,11
9892,1,home,0,8,8
9892,2,work,8,15,7
9892,3,home,15,19,4
9892,4,shop,19,20,1
9892,5,home,20,24,4
9893,1,home,0,8,8
9893,2,work,8,16,8
9893,3,home,16,21,5
9893,4,work,21,22,1
9893,5,home,22,24,2
9894,1,home,0,8,8
9894,2,education,8,11,3
9894,3,home,11,18,7
9894,4,shop,18,20,2
9894,5,home,20,24,4
9895,1,home,0,7,7
9895,2,education,7,11,4
9895,3,home,11,19,8
9895,4,shop,19,20,1
9895,5,home,20,24,4
9896,1,home,0,7,7
9896,2,work,7,13,6
9896,3,home,13,21,8
9896,4,work,21,22,1
9896,5,home,22,24,2
9897,1,home,0,6,6
9897,2,work,6,13,7
9897,3,shop,13,14,1
9897,4,work,14,20,6
9897,5,home,20,24,4
9898,1,home,0,7,7
9898,2,shop,7,9,2
9898,3,education,9,12,3
9898,4,home,12,19,7
9898,5,shop,19,20,1
9898,6,home,20,24,4
9899,1,home,0,9,9
9899,2,work,9,16,7
9899,3,shop,16,17,1
9899,4,home,17,24,7
9900,1,home,0,6,6
9900,2,work,6,13,7
9900,3,home,13,17,4
9900,4,shop,17,18,1
9900,5,home,18,24,6
9901,1,home,0,8,8
9901,2,education,8,12,4
9901,3,shop,12,14,2
9901,4,education,14,16,2
9901,5,shop,16,17,1
9901,6,home,17,24,7
9902,1,home,0,6,6
9902,2,work,6,13,7
9902,3,home,13,21,8
9902,4,work,21,22,1
9902,5,home,22,24,2
9903,1,home,0,7,7
9903,2,work,7,15,8
9903,3,home,15,21,6
9903,4,shop,21,22,1
9903,5,home,22,24,2
9904,1,home,0,6,6
9904,2,work,6,13,7
9904,3,home,13,17,4
9904,4,work,17,20,3
9904,5,home,20,24,4
9905,1,home,0,7,7
9905,2,work,7,13,6
9905,3,shop,13,15,2
9905,4,home,15,23,8
9905,5,work,23,24,1
9906,1,home,0,7,7
9906,2,work,7,13,6
9906,3,home,13,14,1
9906,4,work,14,19,5
9906,5,home,19,24,5
9907,1,home,0,7,7
9907,2,shop,7,9,2
9907,3,education,9,12,3
9907,4,home,12,19,7
9907,5,shop,19,20,1
9907,6,home,20,24,4
9908,1,home,0,8,8
9908,2,work,8,14,6
9908,3,shop,14,15,1
9908,4,home,15,24,9
9909,1,home,0,8,8
9909,2,work,8,15,7
9909,3,home,15,24,9
9910,1,home,0,7,7
9910,2,shop,7,9,2
9910,3,education,9,13,4
9910,4,shop,13,15,2
9910,5,home,15,24,9
9911,1,home,0,8,8
9911,2,work,8,13,5
9911,3,home,13,18,5
9911,4,work,18,20,2
9911,5,home,20,24,4
9912,1,home,0,7,7
9912,2,work,7,14,7
9912,3,shop,14,15,1
9912,4,home,15,24,9
9913,1,work,0,1,1
9913,2,home,1,7,6
9913,3,education,7,11,4
9913,4,home,11,19,8
9913,5,shop,19,20,1
9913,6,home,20,24,4
9914,1,home,0,7,7
9914,2,shop,7,8,1
9914,3,education,8,11,3
9914,4,home,11,18,7
9914,5,shop,18,19,1
9914,6,home,19,24,5
9915,1,home,0,6,6
9915,2,shop,6,7,1
9915,3,home,7,13,6
9915,4,education,13,16,3
9915,5,home,16,20,4
9915,6,shop,20,21,1
9915,7,home,21,24,3
9916,1,home,0,6,6
9916,2,work,6,8,2
9916,3,home,8,12,4
9916,4,work,12,14,2
9916,5,home,14,21,7
9916,6,work,21,22,1
9916,7,home,22,24,2
9917,1,home,0,6,6
9917,2,work,6,8,2
9917,3,shop,8,9,1
9917,4,home,9,14,5
9917,5,work,14,16,2
9917,6,home,16,23,7
9917,7,work,23,24,1
9918,1,home,0,7,7
9918,2,work,7,14,7
9918,3,shop,14,15,1
9918,4,home,15,24,9
9919,1,home,0,7,7
9919,2,work,7,14,7
9919,3,home,14,24,10
9920,1,home,0,8,8
9920,2,work,8,16,8
9920,3,home,16,21,5
9920,4,shop,21,22,1
9920,5,home,22,24,2
9921,1,home,0,7,7
9921,2,work,7,13,6
9921,3,home,13,24,11
9922,1,home,0,7,7
9922,2,work,7,13,6
9922,3,home,13,24,11
9923,1,home,0,9,9
9923,2,work,9,16,7
9923,3,home,16,24,8
9924,1,home,0,7,7
9924,2,work,7,14,7
9924,3,shop,14,15,1
9924,4,home,15,24,9
9925,1,home,0,7,7
9925,2,work,7,13,6
9925,3,home,13,17,4
9925,4,work,17,20,3
9925,5,home,20,24,4
9926,1,home,0,6,6
9926,2,work,6,13,7
9926,3,home,13,24,11
9927,1,home,0,6,6
9927,2,work,6,13,7
9927,3,shop,13,14,1
9927,4,home,14,24,10
9928,1,home,0,8,8
9928,2,work,8,14,6
9928,3,shop,14,15,1
9928,4,work,15,20,5
9928,5,home,20,24,4
9929,1,home,0,6,6
9929,2,work,6,8,2
9929,3,home,8,12,4
9929,4,work,12,14,2
9929,5,home,14,21,7
9929,6,work,21,22,1
9929,7,home,22,24,2
9930,1,home,0,7,7
9930,2,work,7,13,6
9930,3,home,13,24,11
9931,1,home,0,7,7
9931,2,work,7,15,8
9931,3,home,15,24,9
9932,1,home,0,9,9
9932,2,work,9,15,6
9932,3,home,15,24,9
9933,1,home,0,6,6
9933,2,work,6,13,7
9933,3,shop,13,14,1
9933,4,home,14,21,7
9933,5,shop,21,22,1
9933,6,home,22,24,2
9934,1,home,0,6,6
9934,2,shop,6,7,1
9934,3,work,7,14,7
9934,4,home,14,24,10
9935,1,home,0,8,8
9935,2,work,8,15,7
9935,3,home,15,24,9
9936,1,home,0,6,6
9936,2,work,6,13,7
9936,3,shop,13,14,1
9936,4,home,14,24,10
9937,1,home,0,7,7
9937,2,work,7,14,7
9937,3,home,14,16,2
9937,4,shop,16,17,1
9937,5,home,17,24,7
9938,1,home,0,8,8
9938,2,work,8,15,7
9938,3,home,15,24,9
9939,1,home,0,7,7
9939,2,work,7,14,7
9939,3,home,14,24,10
9940,1,home,0,7,7
9940,2,work,7,14,7
9940,3,shop,14,15,1
9940,4,home,15,24,9
9941,1,home,0,6,6
9941,2,work,6,13,7
9941,3,home,13,16,3
9941,4,work,16,19,3
9941,5,home,19,24,5
9942,1,home,0,7,7
9942,2,work,7,13,6
9942,3,shop,13,14,1
9942,4,work,14,19,5
9942,5,home,19,24,5
9943,1,home,0,6,6
9943,2,work,6,13,7
9943,3,home,13,24,11
9944,1,home,0,8,8
9944,2,work,8,15,7
9944,3,shop,15,16,1
9944,4,home,16,21,5
9944,5,work,21,22,1
9944,6,home,22,24,2
9945,1,home,0,7,7
9945,2,work,7,14,7
9945,3,home,14,18,4
9945,4,work,18,19,1
9945,5,home,19,24,5
9946,1,home,0,8,8
9946,2,education,8,12,4
9946,3,home,12,17,5
9946,4,shop,17,18,1
9946,5,work,18,20,2
9946,6,home,20,24,4
9947,1,home,0,6,6
9947,2,shop,6,7,1
9947,3,home,7,10,3
9947,4,education,10,13,3
9947,5,home,13,20,7
9947,6,shop,20,21,1
9947,7,home,21,24,3
9948,1,home,0,6,6
9948,2,shop,6,7,1
9948,3,home,7,13,6
9948,4,education,13,16,3
9948,5,home,16,24,8
9949,1,home,0,7,7
9949,2,education,7,10,3
9949,3,home,10,15,5
9949,4,shop,15,16,1
9949,5,home,16,24,8
9950,1,work,0,7,7
9950,2,shop,7,8,1
9950,3,work,8,15,7
9950,4,home,15,24,9
9951,1,home,0,8,8
9951,2,work,8,15,7
9951,3,home,15,17,2
9951,4,work,17,20,3
9951,5,home,20,24,4
9952,1,work,0,7,7
9952,2,shop,7,8,1
9952,3,work,8,15,7
9952,4,home,15,21,6
9952,5,work,21,22,1
9952,6,home,22,24,2
9953,1,home,0,7,7
9953,2,work,7,13,6
9953,3,home,13,24,11
9954,1,home,0,6,6
9954,2,work,6,14,8
9954,3,shop,14,15,1
9954,4,work,15,20,5
9954,5,home,20,24,4
9955,1,home,0,8,8
9955,2,work,8,15,7
9955,3,home,15,24,9
9956,1,home,0,7,7
9956,2,shop,7,8,1
9956,3,home,8,16,8
9956,4,work,16,20,4
9956,5,home,20,24,4
9957,1,home,0,7,7
9957,2,shop,7,8,1
9957,3,education,8,11,3
9957,4,home,11,19,8
9957,5,shop,19,20,1
9957,6,home,20,24,4
9958,1,home,0,6,6
9958,2,shop,6,7,1
9958,3,home,7,9,2
9958,4,work,9,15,6
9958,5,home,15,24,9
9959,1,home,0,7,7
9959,2,work,7,13,6
9959,3,home,13,18,5
9959,4,work,18,20,2
9959,5,home,20,24,4
9960,1,home,0,9,9
9960,2,work,9,17,8
9960,3,home,17,22,5
9960,4,work,22,23,1
9960,5,home,23,24,1
9961,1,home,0,7,7
9961,2,work,7,13,6
9961,3,home,13,17,4
9961,4,work,17,20,3
9961,5,home,20,24,4
9962,1,home,0,7,7
9962,2,work,7,14,7
9962,3,home,14,20,6
9962,4,shop,20,21,1
9962,5,home,21,24,3
9963,1,home,0,7,7
9963,2,work,7,14,7
9963,3,home,14,24,10
9964,1,home,0,8,8
9964,2,education,8,12,4
9964,3,home,12,19,7
9964,4,shop,19,20,1
9964,5,home,20,24,4
9965,1,home,0,8,8
9965,2,education,8,11,3
9965,3,home,11,15,4
9965,4,work,15,20,5
9965,5,home,20,24,4
9966,1,home,0,7,7
9966,2,shop,7,8,1
9966,3,work,8,15,7
9966,4,home,15,24,9
9967,1,home,0,6,6
9967,2,shop,6,7,1
9967,3,work,7,14,7
9967,4,home,14,24,10
9968,1,home,0,8,8
9968,2,work,8,15,7
9968,3,shop,15,16,1
9968,4,work,16,19,3
9968,5,home,19,24,5
9969,1,home,0,7,7
9969,2,education,7,11,4
9969,3,home,11,13,2
9969,4,education,13,16,3
9969,5,home,16,21,5
9969,6,shop,21,22,1
9969,7,home,22,24,2
9970,1,home,0,6,6
9970,2,work,6,7,1
9970,3,home,7,11,4
9970,4,work,11,13,2
9970,5,shop,13,14,1
9970,6,home,14,22,8
9970,7,work,22,23,1
9970,8,home,23,24,1
9971,1,home,0,7,7
9971,2,education,7,12,5
9971,3,shop,12,14,2
9971,4,education,14,16,2
9971,5,home,16,24,8
9972,1,home,0,7,7
9972,2,education,7,11,4
9972,3,home,11,19,8
9972,4,shop,19,21,2
9972,5,home,21,24,3
9973,1,home,0,7,7
9973,2,education,7,11,4
9973,3,home,11,18,7
9973,4,shop,18,20,2
9973,5,home,20,24,4
9974,1,home,0,7,7
9974,2,work,7,14,7
9974,3,shop,14,15,1
9974,4,home,15,24,9
9975,1,home,0,7,7
9975,2,work,7,9,2
9975,3,home,9,15,6
9975,4,work,15,17,2
9975,5,home,17,24,7
9976,1,home,0,6,6
9976,2,shop,6,7,1
9976,3,home,7,10,3
9976,4,education,10,13,3
9976,5,shop,13,15,2
9976,6,home,15,21,6
9976,7,shop,21,22,1
9976,8,home,22,24,2
9977,1,home,0,7,7
9977,2,work,7,13,6
9977,3,home,13,24,11
9978,1,home,0,7,7
9978,2,education,7,11,4
9978,3,home,11,15,4
9978,4,shop,15,17,2
9978,5,home,17,24,7
9979,1,home,0,7,7
9979,2,work,7,14,7
9979,3,shop,14,15,1
9979,4,home,15,23,8
9979,5,work,23,24,1
9980,1,home,0,6,6
9980,2,work,6,7,1
9980,3,home,7,11,4
9980,4,work,11,12,1
9980,5,home,12,21,9
9980,6,work,21,22,1
9980,7,home,22,24,2
9981,1,home,0,7,7
9981,2,work,7,15,8
9981,3,home,15,23,8
9981,4,work,23,24,1
9982,1,home,0,7,7
9982,2,shop,7,9,2
9982,3,education,9,12,3
9982,4,home,12,18,6
9982,5,shop,18,20,2
9982,6,home,20,24,4
9983,1,home,0,7,7
9983,2,work,7,14,7
9983,3,shop,14,15,1
9983,4,home,15,19,4
9983,5,shop,19,20,1
9983,6,home,20,24,4
9984,1,home,0,7,7
9984,2,work,7,14,7
9984,3,shop,14,15,1
9984,4,work,15,20,5
9984,5,home,20,24,4
9985,1,home,0,6,6
9985,2,work,6,13,7
9985,3,home,13,24,11
9986,1,home,0,8,8
9986,2,work,8,13,5
9986,3,home,13,16,3
9986,4,work,16,20,4
9986,5,home,20,24,4
9987,1,home,0,8,8
9987,2,education,8,11,3
9987,3,home,11,14,3
9987,4,education,14,16,2
9987,5,home,16,24,8
9988,1,home,0,9,9
9988,2,work,9,16,7
9988,3,home,16,24,8
9989,1,home,0,7,7
9989,2,education,7,11,4
9989,3,home,11,17,6
9989,4,shop,17,18,1
9989,5,home,18,24,6
9990,1,home,0,6,6
9990,2,work,6,12,6
9990,3,shop,12,13,1
9990,4,work,13,19,6
9990,5,home,19,24,5
9991,1,home,0,7,7
9991,2,work,7,13,6
9991,3,home,13,22,9
9991,4,work,22,23,1
9991,5,home,23,24,1
9992,1,home,0,7,7
9992,2,education,7,12,5
9992,3,home,12,19,7
9992,4,shop,19,20,1
9992,5,home,20,24,4
9993,1,home,0,6,6
9993,2,work,6,7,1
9993,3,home,7,14,7
9993,4,work,14,17,3
9993,5,home,17,23,6
9993,6,work,23,24,1
9994,1,home,0,7,7
9994,2,work,7,13,6
9994,3,home,13,17,4
9994,4,work,17,20,3
9994,5,home,20,24,4
9995,1,home,0,8,8
9995,2,work,8,13,5
9995,3,shop,13,14,1
9995,4,work,14,20,6
9995,5,home,20,24,4
9996,1,home,0,7,7
9996,2,shop,7,8,1
9996,3,work,8,15,7
9996,4,home,15,24,9
9997,1,home,0,6,6
9997,2,shop,6,7,1
9997,3,home,7,13,6
9997,4,education,13,16,3
9997,5,home,16,24,8
9998,1,home,0,8,8
9998,2,work,8,15,7
9998,3,home,15,19,4
9998,4,shop,19,20,1
9998,5,home,20,24,4
9999,1,home,0,6,6
9999,2,work,6,8,2
9999,3,home,8,12,4
9999,4,work,12,14,2
9999,5,home,14,21,7
9999,6,work,21,22,1
9999,7,home,22,24,2
